sp,N,N_geoOK,N_geoKO,rangeMethod,Ncells
Abarema_abbottii,3,3,0,Points-PointsKO-Adjacents,21
Abarema_acreana,18,9,9,Points-PointsKO-Adjacents,162
Abarema_adenophora,141,77,64,Alphahull-PointsKO-Adjacents,4552
Abarema_alexandri,2,2,0,Points-PointsKO-Adjacents,18
Abarema_asplenifolia,1,1,0,Points-PointsKO-Adjacents,8
Abarema_auriculata,74,40,34,Alphahull-PointsKO-Adjacents,2275
Abarema_barbouriana,304,221,83,Alphahull-PointsKO-Adjacents,21281
Abarema_brachystachya,172,0,172,Points-PointsKO-Adjacents,976
Abarema_callejasii,14,6,8,Points-PointsKO-Adjacents,94
Abarema_campestris,35,10,25,Points-PointsKO-Adjacents,245
Abarema_centiflora,2,2,0,Points-PointsKO-Adjacents,18
Abarema_cochleata,157,112,45,Alphahull-PointsKO-Adjacents,6740
Abarema_cochliocarpos,37,18,19,Points-PointsKO-Adjacents,212
Abarema_commutata,9,3,6,Points-PointsKO-Adjacents,81
Abarema_curvicarpa,24,7,17,Points-PointsKO-Adjacents,165
Abarema_ferruginea,8,0,8,Points-PointsKO-Adjacents,48
Abarema_filamentosa,280,217,63,Alphahull-PointsKO-Adjacents,2064
Abarema_floribunda,85,41,44,Alphahull-PointsKO-Adjacents,2906
Abarema_gallorum,6,2,4,Points-PointsKO-Adjacents,41
Abarema_ganymedea,8,2,6,Points-PointsKO-Adjacents,61
Abarema_glauca,19,1,18,Points-PointsKO-Adjacents,134
Abarema_idiopoda,103,69,34,Alphahull-PointsKO-Adjacents,1160
Abarema_josephi,6,1,5,Points-PointsKO-Adjacents,54
Abarema_jupunba,1143,995,148,Alphahull-PointsKO-Adjacents,82831
Abarema_killipii,48,29,19,Alphahull-PointsKO-Adjacents,408
Abarema_laeta,218,168,50,Alphahull-PointsKO-Adjacents,17332
Abarema_langsdorffii,311,257,54,Alphahull-PointsKO-Adjacents,4390
Abarema_lehmannii,60,47,13,Alphahull-PointsKO-Adjacents,497
Abarema_leucophylla,72,55,17,Alphahull-PointsKO-Adjacents,2135
Abarema_levelii,9,1,8,Points-PointsKO-Adjacents,63
Abarema_longipedunculata,15,6,9,Points-PointsKO-Adjacents,102
Abarema_macradenia,58,40,18,Alphahull-PointsKO-Adjacents,584
Abarema_mataybifolia,57,28,29,Alphahull-PointsKO-Adjacents,4898
Abarema_microcalyx,88,49,39,Alphahull-PointsKO-Adjacents,2163
Abarema_nipensis,3,3,0,Points-PointsKO-Adjacents,25
Abarema_obovalis,24,9,15,Points-PointsKO-Adjacents,179
Abarema_obovata,10,0,10,Points-PointsKO-Adjacents,87
Abarema_oppositifolia,17,9,8,Points-PointsKO-Adjacents,105
Abarema_oxyphyllidia,3,3,0,Points-PointsKO-Adjacents,27
Abarema_racemiflora,20,15,5,Points-PointsKO-Adjacents,99
Abarema_turbinata,61,41,20,Alphahull-PointsKO-Adjacents,267
Abarema_villifera,13,0,13,Points-PointsKO-Adjacents,88
Abarema_zolleriana,14,4,10,Points-PointsKO-Adjacents,96
Abatia_mexicana,33,22,11,Alphahull-PointsKO-Adjacents,395
Abatia_parviflora,251,206,45,Alphahull-PointsKO-Adjacents,2706
Abatia_rugosa,5,5,0,Points-PointsKO-Adjacents,30
Abatia_spicata,7,0,7,Points-PointsKO-Adjacents,51
Abelia_corymbosa,0,0,0,NA,0
Abeliophyllum_distichum,1,1,0,Points-PointsKO-Adjacents,9
Abies_alba,8215,7585,630,Alphahull-PointsKO-Adjacents,34631
Abies_amabilis,1492,1455,37,Alphahull-PointsKO-Adjacents,5879
Abies_balsamea,13381,13128,253,Alphahull-PointsKO-Adjacents,47637
Abies_beshanzuensis,1,1,0,Points-PointsKO-Adjacents,9
Abies_bracteata,78,65,13,Alphahull-PointsKO-Adjacents,113
Abies_cephalonica,38,30,8,Alphahull-PointsKO-Adjacents,754
Abies_chensiensis,38,22,16,Alphahull-PointsKO-Adjacents,1024
Abies_cilicica,21,11,10,Points-PointsKO-Adjacents,151
Abies_concolor,4937,4870,67,Alphahull-PointsKO-Adjacents,25907
Abies_delavayi,59,37,22,Alphahull-PointsKO-Adjacents,933
Abies_densa,16,0,16,Points-PointsKO-Adjacents,129
Abies_durangensis,110,81,29,Alphahull-PointsKO-Adjacents,3836
Abies_fabri,25,14,11,Points-PointsKO-Adjacents,195
Abies_fanjingshanensis,NA,NA,NA,NA,NA
Abies_fargesii,69,50,19,Alphahull-PointsKO-Adjacents,2145
Abies_firma,173,121,52,Alphahull-PointsKO-Adjacents,1679
Abies_forrestii,95,80,15,Alphahull-PointsKO-Adjacents,1438
Abies_fraseri,51,47,4,Alphahull-PointsKO-Adjacents,347
Abies_grandis,4608,4516,92,Alphahull-PointsKO-Adjacents,10821
Abies_guatemalensis,221,180,41,Alphahull-PointsKO-Adjacents,4486
Abies_hickelii,96,82,14,Alphahull-PointsKO-Adjacents,1158
Abies_hidalgensis,6,3,3,Points-PointsKO-Adjacents,36
Abies_holophylla,10,7,3,Points-PointsKO-Adjacents,72
Abies_homolepis,69,51,18,Alphahull-PointsKO-Adjacents,365
Abies_jaliscana,6,2,4,Points-PointsKO-Adjacents,44
Abies_kawakamii,80,72,8,Alphahull-PointsKO-Adjacents,93
Abies_koreana,7,3,4,Points-PointsKO-Adjacents,24
Abies_lasiocarpa,12154,0,12154,Points-PointsKO-Adjacents,11486
Abies_magnifica,1018,0,1018,Points-PointsKO-Adjacents,1733
Abies_mariesii,49,34,15,Alphahull-PointsKO-Adjacents,444
Abies_nebrodensis,3,3,0,Points-PointsKO-Adjacents,12
Abies_nephrolepis,16,2,14,Points-PointsKO-Adjacents,144
Abies_nordmanniana,36,17,19,Points-PointsKO-Adjacents,266
Abies_numidica,1,1,0,Points-PointsKO-Adjacents,9
Abies_pindrow,45,22,23,Alphahull-PointsKO-Adjacents,734
Abies_pinsapo,192,162,30,Alphahull-PointsKO-Adjacents,3034
Abies_procera,456,0,456,Points-PointsKO-Adjacents,1195
Abies_recurvata,35,26,9,Alphahull-PointsKO-Adjacents,1424
Abies_religiosa,565,528,37,Alphahull-PointsKO-Adjacents,5131
Abies_sachalinensis,19,9,10,Points-PointsKO-Adjacents,153
Abies_sibirica,41,9,32,Points-PointsKO-Adjacents,369
Abies_spectabilis,33,0,33,Points-PointsKO-Adjacents,218
Abies_squamata,29,19,10,Points-PointsKO-Adjacents,218
Abies_veitchii,29,16,13,Points-PointsKO-Adjacents,144
Abies_vejarii,72,0,72,Points-PointsKO-Adjacents,260
Abies_yuanbaoshanensis,1,1,0,Points-PointsKO-Adjacents,9
Abies_ziyuanensis,1,1,0,Points-PointsKO-Adjacents,9
Abrahamia_deflexa,17,2,15,Points-PointsKO-Adjacents,148
Abrahamia_ditimena,135,113,22,Alphahull-PointsKO-Adjacents,1968
Abrahamia_grandidieri,72,54,18,Alphahull-PointsKO-Adjacents,2124
Abrahamia_humbertii,11,2,9,Points-PointsKO-Adjacents,68
Abrahamia_latifolia,8,3,5,Points-PointsKO-Adjacents,55
Abrahamia_lecomtei,15,6,9,Points-PointsKO-Adjacents,85
Abrahamia_louvelii,6,1,5,Points-PointsKO-Adjacents,41
Abrahamia_oblongifolia,14,0,14,Points-PointsKO-Adjacents,73
Abrahamia_sericea,73,52,21,Alphahull-PointsKO-Adjacents,766
Abrahamia_thouvenotii,53,39,14,Alphahull-PointsKO-Adjacents,371
Abrahamia_viguieri,23,1,22,Points-PointsKO-Adjacents,135
Abuta_grandifolia,1152,1092,60,Alphahull-PointsKO-Adjacents,81890
Abuta_grisebachii,26,4,22,Points-PointsKO-Adjacents,216
Abuta_imene,91,32,59,Alphahull-PointsKO-Adjacents,7024
Abuta_panurensis,14,0,14,Points-PointsKO-Adjacents,120
Abuta_rufescens,78,28,50,Alphahull-PointsKO-Adjacents,3036
Abuta_sandwithiana,129,70,59,Alphahull-PointsKO-Adjacents,10546
Abuta_seemannii,13,6,7,Points-PointsKO-Adjacents,57
Abuta_velutina,22,5,17,Points-PointsKO-Adjacents,162
Abutilon_giganteum,80,38,42,Alphahull-PointsKO-Adjacents,3455
Abutilon_grandidentatum,16,12,4,Points-PointsKO-Adjacents,51
Abutilon_haenkeanum,4,4,0,Points-PointsKO-Adjacents,36
Abutilon_herzogianum,23,18,5,Points-PointsKO-Adjacents,149
Abutilon_incanum,368,319,49,Alphahull-PointsKO-Adjacents,6360
Abutilon_leonardii,0,0,0,NA,0
Abutilon_peruvianum,34,14,20,Points-PointsKO-Adjacents,218
Abutilon_purpusii,83,55,28,Alphahull-PointsKO-Adjacents,1168
Abutilon_pyramidale,3,3,0,Points-PointsKO-Adjacents,24
Abutilon_sachetianum,1,1,0,Points-PointsKO-Adjacents,3
Abutilon_stenopetalum,7,0,7,Points-PointsKO-Adjacents,32
Abutilon_thyrsodendron,36,25,11,Alphahull-PointsKO-Adjacents,636
Abutilon_venosum,2,2,0,Points-PointsKO-Adjacents,18
Acacia_acradenia,626,584,42,Alphahull-PointsKO-Adjacents,22716
Acacia_acrionastes,35,28,7,Alphahull-PointsKO-Adjacents,72
Acacia_acuminata,945,908,37,Alphahull-PointsKO-Adjacents,9925
Acacia_adsurgens,474,431,43,Alphahull-PointsKO-Adjacents,18016
Acacia_adunca,144,125,19,Alphahull-PointsKO-Adjacents,645
Acacia_aestivalis,108,0,108,Points-PointsKO-Adjacents,457
Acacia_alleniana,268,242,26,Alphahull-PointsKO-Adjacents,3480
Acacia_amblyophylla,11,3,8,Points-PointsKO-Adjacents,49
Acacia_amentacea,50,38,12,Alphahull-PointsKO-Adjacents,482
Acacia_ammobia,90,81,9,Alphahull-PointsKO-Adjacents,227
Acacia_ammophila,25,24,1,Alphahull-PointsKO-Adjacents,39
Acacia_amoena,130,112,18,Alphahull-PointsKO-Adjacents,1397
Acacia_ampliata,14,0,14,Points-PointsKO-Adjacents,95
Acacia_ampliceps,307,0,307,Points-PointsKO-Adjacents,1262
Acacia_anastema,31,23,8,Alphahull-PointsKO-Adjacents,160
Acacia_anaticeps,45,38,7,Alphahull-PointsKO-Adjacents,1172
Acacia_ancistrocarpa,905,861,44,Alphahull-PointsKO-Adjacents,17836
Acacia_aneura,6721,6661,60,Alphahull-PointsKO-Adjacents,51792
Acacia_anfractuosa,94,86,8,Alphahull-PointsKO-Adjacents,350
Acacia_angusta,169,130,39,Alphahull-PointsKO-Adjacents,3514
Acacia_anisophylla,36,22,14,Alphahull-PointsKO-Adjacents,369
Acacia_anthochaera,144,135,9,Alphahull-PointsKO-Adjacents,729
Acacia_aprepta,86,68,18,Alphahull-PointsKO-Adjacents,785
Acacia_aptaneura,702,629,73,Alphahull-PointsKO-Adjacents,29608
Acacia_arafurica,22,18,4,Points-PointsKO-Adjacents,121
Acacia_araneosa,41,37,4,Alphahull-PointsKO-Adjacents,29
Acacia_arenaria,17,3,14,Points-PointsKO-Adjacents,147
Acacia_areolata,42,36,6,Alphahull-PointsKO-Adjacents,176
Acacia_argyrodendron,81,66,15,Alphahull-PointsKO-Adjacents,1819
Acacia_armillata,25,13,12,Points-PointsKO-Adjacents,119
Acacia_armitii,36,19,17,Points-PointsKO-Adjacents,163
Acacia_asak,9,2,7,Points-PointsKO-Adjacents,81
Acacia_assimilis,479,456,23,Alphahull-PointsKO-Adjacents,3362
Acacia_atopa,22,19,3,Points-PointsKO-Adjacents,137
Acacia_attenuata,40,27,13,Alphahull-PointsKO-Adjacents,118
Acacia_aulacocarpa,482,429,53,Alphahull-PointsKO-Adjacents,6740
Acacia_auriculiformis,1329,0,1329,Points-PointsKO-Adjacents,2679
Acacia_auripila,4,4,0,Points-PointsKO-Adjacents,18
Acacia_ausfeldii,181,166,15,Alphahull-PointsKO-Adjacents,221
Acacia_axillaris,63,56,7,Alphahull-PointsKO-Adjacents,154
Acacia_ayersiana,538,481,57,Alphahull-PointsKO-Adjacents,18042
Acacia_baileyana,988,741,247,Alphahull-PointsKO-Adjacents,7780
Acacia_bakeri,145,0,145,Points-PointsKO-Adjacents,266
Acacia_bancroftiorum,289,257,32,Alphahull-PointsKO-Adjacents,3725
Acacia_barrettiorum,8,3,5,Points-PointsKO-Adjacents,39
Acacia_beauverdiana,145,0,145,Points-PointsKO-Adjacents,538
Acacia_binervata,1190,1097,93,Alphahull-PointsKO-Adjacents,1632
Acacia_binervia,681,536,145,Alphahull-PointsKO-Adjacents,1864
Acacia_blakei,591,560,31,Alphahull-PointsKO-Adjacents,5397
Acacia_blakelyi,311,292,19,Alphahull-PointsKO-Adjacents,737
Acacia_blayana,20,18,2,Points-PointsKO-Adjacents,37
Acacia_brachystachya,670,618,52,Alphahull-PointsKO-Adjacents,25704
Acacia_brassii,116,98,18,Alphahull-PointsKO-Adjacents,722
Acacia_brevispica,160,110,50,Alphahull-PointsKO-Adjacents,7630
Acacia_brockii,50,40,10,Alphahull-PointsKO-Adjacents,126
Acacia_bromilowiana,19,13,6,Points-PointsKO-Adjacents,122
Acacia_brumalis,106,95,11,Alphahull-PointsKO-Adjacents,976
Acacia_bulgaensis,42,36,6,Alphahull-PointsKO-Adjacents,50
Acacia_burrowii,323,304,19,Alphahull-PointsKO-Adjacents,3814
Acacia_burrowsiana,11,7,4,Points-PointsKO-Adjacents,64
Acacia_caerulescens,30,23,7,Alphahull-PointsKO-Adjacents,54
Acacia_caesaneura,310,283,27,Alphahull-PointsKO-Adjacents,3846
Acacia_caesia,14,3,11,Points-PointsKO-Adjacents,90
Acacia_caesiella,238,219,19,Alphahull-PointsKO-Adjacents,1446
Acacia_calamifolia,1438,1401,37,Alphahull-PointsKO-Adjacents,8433
Acacia_calcicola,363,310,53,Alphahull-PointsKO-Adjacents,12429
Acacia_cambagei,1014,983,31,Alphahull-PointsKO-Adjacents,21890
Acacia_cana,159,127,32,Alphahull-PointsKO-Adjacents,1656
Acacia_cangaiensis,32,22,10,Alphahull-PointsKO-Adjacents,55
Acacia_cardiophylla,121,87,34,Alphahull-PointsKO-Adjacents,2021
Acacia_carneorum,239,230,9,Alphahull-PointsKO-Adjacents,1336
Acacia_caroleae,516,490,26,Alphahull-PointsKO-Adjacents,3977
Acacia_catenulata,177,149,28,Alphahull-PointsKO-Adjacents,4458
Acacia_celastrifolia,135,123,12,Alphahull-PointsKO-Adjacents,520
Acacia_celsa,115,96,19,Alphahull-PointsKO-Adjacents,264
Acacia_chartacea,93,81,12,Alphahull-PointsKO-Adjacents,284
Acacia_cheelii,210,193,17,Alphahull-PointsKO-Adjacents,1741
Acacia_chiapensis,18,12,6,Points-PointsKO-Adjacents,83
Acacia_chrysotricha,18,11,7,Points-PointsKO-Adjacents,24
Acacia_cincinnata,126,84,42,Alphahull-PointsKO-Adjacents,397
Acacia_citrinoviridis,162,145,17,Alphahull-PointsKO-Adjacents,3158
Acacia_clunies-rossiae,101,95,6,Alphahull-PointsKO-Adjacents,44
Acacia_cockertoniana,64,56,8,Alphahull-PointsKO-Adjacents,463
Acacia_cognata,359,0,359,Points-PointsKO-Adjacents,454
Acacia_colei,690,648,42,Alphahull-PointsKO-Adjacents,15292
Acacia_colletioides,1488,1418,70,Alphahull-PointsKO-Adjacents,12322
Acacia_complanata,483,0,483,Points-PointsKO-Adjacents,1153
Acacia_concinna,7,0,7,Points-PointsKO-Adjacents,29
Acacia_concurrens,773,680,93,Alphahull-PointsKO-Adjacents,3753
Acacia_conferta,570,539,31,Alphahull-PointsKO-Adjacents,5896
Acacia_confusa,219,129,90,Alphahull-PointsKO-Adjacents,1599
Acacia_conniana,56,40,16,Alphahull-PointsKO-Adjacents,210
Acacia_conspersa,139,116,23,Alphahull-PointsKO-Adjacents,2723
Acacia_convallium,55,49,6,Alphahull-PointsKO-Adjacents,352
Acacia_coolgardiensis,371,351,20,Alphahull-PointsKO-Adjacents,4906
Acacia_coriacea,270,232,38,Alphahull-PointsKO-Adjacents,12947
Acacia_courtii,10,5,5,Points-PointsKO-Adjacents,18
Acacia_covenyi,25,17,8,Points-PointsKO-Adjacents,95
Acacia_cowaniana,6,4,2,Points-PointsKO-Adjacents,32
Acacia_cowleana,645,587,58,Alphahull-PointsKO-Adjacents,15366
Acacia_craspedocarpa,293,268,25,Alphahull-PointsKO-Adjacents,3240
Acacia_crassa,509,491,18,Alphahull-PointsKO-Adjacents,4487
Acacia_crassicarpa,323,285,38,Alphahull-PointsKO-Adjacents,2416
Acacia_crassiuscula,68,49,19,Alphahull-PointsKO-Adjacents,547
Acacia_crenulata,14,9,5,Points-PointsKO-Adjacents,80
Acacia_cretacea,27,22,5,Alphahull-PointsKO-Adjacents,44
Acacia_cretata,84,76,8,Alphahull-PointsKO-Adjacents,908
Acacia_crombiei,40,32,8,Alphahull-PointsKO-Adjacents,245
Acacia_cultriformis,324,0,324,Points-PointsKO-Adjacents,937
Acacia_cuspidifolia,49,37,12,Alphahull-PointsKO-Adjacents,1860
Acacia_cuthbertsonii,477,0,477,Points-PointsKO-Adjacents,2289
Acacia_cyclops,720,610,110,Alphahull-PointsKO-Adjacents,3078
Acacia_cyperophylla,322,280,42,Alphahull-PointsKO-Adjacents,8037
Acacia_dallachiana,79,75,4,Alphahull-PointsKO-Adjacents,162
Acacia_dangarensis,8,0,8,Points-PointsKO-Adjacents,16
Acacia_davyi,47,35,12,Alphahull-PointsKO-Adjacents,656
Acacia_dawsonii,263,237,26,Alphahull-PointsKO-Adjacents,1408
Acacia_dealbata,4346,4181,165,Alphahull-PointsKO-Adjacents,8717
Acacia_deanei,2799,0,2799,Points-PointsKO-Adjacents,4792
Acacia_debilis,89,74,15,Alphahull-PointsKO-Adjacents,936
Acacia_decora,2550,2470,80,Alphahull-PointsKO-Adjacents,14021
Acacia_decurrens,1510,1105,405,Alphahull-PointsKO-Adjacents,7401
Acacia_delibrata,85,73,12,Alphahull-PointsKO-Adjacents,522
Acacia_demissa,56,48,8,Alphahull-PointsKO-Adjacents,548
Acacia_dempsteri,57,50,7,Alphahull-PointsKO-Adjacents,357
Acacia_dentifera,110,85,25,Alphahull-PointsKO-Adjacents,463
Acacia_desertorum,57,0,57,Points-PointsKO-Adjacents,244
Acacia_desmondii,22,19,3,Points-PointsKO-Adjacents,75
Acacia_didyma,20,14,6,Points-PointsKO-Adjacents,48
Acacia_dietrichiana,119,102,17,Alphahull-PointsKO-Adjacents,2337
Acacia_difficilis,1307,1262,45,Alphahull-PointsKO-Adjacents,7597
Acacia_difformis,217,197,20,Alphahull-PointsKO-Adjacents,1836
Acacia_disparrima,404,329,75,Alphahull-PointsKO-Adjacents,2535
Acacia_distans,59,47,12,Alphahull-PointsKO-Adjacents,873
Acacia_dodonaeifolia,221,185,36,Alphahull-PointsKO-Adjacents,929
Acacia_dolichophylla,28,24,4,Alphahull-PointsKO-Adjacents,35
Acacia_donaldsonii,35,21,14,Alphahull-PointsKO-Adjacents,673
Acacia_doratoxylon,1534,0,1534,Points-PointsKO-Adjacents,2768
Acacia_drepanophylla,23,0,23,Points-PointsKO-Adjacents,116
Acacia_dunnii,191,1,190,Points-PointsKO-Adjacents,758
Acacia_duriuscula,62,50,12,Alphahull-PointsKO-Adjacents,2176
Acacia_echinuliflora,36,33,3,Alphahull-PointsKO-Adjacents,119
Acacia_effusifolia,327,305,22,Alphahull-PointsKO-Adjacents,3540
Acacia_elachantha,470,422,48,Alphahull-PointsKO-Adjacents,16112
Acacia_elata,658,511,147,Alphahull-PointsKO-Adjacents,1119
Acacia_elongata,1006,0,1006,Points-PointsKO-Adjacents,1182
Acacia_enervia,167,151,16,Alphahull-PointsKO-Adjacents,1789
Acacia_ensifolia,100,87,13,Alphahull-PointsKO-Adjacents,1306
Acacia_ephedroides,77,70,7,Alphahull-PointsKO-Adjacents,794
Acacia_eremaea,100,0,100,Points-PointsKO-Adjacents,448
Acacia_eriopoda,270,237,33,Alphahull-PointsKO-Adjacents,7101
Acacia_erubescens,97,55,42,Alphahull-PointsKO-Adjacents,3565
Acacia_estrophiolata,744,714,30,Alphahull-PointsKO-Adjacents,5807
Acacia_excelsa,648,614,34,Alphahull-PointsKO-Adjacents,13206
Acaena_exigua,0,0,0,NA,0
Acacia_exudans,25,16,9,Points-PointsKO-Adjacents,91
Acacia_falcata,1962,1622,340,Alphahull-PointsKO-Adjacents,4847
Acacia_falciformis,2724,0,2724,Points-PointsKO-Adjacents,3139
Acacia_fasciculifera,153,126,27,Alphahull-PointsKO-Adjacents,2221
Acacia_fauntleroyi,55,41,14,Alphahull-PointsKO-Adjacents,280
Acacia_filicifolia,1163,1129,34,Alphahull-PointsKO-Adjacents,2531
Acacia_filifolia,39,0,39,Points-PointsKO-Adjacents,209
Acacia_fimbriata,1317,1131,186,Alphahull-PointsKO-Adjacents,6856
Acacia_flavescens,322,0,322,Points-PointsKO-Adjacents,1053
Acacia_fleckeri,44,36,8,Alphahull-PointsKO-Adjacents,141
Acacia_fleckii,77,56,21,Alphahull-PointsKO-Adjacents,7236
Acacia_flocktoniae,36,0,36,Points-PointsKO-Adjacents,99
Acacia_floribunda,2146,1807,339,Alphahull-PointsKO-Adjacents,4812
Acacia_floydii,39,32,7,Alphahull-PointsKO-Adjacents,49
Acacia_frigescens,60,48,12,Alphahull-PointsKO-Adjacents,141
Acacia_fulva,47,41,6,Alphahull-PointsKO-Adjacents,54
Acacia_fuscaneura,198,176,22,Alphahull-PointsKO-Adjacents,4449
Acacia_galeata,41,32,9,Alphahull-PointsKO-Adjacents,182
Acacia_gardneri,36,28,8,Alphahull-PointsKO-Adjacents,226
Acacia_georgensis,42,37,5,Alphahull-PointsKO-Adjacents,45
Acacia_georginae,512,488,24,Alphahull-PointsKO-Adjacents,251
Acacia_gerrardii,296,221,75,Alphahull-PointsKO-Adjacents,24255
Acacia_gibbosa,68,63,5,Alphahull-PointsKO-Adjacents,864
Acacia_gillii,243,229,14,Alphahull-PointsKO-Adjacents,191
Acacia_glaucocaesia,21,15,6,Points-PointsKO-Adjacents,122
Acacia_glaucocarpa,207,0,207,Points-PointsKO-Adjacents,807
Acacia_gnidium,49,31,18,Alphahull-PointsKO-Adjacents,1703
Acacia_goetzei,67,27,40,Alphahull-PointsKO-Adjacents,2747
Acacia_gonocarpa,658,630,28,Alphahull-PointsKO-Adjacents,5637
Acacia_gonoclada,370,334,36,Alphahull-PointsKO-Adjacents,12263
Acacia_grandifolia,42,33,9,Alphahull-PointsKO-Adjacents,88
Acacia_grasbyi,213,177,36,Alphahull-PointsKO-Adjacents,6636
Acacia_guarensis,NA,NA,NA,NA,NA
Acacia_gummifera,2,1,1,Points-PointsKO-Adjacents,18
Acacia_hakeoides,2621,2527,94,Alphahull-PointsKO-Adjacents,10162
Acacia_hamersleyensis,110,100,10,Alphahull-PointsKO-Adjacents,397
Acacia_hammondii,552,515,37,Alphahull-PointsKO-Adjacents,8186
Acacia_hamulosa,44,18,26,Points-PointsKO-Adjacents,346
Acacia_harmandiana,0,0,0,NA,0
Acacia_harpophylla,732,691,41,Alphahull-PointsKO-Adjacents,10395
Acacia_havilandiorum,471,445,26,Alphahull-PointsKO-Adjacents,6868
Acacia_hebeclada,102,67,35,Alphahull-PointsKO-Adjacents,10748
Acacia_hemignosta,944,895,49,Alphahull-PointsKO-Adjacents,16331
Acacia_hemsleyi,245,200,45,Alphahull-PointsKO-Adjacents,9523
Acacia_heteroclita,104,77,27,Alphahull-PointsKO-Adjacents,885
Acacia_heterophylla,4,4,0,Points-PointsKO-Adjacents,19
Acacia_holosericea,1648,1557,91,Alphahull-PointsKO-Adjacents,26705
Acacia_holotricha,26,12,14,Points-PointsKO-Adjacents,132
Acacia_homaloclada,13,8,5,Points-PointsKO-Adjacents,18
Acacia_horrida,0,0,0,NA,0
Acacia_howittii,67,27,40,Alphahull-PointsKO-Adjacents,595
Acacia_hydaspica,14,0,14,Points-PointsKO-Adjacents,120
Acacia_hylonoma,15,0,15,Points-PointsKO-Adjacents,33
Acacia_implexa,4448,4081,367,Alphahull-PointsKO-Adjacents,10159
Acacia_inaequilatera,289,245,44,Alphahull-PointsKO-Adjacents,10162
Acacia_inceana,93,80,13,Alphahull-PointsKO-Adjacents,1598
Acacia_incurvaneura,389,346,43,Alphahull-PointsKO-Adjacents,11504
Acacia_ingramii,92,82,10,Alphahull-PointsKO-Adjacents,129
Acacia_inophloia,25,21,4,Alphahull-PointsKO-Adjacents,170
Acacia_intorta,25,19,6,Points-PointsKO-Adjacents,129
Acacia_irrorata,2794,2622,172,Alphahull-PointsKO-Adjacents,3601
Acacia_islana,21,15,6,Points-PointsKO-Adjacents,49
Acacia_ixodes,136,116,20,Alphahull-PointsKO-Adjacents,2069
Acacia_jacquemontii,0,0,0,NA,0
Acacia_jamesiana,76,60,16,Alphahull-PointsKO-Adjacents,2997
Acacia_jasperensis,75,62,13,Alphahull-PointsKO-Adjacents,672
Acacia_jennerae,261,212,49,Alphahull-PointsKO-Adjacents,12077
Acacia_jensenii,47,26,21,Alphahull-PointsKO-Adjacents,1518
Acacia_jibberdingensis,138,119,19,Alphahull-PointsKO-Adjacents,2019
Acacia_jucunda,135,117,18,Alphahull-PointsKO-Adjacents,1137
Acacia_julifera,566,0,566,Points-PointsKO-Adjacents,2121
Acacia_kauaiensis,3,3,0,Points-PointsKO-Adjacents,12
Acacia_kelleri,105,94,11,Alphahull-PointsKO-Adjacents,826
Acacia_kempeana,1782,1741,41,Alphahull-PointsKO-Adjacents,27777
Acacia_kenneallyi,7,2,5,Points-PointsKO-Adjacents,34
Acacia_kettlewelliae,245,0,245,Points-PointsKO-Adjacents,580
Acacia_koa,65,48,17,Alphahull-PointsKO-Adjacents,167
Acacia_koaia,9,2,7,Points-PointsKO-Adjacents,60
Acacia_kuhlmannii,9,0,9,Points-PointsKO-Adjacents,79
Acacia_lacertensis,52,47,5,Alphahull-PointsKO-Adjacents,373
Acacia_lamprocarpa,1703,1646,57,Alphahull-PointsKO-Adjacents,6822
Acacia_lasiocalyx,402,0,402,Points-PointsKO-Adjacents,1632
Acacia_latescens,733,699,34,Alphahull-PointsKO-Adjacents,2898
Acacia_latifolia,332,258,74,Alphahull-PointsKO-Adjacents,11182
Acacia_latior,89,78,11,Alphahull-PointsKO-Adjacents,425
Acacia_latzii,33,29,4,Alphahull-PointsKO-Adjacents,89
Acacia_leeuweniana,8,4,4,Points-PointsKO-Adjacents,42
Acacia_legnota,46,32,14,Alphahull-PointsKO-Adjacents,618
Acacia_leiocalyx,1568,0,1568,Points-PointsKO-Adjacents,3538
Acacia_leiophylla,564,542,22,Alphahull-PointsKO-Adjacents,742
Acacia_leprosa,387,0,387,Points-PointsKO-Adjacents,1163
Acacia_leptocarpa,962,893,69,Alphahull-PointsKO-Adjacents,9178
Acacia_leptoloba,80,72,8,Alphahull-PointsKO-Adjacents,433
Acacia_leptopetala,171,155,16,Alphahull-PointsKO-Adjacents,1768
Acacia_leptostachya,761,719,42,Alphahull-PointsKO-Adjacents,7477
Acacia_leucoclada,323,298,25,Alphahull-PointsKO-Adjacents,3370
Acacia_ligulata,6142,5964,178,Alphahull-PointsKO-Adjacents,61204
Acacia_ligustrina,90,78,12,Alphahull-PointsKO-Adjacents,637
Acacia_linearifolia,477,432,45,Alphahull-PointsKO-Adjacents,1560
Acacia_linifolia,1739,1387,352,Alphahull-PointsKO-Adjacents,886
Acacia_loderi,306,277,29,Alphahull-PointsKO-Adjacents,4078
Acacia_longifolia,7166,6177,989,Alphahull-PointsKO-Adjacents,11685
Acacia_longiphyllodinea,72,66,6,Alphahull-PointsKO-Adjacents,359
Acacia_longispicata,351,327,24,Alphahull-PointsKO-Adjacents,3514
Acacia_longispinea,259,241,18,Alphahull-PointsKO-Adjacents,3514
Acacia_longissima,659,500,159,Alphahull-PointsKO-Adjacents,2370
Acacia_loroloba,62,52,10,Alphahull-PointsKO-Adjacents,211
Acacia_lucens,NA,NA,NA,NA,NA
Acacia_lunata,129,0,129,Points-PointsKO-Adjacents,315
Acacia_mabellae,331,0,331,Points-PointsKO-Adjacents,277
Acacia_macdonnellensis,379,358,21,Alphahull-PointsKO-Adjacents,2541
Acacia_macilenta,24,9,15,Points-PointsKO-Adjacents,205
Acacia_maconochieana,44,31,13,Alphahull-PointsKO-Adjacents,514
Acacia_macradenia,129,107,22,Alphahull-PointsKO-Adjacents,2517
Acacia_maidenii,2130,1958,172,Alphahull-PointsKO-Adjacents,4044
Acacia_mangium,351,230,121,Alphahull-PointsKO-Adjacents,1580
Acacia_maranoensis,34,32,2,Alphahull-PointsKO-Adjacents,98
Acacia_marramamba,65,51,14,Alphahull-PointsKO-Adjacents,1286
Acacia_masliniana,56,46,10,Alphahull-PointsKO-Adjacents,1754
Acacia_mathuataensis,0,0,0,NA,0
Acacia_matthewii,33,0,33,Points-PointsKO-Adjacents,99
Acacia_mearnsii,3283,2930,353,Alphahull-PointsKO-Adjacents,10719
Acacia_megaladena,7,1,6,Points-PointsKO-Adjacents,63
Acacia_meiosperma,33,22,11,Alphahull-PointsKO-Adjacents,325
Acacia_melanoxylon,7389,6783,606,Alphahull-PointsKO-Adjacents,16256
Acacia_mellifera,282,188,94,Alphahull-PointsKO-Adjacents,9689
Acacia_melvillei,590,550,40,Alphahull-PointsKO-Adjacents,9755
Acacia_menabeensis,6,2,4,Points-PointsKO-Adjacents,37
Acacia_merinthophora,74,68,6,Alphahull-PointsKO-Adjacents,984
Acacia_microbotrya,422,396,26,Alphahull-PointsKO-Adjacents,4019
Acacia_microcarpa,702,666,36,Alphahull-PointsKO-Adjacents,3600
Acacia_microcybe,28,22,6,Alphahull-PointsKO-Adjacents,193
Acacia_microsperma,72,62,10,Alphahull-PointsKO-Adjacents,1006
Acacia_midgleyi,87,73,14,Alphahull-PointsKO-Adjacents,310
Acacia_mimula,453,429,24,Alphahull-PointsKO-Adjacents,1558
Acacia_minyura,356,318,38,Alphahull-PointsKO-Adjacents,9971
Acacia_modesta,24,13,11,Points-PointsKO-Adjacents,195
Acacia_mollifolia,121,102,19,Alphahull-PointsKO-Adjacents,970
Acacia_montana,715,662,53,Alphahull-PointsKO-Adjacents,6483
Acacia_monticola,785,736,49,Alphahull-PointsKO-Adjacents,19973
Acacia_mountfordiae,34,28,6,Alphahull-PointsKO-Adjacents,132
Acacia_mucronata,644,605,39,Alphahull-PointsKO-Adjacents,2933
Acacia_muelleriana,105,87,18,Alphahull-PointsKO-Adjacents,1015
Acacia_mulganeura,219,188,31,Alphahull-PointsKO-Adjacents,6717
Acacia_multisiliqua,601,564,37,Alphahull-PointsKO-Adjacents,8789
Acacia_multistipulosa,38,32,6,Alphahull-PointsKO-Adjacents,50
Acacia_murrayana,1577,1505,72,Alphahull-PointsKO-Adjacents,32313
Acacia_myrmecophila,16,10,6,Points-PointsKO-Adjacents,103
Acacia_myrtifolia,4602,4252,350,Alphahull-PointsKO-Adjacents,9901
Acacia_nanodealbata,94,79,15,Alphahull-PointsKO-Adjacents,372
Acacia_neriifolia,1017,983,34,Alphahull-PointsKO-Adjacents,6302
Acacia_neurocarpa,223,192,31,Alphahull-PointsKO-Adjacents,8846
Acacia_neurophylla,284,258,26,Alphahull-PointsKO-Adjacents,2757
Acacia_nyssophylla,1594,1524,70,Alphahull-PointsKO-Adjacents,18588
Acacia_obliquinervia,806,781,25,Alphahull-PointsKO-Adjacents,2009
Acacia_obtusifolia,1772,1713,59,Alphahull-PointsKO-Adjacents,2668
Acacia_occidentalis,27,19,8,Points-PointsKO-Adjacents,191
Acacia_oerfota,58,19,39,Points-PointsKO-Adjacents,439
Acacia_oldfieldii,81,71,10,Alphahull-PointsKO-Adjacents,158
Acacia_olgana,147,126,21,Alphahull-PointsKO-Adjacents,887
Acacia_oligoneura,63,40,23,Alphahull-PointsKO-Adjacents,1075
Acacia_olsenii,21,17,4,Points-PointsKO-Adjacents,68
Acacia_omalophylla,209,178,31,Alphahull-PointsKO-Adjacents,8785
Acacia_ommatosperma,7,5,2,Points-PointsKO-Adjacents,56
Acacia_oncinocarpa,877,843,34,Alphahull-PointsKO-Adjacents,5839
Acacia_oncinophylla,53,42,11,Alphahull-PointsKO-Adjacents,602
Acacia_oraria,147,0,147,Points-PointsKO-Adjacents,446
Acacia_orites,117,105,12,Alphahull-PointsKO-Adjacents,239
Acacia_orthocarpa,418,368,50,Alphahull-PointsKO-Adjacents,9575
Acacia_oshanesii,160,130,30,Alphahull-PointsKO-Adjacents,783
Acacia_oswaldii,4427,4324,103,Alphahull-PointsKO-Adjacents,48343
Acacia_ouyrarema,1,1,0,Points-PointsKO-Adjacents,9
Acacia_oxycedrus,659,546,113,Alphahull-PointsKO-Adjacents,2257
Acacia_pachyacra,218,189,29,Alphahull-PointsKO-Adjacents,5227
Acacia_pachycarpa,77,51,26,Alphahull-PointsKO-Adjacents,1250
Acacia_pachyceras,4,4,0,Points-PointsKO-Adjacents,34
Acacia_palustris,35,27,8,Alphahull-PointsKO-Adjacents,467
Acacia_papyrocarpa,1241,1178,63,Alphahull-PointsKO-Adjacents,9229
Acacia_paradoxa,3422,3156,266,Alphahull-PointsKO-Adjacents,9992
Acacia_paraneura,329,308,21,Alphahull-PointsKO-Adjacents,14971
Acacia_parramattensis,1840,1405,435,Alphahull-PointsKO-Adjacents,2069
Acacia_parviflora,11,7,4,Points-PointsKO-Adjacents,84
Acacia_parvipinnula,836,774,62,Alphahull-PointsKO-Adjacents,956
Acacia_pataczekii,32,28,4,Alphahull-PointsKO-Adjacents,32
Acacia_pedleyi,14,10,4,Points-PointsKO-Adjacents,28
Acacia_pellita,200,179,21,Alphahull-PointsKO-Adjacents,2926
Acacia_pendula,1130,1088,42,Alphahull-PointsKO-Adjacents,11817
Acacia_peninsularis,13,5,8,Points-PointsKO-Adjacents,99
Acacia_pennata,44,16,28,Points-PointsKO-Adjacents,361
Acacia_penninervis,1718,1604,114,Alphahull-PointsKO-Adjacents,10544
Acacia_pentadenia,187,0,187,Points-PointsKO-Adjacents,265
Acacia_pentagona,106,47,59,Alphahull-PointsKO-Adjacents,2972
Acacia_petraea,112,98,14,Alphahull-PointsKO-Adjacents,1896
Acacia_peuce,110,92,18,Alphahull-PointsKO-Adjacents,991
Acacia_phlebophylla,30,21,9,Alphahull-PointsKO-Adjacents,48
Acacia_pickardii,33,26,7,Alphahull-PointsKO-Adjacents,84
Acacia_platycarpa,1131,1072,59,Alphahull-PointsKO-Adjacents,16079
Acacia_plectocarpa,705,671,34,Alphahull-PointsKO-Adjacents,8119
Acacia_podalyriifolia,496,345,151,Alphahull-PointsKO-Adjacents,6848
Acacia_polifolia,87,76,11,Alphahull-PointsKO-Adjacents,629
Acacia_polyadenia,7,0,7,Points-PointsKO-Adjacents,41
Acacia_polybotrya,410,393,17,Alphahull-PointsKO-Adjacents,2188
Acacia_polystachya,203,0,203,Points-PointsKO-Adjacents,565
Acacia_praelongata,110,96,14,Alphahull-PointsKO-Adjacents,690
Acacia_prainii,440,406,34,Alphahull-PointsKO-Adjacents,11900
Acacia_pravissima,313,0,313,Points-PointsKO-Adjacents,786
Acacia_proiantha,19,16,3,Points-PointsKO-Adjacents,71
Acacia_prominens,322,210,112,Alphahull-PointsKO-Adjacents,639
Acacia_pruinescens,0,0,0,NA,0
Acacia_pruinocarpa,427,399,28,Alphahull-PointsKO-Adjacents,12461
Acacia_pteraneura,379,0,379,Points-PointsKO-Adjacents,1901
Acacia_pteridifolia,2,1,1,Points-PointsKO-Adjacents,18
Acacia_pubescens,277,129,148,Alphahull-PointsKO-Adjacents,761
Acacia_pubicosta,15,7,8,Points-PointsKO-Adjacents,46
Acacia_pubifolia,55,44,11,Alphahull-PointsKO-Adjacents,146
Acacia_pubirhachis,62,54,8,Alphahull-PointsKO-Adjacents,93
Acacia_pulchella,1003,885,118,Alphahull-PointsKO-Adjacents,2669
Acacia_pustula,125,113,12,Alphahull-PointsKO-Adjacents,1013
Acacia_pycnantha,5411,5145,266,Alphahull-PointsKO-Adjacents,12035
Acacia_pycnostachya,40,36,4,Alphahull-PointsKO-Adjacents,44
Acacia_pyrifolia,416,0,416,Points-PointsKO-Adjacents,1712
Acacia_quadrimarginea,185,169,16,Alphahull-PointsKO-Adjacents,4224
Acacia_racospermoides,36,24,12,Alphahull-PointsKO-Adjacents,98
Acacia_ramulosa,1763,1709,54,Alphahull-PointsKO-Adjacents,30446
Acacia_redolens,84,1,83,Points-PointsKO-Adjacents,275
Acacia_rehmanniana,31,16,15,Points-PointsKO-Adjacents,266
Acacia_resinimarginea,214,200,14,Alphahull-PointsKO-Adjacents,4116
Acacia_resinistipulea,46,43,3,Alphahull-PointsKO-Adjacents,442
Acacia_retinervis,102,92,10,Alphahull-PointsKO-Adjacents,617
Acacia_retinodes,1023,838,185,Alphahull-PointsKO-Adjacents,4811
Acacia_retusa,2,1,1,Points-PointsKO-Adjacents,11
Acacia_rhodophloia,446,405,41,Alphahull-PointsKO-Adjacents,11779
Acacia_rhodoxylon,81,63,18,Alphahull-PointsKO-Adjacents,1556
Acacia_riceana,167,154,13,Alphahull-PointsKO-Adjacents,280
Acacia_richii,0,0,0,NA,0
Acacia_rigens,2020,1950,70,Alphahull-PointsKO-Adjacents,21620
Acacia_rigidula,81,68,13,Alphahull-PointsKO-Adjacents,3060
Acacia_riparia,128,51,77,Alphahull-PointsKO-Adjacents,1568
Acacia_rivalis,417,405,12,Alphahull-PointsKO-Adjacents,719
Acacia_robusta,112,86,26,Alphahull-PointsKO-Adjacents,4957
Acacia_roemeriana,60,42,18,Alphahull-PointsKO-Adjacents,3073
Acacia_rostellifera,379,325,54,Alphahull-PointsKO-Adjacents,2542
Acacia_rostriformis,57,53,4,Alphahull-PointsKO-Adjacents,59
Acacia_rothii,111,99,12,Alphahull-PointsKO-Adjacents,1109
Acacia_rovumae,55,31,24,Alphahull-PointsKO-Adjacents,1002
Acacia_roycei,43,37,6,Alphahull-PointsKO-Adjacents,324
Acacia_rubida,1450,1381,69,Alphahull-PointsKO-Adjacents,3866
Acacia_saliciformis,219,206,13,Alphahull-PointsKO-Adjacents,273
Acacia_salicina,2175,2027,148,Alphahull-PointsKO-Adjacents,34394
Acacia_saligna,2529,1919,610,Alphahull-PointsKO-Adjacents,14517
Acacia_saxatilis,45,34,11,Alphahull-PointsKO-Adjacents,273
Acacia_schinoides,250,174,76,Alphahull-PointsKO-Adjacents,398
Acacia_schweinfurthii,98,51,47,Alphahull-PointsKO-Adjacents,3487
Acacia_scirpifolia,97,81,16,Alphahull-PointsKO-Adjacents,350
Acacia_sclerosperma,508,470,38,Alphahull-PointsKO-Adjacents,7782
Acacia_scopulorum,57,49,8,Alphahull-PointsKO-Adjacents,234
Acacia_seclusa,4,4,0,Points-PointsKO-Adjacents,17
Acacia_semilunata,113,98,15,Alphahull-PointsKO-Adjacents,597
Acacia_semirigida,61,46,15,Alphahull-PointsKO-Adjacents,526
Acacia_sericata,49,31,18,Alphahull-PointsKO-Adjacents,939
Acacia_sericoflora,87,77,10,Alphahull-PointsKO-Adjacents,504
Acacia_shirleyi,800,754,46,Alphahull-PointsKO-Adjacents,12509
Acacia_sibilans,67,52,15,Alphahull-PointsKO-Adjacents,2787
Acacia_sibina,174,156,18,Alphahull-PointsKO-Adjacents,3804
Acacia_sibirica,976,916,60,Alphahull-PointsKO-Adjacents,33991
Acacia_sieberiana,170,101,69,Alphahull-PointsKO-Adjacents,9735
Acacia_signata,103,87,16,Alphahull-PointsKO-Adjacents,720
Acacia_silvestris,236,223,13,Alphahull-PointsKO-Adjacents,400
Acacia_simplex,9,1,8,Points-PointsKO-Adjacents,56
Acacia_simsii,454,391,63,Alphahull-PointsKO-Adjacents,6705
Acacia_solenota,13,10,3,Points-PointsKO-Adjacents,25
Acacia_spania,15,9,6,Points-PointsKO-Adjacents,94
Acacia_sparsiflora,199,181,18,Alphahull-PointsKO-Adjacents,3739
Acacia_speckii,31,27,4,Alphahull-PointsKO-Adjacents,246
Acacia_spectabilis,740,701,39,Alphahull-PointsKO-Adjacents,4362
Acacia_spectra,3,3,0,Points-PointsKO-Adjacents,12
Acacia_spirorbis,66,0,66,Points-PointsKO-Adjacents,244
Acacia_splendens,10,5,5,Points-PointsKO-Adjacents,42
Acacia_steedmanii,157,138,19,Alphahull-PointsKO-Adjacents,1853
Acacia_stenophylla,2143,2073,70,Alphahull-PointsKO-Adjacents,30378
Acacia_stereophylla,273,262,11,Alphahull-PointsKO-Adjacents,2241
Acacia_stictophylla,38,27,11,Alphahull-PointsKO-Adjacents,45
Acacia_stipuligera,635,590,45,Alphahull-PointsKO-Adjacents,11987
Acacia_storyi,29,21,8,Alphahull-PointsKO-Adjacents,48
Acacia_striatifolia,54,42,12,Alphahull-PointsKO-Adjacents,250
Acacia_stricta,952,799,153,Alphahull-PointsKO-Adjacents,5696
Acacia_strongylophylla,255,0,255,Points-PointsKO-Adjacents,701
Acacia_subangulata,153,0,153,Points-PointsKO-Adjacents,243
Acacia_subporosa,123,109,14,Alphahull-PointsKO-Adjacents,134
Acacia_subtessarogona,65,52,13,Alphahull-PointsKO-Adjacents,828
Acacia_subtilinervis,154,133,21,Alphahull-PointsKO-Adjacents,469
Acacia_subulata,202,1,201,Points-PointsKO-Adjacents,590
Acacia_symonii,29,21,8,Alphahull-PointsKO-Adjacents,107
Acacia_synchronicia,280,234,46,Alphahull-PointsKO-Adjacents,8556
Acacia_synoria,6,4,2,Points-PointsKO-Adjacents,35
Acacia_teniana,1,1,0,Points-PointsKO-Adjacents,9
Acacia_tenuinervis,50,44,6,Alphahull-PointsKO-Adjacents,264
Acacia_tenuispica,42,31,11,Alphahull-PointsKO-Adjacents,339
Acacia_tenuissima,854,794,60,Alphahull-PointsKO-Adjacents,14678
Acacia_tephrina,195,161,34,Alphahull-PointsKO-Adjacents,4146
Acacia_terminalis,3489,0,3489,Points-PointsKO-Adjacents,2156
Acacia_tessellata,62,58,4,Alphahull-PointsKO-Adjacents,300
Acacia_tetragonophylla,3752,3685,67,Alphahull-PointsKO-Adjacents,42560
Acacia_theronii,3,2,1,Points-PointsKO-Adjacents,27
Acacia_thomsonii,103,81,22,Alphahull-PointsKO-Adjacents,2485
Acacia_tingoorensis,8,6,2,Points-PointsKO-Adjacents,19
Acacia_torulosa,869,829,40,Alphahull-PointsKO-Adjacents,13976
Acacia_trachycarpa,223,206,17,Alphahull-PointsKO-Adjacents,2009
Acacia_trachyphloia,158,146,12,Alphahull-PointsKO-Adjacents,142
Acacia_trinalis,19,15,4,Points-PointsKO-Adjacents,93
Acacia_trinervata,145,1,144,Points-PointsKO-Adjacents,223
Acacia_trineura,217,191,26,Alphahull-PointsKO-Adjacents,2583
Acacia_triptera,616,585,31,Alphahull-PointsKO-Adjacents,6837
Acacia_triptycha,93,77,16,Alphahull-PointsKO-Adjacents,918
Acacia_tropica,111,88,23,Alphahull-PointsKO-Adjacents,2800
Acacia_tumida,820,774,46,Alphahull-PointsKO-Adjacents,12337
Acacia_tysonii,120,102,18,Alphahull-PointsKO-Adjacents,2400
Acacia_uncifera,52,41,11,Alphahull-PointsKO-Adjacents,153
Acacia_undoolyana,43,39,4,Alphahull-PointsKO-Adjacents,25
Acacia_undulifolia,49,36,13,Alphahull-PointsKO-Adjacents,618
Acacia_unguicula,4,4,0,Points-PointsKO-Adjacents,15
Acacia_verniciflua,1461,1398,63,Alphahull-PointsKO-Adjacents,7582
Acacia_veronica,11,9,2,Points-PointsKO-Adjacents,34
Acacia_verricula,167,154,13,Alphahull-PointsKO-Adjacents,1884
Acacia_verticillata,1664,1561,103,Alphahull-PointsKO-Adjacents,2854
Acacia_vestita,237,0,237,Points-PointsKO-Adjacents,768
Acacia_victoriae,20873,20197,676,Alphahull-PointsKO-Adjacents,101158
Acacia_viguieri,7,2,5,Points-PointsKO-Adjacents,51
Acacia_viscidula,462,431,31,Alphahull-PointsKO-Adjacents,2462
Acacia_wanyu,88,74,14,Alphahull-PointsKO-Adjacents,3361
Acacia_wardellii,32,25,7,Alphahull-PointsKO-Adjacents,237
Acacia_wattsiana,211,197,14,Alphahull-PointsKO-Adjacents,298
Acacia_websteri,16,10,6,Points-PointsKO-Adjacents,74
Acacia_wetarensis,6,1,5,Points-PointsKO-Adjacents,31
Acacia_wilcoxii,10,2,8,Points-PointsKO-Adjacents,60
Acacia_willingii,4,4,0,Points-PointsKO-Adjacents,23
Acacia_xanthina,87,53,34,Alphahull-PointsKO-Adjacents,311
Acacia_xiphophylla,131,121,10,Alphahull-PointsKO-Adjacents,3158
Acacia_yorkrakinensis,231,222,9,Alphahull-PointsKO-Adjacents,1445
Acacia_zanzibarica,45,24,21,Alphahull-PointsKO-Adjacents,2393
Acaciella_angustissima,2523,2215,308,Alphahull-PointsKO-Adjacents,37838
Acaciella_chamelensis,9,1,8,Points-PointsKO-Adjacents,34
Acaciella_glauca,9,0,9,Points-PointsKO-Adjacents,64
Acaciella_goldmanii,139,116,23,Alphahull-PointsKO-Adjacents,723
Acaciella_rosei,42,26,16,Alphahull-PointsKO-Adjacents,98
Acaciella_villosa,184,127,57,Alphahull-PointsKO-Adjacents,3935
Acalypha_acrogyna,8,0,8,Points-PointsKO-Adjacents,62
Acalypha_amplexicaulis,0,0,0,NA,0
Acalypha_angatensis,56,44,12,Alphahull-PointsKO-Adjacents,211
Acalypha_apodanthes,106,92,14,Alphahull-PointsKO-Adjacents,316
Acalypha_balansae,0,0,0,NA,0
Acalypha_baronii,0,0,0,NA,0
Acalypha_benensis,7,2,5,Points-PointsKO-Adjacents,63
Acalypha_boiviniana,0,0,0,NA,0
Acalypha_buchtienii,1,1,0,Points-PointsKO-Adjacents,9
Acalypha_cardiophylla,16,6,10,Points-PointsKO-Adjacents,77
Acalypha_caturus,48,0,48,Points-PointsKO-Adjacents,271
Acalypha_chocoana,3,3,0,Points-PointsKO-Adjacents,27
Acalypha_controversa,0,0,0,NA,0
Acalypha_cuneata,494,421,73,Alphahull-PointsKO-Adjacents,21713
Acalypha_diversifolia,2548,2313,235,Alphahull-PointsKO-Adjacents,59188
Acalypha_ferdinandii,77,57,20,Alphahull-PointsKO-Adjacents,272
Acalypha_filiformis,208,181,27,Alphahull-PointsKO-Adjacents,4791
Acalypha_floresensis,NA,NA,NA,NA,NA
Acalypha_forsteriana,1,1,0,Points-PointsKO-Adjacents,9
Acalypha_fragilis,0,0,0,NA,0
Acalypha_fruticosa,134,82,52,Alphahull-PointsKO-Adjacents,5112
Acalypha_glabrata,140,101,39,Alphahull-PointsKO-Adjacents,4721
Acalypha_grandibracteata,4,4,0,Points-PointsKO-Adjacents,21
Acalypha_grandis,12,2,10,Points-PointsKO-Adjacents,78
Acalypha_grisebachiana,1,1,0,Points-PointsKO-Adjacents,9
Acalypha_hellwigii,58,32,26,Alphahull-PointsKO-Adjacents,1275
Acalypha_hibiscifolia,21,18,3,Points-PointsKO-Adjacents,112
Acalypha_inaequilatera,2,2,0,Points-PointsKO-Adjacents,17
Acalypha_insulana,1,1,0,Points-PointsKO-Adjacents,9
Acalypha_juruana,3,3,0,Points-PointsKO-Adjacents,27
Acalypha_lepinei,2,2,0,Points-PointsKO-Adjacents,15
Acalypha_longispica,12,3,9,Points-PointsKO-Adjacents,81
Acalypha_lyonsii,12,6,6,Points-PointsKO-Adjacents,25
Acalypha_macrostachya,2143,1909,234,Alphahull-PointsKO-Adjacents,43595
Acalypha_madreporica,0,0,0,NA,0
Acalypha_mapirensis,30,12,18,Points-PointsKO-Adjacents,234
Acalypha_martiana,3,3,0,Points-PointsKO-Adjacents,27
Acalypha_muelleriana,45,19,26,Points-PointsKO-Adjacents,337
Acalypha_multiflora,10,1,9,Points-PointsKO-Adjacents,37
Acalypha_neptunica,114,77,37,Alphahull-PointsKO-Adjacents,1778
Acalypha_novoguineensis,81,59,22,Alphahull-PointsKO-Adjacents,2689
Acalypha_ornata,227,158,69,Alphahull-PointsKO-Adjacents,8952
Acalypha_padifolia,168,123,45,Alphahull-PointsKO-Adjacents,2674
Acalypha_pancheriana,17,9,8,Points-PointsKO-Adjacents,96
Acalypha_peruviana,42,15,27,Points-PointsKO-Adjacents,292
Acalypha_platyphylla,162,135,27,Alphahull-PointsKO-Adjacents,2472
Acalypha_pubiflora,19,2,17,Points-PointsKO-Adjacents,134
Acalypha_pulogensis,NA,NA,NA,NA,NA
Acalypha_raivavensis,3,3,0,Points-PointsKO-Adjacents,3
Acalypha_rapensis,4,4,0,Points-PointsKO-Adjacents,4
Acalypha_repanda,4,4,0,Points-PointsKO-Adjacents,25
Acalypha_rivularis,1,1,0,Points-PointsKO-Adjacents,9
Acalypha_salviifolia,9,2,7,Points-PointsKO-Adjacents,51
Acalypha_schiedeana,401,293,108,Alphahull-PointsKO-Adjacents,7871
Acalypha_skutchii,65,47,18,Alphahull-PointsKO-Adjacents,718
Acalypha_sonderiana,14,4,10,Points-PointsKO-Adjacents,109
Acalypha_stachyura,244,201,43,Alphahull-PointsKO-Adjacents,7914
Acalypha_stellata,7,2,5,Points-PointsKO-Adjacents,62
Acalypha_stenoloba,251,213,38,Alphahull-PointsKO-Adjacents,6415
Acalypha_stricta,93,76,17,Alphahull-PointsKO-Adjacents,2514
Acalypha_subintegra,0,0,0,NA,0
Acalypha_suirenbiensis,16,7,9,Points-PointsKO-Adjacents,52
Acalypha_tenuifolia,15,4,11,Points-PointsKO-Adjacents,88
Acalypha_villosa,105,48,57,Alphahull-PointsKO-Adjacents,9158
Acalypha_wilderi,0,0,0,NA,0
Acalypha_wilkesiana,1,1,0,Points-PointsKO-Adjacents,5
Acanthella_sprucei,130,106,24,Alphahull-PointsKO-Adjacents,2679
Acanthocereus_tetragonus,131,72,59,Alphahull-PointsKO-Adjacents,4868
Acanthocladus_albicans,85,47,38,Alphahull-PointsKO-Adjacents,4064
Acanthocladus_colombianus,0,0,0,NA,0
Acanthocladus_guayaquilensis,5,5,0,Points-PointsKO-Adjacents,39
Acanthocladus_pulcherrimus,35,21,14,Alphahull-PointsKO-Adjacents,499
Acanthocladus_santosii,11,5,6,Points-PointsKO-Adjacents,98
Acanthocladus_scleroxylon,16,5,11,Points-PointsKO-Adjacents,126
Acanthophoenix_crinita,0,0,0,NA,0
Acanthophoenix_rousselii,0,0,0,NA,0
Acanthophoenix_rubra,18,12,6,Points-PointsKO-Adjacents,39
Acanthosyris_annonagustata,9,8,1,Points-PointsKO-Adjacents,32
Acanthosyris_asipapote,6,2,4,Points-PointsKO-Adjacents,41
Acanthosyris_falcata,102,76,26,Alphahull-PointsKO-Adjacents,9126
Acanthosyris_glabrata,26,15,11,Points-PointsKO-Adjacents,172
Acanthosyris_paulo-alvinii,9,3,6,Points-PointsKO-Adjacents,54
Acanthosyris_spinescens,82,54,28,Alphahull-PointsKO-Adjacents,4768
Acca_lanuginosa,7,1,6,Points-PointsKO-Adjacents,63
Acca_macrostema,13,3,10,Points-PointsKO-Adjacents,113
Acca_sellowiana,317,274,43,Alphahull-PointsKO-Adjacents,5981
Acer_acuminatum,9,0,9,Points-PointsKO-Adjacents,70
Acer_amamiense,1,1,0,Points-PointsKO-Adjacents,8
Acer_amplum,53,27,26,Alphahull-PointsKO-Adjacents,7231
Acer_argutum,84,64,20,Alphahull-PointsKO-Adjacents,494
Acer_barbinerve,10,4,6,Points-PointsKO-Adjacents,86
Acer_brachystephyanum,NA,NA,NA,NA,NA
Acer_buergerianum,62,15,47,Points-PointsKO-Adjacents,499
Acer_caesium,45,13,32,Points-PointsKO-Adjacents,391
Acer_calcaratum,5,4,1,Points-PointsKO-Adjacents,39
Acer_caloneurum,NA,NA,NA,NA,NA
Acer_campbellii,199,149,50,Alphahull-PointsKO-Adjacents,17550
Acer_campestre,40667,32885,7782,Alphahull-PointsKO-Adjacents,56015
Acer_capillipes,79,65,14,Alphahull-PointsKO-Adjacents,364
Acer_cappadocicum,84,39,45,Alphahull-PointsKO-Adjacents,2072
Acer_carpinifolium,216,180,36,Alphahull-PointsKO-Adjacents,1618
Acer_caudatifolium,258,236,22,Alphahull-PointsKO-Adjacents,245
Acer_caudatum,77,1,76,Points-PointsKO-Adjacents,598
Acer_ceriferum,2,2,0,Points-PointsKO-Adjacents,18
Acer_chapaense,1,1,0,Points-PointsKO-Adjacents,9
Acer_chiangdaoense,1,1,0,Points-PointsKO-Adjacents,9
Acer_cinerascentiforme,NA,NA,NA,NA,NA
Acer_circinatum,815,0,815,Points-PointsKO-Adjacents,2378
Acer_cissifolium,165,127,38,Alphahull-PointsKO-Adjacents,1090
Acer_confertifolium,6,1,5,Points-PointsKO-Adjacents,50
Acer_cordatum,60,0,60,Points-PointsKO-Adjacents,536
Acer_crassum,5,5,0,Points-PointsKO-Adjacents,45
Acer_crataegifolium,314,251,63,Alphahull-PointsKO-Adjacents,1539
Acer_davidii,284,243,41,Alphahull-PointsKO-Adjacents,22593
Acer_diabolicum,105,82,23,Alphahull-PointsKO-Adjacents,374
Acer_discolor,2,2,0,Points-PointsKO-Adjacents,18
Acer_distylum,51,34,17,Alphahull-PointsKO-Adjacents,408
Acer_duplicatoserratum,25,19,6,Points-PointsKO-Adjacents,111
Acer_elegantulum,3,3,0,Points-PointsKO-Adjacents,27
Acer_emeiense,NA,NA,NA,NA,NA
Acer_erianthum,26,9,17,Points-PointsKO-Adjacents,233
Acer_erythranthum,3,3,0,Points-PointsKO-Adjacents,27
Acer_eucalyptoides,NA,NA,NA,NA,NA
Acer_fabri,107,0,107,Points-PointsKO-Adjacents,946
Acer_fengii,0,0,0,NA,0
Acer_fenzelianum,4,4,0,Points-PointsKO-Adjacents,36
Acer_floridanum,250,191,59,Alphahull-PointsKO-Adjacents,4495
Acer_garrettii,6,1,5,Points-PointsKO-Adjacents,54
Acer_glabrum,3362,3246,116,Alphahull-PointsKO-Adjacents,43394
Acer_gracilifolium,NA,NA,NA,NA,NA
Acer_granatense,1005,960,45,Alphahull-PointsKO-Adjacents,1432
Acer_grandidentatum,758,711,47,Alphahull-PointsKO-Adjacents,10396
Acer_griseum,13,7,6,Points-PointsKO-Adjacents,114
Acer_guizhouense,0,0,0,NA,0
Acer_hainanense,0,0,0,NA,0
Acer_heldreichii,42,27,15,Alphahull-PointsKO-Adjacents,1205
Acer_henryi,40,19,21,Points-PointsKO-Adjacents,360
Acer_hyrcanum,24,11,13,Points-PointsKO-Adjacents,151
Acer_japonicum,211,178,33,Alphahull-PointsKO-Adjacents,1917
Acer_kweilinense,0,0,0,NA,0
Acer_laevigatum,69,41,28,Alphahull-PointsKO-Adjacents,7305
Acer_laurinum,27,0,27,Points-PointsKO-Adjacents,224
Acer_leipoense,5,5,0,Points-PointsKO-Adjacents,45
Acer_leucoderme,262,210,52,Alphahull-PointsKO-Adjacents,6198
Acer_lichuanense,1,1,0,Points-PointsKO-Adjacents,9
Acer_linganense,5,5,0,Points-PointsKO-Adjacents,45
Acer_longipes,26,7,19,Points-PointsKO-Adjacents,233
Acer_lucidum,6,1,5,Points-PointsKO-Adjacents,54
Acer_macrophyllum,2639,2390,249,Alphahull-PointsKO-Adjacents,8500
Acer_mairei,NA,NA,NA,NA,NA
Acer_mandshuricum,11,5,6,Points-PointsKO-Adjacents,99
Acer_mapienense,6,3,3,Points-PointsKO-Adjacents,53
Acer_maximowiczianum,16,0,16,Points-PointsKO-Adjacents,125
Acer_mazandaranicum,0,0,0,NA,0
Acer_medogense,NA,NA,NA,NA,NA
Acer_miaoshanicum,NA,NA,NA,NA,NA
Acer_micranthum,168,142,26,Alphahull-PointsKO-Adjacents,1226
Acer_mirabile,0,0,0,NA,0
Acer_miyabei,3,3,0,Points-PointsKO-Adjacents,27
Acer_monspessulanum,3148,2895,253,Alphahull-PointsKO-Adjacents,24708
Acer_morifolium,5,0,5,Points-PointsKO-Adjacents,30
Acer_nayongense,1,1,0,Points-PointsKO-Adjacents,9
Acer_negundo,9723,8061,1662,Alphahull-PointsKO-Adjacents,117462
Acer_nipponicum,45,30,15,Alphahull-PointsKO-Adjacents,441
Acer_oblongum,91,48,43,Alphahull-PointsKO-Adjacents,8675
Acer_obtusifolium,41,31,10,Alphahull-PointsKO-Adjacents,65
Acer_okamotoi,NA,NA,NA,NA,NA
Acer_oligocarpum,3,3,0,Points-PointsKO-Adjacents,24
Acer_olivaceum,1,1,0,Points-PointsKO-Adjacents,9
Acer_oliverianum,63,30,33,Alphahull-PointsKO-Adjacents,4012
Acer_opalus,1775,1643,132,Alphahull-PointsKO-Adjacents,13962
Acer_palmatum,594,435,159,Alphahull-PointsKO-Adjacents,3127
Acer_pauciflorum,1,1,0,Points-PointsKO-Adjacents,9
Acer_paxii,40,21,19,Alphahull-PointsKO-Adjacents,2760
Acer_pectinatum,162,119,43,Alphahull-PointsKO-Adjacents,8439
Acer_pehpeiense,NA,NA,NA,NA,NA
Acer_pensylvanicum,5083,4927,156,Alphahull-PointsKO-Adjacents,17705
Acer_pentaphyllum,8,0,8,Points-PointsKO-Adjacents,54
Acer_pentapomicum,19,9,10,Points-PointsKO-Adjacents,159
Acer_pictum,701,529,172,Alphahull-PointsKO-Adjacents,8241
Acer_pilosum,7,0,7,Points-PointsKO-Adjacents,63
Acer_pinnatinervium,0,0,0,NA,0
Acer_platanoides,44290,36011,8279,Alphahull-PointsKO-Adjacents,79197
Acer_pluridens,NA,NA,NA,NA,NA
Acer_poliophyllum,1,1,0,Points-PointsKO-Adjacents,9
Acer_pseudoplatanus,6640,5209,1431,Alphahull-PointsKO-Adjacents,22927
Acer_pseudosieboldianum,9,0,9,Points-PointsKO-Adjacents,75
Acer_pseudowilsonii,0,0,0,NA,0
Acer_pubipalmatum,5,5,0,Points-PointsKO-Adjacents,45
Acer_pycnanthum,2,2,0,Points-PointsKO-Adjacents,18
Acer_robustum,23,5,18,Points-PointsKO-Adjacents,207
Acer_rubescens,16,8,8,Points-PointsKO-Adjacents,85
Acer_rubrum,69892,66730,3162,Alphahull-PointsKO-Adjacents,55802
Acer_rufinerve,269,217,52,Alphahull-PointsKO-Adjacents,2059
Acer_saccharinum,3981,3158,823,Alphahull-PointsKO-Adjacents,53981
Acer_saccharum,24267,23113,1154,Alphahull-PointsKO-Adjacents,52030
Acer_schneiderianum,8,0,8,Points-PointsKO-Adjacents,72
Acer_sempervirens,52,41,11,Alphahull-PointsKO-Adjacents,702
Acer_shangszeense,3,3,0,Points-PointsKO-Adjacents,27
Acer_shenkanense,5,5,0,Points-PointsKO-Adjacents,45
Acer_shensiense,NA,NA,NA,NA,NA
Acer_shihweii,NA,NA,NA,NA,NA
Acer_shirasawanum,138,116,22,Alphahull-PointsKO-Adjacents,1015
Acer_sichourense,2,2,0,Points-PointsKO-Adjacents,18
Acer_sieboldianum,268,225,43,Alphahull-PointsKO-Adjacents,1743
Acer_sikkimense,27,4,23,Points-PointsKO-Adjacents,234
Acer_sinense,1,1,0,Points-PointsKO-Adjacents,9
Acer_sino-oblongum,4,4,0,Points-PointsKO-Adjacents,36
Acer_sinopurpurascens,3,3,0,Points-PointsKO-Adjacents,27
Acer_spicatum,2199,2008,191,Alphahull-PointsKO-Adjacents,37053
Acer_stachyophyllum,61,35,26,Alphahull-PointsKO-Adjacents,2410
Acer_sterculiaceum,81,48,33,Alphahull-PointsKO-Adjacents,5636
Acer_sutchuenense,2,2,0,Points-PointsKO-Adjacents,18
Acer_sycopseoides,4,4,0,Points-PointsKO-Adjacents,36
Acer_tataricum,151,62,89,Alphahull-PointsKO-Adjacents,7314
Acer_tegmentosum,10,0,10,Points-PointsKO-Adjacents,85
Acer_tenellum,9,0,9,Points-PointsKO-Adjacents,81
Acer_tibetense,1,1,0,Points-PointsKO-Adjacents,9
Acer_tonkinense,18,9,9,Points-PointsKO-Adjacents,153
Acer_trialatum,NA,NA,NA,NA,NA
Acer_triflorum,12,4,8,Points-PointsKO-Adjacents,102
Acer_truncatum,35,7,28,Points-PointsKO-Adjacents,292
Acer_tschonoskii,103,80,23,Alphahull-PointsKO-Adjacents,906
Acer_tutcheri,27,15,12,Points-PointsKO-Adjacents,237
Acer_undulatum,1,1,0,Points-PointsKO-Adjacents,9
Acer_velutinum,2,0,2,Points-PointsKO-Adjacents,18
Acer_wangchii,5,5,0,Points-PointsKO-Adjacents,45
Acer_wardii,24,16,8,Points-PointsKO-Adjacents,112
Acer_wilsonii,1,1,0,Points-PointsKO-Adjacents,9
Acer_wuyuanense,7,1,6,Points-PointsKO-Adjacents,63
Acer_yangbiense,0,0,0,NA,0
Acer_yaoshanicum,NA,NA,NA,NA,NA
Acer_yinkunii,2,2,0,Points-PointsKO-Adjacents,18
Acer_yui,3,3,0,Points-PointsKO-Adjacents,27
Aceratium_archboldianum,11,4,7,Points-PointsKO-Adjacents,62
Aceratium_brassii,17,4,13,Points-PointsKO-Adjacents,111
Aceratium_concinnum,46,32,14,Alphahull-PointsKO-Adjacents,194
Aceratium_doggrellii,46,39,7,Alphahull-PointsKO-Adjacents,49
Aceratium_ferrugineum,43,38,5,Alphahull-PointsKO-Adjacents,30
Aceratium_hypoleucum,0,0,0,NA,0
Aceratium_ledermannii,33,15,18,Points-PointsKO-Adjacents,168
Aceratium_megalospermum,126,110,16,Alphahull-PointsKO-Adjacents,190
Aceratium_muellerianum,25,7,18,Points-PointsKO-Adjacents,121
Aceratium_oppositifolium,84,33,51,Alphahull-PointsKO-Adjacents,4359
Aceratium_pachypetalum,1,1,0,Points-PointsKO-Adjacents,7
Aceratium_parvifolium,11,3,8,Points-PointsKO-Adjacents,63
Aceratium_pittosporoides,10,1,9,Points-PointsKO-Adjacents,84
Aceratium_sericeum,2,2,0,Points-PointsKO-Adjacents,18
Aceratium_sericoleopsis,17,14,3,Points-PointsKO-Adjacents,35
Aceratium_sinuatum,5,5,0,Points-PointsKO-Adjacents,24
Aceratium_sphaerocarpum,9,0,9,Points-PointsKO-Adjacents,45
Aceratium_tomentosum,8,3,5,Points-PointsKO-Adjacents,49
Achatocarpus_balansae,10,4,6,Points-PointsKO-Adjacents,75
Achatocarpus_brevipedicellatus,3,3,0,Points-PointsKO-Adjacents,24
Achatocarpus_gracilis,57,39,18,Alphahull-PointsKO-Adjacents,128
Achatocarpus_hasslerianus,3,3,0,Points-PointsKO-Adjacents,23
Achatocarpus_microcarpus,8,3,5,Points-PointsKO-Adjacents,69
Achatocarpus_nigricans,449,333,116,Alphahull-PointsKO-Adjacents,14056
Achatocarpus_oaxacanus,30,22,8,Alphahull-PointsKO-Adjacents,90
Achatocarpus_praecox,206,155,51,Alphahull-PointsKO-Adjacents,12699
Achatocarpus_pubescens,76,55,21,Alphahull-PointsKO-Adjacents,474
Achuaria_hirsuta,1,0,1,Points-PointsKO-Adjacents,9
Achyranthes_arborescens,7,2,5,Points-PointsKO-Adjacents,3
Achyranthes_mangarevica,2,2,0,Points-PointsKO-Adjacents,8
Achyranthes_marchionica,2,2,0,Points-PointsKO-Adjacents,14
Acidocroton_gentryi,2,2,0,Points-PointsKO-Adjacents,12
Acidocroton_verrucosus,0,0,0,NA,0
Acidoton_nicaraguensis,251,0,251,Points-PointsKO-Adjacents,1037
Acioa_dolichopoda,25,14,11,Points-PointsKO-Adjacents,193
Acioa_edulis,23,6,17,Points-PointsKO-Adjacents,195
Acioa_guianensis,5,5,0,Points-PointsKO-Adjacents,45
Acioa_longipendula,NA,NA,NA,NA,NA
Acioa_schultesii,20,0,20,Points-PointsKO-Adjacents,141
Acioa_somnolens,5,5,0,Points-PointsKO-Adjacents,45
Aciotis_indecora,607,470,137,Alphahull-PointsKO-Adjacents,32112
Acmanthera_cowanii,5,5,0,Points-PointsKO-Adjacents,45
Acmanthera_duckei,7,2,5,Points-PointsKO-Adjacents,59
Acmanthera_fernandesii,2,2,0,Points-PointsKO-Adjacents,12
Acmanthera_longifolia,8,0,8,Points-PointsKO-Adjacents,57
Acmanthera_minima,2,2,0,Points-PointsKO-Adjacents,18
Acmanthera_parviflora,6,1,5,Points-PointsKO-Adjacents,26
Acmopyle_pancheri,56,45,11,Alphahull-PointsKO-Adjacents,93
Acmopyle_sahniana,3,3,0,Points-PointsKO-Adjacents,27
Acnistus_arborescens,801,610,191,Alphahull-PointsKO-Adjacents,22317
Acoelorrhaphe_wrightii,175,142,33,Alphahull-PointsKO-Adjacents,1784
Acokanthera_laevigata,3,3,0,Points-PointsKO-Adjacents,18
Acokanthera_oblongifolia,29,10,19,Points-PointsKO-Adjacents,224
Acokanthera_oppositifolia,96,50,46,Alphahull-PointsKO-Adjacents,3154
Acokanthera_rotundata,23,10,13,Points-PointsKO-Adjacents,197
Acokanthera_schimperi,57,32,25,Alphahull-PointsKO-Adjacents,2343
Acosmium_cardenasii,42,31,11,Alphahull-PointsKO-Adjacents,1015
Acosmium_diffusissimum,80,67,13,Alphahull-PointsKO-Adjacents,2871
Acosmium_lentiscifolium,77,51,26,Alphahull-PointsKO-Adjacents,3778
Acradenia_euodiiformis,276,0,276,Points-PointsKO-Adjacents,422
Acradenia_frankliniae,64,56,8,Alphahull-PointsKO-Adjacents,184
Acridocarpus_austrocaledonicus,14,4,10,Points-PointsKO-Adjacents,87
Acridocarpus_excelsus,36,15,21,Points-PointsKO-Adjacents,255
Acridocarpus_humbertii,9,0,9,Points-PointsKO-Adjacents,69
Acridocarpus_katangensis,20,9,11,Points-PointsKO-Adjacents,156
Acridocarpus_macrocalyx,38,25,13,Alphahull-PointsKO-Adjacents,945
Acridocarpus_natalitius,63,39,24,Alphahull-PointsKO-Adjacents,629
Acridocarpus_plagiopterus,73,51,22,Alphahull-PointsKO-Adjacents,2711
Acridocarpus_socotranus,12,8,4,Points-PointsKO-Adjacents,33
Acridocarpus_spectabilis,20,7,13,Points-PointsKO-Adjacents,149
Acritopappus_buiquensis,6,2,4,Points-PointsKO-Adjacents,24
Acritopappus_catolesensis,60,48,12,Alphahull-PointsKO-Adjacents,273
Acritopappus_confertus,233,0,233,Points-PointsKO-Adjacents,769
Acritopappus_connatifolius,17,13,4,Points-PointsKO-Adjacents,51
Acritopappus_harleyi,24,17,7,Points-PointsKO-Adjacents,127
Acritopappus_heterolepis,67,58,9,Alphahull-PointsKO-Adjacents,198
Acritopappus_irwinii,8,0,8,Points-PointsKO-Adjacents,61
Acritopappus_pintoi,7,3,4,Points-PointsKO-Adjacents,29
Acritopappus_prunifolius,25,17,8,Points-PointsKO-Adjacents,91
Acritopappus_subtomentosus,4,4,0,Points-PointsKO-Adjacents,29
Acritopappus_teixeirae,8,2,6,Points-PointsKO-Adjacents,41
Acrocarpus_fraxinifolius,10,0,10,Points-PointsKO-Adjacents,84
Acrocomia_aculeata,1029,812,217,Alphahull-PointsKO-Adjacents,45640
Acrocomia_crispa,1,1,0,Points-PointsKO-Adjacents,9
Acrocomia_hassleri,23,6,17,Points-PointsKO-Adjacents,162
Acrocomia_intumescens,100,0,100,Points-PointsKO-Adjacents,588
Acrocomia_media,1,1,0,Points-PointsKO-Adjacents,6
Acrocomia_totai,19,1,18,Points-PointsKO-Adjacents,168
Acronychia_aberrans,28,19,9,Points-PointsKO-Adjacents,61
Acronychia_acidula,95,83,12,Alphahull-PointsKO-Adjacents,152
Acronychia_acronychioides,160,0,160,Points-PointsKO-Adjacents,437
Acronychia_acuminata,18,13,5,Points-PointsKO-Adjacents,36
Acronychia_baeuerlenii,134,127,7,Alphahull-PointsKO-Adjacents,101
Acronychia_carrii,2,2,0,Points-PointsKO-Adjacents,15
Acronychia_cartilaginea,3,3,0,Points-PointsKO-Adjacents,18
Acronychia_chooreechillum,62,50,12,Alphahull-PointsKO-Adjacents,135
Acronychia_crassipetala,69,60,9,Alphahull-PointsKO-Adjacents,83
Acronychia_cuspidata,NA,NA,NA,NA,NA
Acronychia_dimorphocalyx,3,3,0,Points-PointsKO-Adjacents,16
Acronychia_emarginata,8,2,6,Points-PointsKO-Adjacents,66
Acronychia_eungellensis,22,18,4,Points-PointsKO-Adjacents,37
Acronychia_foveata,5,5,0,Points-PointsKO-Adjacents,44
Acronychia_glauca,0,0,0,NA,0
Acronychia_goniocarpa,2,2,0,Points-PointsKO-Adjacents,18
Acronychia_gurakorensis,0,0,0,NA,0
Acronychia_imperforata,343,270,73,Alphahull-PointsKO-Adjacents,1018
Acronychia_intermedia,1,1,0,Points-PointsKO-Adjacents,9
Acronychia_kaindiensis,3,3,0,Points-PointsKO-Adjacents,23
Acronychia_laevis,435,371,64,Alphahull-PointsKO-Adjacents,3728
Acronychia_ledermannii,8,3,5,Points-PointsKO-Adjacents,57
Acronychia_littoralis,106,85,21,Alphahull-PointsKO-Adjacents,203
Acronychia_macrocalyx,3,3,0,Points-PointsKO-Adjacents,12
Acronychia_montana,10,6,4,Points-PointsKO-Adjacents,57
Acronychia_murina,34,13,21,Points-PointsKO-Adjacents,206
Acronychia_normanbiensis,0,0,0,NA,0
Acronychia_oblongifolia,1126,0,1126,Points-PointsKO-Adjacents,1495
Acronychia_octandra,118,108,10,Alphahull-PointsKO-Adjacents,299
Acronychia_papuana,1,1,0,Points-PointsKO-Adjacents,9
Acronychia_parviflora,80,67,13,Alphahull-PointsKO-Adjacents,137
Acronychia_pauciflora,111,82,29,Alphahull-PointsKO-Adjacents,1226
Acronychia_pedunculata,154,72,82,Alphahull-PointsKO-Adjacents,8163
Acronychia_pubescens,312,294,18,Alphahull-PointsKO-Adjacents,591
Acronychia_pullei,8,3,5,Points-PointsKO-Adjacents,60
Acronychia_reticulata,2,2,0,Points-PointsKO-Adjacents,18
Acronychia_richards-beehleri,1,1,0,Points-PointsKO-Adjacents,9
Acronychia_rubescens,NA,NA,NA,NA,NA
Acronychia_rugosa,7,1,6,Points-PointsKO-Adjacents,53
Acronychia_schistacea,2,2,0,Points-PointsKO-Adjacents,18
Acronychia_smithii,3,3,0,Points-PointsKO-Adjacents,12
Acronychia_suberosa,74,68,6,Alphahull-PointsKO-Adjacents,87
Acronychia_trifoliolata,47,21,26,Alphahull-PointsKO-Adjacents,411
Acronychia_vestita,102,96,6,Alphahull-PointsKO-Adjacents,233
Acronychia_wabagensis,1,1,0,Points-PointsKO-Adjacents,9
Acronychia_wilcoxiana,140,105,35,Alphahull-PointsKO-Adjacents,548
Acronychia_wisseliana,NA,NA,NA,NA,NA
Acropogon_aoupiniensis,7,3,4,Points-PointsKO-Adjacents,19
Acropogon_austrocaledonicus,0,0,0,NA,0
Acropogon_bosseri,5,5,0,Points-PointsKO-Adjacents,18
Acropogon_bullatus,16,8,8,Points-PointsKO-Adjacents,54
Acropogon_domatifer,4,4,0,Points-PointsKO-Adjacents,21
Acropogon_dzumacensis,20,11,9,Points-PointsKO-Adjacents,57
Acropogon_fatsioides,0,0,0,NA,0
Acropogon_francii,1,1,0,Points-PointsKO-Adjacents,9
Acropogon_grandiflorus,3,3,0,Points-PointsKO-Adjacents,12
Acropogon_jaffrei,4,4,0,Points-PointsKO-Adjacents,12
Acropogon_macrocarpus,4,4,0,Points-PointsKO-Adjacents,15
Acropogon_margaretae,1,1,0,Points-PointsKO-Adjacents,9
Acropogon_megaphyllus,0,0,0,NA,0
Acropogon_merytifolius,8,1,7,Points-PointsKO-Adjacents,23
Acropogon_sageniifolia,1,1,0,Points-PointsKO-Adjacents,9
Acropogon_schefflerifolius,0,0,0,NA,0
Acropogon_schistophilus,4,4,0,Points-PointsKO-Adjacents,18
Acropogon_schumanniana,7,2,5,Points-PointsKO-Adjacents,31
Acropogon_veillonii,6,1,5,Points-PointsKO-Adjacents,35
Acrosynanthus_parvifolius,3,3,0,Points-PointsKO-Adjacents,24
Acsmithia_brongniartiana,2,2,0,Points-PointsKO-Adjacents,12
Acsmithia_densiflora,6,2,4,Points-PointsKO-Adjacents,28
Acsmithia_elliptica,8,3,5,Points-PointsKO-Adjacents,49
Acsmithia_pedunculata,2,2,0,Points-PointsKO-Adjacents,9
Acsmithia_pubescens,6,1,5,Points-PointsKO-Adjacents,41
Actephila_championiae,8,4,4,Points-PointsKO-Adjacents,20
Actephila_excelsa,114,31,83,Alphahull-PointsKO-Adjacents,1490
Actephila_flavescens,5,5,0,Points-PointsKO-Adjacents,25
Actephila_lindleyi,351,305,46,Alphahull-PointsKO-Adjacents,1345
Actephila_merrilliana,8,0,8,Points-PointsKO-Adjacents,71
Actephila_ovalis,28,11,17,Points-PointsKO-Adjacents,219
Actephila_petiolaris,20,8,12,Points-PointsKO-Adjacents,91
Actephila_plicata,11,6,5,Points-PointsKO-Adjacents,48
Actephila_sessilifolia,40,21,19,Alphahull-PointsKO-Adjacents,257
Actephila_subsessilis,4,4,0,Points-PointsKO-Adjacents,34
Actephila_trichogyna,2,2,0,Points-PointsKO-Adjacents,16
Actinocheita_filicina,19,14,5,Points-PointsKO-Adjacents,124
Actinodaphne_acuminata,409,380,29,Alphahull-PointsKO-Adjacents,416
Actinodaphne_acutivena,2,2,0,Points-PointsKO-Adjacents,9
Actinodaphne_akoensis,0,0,0,NA,0
Actinodaphne_albifrons,0,0,0,NA,0
Actinodaphne_amabilis,1,1,0,Points-PointsKO-Adjacents,9
Actinodaphne_ambigua,0,0,0,NA,0
Actinodaphne_andamanica,NA,NA,NA,NA,NA
Actinodaphne_archboldiana,1,1,0,Points-PointsKO-Adjacents,9
Actinodaphne_areolata,0,0,0,NA,0
Actinodaphne_bicolor,0,0,0,NA,0
Actinodaphne_borneensis,6,3,3,Points-PointsKO-Adjacents,45
Actinodaphne_bourdillonii,0,0,0,NA,0
Actinodaphne_bourneae,0,0,0,NA,0
Actinodaphne_brassii,0,0,0,NA,0
Actinodaphne_caesia,NA,NA,NA,NA,NA
Actinodaphne_campanulata,0,0,0,NA,0
Actinodaphne_celebica,0,0,0,NA,0
Actinodaphne_cinerea,0,0,0,NA,0
Actinodaphne_cochinchinensis,0,0,0,NA,0
Actinodaphne_concinna,0,0,0,NA,0
Actinodaphne_concolor,NA,NA,NA,NA,NA
Actinodaphne_corymbosa,NA,NA,NA,NA,NA
Actinodaphne_crassa,0,0,0,NA,0
Actinodaphne_cuneata,1,0,1,Points-PointsKO-Adjacents,8
Actinodaphne_cupularis,22,11,11,Points-PointsKO-Adjacents,192
Actinodaphne_cuspidata,0,0,0,NA,0
Actinodaphne_diversifolia,4,4,0,Points-PointsKO-Adjacents,36
Actinodaphne_dolichophylla,0,0,0,NA,0
Actinodaphne_elegans,2,2,0,Points-PointsKO-Adjacents,15
Actinodaphne_ellipticibacca,0,0,0,NA,0
Actinodaphne_engleriana,NA,NA,NA,NA,NA
Actinodaphne_ferruginea,0,0,0,NA,0
Actinodaphne_forrestii,12,4,8,Points-PointsKO-Adjacents,104
Actinodaphne_fragilis,1,1,0,Points-PointsKO-Adjacents,9
Actinodaphne_fuliginosa,0,0,0,NA,0
Actinodaphne_furfuracea,NA,NA,NA,NA,NA
Actinodaphne_glabra,1,1,0,Points-PointsKO-Adjacents,6
Actinodaphne_glauca,2,2,0,Points-PointsKO-Adjacents,18
Actinodaphne_glaucina,2,2,0,Points-PointsKO-Adjacents,18
Actinodaphne_glomerata,13,1,12,Points-PointsKO-Adjacents,111
Actinodaphne_gracilis,0,0,0,NA,0
Actinodaphne_gullavara,0,0,0,NA,0
Actinodaphne_henryi,3,3,0,Points-PointsKO-Adjacents,27
Actinodaphne_hirsuta,0,0,0,NA,0
Actinodaphne_hookeri,1,1,0,Points-PointsKO-Adjacents,9
Actinodaphne_hypoleucophylla,6,2,4,Points-PointsKO-Adjacents,39
Actinodaphne_javanica,NA,NA,NA,NA,NA
Actinodaphne_johorensis,0,0,0,NA,0
Actinodaphne_kinabaluensis,2,2,0,Points-PointsKO-Adjacents,9
Actinodaphne_koshepangii,1,1,0,Points-PointsKO-Adjacents,9
Actinodaphne_kostermansii,1,1,0,Points-PointsKO-Adjacents,9
Actinodaphne_kweichowensis,6,1,5,Points-PointsKO-Adjacents,54
Actinodaphne_lanata,0,0,0,NA,0
Actinodaphne_lanceolata,NA,NA,NA,NA,NA
Actinodaphne_latifolia,0,0,0,NA,0
Actinodaphne_lawsonii,0,0,0,NA,0
Actinodaphne_lecomtei,9,0,9,Points-PointsKO-Adjacents,81
Actinodaphne_ledermannii,0,0,0,NA,0
Actinodaphne_leiantha,1,0,1,Points-PointsKO-Adjacents,9
Actinodaphne_leiophylla,0,0,0,NA,0
Actinodaphne_longipes,1,1,0,Points-PointsKO-Adjacents,9
Actinodaphne_macgregorii,0,0,0,NA,0
Actinodaphne_macrophylla,8,0,8,Points-PointsKO-Adjacents,69
Actinodaphne_macroptera,0,0,0,NA,0
Actinodaphne_madraspatana,0,0,0,NA,0
Actinodaphne_magniflora,0,0,0,NA,0
Actinodaphne_malaccensis,0,0,0,NA,0
Actinodaphne_mansonii,NA,NA,NA,NA,NA
Actinodaphne_menghaiensis,NA,NA,NA,NA,NA
Actinodaphne_microphylla,0,0,0,NA,0
Actinodaphne_mollis,0,0,0,NA,0
Actinodaphne_molochina,2,2,0,Points-PointsKO-Adjacents,18
Actinodaphne_moluccana,NA,NA,NA,NA,NA
Actinodaphne_montana,1,1,0,Points-PointsKO-Adjacents,9
Actinodaphne_multiflora,0,0,0,NA,0
Actinodaphne_mushaensis,147,131,16,Alphahull-PointsKO-Adjacents,244
Actinodaphne_myriantha,7,1,6,Points-PointsKO-Adjacents,61
Actinodaphne_nicobarica,NA,NA,NA,NA,NA
Actinodaphne_novoguineensis,0,0,0,NA,0
Actinodaphne_obovata,11,0,11,Points-PointsKO-Adjacents,99
Actinodaphne_obscurinervia,0,0,0,NA,0
Actinodaphne_obtusa,0,0,0,NA,0
Actinodaphne_omeiensis,9,0,9,Points-PointsKO-Adjacents,80
Actinodaphne_paotingensis,1,1,0,Points-PointsKO-Adjacents,9
Actinodaphne_pauciflora,0,0,0,NA,0
Actinodaphne_pedunculata,NA,NA,NA,NA,NA
Actinodaphne_percoriacea,2,2,0,Points-PointsKO-Adjacents,18
Actinodaphne_perglabra,NA,NA,NA,NA,NA
Actinodaphne_perlucida,0,0,0,NA,0
Actinodaphne_philippinensis,0,0,0,NA,0
Actinodaphne_pilosa,27,12,15,Points-PointsKO-Adjacents,227
Actinodaphne_pisifera,0,0,0,NA,0
Actinodaphne_procera,2,1,1,Points-PointsKO-Adjacents,18
Actinodaphne_pruinosa,16,3,13,Points-PointsKO-Adjacents,114
Actinodaphne_pubescens,0,0,0,NA,0
Actinodaphne_pulchra,0,0,0,NA,0
Actinodaphne_quercina,0,0,0,NA,0
Actinodaphne_reticulata,0,0,0,NA,0
Actinodaphne_ridleyi,0,0,0,NA,0
Actinodaphne_robusta,NA,NA,NA,NA,NA
Actinodaphne_rufescens,0,0,0,NA,0
Actinodaphne_rumphii,0,0,0,NA,0
Actinodaphne_salicina,0,0,0,NA,0
Actinodaphne_samarensis,0,0,0,NA,0
Actinodaphne_sasakii,NA,NA,NA,NA,NA
Actinodaphne_scleroptera,NA,NA,NA,NA,NA
Actinodaphne_semengohensis,NA,NA,NA,NA,NA
Actinodaphne_sesquipedalis,4,4,0,Points-PointsKO-Adjacents,36
Actinodaphne_sessilifructa,NA,NA,NA,NA,NA
Actinodaphne_setchuenensis,1,1,0,Points-PointsKO-Adjacents,9
Actinodaphne_sikkimensis,1,1,0,Points-PointsKO-Adjacents,9
Actinodaphne_soepadmoi,NA,NA,NA,NA,NA
Actinodaphne_solomonensis,2,2,0,Points-PointsKO-Adjacents,18
Actinodaphne_spathulifolia,NA,NA,NA,NA,NA
Actinodaphne_speciosa,2,2,0,Points-PointsKO-Adjacents,18
Actinodaphne_sphaerocarpa,1,1,0,Points-PointsKO-Adjacents,9
Actinodaphne_stenophylla,3,3,0,Points-PointsKO-Adjacents,27
Actinodaphne_sulcata,2,2,0,Points-PointsKO-Adjacents,16
Actinodaphne_tadulingamii,0,0,0,NA,0
Actinodaphne_tayabensis,4,4,0,Points-PointsKO-Adjacents,29
Actinodaphne_tomentosa,8,1,7,Points-PointsKO-Adjacents,60
Actinodaphne_trichocarpa,10,3,7,Points-PointsKO-Adjacents,90
Actinodaphne_tsaii,3,3,0,Points-PointsKO-Adjacents,27
Actinodaphne_venosa,NA,NA,NA,NA,NA
Actinodaphne_wightiana,1,0,1,Points-PointsKO-Adjacents,9
Actinokentia_divaricata,34,25,9,Alphahull-PointsKO-Adjacents,91
Actinokentia_huerlimannii,3,3,0,Points-PointsKO-Adjacents,15
Actinorhytis_calapparia,8,0,8,Points-PointsKO-Adjacents,57
Actinostemon_amazonicus,75,31,44,Alphahull-PointsKO-Adjacents,1881
Actinostemon_caribaeus,24,8,16,Points-PointsKO-Adjacents,128
Actinostemon_concepcionis,128,85,43,Alphahull-PointsKO-Adjacents,2155
Actinostemon_concolor,1007,881,126,Alphahull-PointsKO-Adjacents,20237
Actinostemon_echinatus,7,1,6,Points-PointsKO-Adjacents,57
Actinostemon_glaziovii,1,1,0,Points-PointsKO-Adjacents,9
Actinostemon_imbricatus,2,2,0,Points-PointsKO-Adjacents,18
Actinostemon_klotzschii,299,214,85,Alphahull-PointsKO-Adjacents,6555
Actinostemon_leptopus,10,2,8,Points-PointsKO-Adjacents,88
Actinostemon_mandiocanus,2,2,0,Points-PointsKO-Adjacents,18
Actinostemon_schomburgkii,275,183,92,Alphahull-PointsKO-Adjacents,9302
Actinostemon_verticillatus,188,138,50,Alphahull-PointsKO-Adjacents,3950
Acunaeanthus_tinifolius,2,2,0,Points-PointsKO-Adjacents,17
Adansonia_digitata,573,442,131,Alphahull-PointsKO-Adjacents,13569
Adansonia_fony,2,0,2,Points-PointsKO-Adjacents,18
Adansonia_grandidieri,15,11,4,Points-PointsKO-Adjacents,45
Adansonia_gregorii,251,222,29,Alphahull-PointsKO-Adjacents,2906
Adansonia_madagascariensis,54,43,11,Alphahull-PointsKO-Adjacents,1032
Adansonia_perrieri,24,0,24,Points-PointsKO-Adjacents,91
Adansonia_suarezensis,10,6,4,Points-PointsKO-Adjacents,34
Adansonia_za,124,95,29,Alphahull-PointsKO-Adjacents,1996
Adelia_barbinervis,535,470,65,Alphahull-PointsKO-Adjacents,7397
Adelia_membranifolia,139,97,42,Alphahull-PointsKO-Adjacents,6266
Adelia_oaxacana,74,46,28,Alphahull-PointsKO-Adjacents,2719
Adelia_panamensis,0,0,0,NA,0
Adelia_ricinella,128,74,54,Alphahull-PointsKO-Adjacents,2355
Adelia_triloba,225,173,52,Alphahull-PointsKO-Adjacents,2917
Adelobotrys_antioquiensis,8,2,6,Points-PointsKO-Adjacents,45
Adelobotrys_klugii,28,0,28,Points-PointsKO-Adjacents,182
Adelobotrys_macrantha,11,0,11,Points-PointsKO-Adjacents,66
Adelobotrys_panamensis,9,6,3,Points-PointsKO-Adjacents,16
Adenanthera_abrosperma,84,74,10,Alphahull-PointsKO-Adjacents,1874
Adenanthera_aglaosperma,0,0,0,NA,0
Adenanthera_borneensis,2,2,0,Points-PointsKO-Adjacents,12
Adenanthera_forbesii,1,1,0,Points-PointsKO-Adjacents,9
Adenanthera_intermedia,8,0,8,Points-PointsKO-Adjacents,70
Adenanthera_kostermansii,5,5,0,Points-PointsKO-Adjacents,45
Adenanthera_malayana,2,2,0,Points-PointsKO-Adjacents,16
Adenanthera_mantaroa,38,18,20,Points-PointsKO-Adjacents,216
Adenanthera_marina,NA,NA,NA,NA,NA
Adenanthera_microsperma,31,6,25,Points-PointsKO-Adjacents,258
Adenanthera_novo-guineensis,63,30,33,Alphahull-PointsKO-Adjacents,2133
Adenanthera_pavonina,208,0,208,Points-PointsKO-Adjacents,1244
Adenanthos_sericeus,66,0,66,Points-PointsKO-Adjacents,157
Adenaria_floribunda,894,730,164,Alphahull-PointsKO-Adjacents,36451
Adenia_karibaensis,1,1,0,Points-PointsKO-Adjacents,9
Adenia_pechuelii,6,1,5,Points-PointsKO-Adjacents,54
Adenia_spinosa,15,9,6,Points-PointsKO-Adjacents,121
Adenium_boehmianum,41,28,13,Alphahull-PointsKO-Adjacents,2081
Adenium_multiflorum,29,14,15,Points-PointsKO-Adjacents,234
Adenium_obesum,143,66,77,Alphahull-PointsKO-Adjacents,2980
Adenocalymma_bracteosum,44,7,37,Points-PointsKO-Adjacents,337
Adenocalymma_cladotrichum,234,189,45,Alphahull-PointsKO-Adjacents,12956
Adenocarpus_mannii,70,34,36,Alphahull-PointsKO-Adjacents,288
Adenodaphne_uniflora,13,4,9,Points-PointsKO-Adjacents,61
Adenolobus_garipensis,81,52,29,Alphahull-PointsKO-Adjacents,1695
Adenophaedra_grandifolia,100,51,49,Alphahull-PointsKO-Adjacents,1973
Adenophaedra_megalophylla,73,38,35,Alphahull-PointsKO-Adjacents,465
Adenopodia_oaxacana,32,23,9,Alphahull-PointsKO-Adjacents,59
Adenopodia_rotundifolia,4,4,0,Points-PointsKO-Adjacents,32
Adenorandia_kalbreyeri,23,0,23,Points-PointsKO-Adjacents,162
Adenostoma_sparsifolium,250,233,17,Alphahull-PointsKO-Adjacents,553
Adesmia_resinosa,2,2,0,Points-PointsKO-Adjacents,18
Adesmia_viscosa,1,1,0,Points-PointsKO-Adjacents,9
Adina_dissimilis,4,4,0,Points-PointsKO-Adjacents,18
Adina_pilulifera,152,105,47,Alphahull-PointsKO-Adjacents,7844
Adina_pubicostata,0,0,0,NA,0
Adinandra_acuminata,9,2,7,Points-PointsKO-Adjacents,75
Adinandra_acuta,NA,NA,NA,NA,NA
Adinandra_angulata,0,0,0,NA,0
Adinandra_anisobasis,2,1,1,Points-PointsKO-Adjacents,18
Adinandra_annamensis,0,0,0,NA,0
Adinandra_apoensis,5,0,5,Points-PointsKO-Adjacents,24
Adinandra_argentifolia,NA,NA,NA,NA,NA
Adinandra_auriformis,NA,NA,NA,NA,NA
Adinandra_bicuspidata,0,0,0,NA,0
Adinandra_bockiana,43,22,21,Alphahull-PointsKO-Adjacents,2751
Adinandra_borneensis,2,0,2,Points-PointsKO-Adjacents,18
Adinandra_brassii,7,0,7,Points-PointsKO-Adjacents,53
Adinandra_brefeldii,2,2,0,Points-PointsKO-Adjacents,18
Adinandra_calciphila,NA,NA,NA,NA,NA
Adinandra_caudata,0,0,0,NA,0
Adinandra_celebica,14,7,7,Points-PointsKO-Adjacents,94
Adinandra_clemensiae,5,0,5,Points-PointsKO-Adjacents,42
Adinandra_coarctata,0,0,0,NA,0
Adinandra_collina,6,2,4,Points-PointsKO-Adjacents,52
Adinandra_colombonensis,2,0,2,Points-PointsKO-Adjacents,18
Adinandra_cordifolia,9,1,8,Points-PointsKO-Adjacents,79
Adinandra_corneriana,0,0,0,NA,0
Adinandra_crassifolia,0,0,0,NA,0
Adinandra_dasyantha,1,0,1,Points-PointsKO-Adjacents,9
Adinandra_donnaiensis,0,0,0,NA,0
Adinandra_dubia,0,0,0,NA,0
Adinandra_dumosa,41,17,24,Points-PointsKO-Adjacents,306
Adinandra_elegans,NA,NA,NA,NA,NA
Adinandra_elliptica,6,0,6,Points-PointsKO-Adjacents,52
Adinandra_endertii,0,0,0,NA,0
Adinandra_epunctata,2,1,1,Points-PointsKO-Adjacents,18
Adinandra_excelsa,8,1,7,Points-PointsKO-Adjacents,69
Adinandra_eymae,0,0,0,NA,0
Adinandra_filipes,0,0,0,NA,0
Adinandra_forbesii,13,5,8,Points-PointsKO-Adjacents,94
Adinandra_formosana,286,239,47,Alphahull-PointsKO-Adjacents,326
Adinandra_gallatlyi,NA,NA,NA,NA,NA
Adinandra_glischroloma,35,17,18,Points-PointsKO-Adjacents,314
Adinandra_grandifolia,NA,NA,NA,NA,NA
Adinandra_grandis,2,2,0,Points-PointsKO-Adjacents,18
Adinandra_griffithii,0,0,0,NA,0
Adinandra_hainanensis,2,0,2,Points-PointsKO-Adjacents,18
Adinandra_hirta,9,3,6,Points-PointsKO-Adjacents,81
Adinandra_howii,1,1,0,Points-PointsKO-Adjacents,9
Adinandra_impressa,4,4,0,Points-PointsKO-Adjacents,9
Adinandra_inaequalis,0,0,0,NA,0
Adinandra_integerrima,1,1,0,Points-PointsKO-Adjacents,9
Adinandra_kjellbergii,0,0,0,NA,0
Adinandra_kostermansii,NA,NA,NA,NA,NA
Adinandra_lancipetala,2,2,0,Points-PointsKO-Adjacents,18
Adinandra_laotica,0,0,0,NA,0
Adinandra_laronensis,0,0,0,NA,0
Adinandra_lasiopetala,1,1,0,Points-PointsKO-Adjacents,9
Adinandra_lasiostyla,57,47,10,Alphahull-PointsKO-Adjacents,126
Adinandra_latifolia,2,2,0,Points-PointsKO-Adjacents,18
Adinandra_lenticellata,NA,NA,NA,NA,NA
Adinandra_leytensis,0,0,0,NA,0
Adinandra_lienii,0,0,0,NA,0
Adinandra_loerzingiana,0,0,0,NA,0
Adinandra_loheri,1,1,0,Points-PointsKO-Adjacents,9
Adinandra_longipedicellata,0,0,0,NA,0
Adinandra_luzonica,1,1,0,Points-PointsKO-Adjacents,9
Adinandra_macgregorii,0,0,0,NA,0
Adinandra_maculosa,1,1,0,Points-PointsKO-Adjacents,9
Adinandra_magniflora,3,2,1,Points-PointsKO-Adjacents,21
Adinandra_masambensis,0,0,0,NA,0
Adinandra_megaphylla,9,4,5,Points-PointsKO-Adjacents,81
Adinandra_mendamitensis,NA,NA,NA,NA,NA
Adinandra_meratusensis,1,1,0,Points-PointsKO-Adjacents,9
Adinandra_milletii,4,4,0,Points-PointsKO-Adjacents,36
Adinandra_myrioneura,1,1,0,Points-PointsKO-Adjacents,9
Adinandra_nigroglandulosa,3,3,0,Points-PointsKO-Adjacents,27
Adinandra_nigropunctata,1,1,0,Points-PointsKO-Adjacents,9
Adinandra_nitida,0,0,0,NA,0
Adinandra_nunkokensis,2,1,1,Points-PointsKO-Adjacents,18
Adinandra_oblonga,1,1,0,Points-PointsKO-Adjacents,9
Adinandra_pangiensis,NA,NA,NA,NA,NA
Adinandra_parvifolia,1,1,0,Points-PointsKO-Adjacents,9
Adinandra_pingbianensis,1,1,0,Points-PointsKO-Adjacents,9
Adinandra_plagiobasis,0,0,0,NA,0
Adinandra_polyneura,0,0,0,NA,0
Adinandra_quinquepartita,1,1,0,Points-PointsKO-Adjacents,9
Adinandra_rantepaoensis,0,0,0,NA,0
Adinandra_rubiginosa,0,0,0,NA,0
Adinandra_ryukyuensis,2,2,0,Points-PointsKO-Adjacents,10
Adinandra_sadaui,0,0,0,NA,0
Adinandra_sarosanthera,10,2,8,Points-PointsKO-Adjacents,78
Adinandra_steenisii,0,0,0,NA,0
Adinandra_subauriculata,0,0,0,NA,0
Adinandra_subsessilis,4,4,0,Points-PointsKO-Adjacents,36
Adinandra_subunguiculata,0,0,0,NA,0
Adinandra_tomentosa,NA,NA,NA,NA,NA
Adinandra_verrucosa,3,3,0,Points-PointsKO-Adjacents,27
Adinandra_villosa,4,4,0,Points-PointsKO-Adjacents,21
Adinandra_yaeyamensis,8,7,1,Points-PointsKO-Adjacents,17
Adiscanthus_fusciflorus,68,44,24,Alphahull-PointsKO-Adjacents,1231
Adonidia_merrillii,0,0,0,NA,0
Aegialitis_annulata,178,114,64,Alphahull-PointsKO-Adjacents,3376
Aegialitis_rotundifolia,2,1,1,Points-PointsKO-Adjacents,18
Aegiceras_corniculatum,687,470,217,Alphahull-PointsKO-Adjacents,9106
Aegiceras_floridum,12,0,12,Points-PointsKO-Adjacents,89
Aegiphila_alba,128,107,21,Alphahull-PointsKO-Adjacents,1724
Aegiphila_anomala,120,94,26,Alphahull-PointsKO-Adjacents,759
Aegiphila_arcta,0,0,0,NA,0
Aegiphila_bogotensis,130,100,30,Alphahull-PointsKO-Adjacents,3038
Aegiphila_boliviana,30,7,23,Points-PointsKO-Adjacents,237
Aegiphila_brachiata,311,259,52,Alphahull-PointsKO-Adjacents,10411
Aegiphila_buchtienii,7,3,4,Points-PointsKO-Adjacents,60
Aegiphila_caucensis,5,5,0,Points-PointsKO-Adjacents,45
Aegiphila_cephalophora,85,68,17,Alphahull-PointsKO-Adjacents,657
Aegiphila_conturbata,2,2,0,Points-PointsKO-Adjacents,18
Aegiphila_cordata,102,66,36,Alphahull-PointsKO-Adjacents,4948
Aegiphila_cordifolia,5,5,0,Points-PointsKO-Adjacents,45
Aegiphila_costaricensis,190,151,39,Alphahull-PointsKO-Adjacents,1492
Aegiphila_cuatrecasasii,33,15,18,Points-PointsKO-Adjacents,223
Aegiphila_cuneata,62,37,25,Alphahull-PointsKO-Adjacents,2579
Aegiphila_deppeana,98,60,38,Alphahull-PointsKO-Adjacents,970
Aegiphila_duckei,2,2,0,Points-PointsKO-Adjacents,18
Aegiphila_elata,202,127,75,Alphahull-PointsKO-Adjacents,4445
Aegiphila_elegans,36,12,24,Points-PointsKO-Adjacents,286
Aegiphila_exiguiflora,3,3,0,Points-PointsKO-Adjacents,27
Aegiphila_falcata,37,19,18,Points-PointsKO-Adjacents,199
Aegiphila_fasciculata,20,10,10,Points-PointsKO-Adjacents,101
Aegiphila_ferruginea,45,34,11,Alphahull-PointsKO-Adjacents,300
Aegiphila_filipes,13,0,13,Points-PointsKO-Adjacents,108
Aegiphila_floribunda,22,7,15,Points-PointsKO-Adjacents,145
Aegiphila_fluminensis,86,44,42,Alphahull-PointsKO-Adjacents,1297
Aegiphila_glabrata,5,5,0,Points-PointsKO-Adjacents,36
Aegiphila_glomerata,2,2,0,Points-PointsKO-Adjacents,18
Aegiphila_grandis,34,18,16,Points-PointsKO-Adjacents,247
Aegiphila_hastingsiana,2,1,1,Points-PointsKO-Adjacents,18
Aegiphila_haughtii,22,0,22,Points-PointsKO-Adjacents,130
Aegiphila_hirsutissima,27,16,11,Points-PointsKO-Adjacents,173
Aegiphila_hoehnei,62,33,29,Alphahull-PointsKO-Adjacents,366
Aegiphila_hystricina,0,0,0,NA,0
Aegiphila_integrifolia,2240,2031,209,Alphahull-PointsKO-Adjacents,128554
Aegiphila_intermedia,1,1,0,Points-PointsKO-Adjacents,9
Aegiphila_laeta,109,76,33,Alphahull-PointsKO-Adjacents,3802
Aegiphila_laxiflora,17,2,15,Points-PointsKO-Adjacents,145
Aegiphila_lehmannii,36,19,17,Points-PointsKO-Adjacents,235
Aegiphila_lopez-palacii,1,1,0,Points-PointsKO-Adjacents,9
Aegiphila_luschnathii,47,9,38,Points-PointsKO-Adjacents,344
Aegiphila_martinicensis,184,99,85,Alphahull-PointsKO-Adjacents,5970
Aegiphila_mattogrossensis,1,1,0,Points-PointsKO-Adjacents,9
Aegiphila_mediterranea,128,88,40,Alphahull-PointsKO-Adjacents,2789
Aegiphila_membranacea,102,38,64,Alphahull-PointsKO-Adjacents,3295
Aegiphila_microcalycina,8,0,8,Points-PointsKO-Adjacents,63
Aegiphila_minasensis,0,0,0,NA,0
Aegiphila_moldenkeana,11,5,6,Points-PointsKO-Adjacents,39
Aegiphila_mollis,222,0,222,Points-PointsKO-Adjacents,1442
Aegiphila_monstrosa,157,140,17,Alphahull-PointsKO-Adjacents,3049
Aegiphila_montana,0,0,0,NA,0
Aegiphila_monticola,26,15,11,Points-PointsKO-Adjacents,133
Aegiphila_multiflora,62,28,34,Alphahull-PointsKO-Adjacents,559
Aegiphila_nervosa,1,1,0,Points-PointsKO-Adjacents,8
Aegiphila_novogranatensis,74,47,27,Alphahull-PointsKO-Adjacents,818
Aegiphila_obducta,267,220,47,Alphahull-PointsKO-Adjacents,2804
Aegiphila_obovata,1,1,0,Points-PointsKO-Adjacents,9
Aegiphila_odontophylla,117,95,22,Alphahull-PointsKO-Adjacents,295
Aegiphila_panamensis,337,279,58,Alphahull-PointsKO-Adjacents,4664
Aegiphila_parviflora,1,1,0,Points-PointsKO-Adjacents,9
Aegiphila_pauciflora,2,1,1,Points-PointsKO-Adjacents,12
Aegiphila_pennellii,15,10,5,Points-PointsKO-Adjacents,55
Aegiphila_pernambucensis,93,18,75,Points-PointsKO-Adjacents,485
Aegiphila_perplexa,6,0,6,Points-PointsKO-Adjacents,54
Aegiphila_peruviana,25,6,19,Points-PointsKO-Adjacents,204
Aegiphila_purpurascens,6,0,6,Points-PointsKO-Adjacents,54
Aegiphila_quinduensis,36,15,21,Points-PointsKO-Adjacents,278
Aegiphila_rimbachii,6,0,6,Points-PointsKO-Adjacents,54
Aegiphila_roraimensis,13,3,10,Points-PointsKO-Adjacents,99
Aegiphila_saltensis,7,3,4,Points-PointsKO-Adjacents,63
Aegiphila_salticola,3,3,0,Points-PointsKO-Adjacents,27
Aegiphila_scandens,0,0,0,NA,0
Aegiphila_schimpffii,5,5,0,Points-PointsKO-Adjacents,33
Aegiphila_sellowiana,1,1,0,Points-PointsKO-Adjacents,9
Aegiphila_skutchii,22,7,15,Points-PointsKO-Adjacents,121
Aegiphila_smithii,38,17,21,Points-PointsKO-Adjacents,232
Aegiphila_sordida,5,5,0,Points-PointsKO-Adjacents,45
Aegiphila_spicata,15,5,10,Points-PointsKO-Adjacents,94
Aegiphila_steinbachii,6,1,5,Points-PointsKO-Adjacents,43
Aegiphila_sufflava,23,13,10,Points-PointsKO-Adjacents,170
Aegiphila_sylvatica,0,0,0,NA,0
Aegiphila_ternifolia,21,7,14,Points-PointsKO-Adjacents,147
Aegiphila_trifida,3,3,0,Points-PointsKO-Adjacents,27
Aegiphila_truncata,45,35,10,Alphahull-PointsKO-Adjacents,1225
Aegiphila_ulei,89,54,35,Alphahull-PointsKO-Adjacents,7563
Aegiphila_valerioi,61,41,20,Alphahull-PointsKO-Adjacents,285
Aegiphila_vallensis,11,6,5,Points-PointsKO-Adjacents,60
Aegiphila_venezuelensis,25,14,11,Points-PointsKO-Adjacents,166
Aegiphila_verticillata,851,720,131,Alphahull-PointsKO-Adjacents,47682
Aegiphila_villosa,17,10,7,Points-PointsKO-Adjacents,114
Aegiphila_vitelliniflora,257,140,117,Alphahull-PointsKO-Adjacents,15665
Aegiphila_wigandioides,13,0,13,Points-PointsKO-Adjacents,52
Aegle_marmelos,0,0,0,NA,0
Aeglopsis_chevalieri,22,9,13,Points-PointsKO-Adjacents,169
Aeglopsis_eggelingii,2,2,0,Points-PointsKO-Adjacents,18
Aeglopsis_mangenotii,NA,NA,NA,NA,NA
Aequatorium_asterotrichum,3,3,0,Points-PointsKO-Adjacents,27
Aequatorium_cajamarcense,6,0,6,Points-PointsKO-Adjacents,42
Aequatorium_carpishense,2,2,0,Points-PointsKO-Adjacents,18
Aequatorium_jamesonii,9,4,5,Points-PointsKO-Adjacents,51
Aequatorium_latibracteolatum,4,4,0,Points-PointsKO-Adjacents,36
Aequatorium_lepidotum,1,1,0,Points-PointsKO-Adjacents,9
Aequatorium_limonense,1,1,0,Points-PointsKO-Adjacents,9
Aequatorium_repandiforme,5,5,0,Points-PointsKO-Adjacents,45
Aequatorium_rimachianum,2,2,0,Points-PointsKO-Adjacents,18
Aequatorium_stellatopilosum,7,1,6,Points-PointsKO-Adjacents,54
Aequatorium_verrucosum,15,12,3,Points-PointsKO-Adjacents,112
Aeschrion_cubensis,NA,NA,NA,NA,NA
Aeschynomene_amorphoides,118,91,27,Alphahull-PointsKO-Adjacents,994
Aeschynomene_burttii,9,4,5,Points-PointsKO-Adjacents,52
Aeschynomene_ciliata,132,57,75,Alphahull-PointsKO-Adjacents,1628
Aeschynomene_elaphroxylon,33,10,23,Points-PointsKO-Adjacents,232
Aeschynomene_megalophylla,18,10,8,Points-PointsKO-Adjacents,74
Aeschynomene_mollicula,79,0,79,Points-PointsKO-Adjacents,628
Aeschynomene_monteiroi,51,35,16,Alphahull-PointsKO-Adjacents,1736
Aeschynomene_nyikensis,20,10,10,Points-PointsKO-Adjacents,128
Aeschynomene_pararubrofarinacea,23,17,6,Points-PointsKO-Adjacents,134
Aeschynomene_pfundii,2,2,0,Points-PointsKO-Adjacents,18
Aeschynomene_schliebenii,40,26,14,Alphahull-PointsKO-Adjacents,2163
Aesculus_assamica,19,5,14,Points-PointsKO-Adjacents,171
Aesculus_californica,1157,972,185,Alphahull-PointsKO-Adjacents,4262
Aesculus_chinensis,43,18,25,Points-PointsKO-Adjacents,372
Aesculus_flava,1372,1261,111,Alphahull-PointsKO-Adjacents,9091
Aesculus_glabra,1474,1147,327,Alphahull-PointsKO-Adjacents,28615
Aesculus_hippocastanum,9,5,4,Points-PointsKO-Adjacents,70
Aesculus_indica,22,6,16,Points-PointsKO-Adjacents,181
Aesculus_parryi,56,0,56,Points-PointsKO-Adjacents,188
Aesculus_parviflora,77,43,34,Alphahull-PointsKO-Adjacents,855
Aesculus_pavia,890,700,190,Alphahull-PointsKO-Adjacents,16641
Aesculus_sylvatica,256,197,59,Alphahull-PointsKO-Adjacents,2755
Aesculus_turbinata,110,81,29,Alphahull-PointsKO-Adjacents,1361
Aesculus_wangii,7,2,5,Points-PointsKO-Adjacents,63
Aetoxylon_sympetalum,5,1,4,Points-PointsKO-Adjacents,45
Aextoxicon_punctatum,58,39,19,Alphahull-PointsKO-Adjacents,1802
Afraegle_paniculata,71,57,14,Alphahull-PointsKO-Adjacents,2102
Afrocanthium_burttii,35,16,19,Points-PointsKO-Adjacents,208
Afrocanthium_gilfillanii,39,26,13,Alphahull-PointsKO-Adjacents,1144
Afrocanthium_keniense,14,3,11,Points-PointsKO-Adjacents,49
Afrocanthium_kilifiense,20,12,8,Points-PointsKO-Adjacents,97
Afrocanthium_lactescens,57,22,35,Alphahull-PointsKO-Adjacents,389
Afrocanthium_mundianum,111,77,34,Alphahull-PointsKO-Adjacents,3391
Afrocanthium_ngonii,2,2,0,Points-PointsKO-Adjacents,9
Afrocanthium_parasiebenlistii,9,1,8,Points-PointsKO-Adjacents,68
Afrocanthium_peteri,14,6,8,Points-PointsKO-Adjacents,83
Afrocanthium_pseudorandii,16,5,11,Points-PointsKO-Adjacents,130
Afrocanthium_pseudoverticillatum,47,28,19,Alphahull-PointsKO-Adjacents,779
Afrocanthium_racemulosum,13,5,8,Points-PointsKO-Adjacents,106
Afrocanthium_rondoense,4,4,0,Points-PointsKO-Adjacents,21
Afrocanthium_salubenii,3,3,0,Points-PointsKO-Adjacents,17
Afrocanthium_shabanii,8,6,2,Points-PointsKO-Adjacents,40
Afrocanthium_siebenlistii,24,0,24,Points-PointsKO-Adjacents,129
Afrocanthium_vollesenii,3,3,0,Points-PointsKO-Adjacents,25
Afrocarpus_dawei,9,4,5,Points-PointsKO-Adjacents,69
Afrocarpus_falcatus,127,92,35,Alphahull-PointsKO-Adjacents,3266
Afrocarpus_gracilior,59,32,27,Alphahull-PointsKO-Adjacents,2153
Afrocarpus_mannii,9,6,3,Points-PointsKO-Adjacents,14
Afrocarpus_usambarensis,14,5,9,Points-PointsKO-Adjacents,95
Afrolicania_elaeosperma,74,40,34,Alphahull-PointsKO-Adjacents,2484
Afrostyrax_kamerunensis,114,93,21,Alphahull-PointsKO-Adjacents,1194
Afrostyrax_lepidophyllus,186,159,27,Alphahull-PointsKO-Adjacents,3499
Afrostyrax_macranthus,8,0,8,Points-PointsKO-Adjacents,43
Afrotrewia_kamerunica,6,3,3,Points-PointsKO-Adjacents,32
Afzelia_africana,118,65,53,Alphahull-PointsKO-Adjacents,3816
Afzelia_bella,163,104,59,Alphahull-PointsKO-Adjacents,8603
Afzelia_bipindensis,136,92,44,Alphahull-PointsKO-Adjacents,9513
Afzelia_javanica,1,0,1,Points-PointsKO-Adjacents,7
Afzelia_martabanica,NA,NA,NA,NA,NA
Afzelia_pachyloba,38,23,15,Alphahull-PointsKO-Adjacents,1573
Afzelia_parviflora,49,38,11,Alphahull-PointsKO-Adjacents,1032
Afzelia_peturei,3,3,0,Points-PointsKO-Adjacents,27
Afzelia_quanzensis,191,107,84,Alphahull-PointsKO-Adjacents,22190
Afzelia_rhomboidea,7,0,7,Points-PointsKO-Adjacents,54
Afzelia_xylocarpa,8,2,6,Points-PointsKO-Adjacents,70
Aganope_balansae,0,0,0,NA,0
Aganope_impressa,23,12,11,Points-PointsKO-Adjacents,153
Aganope_latifolia,0,0,0,NA,0
Aganope_leucobotrya,74,47,27,Alphahull-PointsKO-Adjacents,2262
Aganope_stuhlmannii,291,229,62,Alphahull-PointsKO-Adjacents,5182
Agapetes_pilifera,1,1,0,Points-PointsKO-Adjacents,9
Agarista_boliviensis,40,26,14,Alphahull-PointsKO-Adjacents,332
Agarista_bracamorensis,3,3,0,Points-PointsKO-Adjacents,27
Agarista_duckei,16,3,13,Points-PointsKO-Adjacents,132
Agarista_eucalyptoides,151,103,48,Alphahull-PointsKO-Adjacents,4957
Agarista_glaberrima,79,67,12,Alphahull-PointsKO-Adjacents,602
Agarista_mexicana,183,144,39,Alphahull-PointsKO-Adjacents,5005
Agarista_minensis,6,0,6,Points-PointsKO-Adjacents,51
Agarista_niederleinii,89,0,89,Points-PointsKO-Adjacents,518
Agarista_oleifolia,239,190,49,Alphahull-PointsKO-Adjacents,6810
Agarista_pulchra,48,28,20,Alphahull-PointsKO-Adjacents,206
Agarista_revoluta,114,61,53,Alphahull-PointsKO-Adjacents,3117
Agarista_salicifolia,244,164,80,Alphahull-PointsKO-Adjacents,4468
Agarista_uleana,10,1,9,Points-PointsKO-Adjacents,70
Agasthiyamalaia_pauciflora,1,1,0,Points-PointsKO-Adjacents,9
Agathis_atropurpurea,60,52,8,Alphahull-PointsKO-Adjacents,84
Agathis_australis,736,681,55,Alphahull-PointsKO-Adjacents,1528
Agathis_borneensis,41,16,25,Points-PointsKO-Adjacents,331
Agathis_dammara,44,11,33,Points-PointsKO-Adjacents,333
Agathis_flavescens,4,4,0,Points-PointsKO-Adjacents,18
Agathis_kinabaluensis,8,1,7,Points-PointsKO-Adjacents,21
Agathis_labillardierei,53,33,20,Alphahull-PointsKO-Adjacents,980
Agathis_lanceolata,38,29,9,Alphahull-PointsKO-Adjacents,72
Agathis_lenticula,10,6,4,Points-PointsKO-Adjacents,43
Agathis_macrophylla,16,6,10,Points-PointsKO-Adjacents,95
Agathis_microstachya,72,67,5,Alphahull-PointsKO-Adjacents,50
Agathis_montana,0,0,0,NA,0
Agathis_moorei,53,41,12,Alphahull-PointsKO-Adjacents,135
Agathis_orbicula,3,3,0,Points-PointsKO-Adjacents,27
Agathis_ovata,66,56,10,Alphahull-PointsKO-Adjacents,72
Agathis_robusta,181,132,49,Alphahull-PointsKO-Adjacents,795
Agathis_silbae,4,4,0,Points-PointsKO-Adjacents,26
Agelaea_borneensis,66,38,28,Alphahull-PointsKO-Adjacents,730
Agelaea_macrophylla,11,2,9,Points-PointsKO-Adjacents,82
Agelaea_trinervis,24,4,20,Points-PointsKO-Adjacents,205
Ageratina_gloeoclada,17,8,9,Points-PointsKO-Adjacents,105
Ageratina_havanensis,365,288,77,Alphahull-PointsKO-Adjacents,7857
Ageratina_illita,18,11,7,Points-PointsKO-Adjacents,74
Ageratina_latipes,23,17,6,Points-PointsKO-Adjacents,146
Ageratina_macbridei,9,1,8,Points-PointsKO-Adjacents,72
Ageratina_mairetiana,425,373,52,Alphahull-PointsKO-Adjacents,5673
Ageratina_popayanensis,213,183,30,Alphahull-PointsKO-Adjacents,1715
Aglaia_agglomerata,29,15,14,Points-PointsKO-Adjacents,206
Aglaia_aherniana,1,1,0,Points-PointsKO-Adjacents,9
Aglaia_amplexicaulis,1,1,0,Points-PointsKO-Adjacents,9
Aglaia_angustifolia,7,0,7,Points-PointsKO-Adjacents,63
Aglaia_apiocarpa,2,2,0,Points-PointsKO-Adjacents,18
Aglaia_archboldiana,1,1,0,Points-PointsKO-Adjacents,9
Aglaia_argentea,100,38,62,Alphahull-PointsKO-Adjacents,1600
Aglaia_australiensis,35,29,6,Alphahull-PointsKO-Adjacents,32
Aglaia_barbanthera,4,4,0,Points-PointsKO-Adjacents,36
Aglaia_basiphylla,1,1,0,Points-PointsKO-Adjacents,9
Aglaia_beccarii,1,1,0,Points-PointsKO-Adjacents,9
Aglaia_bourdillonii,0,0,0,NA,0
Aglaia_brassii,32,24,8,Alphahull-PointsKO-Adjacents,62
Aglaia_brownii,261,211,50,Alphahull-PointsKO-Adjacents,1086
Aglaia_bullata,NA,NA,NA,NA,NA
Aglaia_ceramica,0,0,0,NA,0
Aglaia_chittagonga,4,4,0,Points-PointsKO-Adjacents,24
Aglaia_conferta,5,5,0,Points-PointsKO-Adjacents,43
Aglaia_cooperae,8,4,4,Points-PointsKO-Adjacents,23
Aglaia_coriacea,1,1,0,Points-PointsKO-Adjacents,9
Aglaia_costata,2,2,0,Points-PointsKO-Adjacents,12
Aglaia_crassinervia,19,0,19,Points-PointsKO-Adjacents,158
Aglaia_cremea,7,0,7,Points-PointsKO-Adjacents,55
Aglaia_cucullata,1,1,0,Points-PointsKO-Adjacents,9
Aglaia_cumingiana,6,0,6,Points-PointsKO-Adjacents,30
Aglaia_cuspidata,1,1,0,Points-PointsKO-Adjacents,9
Aglaia_densisquama,0,0,0,NA,0
Aglaia_densitricha,0,0,0,NA,0
Aglaia_edulis,9,1,8,Points-PointsKO-Adjacents,76
Aglaia_elaeagnoidea,242,153,89,Alphahull-PointsKO-Adjacents,1483
Aglaia_elliptica,63,9,54,Points-PointsKO-Adjacents,440
Aglaia_erythrosperma,1,1,0,Points-PointsKO-Adjacents,9
Aglaia_euryanthera,59,34,25,Alphahull-PointsKO-Adjacents,263
Aglaia_evansensis,1,1,0,Points-PointsKO-Adjacents,9
Aglaia_eximia,5,0,5,Points-PointsKO-Adjacents,39
Aglaia_exstipulata,6,0,6,Points-PointsKO-Adjacents,51
Aglaia_flavescens,6,0,6,Points-PointsKO-Adjacents,45
Aglaia_flavida,6,0,6,Points-PointsKO-Adjacents,54
Aglaia_forbesii,14,0,14,Points-PointsKO-Adjacents,119
Aglaia_foveolata,6,0,6,Points-PointsKO-Adjacents,41
Aglaia_fragilis,1,1,0,Points-PointsKO-Adjacents,9
Aglaia_glabrata,3,3,0,Points-PointsKO-Adjacents,27
Aglaia_gracilis,2,2,0,Points-PointsKO-Adjacents,17
Aglaia_grandis,4,0,4,Points-PointsKO-Adjacents,34
Aglaia_heterotricha,0,0,0,NA,0
Aglaia_hiernii,8,1,7,Points-PointsKO-Adjacents,72
Aglaia_ijzermannii,3,3,0,Points-PointsKO-Adjacents,21
Aglaia_integrifolia,1,1,0,Points-PointsKO-Adjacents,9
Aglaia_korthalsii,13,1,12,Points-PointsKO-Adjacents,94
Aglaia_lancilimba,4,4,0,Points-PointsKO-Adjacents,36
Aglaia_lawii,125,36,89,Alphahull-PointsKO-Adjacents,3893
Aglaia_laxiflora,4,4,0,Points-PointsKO-Adjacents,36
Aglaia_lepidopetala,12,2,10,Points-PointsKO-Adjacents,100
Aglaia_lepiorrhachis,13,0,13,Points-PointsKO-Adjacents,68
Aglaia_leptantha,20,1,19,Points-PointsKO-Adjacents,140
Aglaia_leucoclada,8,1,7,Points-PointsKO-Adjacents,60
Aglaia_leucophylla,26,5,21,Points-PointsKO-Adjacents,194
Aglaia_luzoniensis,12,0,12,Points-PointsKO-Adjacents,87
Aglaia_mackiana,1,1,0,Points-PointsKO-Adjacents,9
Aglaia_macrocarpa,12,0,12,Points-PointsKO-Adjacents,101
Aglaia_macrostigma,1,1,0,Points-PointsKO-Adjacents,9
Aglaia_malabarica,NA,NA,NA,NA,NA
Aglaia_malaccensis,4,0,4,Points-PointsKO-Adjacents,27
Aglaia_mariannensis,3,1,2,Points-PointsKO-Adjacents,14
Aglaia_membranifolia,0,0,0,NA,0
Aglaia_monozyga,2,0,2,Points-PointsKO-Adjacents,18
Aglaia_multinervis,2,2,0,Points-PointsKO-Adjacents,18
Aglaia_odorata,37,9,28,Points-PointsKO-Adjacents,324
Aglaia_odoratissima,47,14,33,Points-PointsKO-Adjacents,377
Aglaia_oligophylla,18,1,17,Points-PointsKO-Adjacents,144
Aglaia_pachyphylla,7,0,7,Points-PointsKO-Adjacents,62
Aglaia_palembanica,4,4,0,Points-PointsKO-Adjacents,36
Aglaia_pannelliana,1,1,0,Points-PointsKO-Adjacents,9
Aglaia_parksii,1,1,0,Points-PointsKO-Adjacents,9
Aglaia_parviflora,32,8,24,Points-PointsKO-Adjacents,248
Aglaia_penningtoniana,2,2,0,Points-PointsKO-Adjacents,18
Aglaia_perviridis,9,2,7,Points-PointsKO-Adjacents,81
Aglaia_pinnata,3,0,3,Points-PointsKO-Adjacents,27
Aglaia_pleuropteris,0,0,0,NA,0
Aglaia_polyneura,3,3,0,Points-PointsKO-Adjacents,27
Aglaia_puberulanthera,5,5,0,Points-PointsKO-Adjacents,43
Aglaia_pyriformis,2,2,0,Points-PointsKO-Adjacents,18
Aglaia_ramotricha,1,1,0,Points-PointsKO-Adjacents,9
Aglaia_rimosa,94,58,36,Alphahull-PointsKO-Adjacents,583
Aglaia_rivularis,9,3,6,Points-PointsKO-Adjacents,63
Aglaia_rubiginosa,3,0,3,Points-PointsKO-Adjacents,27
Aglaia_rubrivenia,1,1,0,Points-PointsKO-Adjacents,8
Aglaia_rufibarbis,1,1,0,Points-PointsKO-Adjacents,9
Aglaia_rufinervis,3,0,3,Points-PointsKO-Adjacents,18
Aglaia_rugulosa,0,0,0,NA,0
Aglaia_saltatorum,3,3,0,Points-PointsKO-Adjacents,25
Aglaia_samoensis,33,11,22,Points-PointsKO-Adjacents,165
Aglaia_sapindina,464,375,89,Alphahull-PointsKO-Adjacents,5683
Aglaia_scortechinii,3,3,0,Points-PointsKO-Adjacents,27
Aglaia_sessilifolia,NA,NA,NA,NA,NA
Aglaia_sexipetala,18,2,16,Points-PointsKO-Adjacents,154
Aglaia_silvestris,94,33,61,Alphahull-PointsKO-Adjacents,1787
Aglaia_simplicifolia,16,0,16,Points-PointsKO-Adjacents,138
Aglaia_smithii,4,4,0,Points-PointsKO-Adjacents,36
Aglaia_soepadmoi,NA,NA,NA,NA,NA
Aglaia_speciosa,1,0,1,Points-PointsKO-Adjacents,9
Aglaia_squamulosa,7,0,7,Points-PointsKO-Adjacents,62
Aglaia_stellatopilosa,0,0,0,NA,0
Aglaia_subcuprea,20,2,18,Points-PointsKO-Adjacents,150
Aglaia_subminutiflora,44,28,16,Alphahull-PointsKO-Adjacents,861
Aglaia_subsessilis,0,0,0,NA,0
Aglaia_tenuicaulis,4,0,4,Points-PointsKO-Adjacents,36
Aglaia_teysmanniana,5,5,0,Points-PointsKO-Adjacents,42
Aglaia_tomentosa,199,0,199,Points-PointsKO-Adjacents,922
Aglaia_unifolia,1,1,0,Points-PointsKO-Adjacents,9
Aglaia_variisquama,NA,NA,NA,NA,NA
Aglaia_vitiensis,2,2,0,Points-PointsKO-Adjacents,14
Agonandra_brasiliensis,1061,910,151,Alphahull-PointsKO-Adjacents,55689
Agonandra_excelsa,480,366,114,Alphahull-PointsKO-Adjacents,38186
Agonandra_fluminensis,4,3,1,Points-PointsKO-Adjacents,36
Agonandra_goldbergiana,3,3,0,Points-PointsKO-Adjacents,27
Agonandra_macrocarpa,43,30,13,Alphahull-PointsKO-Adjacents,135
Agonandra_obtusifolia,87,66,21,Alphahull-PointsKO-Adjacents,1458
Agonandra_ovatifolia,5,0,5,Points-PointsKO-Adjacents,30
Agonandra_peruviana,77,26,51,Alphahull-PointsKO-Adjacents,2132
Agonandra_racemosa,255,208,47,Alphahull-PointsKO-Adjacents,4725
Agonandra_silvatica,214,144,70,Alphahull-PointsKO-Adjacents,28112
Agonis_flexuosa,327,226,101,Alphahull-PointsKO-Adjacents,1315
Agouticarpa_curviflora,183,128,55,Alphahull-PointsKO-Adjacents,12233
Agouticarpa_grandistipula,21,13,8,Points-PointsKO-Adjacents,92
Agouticarpa_hirsuta,20,13,7,Points-PointsKO-Adjacents,100
Agouticarpa_isernii,97,66,31,Alphahull-PointsKO-Adjacents,5705
Agouticarpa_velutina,36,25,11,Alphahull-PointsKO-Adjacents,633
Agouticarpa_williamsii,122,84,38,Alphahull-PointsKO-Adjacents,4381
Agrostistachys_borneensis,28,7,21,Points-PointsKO-Adjacents,213
Agrostistachys_gaudichaudii,4,0,4,Points-PointsKO-Adjacents,36
Agrostistachys_hookeri,4,4,0,Points-PointsKO-Adjacents,27
Agrostistachys_indica,12,1,11,Points-PointsKO-Adjacents,99
Aguiaria_excelsa,8,5,3,Points-PointsKO-Adjacents,52
Aidia_abeidii,10,5,5,Points-PointsKO-Adjacents,40
Aidia_borneensis,8,3,5,Points-PointsKO-Adjacents,66
Aidia_brisipensis,0,0,0,NA,0
Aidia_canthioides,73,28,45,Alphahull-PointsKO-Adjacents,1475
Aidia_chantonea,4,4,0,Points-PointsKO-Adjacents,36
Aidia_cochinchinensis,131,90,41,Alphahull-PointsKO-Adjacents,7235
Aidia_congesta,7,1,6,Points-PointsKO-Adjacents,29
Aidia_densiflora,34,12,22,Points-PointsKO-Adjacents,268
Aidia_gardneri,3,2,1,Points-PointsKO-Adjacents,27
Aidia_genipiflora,157,114,43,Alphahull-PointsKO-Adjacents,2652
Aidia_henryi,14,1,13,Points-PointsKO-Adjacents,126
Aidia_micrantha,602,535,67,Alphahull-PointsKO-Adjacents,28003
Aidia_ochroleuca,59,30,29,Alphahull-PointsKO-Adjacents,2159
Aidia_oxyodonta,9,0,9,Points-PointsKO-Adjacents,75
Aidia_parvifolia,1,1,0,Points-PointsKO-Adjacents,9
Aidia_pseudospicata,0,0,0,NA,0
Aidia_pycnantha,46,26,20,Alphahull-PointsKO-Adjacents,3914
Aidia_quintasii,12,6,6,Points-PointsKO-Adjacents,18
Aidia_racemosa,922,802,120,Alphahull-PointsKO-Adjacents,6460
Aidia_rhacodosepala,43,32,11,Alphahull-PointsKO-Adjacents,679
Aidia_rubens,51,38,13,Alphahull-PointsKO-Adjacents,461
Aidia_vieillardii,5,5,0,Points-PointsKO-Adjacents,38
Aidia_vitiensis,1,1,0,Points-PointsKO-Adjacents,8
Aidia_wattii,1,1,0,Points-PointsKO-Adjacents,8
Aidia_waugia,6,1,5,Points-PointsKO-Adjacents,39
Aidia_yunnanensis,3,3,0,Points-PointsKO-Adjacents,27
Aidiopsis_orophila,2,2,0,Points-PointsKO-Adjacents,18
Ailanthus_altissima,5528,3773,1755,Alphahull-PointsKO-Adjacents,65852
Ailanthus_excelsa,1,1,0,Points-PointsKO-Adjacents,9
Ailanthus_fordii,3,3,0,Points-PointsKO-Adjacents,27
Ailanthus_guangxiensis,0,0,0,NA,0
Ailanthus_integrifolia,21,6,15,Points-PointsKO-Adjacents,144
Ailanthus_triphysa,5,0,5,Points-PointsKO-Adjacents,44
Ailanthus_vietnamensis,NA,NA,NA,NA,NA
Aiouea_acarodomatifera,67,44,23,Alphahull-PointsKO-Adjacents,1088
Aiouea_angulata,8,1,7,Points-PointsKO-Adjacents,72
Aiouea_benthamiana,16,2,14,Points-PointsKO-Adjacents,141
Aiouea_bracteata,12,0,12,Points-PointsKO-Adjacents,108
Aiouea_costaricensis,106,89,17,Alphahull-PointsKO-Adjacents,268
Aiouea_dubia,72,47,25,Alphahull-PointsKO-Adjacents,689
Aiouea_grandifolia,102,76,26,Alphahull-PointsKO-Adjacents,2245
Aiouea_guatemalensis,10,4,6,Points-PointsKO-Adjacents,56
Aiouea_guianensis,78,38,40,Alphahull-PointsKO-Adjacents,2554
Aiouea_impressa,15,2,13,Points-PointsKO-Adjacents,122
Aiouea_laevis,90,37,53,Alphahull-PointsKO-Adjacents,2040
Aiouea_lehmannii,9,2,7,Points-PointsKO-Adjacents,66
Aiouea_longipetiolata,9,4,5,Points-PointsKO-Adjacents,54
Aiouea_macedoana,7,0,7,Points-PointsKO-Adjacents,63
Aiouea_maguireana,43,24,19,Alphahull-PointsKO-Adjacents,386
Aiouea_myristicoides,44,17,27,Points-PointsKO-Adjacents,354
Aiouea_obscura,22,15,7,Points-PointsKO-Adjacents,50
Aiouea_opaca,1,1,0,Points-PointsKO-Adjacents,9
Aiouea_parvissima,5,5,0,Points-PointsKO-Adjacents,35
Aiouea_piauhyensis,83,54,29,Alphahull-PointsKO-Adjacents,8390
Aiouea_saligna,416,310,106,Alphahull-PointsKO-Adjacents,21399
Aiouea_talamancensis,7,5,2,Points-PointsKO-Adjacents,46
Aiouea_tomentella,41,22,19,Alphahull-PointsKO-Adjacents,267
Aiouea_trinervis,303,248,55,Alphahull-PointsKO-Adjacents,23522
Aiphanes_bicornis,2,2,0,Points-PointsKO-Adjacents,12
Aiphanes_buenaventurae,1,1,0,Points-PointsKO-Adjacents,9
Aiphanes_chiribogensis,19,8,11,Points-PointsKO-Adjacents,97
Aiphanes_deltoidea,14,8,6,Points-PointsKO-Adjacents,82
Aiphanes_duquei,7,0,7,Points-PointsKO-Adjacents,49
Aiphanes_eggersii,12,6,6,Points-PointsKO-Adjacents,98
Aiphanes_erinacea,66,49,17,Alphahull-PointsKO-Adjacents,692
Aiphanes_gelatinosa,7,1,6,Points-PointsKO-Adjacents,60
Aiphanes_graminifolia,2,2,0,Points-PointsKO-Adjacents,9
Aiphanes_grandis,7,2,5,Points-PointsKO-Adjacents,39
Aiphanes_hirsuta,156,127,29,Alphahull-PointsKO-Adjacents,1657
Aiphanes_horrida,268,213,55,Alphahull-PointsKO-Adjacents,7809
Aiphanes_leiostachys,2,2,0,Points-PointsKO-Adjacents,9
Aiphanes_lindeniana,59,43,16,Alphahull-PointsKO-Adjacents,1133
Aiphanes_linearis,27,18,9,Points-PointsKO-Adjacents,182
Aiphanes_macroloba,17,7,10,Points-PointsKO-Adjacents,85
Aiphanes_minima,14,8,6,Points-PointsKO-Adjacents,23
Aiphanes_multiplex,0,0,0,NA,0
Aiphanes_pilaris,2,2,0,Points-PointsKO-Adjacents,12
Aiphanes_simplex,76,59,17,Alphahull-PointsKO-Adjacents,1289
Aiphanes_stergiosii,0,0,0,NA,0
Aiphanes_tricuspidata,46,33,13,Alphahull-PointsKO-Adjacents,1218
Aiphanes_ulei,111,96,15,Alphahull-PointsKO-Adjacents,2094
Aiphanes_verrucosa,6,1,5,Points-PointsKO-Adjacents,24
Airosperma_grandifolia,6,0,6,Points-PointsKO-Adjacents,53
Airosperma_trichotomum,7,2,5,Points-PointsKO-Adjacents,27
Airosperma_vanuense,0,0,0,NA,0
Airyantha_schweinfurthii,35,15,20,Points-PointsKO-Adjacents,228
Aistopetalum_multiflorum,6,1,5,Points-PointsKO-Adjacents,35
Aistopetalum_viticoides,19,5,14,Points-PointsKO-Adjacents,93
Akania_bidwillii,358,336,22,Alphahull-PointsKO-Adjacents,617
Akrosida_floribunda,1,1,0,Points-PointsKO-Adjacents,9
Akrosida_macrophylla,1,1,0,Points-PointsKO-Adjacents,9
Alangium_alpinum,5,5,0,Points-PointsKO-Adjacents,45
Alangium_barbatum,57,35,22,Alphahull-PointsKO-Adjacents,7626
Alangium_brachyanthum,NA,NA,NA,NA,NA
Alangium_chinense,35,14,21,Points-PointsKO-Adjacents,232
Alangium_circulare,0,0,0,NA,0
Alangium_grisolleoides,31,19,12,Points-PointsKO-Adjacents,151
Alangium_havilandii,2,2,0,Points-PointsKO-Adjacents,18
Alangium_javanicum,38,16,22,Points-PointsKO-Adjacents,304
Alangium_kurzii,142,0,142,Points-PointsKO-Adjacents,1242
Alangium_longiflorum,16,0,16,Points-PointsKO-Adjacents,133
Alangium_maliliense,3,3,0,Points-PointsKO-Adjacents,25
Alangium_nobile,7,1,6,Points-PointsKO-Adjacents,62
Alangium_platanifolium,472,367,105,Alphahull-PointsKO-Adjacents,8071
Alangium_premnifolium,9,1,8,Points-PointsKO-Adjacents,50
Alangium_qingchuanense,NA,NA,NA,NA,NA
Alangium_ridleyi,4,0,4,Points-PointsKO-Adjacents,30
Alangium_rotundifolium,8,0,8,Points-PointsKO-Adjacents,54
Alangium_salviifolium,19,4,15,Points-PointsKO-Adjacents,156
Alangium_sinicum,1,1,0,Points-PointsKO-Adjacents,9
Alangium_taiwanianum,NA,NA,NA,NA,NA
Alangium_tetrandrum,NA,NA,NA,NA,NA
Alangium_tonkinense,0,0,0,NA,0
Alangium_uniloculare,8,0,8,Points-PointsKO-Adjacents,70
Alangium_villosum,812,715,97,Alphahull-PointsKO-Adjacents,2383
Alangium_yunnanense,2,2,0,Points-PointsKO-Adjacents,18
Alantsilodendron_decaryanum,16,8,8,Points-PointsKO-Adjacents,87
Alantsilodendron_pilosum,23,0,23,Points-PointsKO-Adjacents,100
Alberta_magna,22,1,21,Points-PointsKO-Adjacents,159
Albizia_acle,6,1,5,Points-PointsKO-Adjacents,41
Albizia_adianthifolia,654,485,169,Alphahull-PointsKO-Adjacents,18072
Albizia_adinocephala,203,159,44,Alphahull-PointsKO-Adjacents,4017
Albizia_altissima,87,36,51,Alphahull-PointsKO-Adjacents,2617
Albizia_amara,45,19,26,Points-PointsKO-Adjacents,325
Albizia_androyensis,24,15,9,Points-PointsKO-Adjacents,126
Albizia_anthelmintica,84,53,31,Alphahull-PointsKO-Adjacents,2223
Albizia_antunesiana,61,24,37,Alphahull-PointsKO-Adjacents,915
Albizia_arenicola,52,31,21,Alphahull-PointsKO-Adjacents,406
Albizia_attopeuensis,5,5,0,Points-PointsKO-Adjacents,45
Albizia_aurisparsa,44,25,19,Alphahull-PointsKO-Adjacents,620
Albizia_aylmeri,NA,NA,NA,NA,NA
Albizia_balabaka,14,9,5,Points-PointsKO-Adjacents,88
Albizia_barinensis,14,6,8,Points-PointsKO-Adjacents,119
Albizia_bernieri,94,68,26,Alphahull-PointsKO-Adjacents,2019
Albizia_berteroana,26,6,20,Points-PointsKO-Adjacents,216
Albizia_boinensis,30,18,12,Points-PointsKO-Adjacents,186
Albizia_boivinii,91,73,18,Alphahull-PointsKO-Adjacents,3018
Albizia_brevifolia,57,31,26,Alphahull-PointsKO-Adjacents,1329
Albizia_buntingii,0,0,0,NA,0
Albizia_burkartiana,19,11,8,Points-PointsKO-Adjacents,154
Albizia_burmanica,0,0,0,NA,0
Albizia_calcarea,4,4,0,Points-PointsKO-Adjacents,36
Albizia_canescens,109,71,38,Alphahull-PointsKO-Adjacents,2689
Albizia_carbonaria,100,70,30,Alphahull-PointsKO-Adjacents,2482
Albizia_chevalieri,68,44,24,Alphahull-PointsKO-Adjacents,1095
Albizia_chinensis,77,30,47,Alphahull-PointsKO-Adjacents,3179
Albizia_coriaria,67,25,42,Alphahull-PointsKO-Adjacents,495
Albizia_coripatensis,13,5,8,Points-PointsKO-Adjacents,98
Albizia_corniculata,61,25,36,Alphahull-PointsKO-Adjacents,2223
Albizia_crassiramea,6,0,6,Points-PointsKO-Adjacents,39
Albizia_decandra,15,2,13,Points-PointsKO-Adjacents,125
Albizia_dolichadena,0,0,0,NA,0
Albizia_duckeana,51,13,38,Points-PointsKO-Adjacents,435
Albizia_duclouxii,1,1,0,Points-PointsKO-Adjacents,9
Albizia_edwallii,285,248,37,Alphahull-PointsKO-Adjacents,6779
Albizia_elegans,0,0,0,NA,0
Albizia_eriorhachis,2,2,0,Points-PointsKO-Adjacents,18
Albizia_ferruginea,186,129,57,Alphahull-PointsKO-Adjacents,3763
Albizia_forbesii,60,27,33,Alphahull-PointsKO-Adjacents,1549
Albizia_garrettii,1,1,0,Points-PointsKO-Adjacents,9
Albizia_glaberrima,219,166,53,Alphahull-PointsKO-Adjacents,2285
Albizia_glabripetala,39,15,24,Points-PointsKO-Adjacents,309
Albizia_grandibracteata,58,43,15,Alphahull-PointsKO-Adjacents,741
Albizia_greveana,24,13,11,Points-PointsKO-Adjacents,157
Albizia_guachapele,127,85,42,Alphahull-PointsKO-Adjacents,2604
Albizia_guillainii,0,0,0,NA,0
Albizia_gummifera,232,167,65,Alphahull-PointsKO-Adjacents,15193
Albizia_harveyi,209,143,66,Alphahull-PointsKO-Adjacents,16057
Albizia_inundata,528,423,105,Alphahull-PointsKO-Adjacents,38573
Albizia_isenbergiana,3,3,0,Points-PointsKO-Adjacents,18
Albizia_jaubertiana,9,3,6,Points-PointsKO-Adjacents,58
Albizia_julibrissin,1333,890,443,Alphahull-PointsKO-Adjacents,30578
Albizia_kalkora,136,94,42,Alphahull-PointsKO-Adjacents,16440
Albizia_kostermansii,0,0,0,NA,0
Albizia_lankaensis,NA,NA,NA,NA,NA
Albizia_lathamii,0,0,0,NA,0
Albizia_laurentii,31,16,15,Points-PointsKO-Adjacents,182
Albizia_lebbeck,260,149,111,Alphahull-PointsKO-Adjacents,11193
Albizia_lebbekoides,14,0,14,Points-PointsKO-Adjacents,118
Albizia_leonardii,3,3,0,Points-PointsKO-Adjacents,27
Albizia_leucocalyx,48,40,8,Alphahull-PointsKO-Adjacents,588
Albizia_lucidior,25,7,18,Points-PointsKO-Adjacents,195
Albizia_mahalao,38,28,10,Alphahull-PointsKO-Adjacents,478
Albizia_mainaea,79,53,26,Alphahull-PointsKO-Adjacents,2539
Albizia_malacophylla,20,5,15,Points-PointsKO-Adjacents,152
Albizia_morombensis,6,0,6,Points-PointsKO-Adjacents,34
Albizia_mossamedensis,1,1,0,Points-PointsKO-Adjacents,9
Albizia_multiflora,116,90,26,Alphahull-PointsKO-Adjacents,1833
Albizia_myriophylla,9,1,8,Points-PointsKO-Adjacents,68
Albizia_nayaritensis,6,2,4,Points-PointsKO-Adjacents,54
Albizia_niopoides,1017,839,178,Alphahull-PointsKO-Adjacents,52737
Albizia_numidarum,7,3,4,Points-PointsKO-Adjacents,54
Albizia_obbiadensis,1,1,0,Points-PointsKO-Adjacents,9
Albizia_obliquifoliolata,18,2,16,Points-PointsKO-Adjacents,142
Albizia_occidentalis,254,203,51,Alphahull-PointsKO-Adjacents,3935
Albizia_odorata,9,4,5,Points-PointsKO-Adjacents,68
Albizia_odoratissima,56,24,32,Alphahull-PointsKO-Adjacents,2579
Albizia_papuensis,1,1,0,Points-PointsKO-Adjacents,9
Albizia_pedicellaris,759,591,168,Alphahull-PointsKO-Adjacents,45221
Albizia_pedicellata,5,0,5,Points-PointsKO-Adjacents,41
Albizia_perrieri,29,8,21,Points-PointsKO-Adjacents,167
Albizia_petersiana,73,47,26,Alphahull-PointsKO-Adjacents,2222
Albizia_philippinensis,1,1,0,Points-PointsKO-Adjacents,9
Albizia_pistaciifolia,51,32,19,Alphahull-PointsKO-Adjacents,2542
Albizia_poilanei,1,1,0,Points-PointsKO-Adjacents,9
Albizia_polycephala,923,818,105,Alphahull-PointsKO-Adjacents,26340
Albizia_polyphylla,71,46,25,Alphahull-PointsKO-Adjacents,963
Albizia_procera,216,111,105,Alphahull-PointsKO-Adjacents,1930
Albizia_retusa,54,24,30,Alphahull-PointsKO-Adjacents,326
Albizia_rhombifolia,6,1,5,Points-PointsKO-Adjacents,54
Albizia_rosulata,2,2,0,Points-PointsKO-Adjacents,9
Albizia_rufa,0,0,0,NA,0
Albizia_sahafariensis,9,1,8,Points-PointsKO-Adjacents,54
Albizia_saponaria,35,5,30,Points-PointsKO-Adjacents,251
Albizia_schimperiana,42,14,28,Points-PointsKO-Adjacents,328
Albizia_sherriffii,4,4,0,Points-PointsKO-Adjacents,33
Albizia_sinaloensis,28,19,9,Points-PointsKO-Adjacents,154
Albizia_splendens,5,0,5,Points-PointsKO-Adjacents,29
Albizia_subdimidiata,359,269,90,Alphahull-PointsKO-Adjacents,48737
Albizia_suluensis,5,4,1,Points-PointsKO-Adjacents,27
Albizia_tanganyicensis,62,0,62,Points-PointsKO-Adjacents,488
Albizia_thompsonii,9,0,9,Points-PointsKO-Adjacents,81
Albizia_tomentella,4,4,0,Points-PointsKO-Adjacents,31
Albizia_tomentosa,326,275,51,Alphahull-PointsKO-Adjacents,7498
Albizia_tulearensis,58,0,58,Points-PointsKO-Adjacents,357
Albizia_vaughanii,0,0,0,NA,0
Albizia_verrucosa,2,2,0,Points-PointsKO-Adjacents,18
Albizia_versicolor,201,116,85,Alphahull-PointsKO-Adjacents,12846
Albizia_vialeana,1,1,0,Points-PointsKO-Adjacents,9
Albizia_viridis,40,21,19,Alphahull-PointsKO-Adjacents,1727
Albizia_welwitschii,1,1,0,Points-PointsKO-Adjacents,9
Albizia_westerhuisii,0,0,0,NA,0
Albizia_xerophytica,11,7,4,Points-PointsKO-Adjacents,92
Albizia_zimmermannii,17,3,14,Points-PointsKO-Adjacents,127
Albizia_zygia,742,675,67,Alphahull-PointsKO-Adjacents,13833
Alchornea_acutifolia,75,47,28,Alphahull-PointsKO-Adjacents,771
Alchornea_alnifolia,65,45,20,Alphahull-PointsKO-Adjacents,2361
Alchornea_anamariae,26,0,26,Points-PointsKO-Adjacents,97
Alchornea_aquifolia,682,605,77,Alphahull-PointsKO-Adjacents,3246
Alchornea_bogotensis,47,27,20,Alphahull-PointsKO-Adjacents,961
Alchornea_brittonii,51,31,20,Alphahull-PointsKO-Adjacents,285
Alchornea_castaneifolia,274,156,118,Alphahull-PointsKO-Adjacents,22576
Alchornea_chiapasana,5,0,5,Points-PointsKO-Adjacents,45
Alchornea_coelophylla,87,64,23,Alphahull-PointsKO-Adjacents,2056
Alchornea_cordifolia,604,487,117,Alphahull-PointsKO-Adjacents,26496
Alchornea_costaricensis,240,203,37,Alphahull-PointsKO-Adjacents,3561
Alchornea_discolor,750,663,87,Alphahull-PointsKO-Adjacents,76968
Alchornea_floribunda,285,222,63,Alphahull-PointsKO-Adjacents,7603
Alchornea_fluviatilis,110,50,60,Alphahull-PointsKO-Adjacents,16678
Alchornea_glandulosa,1892,1688,204,Alphahull-PointsKO-Adjacents,55243
Alchornea_grandiflora,336,251,85,Alphahull-PointsKO-Adjacents,6918
Alchornea_grandis,98,66,32,Alphahull-PointsKO-Adjacents,4210
Alchornea_guatemalensis,3,3,0,Points-PointsKO-Adjacents,27
Alchornea_hilariana,13,4,9,Points-PointsKO-Adjacents,117
Alchornea_hirtella,220,146,74,Alphahull-PointsKO-Adjacents,5874
Alchornea_humbertii,18,9,9,Points-PointsKO-Adjacents,108
Alchornea_integrifolia,1,1,0,Points-PointsKO-Adjacents,9
Alchornea_latifolia,1157,1015,142,Alphahull-PointsKO-Adjacents,25413
Alchornea_laxiflora,140,75,65,Alphahull-PointsKO-Adjacents,3195
Alchornea_lojaensis,6,3,3,Points-PointsKO-Adjacents,30
Alchornea_megalophylla,52,32,20,Alphahull-PointsKO-Adjacents,1034
Alchornea_mollis,3,3,0,Points-PointsKO-Adjacents,27
Alchornea_occidentalis,4,4,0,Points-PointsKO-Adjacents,36
Alchornea_parviflora,9,0,9,Points-PointsKO-Adjacents,81
Alchornea_pearcei,84,46,38,Alphahull-PointsKO-Adjacents,1179
Alchornea_perrieri,14,8,6,Points-PointsKO-Adjacents,99
Alchornea_rugosa,218,100,118,Alphahull-PointsKO-Adjacents,5988
Alchornea_sidifolia,299,0,299,Points-PointsKO-Adjacents,1777
Alchornea_tachirensis,6,1,5,Points-PointsKO-Adjacents,36
Alchornea_tiliifolia,49,15,34,Points-PointsKO-Adjacents,435
Alchornea_triplinervia,2326,2070,256,Alphahull-PointsKO-Adjacents,77101
Alchornea_ulmifolia,0,0,0,NA,0
Alchornea_websteri,6,2,4,Points-PointsKO-Adjacents,51
Alchorneopsis_floribunda,491,368,123,Alphahull-PointsKO-Adjacents,53940
Alchorneopsis_portoricensis,5,3,2,Points-PointsKO-Adjacents,31
Aldina_amazonica,0,0,0,NA,0
Aldina_aurea,2,2,0,Points-PointsKO-Adjacents,12
Aldina_berryi,5,5,0,Points-PointsKO-Adjacents,40
Aldina_discolor,22,13,9,Points-PointsKO-Adjacents,166
Aldina_elliptica,4,4,0,Points-PointsKO-Adjacents,36
Aldina_heterophylla,50,32,18,Alphahull-PointsKO-Adjacents,660
Aldina_insignis,9,4,5,Points-PointsKO-Adjacents,77
Aldina_kunhardtiana,32,23,9,Alphahull-PointsKO-Adjacents,486
Aldina_latifolia,119,88,31,Alphahull-PointsKO-Adjacents,6340
Aldina_macrophylla,12,6,6,Points-PointsKO-Adjacents,90
Aldina_microphylla,9,1,8,Points-PointsKO-Adjacents,65
Aldina_occidentalis,5,5,0,Points-PointsKO-Adjacents,36
Aldina_paulberryi,2,2,0,Points-PointsKO-Adjacents,18
Aldina_petiolulata,4,4,0,Points-PointsKO-Adjacents,27
Aldina_polyphylla,8,4,4,Points-PointsKO-Adjacents,65
Aldina_reticulata,9,2,7,Points-PointsKO-Adjacents,53
Alectryon_cardiocarpus,4,4,0,Points-PointsKO-Adjacents,17
Alectryon_carinatus,35,23,12,Alphahull-PointsKO-Adjacents,253
Alectryon_celebicus,5,5,0,Points-PointsKO-Adjacents,45
Alectryon_connatum,344,296,48,Alphahull-PointsKO-Adjacents,5110
Alectryon_coriaceus,204,162,42,Alphahull-PointsKO-Adjacents,474
Alectryon_diversifolius,248,228,20,Alphahull-PointsKO-Adjacents,3655
Alectryon_excelsus,923,830,93,Alphahull-PointsKO-Adjacents,2278
Alectryon_excisus,2,2,0,Points-PointsKO-Adjacents,17
Alectryon_ferrugineum,88,67,21,Alphahull-PointsKO-Adjacents,687
Alectryon_forsythii,95,84,11,Alphahull-PointsKO-Adjacents,339
Alectryon_fuscus,1,1,0,Points-PointsKO-Adjacents,9
Alectryon_glaber,7,0,7,Points-PointsKO-Adjacents,53
Alectryon_grandifolius,0,0,0,NA,0
Alectryon_inaequilaterus,2,2,0,Points-PointsKO-Adjacents,17
Alectryon_kangeanensis,0,0,0,NA,0
Alectryon_kimberleyanus,35,24,11,Alphahull-PointsKO-Adjacents,407
Alectryon_laevis,NA,NA,NA,NA,NA
Alectryon_macrococcum,8,1,7,Points-PointsKO-Adjacents,47
Alectryon_macrophyllus,33,18,15,Points-PointsKO-Adjacents,135
Alectryon_mahoe,8,1,7,Points-PointsKO-Adjacents,47
Alectryon_mollis,31,17,14,Points-PointsKO-Adjacents,131
Alectryon_myrmecophilus,7,5,2,Points-PointsKO-Adjacents,27
Alectryon_ochraceus,2,2,0,Points-PointsKO-Adjacents,17
Alectryon_oleifolius,5254,5134,120,Alphahull-PointsKO-Adjacents,48269
Alectryon_pubescens,34,26,8,Alphahull-PointsKO-Adjacents,803
Alectryon_ramiflorus,7,5,2,Points-PointsKO-Adjacents,22
Alectryon_repandodentatus,20,11,9,Points-PointsKO-Adjacents,58
Alectryon_reticulatus,0,0,0,NA,0
Alectryon_samoensis,2,2,0,Points-PointsKO-Adjacents,9
Alectryon_semicinereum,128,87,41,Alphahull-PointsKO-Adjacents,358
Alectryon_serratus,5,5,0,Points-PointsKO-Adjacents,45
Alectryon_strigosus,31,17,14,Points-PointsKO-Adjacents,131
Alectryon_subcinereum,1671,1,1670,Points-PointsKO-Adjacents,1802
Alectryon_subdentatum,476,452,24,Alphahull-PointsKO-Adjacents,3920
Alectryon_tomentosum,411,341,70,Alphahull-PointsKO-Adjacents,3927
Alectryon_tropicus,49,33,16,Alphahull-PointsKO-Adjacents,380
Alectryon_unilobatus,6,0,6,Points-PointsKO-Adjacents,50
Aleisanthia_sylvatica,0,0,0,NA,0
Aleisanthiopsis_distantiflora,5,5,0,Points-PointsKO-Adjacents,45
Aleisanthiopsis_multiflora,1,1,0,Points-PointsKO-Adjacents,9
Aleurites_moluccanus,139,70,69,Alphahull-PointsKO-Adjacents,1345
Aleurites_rockinghamensis,71,54,17,Alphahull-PointsKO-Adjacents,208
Alexa_bauhiniiflora,21,12,9,Points-PointsKO-Adjacents,146
Alexa_canaracunensis,71,56,15,Alphahull-PointsKO-Adjacents,2571
Alexa_confusa,71,60,11,Alphahull-PointsKO-Adjacents,1811
Alexa_cowanii,7,5,2,Points-PointsKO-Adjacents,52
Alexa_grandiflora,101,71,30,Alphahull-PointsKO-Adjacents,7157
Alexa_herminiana,6,1,5,Points-PointsKO-Adjacents,33
Alexa_imperatricis,49,25,24,Alphahull-PointsKO-Adjacents,1173
Alexa_leiopetala,1,1,0,Points-PointsKO-Adjacents,9
Alexa_surinamensis,7,1,6,Points-PointsKO-Adjacents,54
Alexa_wachenheimii,32,15,17,Points-PointsKO-Adjacents,241
Alfaroa_colombiana,46,24,22,Alphahull-PointsKO-Adjacents,720
Alfaroa_costaricensis,95,85,10,Alphahull-PointsKO-Adjacents,315
Alfaroa_guanacastensis,35,28,7,Alphahull-PointsKO-Adjacents,54
Alfaroa_guatemalensis,14,8,6,Points-PointsKO-Adjacents,100
Alfaroa_hondurensis,3,3,0,Points-PointsKO-Adjacents,27
Alfaroa_manningii,19,12,7,Points-PointsKO-Adjacents,73
Alfaroa_mexicana,48,34,14,Alphahull-PointsKO-Adjacents,249
Alfaroa_williamsii,121,94,27,Alphahull-PointsKO-Adjacents,1360
Algernonia_amazonica,4,4,0,Points-PointsKO-Adjacents,36
Algernonia_bahiensis,9,0,9,Points-PointsKO-Adjacents,64
Algernonia_brasiliensis,15,1,14,Points-PointsKO-Adjacents,90
Algernonia_dimitrii,6,1,5,Points-PointsKO-Adjacents,44
Algernonia_gibbosa,6,0,6,Points-PointsKO-Adjacents,50
Algernonia_glazioui,2,2,0,Points-PointsKO-Adjacents,17
Algernonia_kuhlmannii,2,2,0,Points-PointsKO-Adjacents,18
Algernonia_leandrii,63,36,27,Alphahull-PointsKO-Adjacents,678
Algernonia_obovata,20,7,13,Points-PointsKO-Adjacents,159
Algernonia_pardina,10,6,4,Points-PointsKO-Adjacents,53
Algernonia_paulae,1,1,0,Points-PointsKO-Adjacents,9
Algernonia_riedelii,21,11,10,Points-PointsKO-Adjacents,146
Alibertia_atlantica,66,51,15,Alphahull-PointsKO-Adjacents,428
Alibertia_bertierifolia,240,154,86,Alphahull-PointsKO-Adjacents,22793
Alibertia_claviflora,107,74,33,Alphahull-PointsKO-Adjacents,7386
Alibertia_curviflora,9,2,7,Points-PointsKO-Adjacents,70
Alibertia_duckei,12,0,12,Points-PointsKO-Adjacents,108
Alibertia_dwyeri,7,2,5,Points-PointsKO-Adjacents,49
Alibertia_edulis,2663,2418,245,Alphahull-PointsKO-Adjacents,116754
Alibertia_iquitensis,0,0,0,NA,0
Alibertia_itayensis,13,2,11,Points-PointsKO-Adjacents,102
Alibertia_latifolia,294,198,96,Alphahull-PointsKO-Adjacents,34359
Alibertia_patinoi,84,52,32,Alphahull-PointsKO-Adjacents,1994
Alibertia_pedicellata,2,2,0,Points-PointsKO-Adjacents,18
Alibertia_pilosa,108,74,34,Alphahull-PointsKO-Adjacents,8640
Alibertia_sorbilis,45,22,23,Alphahull-PointsKO-Adjacents,3662
Alibertia_stipularis,8,1,7,Points-PointsKO-Adjacents,72
Alibertia_utleyorum,27,21,6,Alphahull-PointsKO-Adjacents,182
Alibertia_verticillata,5,5,0,Points-PointsKO-Adjacents,43
Allagoptera_caudescens,171,127,44,Alphahull-PointsKO-Adjacents,1896
Allamanda_weberbaueri,9,0,9,Points-PointsKO-Adjacents,75
Allanblackia_floribunda,165,115,50,Alphahull-PointsKO-Adjacents,6571
Allanblackia_gabonensis,31,19,12,Points-PointsKO-Adjacents,160
Allanblackia_kimbiliensis,5,5,0,Points-PointsKO-Adjacents,45
Allanblackia_kisonghi,7,1,6,Points-PointsKO-Adjacents,63
Allanblackia_marienii,9,4,5,Points-PointsKO-Adjacents,71
Allanblackia_staneriana,4,4,0,Points-PointsKO-Adjacents,36
Allanblackia_stuhlmannii,35,22,13,Alphahull-PointsKO-Adjacents,206
Allanblackia_ulugurensis,19,12,7,Points-PointsKO-Adjacents,70
Allantoma_decandra,169,122,47,Alphahull-PointsKO-Adjacents,10126
Allantoma_integrifolia,23,14,9,Points-PointsKO-Adjacents,116
Allantoma_kuhlmannii,5,5,0,Points-PointsKO-Adjacents,41
Allantoma_lineata,169,128,41,Alphahull-PointsKO-Adjacents,8594
Allantoma_pachyantha,6,0,6,Points-PointsKO-Adjacents,52
Allantoma_pauciramosa,6,0,6,Points-PointsKO-Adjacents,53
Allantoma_pluriflora,23,10,13,Points-PointsKO-Adjacents,195
Allantoma_uaupensis,4,4,0,Points-PointsKO-Adjacents,32
Allantospermum_borneense,10,0,10,Points-PointsKO-Adjacents,78
Allantospermum_multicaule,4,4,0,Points-PointsKO-Adjacents,20
Alleizettella_rubra,2,2,0,Points-PointsKO-Adjacents,18
Allexis_batangae,10,3,7,Points-PointsKO-Adjacents,36
Allexis_cauliflora,9,6,3,Points-PointsKO-Adjacents,36
Allexis_obanensis,6,0,6,Points-PointsKO-Adjacents,42
Allexis_zygomorpha,2,2,0,Points-PointsKO-Adjacents,13
Allocasuarina_acutivalvis,438,420,18,Alphahull-PointsKO-Adjacents,4573
Allocasuarina_campestris,725,702,23,Alphahull-PointsKO-Adjacents,5019
Allocasuarina_decaisneana,324,301,23,Alphahull-PointsKO-Adjacents,5472
Allocasuarina_decussata,103,98,5,Alphahull-PointsKO-Adjacents,833
Allocasuarina_dielsiana,93,77,16,Alphahull-PointsKO-Adjacents,708
Allocasuarina_diminuta,863,829,34,Alphahull-PointsKO-Adjacents,2350
Allocasuarina_duncanii,36,31,5,Alphahull-PointsKO-Adjacents,44
Allocasuarina_fraseriana,225,184,41,Alphahull-PointsKO-Adjacents,749
Allocasuarina_grampiana,66,60,6,Alphahull-PointsKO-Adjacents,60
Allocasuarina_gymnanthera,369,359,10,Alphahull-PointsKO-Adjacents,928
Allocasuarina_huegeliana,347,326,21,Alphahull-PointsKO-Adjacents,4035
Allocasuarina_hystricosa,19,10,9,Points-PointsKO-Adjacents,92
Allocasuarina_inophloia,437,408,29,Alphahull-PointsKO-Adjacents,851
Allocasuarina_littoralis,9611,8870,741,Alphahull-PointsKO-Adjacents,10490
Allocasuarina_luehmannii,4270,4198,72,Alphahull-PointsKO-Adjacents,14742
Allocasuarina_monilifera,861,834,27,Alphahull-PointsKO-Adjacents,1307
Allocasuarina_portuensis,7,2,5,Points-PointsKO-Adjacents,14
Allocasuarina_robusta,83,77,6,Alphahull-PointsKO-Adjacents,54
Allocasuarina_striata,656,624,32,Alphahull-PointsKO-Adjacents,214
Allocasuarina_tessellata,25,19,6,Points-PointsKO-Adjacents,119
Allocasuarina_torulosa,6001,5624,377,Alphahull-PointsKO-Adjacents,5471
Allocasuarina_verticillata,6879,6548,331,Alphahull-PointsKO-Adjacents,13492
Allomaieta_hirsuta,24,14,10,Points-PointsKO-Adjacents,115
Allomaieta_pancurana,26,22,4,Alphahull-PointsKO-Adjacents,65
Allomaieta_strigosa,17,10,7,Points-PointsKO-Adjacents,115
Allomaieta_villosa,14,7,7,Points-PointsKO-Adjacents,52
Allomorphia_howellii,7,0,7,Points-PointsKO-Adjacents,34
Allophylus_acutatus,2,2,0,Points-PointsKO-Adjacents,18
Allophylus_africanus,766,612,154,Alphahull-PointsKO-Adjacents,34368
Allophylus_agbala,NA,NA,NA,NA,NA
Allophylus_aldabricus,4,4,0,Points-PointsKO-Adjacents,10
Allophylus_amazonicus,213,148,65,Alphahull-PointsKO-Adjacents,26886
Allophylus_amboinensis,12,2,10,Points-PointsKO-Adjacents,80
Allophylus_amentaceus,0,0,0,NA,0
Allophylus_amplissimus,1,1,0,Points-PointsKO-Adjacents,9
Allophylus_angustatus,30,0,30,Points-PointsKO-Adjacents,158
Allophylus_antunesii,2,1,1,Points-PointsKO-Adjacents,18
Allophylus_apiocarpus,0,0,0,NA,0
Allophylus_bartlettii,2,2,0,Points-PointsKO-Adjacents,12
Allophylus_bicruris,4,4,0,Points-PointsKO-Adjacents,34
Allophylus_bongolavensis,1,1,0,Points-PointsKO-Adjacents,9
Allophylus_borbonicus,2,2,0,Points-PointsKO-Adjacents,18
Allophylus_brachypetalus,3,3,0,Points-PointsKO-Adjacents,27
Allophylus_brachystachys,2,2,0,Points-PointsKO-Adjacents,18
Allophylus_brevipes,NA,NA,NA,NA,NA
Allophylus_brevipetiolaris,0,0,0,NA,0
Allophylus_bullatus,31,17,14,Points-PointsKO-Adjacents,122
Allophylus_camptoneurus,1,1,0,Points-PointsKO-Adjacents,9
Allophylus_camptostachys,160,130,30,Alphahull-PointsKO-Adjacents,2485
Allophylus_capillipes,1,1,0,Points-PointsKO-Adjacents,9
Allophylus_caudatus,4,4,0,Points-PointsKO-Adjacents,36
Allophylus_chartaceus,0,0,0,NA,0
Allophylus_chaunostachys,60,33,27,Alphahull-PointsKO-Adjacents,633
Allophylus_chirindensis,3,3,0,Points-PointsKO-Adjacents,27
Allophylus_chlorocarpus,NA,NA,NA,NA,NA
Allophylus_cobbe,44,1,43,Points-PointsKO-Adjacents,346
Allophylus_cominia,661,574,87,Alphahull-PointsKO-Adjacents,5938
Allophylus_commersonii,0,0,0,NA,0
Allophylus_congolanus,22,9,13,Points-PointsKO-Adjacents,134
Allophylus_coriaceus,8,2,6,Points-PointsKO-Adjacents,69
Allophylus_crassinervis,67,49,18,Alphahull-PointsKO-Adjacents,665
Allophylus_crenatus,2,2,0,Points-PointsKO-Adjacents,17
Allophylus_cristalensis,2,2,0,Points-PointsKO-Adjacents,18
Allophylus_dasythyrsus,0,0,0,NA,0
Allophylus_decipiens,72,44,28,Alphahull-PointsKO-Adjacents,2067
Allophylus_densiflorus,5,5,0,Points-PointsKO-Adjacents,45
Allophylus_dimorphus,1,1,0,Points-PointsKO-Adjacents,8
Allophylus_dioicus,14,2,12,Points-PointsKO-Adjacents,108
Allophylus_divaricatus,164,105,59,Alphahull-PointsKO-Adjacents,11021
Allophylus_dodsonii,6,2,4,Points-PointsKO-Adjacents,48
Allophylus_domingensis,4,4,0,Points-PointsKO-Adjacents,36
Allophylus_dregeanus,36,17,19,Points-PointsKO-Adjacents,301
Allophylus_dummeri,37,29,8,Alphahull-PointsKO-Adjacents,167
Allophylus_edulis,2249,2010,239,Alphahull-PointsKO-Adjacents,68736
Allophylus_elongatus,NA,NA,NA,NA,NA
Allophylus_eustachys,0,0,0,NA,0
Allophylus_excelsus,129,106,23,Alphahull-PointsKO-Adjacents,2077
Allophylus_ferrugineus,173,125,48,Alphahull-PointsKO-Adjacents,7007
Allophylus_filiger,0,0,0,NA,0
Allophylus_floribundus,177,134,43,Alphahull-PointsKO-Adjacents,7049
Allophylus_fulvotomentosus,9,4,5,Points-PointsKO-Adjacents,62
Allophylus_fuscus,0,0,0,NA,0
Allophylus_gentryi,16,9,7,Points-PointsKO-Adjacents,86
Allophylus_glabratus,9,1,8,Points-PointsKO-Adjacents,81
Allophylus_gossweileri,0,0,0,NA,0
Allophylus_goudotii,27,16,11,Points-PointsKO-Adjacents,200
Allophylus_grandiflorus,4,4,0,Points-PointsKO-Adjacents,27
Allophylus_grandifolius,18,14,4,Points-PointsKO-Adjacents,116
Allophylus_granulatus,0,0,0,NA,0
Allophylus_grotei,4,4,0,Points-PointsKO-Adjacents,18
Allophylus_guaraniticus,401,372,29,Alphahull-PointsKO-Adjacents,8035
Allophylus_haitiensis,1,1,0,Points-PointsKO-Adjacents,9
Allophylus_hallaei,10,5,5,Points-PointsKO-Adjacents,72
Allophylus_hamatus,19,2,17,Points-PointsKO-Adjacents,145
Allophylus_hayatae,2,2,0,Points-PointsKO-Adjacents,18
Allophylus_hirsutus,2,2,0,Points-PointsKO-Adjacents,18
Allophylus_hirtellus,27,18,9,Points-PointsKO-Adjacents,115
Allophylus_holophyllus,0,0,0,NA,0
Allophylus_hylophilus,NA,NA,NA,NA,NA
Allophylus_hymenocalyx,NA,NA,NA,NA,NA
Allophylus_imenoensis,3,3,0,Points-PointsKO-Adjacents,27
Allophylus_incanus,49,27,22,Alphahull-PointsKO-Adjacents,1250
Allophylus_insignis,0,0,0,NA,0
Allophylus_jamaicensis,3,3,0,Points-PointsKO-Adjacents,19
Allophylus_javensis,6,0,6,Points-PointsKO-Adjacents,42
Allophylus_jejunus,1,1,0,Points-PointsKO-Adjacents,9
Allophylus_katangensis,2,2,0,Points-PointsKO-Adjacents,18
Allophylus_laetevirens,4,4,0,Points-PointsKO-Adjacents,27
Allophylus_laetus,70,15,55,Points-PointsKO-Adjacents,487
Allophylus_laevigatus,57,29,28,Alphahull-PointsKO-Adjacents,672
Allophylus_lasiopus,0,0,0,NA,0
Allophylus_lastoursvillensis,19,1,18,Points-PointsKO-Adjacents,106
Allophylus_latifolius,25,0,25,Points-PointsKO-Adjacents,188
Allophylus_laxiflorus,3,3,0,Points-PointsKO-Adjacents,27
Allophylus_leptocladus,0,0,0,NA,0
Allophylus_leptococcus,2,2,0,Points-PointsKO-Adjacents,12
Allophylus_leptostachys,10,0,10,Points-PointsKO-Adjacents,90
Allophylus_le-testui,7,2,5,Points-PointsKO-Adjacents,61
Allophylus_leucochrous,0,0,0,NA,0
Allophylus_leucoclados,45,26,19,Alphahull-PointsKO-Adjacents,462
Allophylus_leucophloeus,5,5,0,Points-PointsKO-Adjacents,27
Allophylus_livescens,2,2,0,Points-PointsKO-Adjacents,18
Allophylus_longicuneatus,5,4,1,Points-PointsKO-Adjacents,45
Allophylus_longifolius,1,1,0,Points-PointsKO-Adjacents,9
Allophylus_longipes,8,0,8,Points-PointsKO-Adjacents,72
Allophylus_longipetiolatus,NA,NA,NA,NA,NA
Allophylus_lopezii,0,0,0,NA,0
Allophylus_loretensis,69,46,23,Alphahull-PointsKO-Adjacents,1668
Allophylus_macrodontus,2,2,0,Points-PointsKO-Adjacents,18
Allophylus_macrostachys,0,0,0,NA,0
Allophylus_maestrensis,2,2,0,Points-PointsKO-Adjacents,18
Allophylus_malvaceus,0,0,0,NA,0
Allophylus_marquesensis,NA,NA,NA,NA,NA
Allophylus_mayimbensis,5,5,0,Points-PointsKO-Adjacents,43
Allophylus_megaphyllus,17,10,7,Points-PointsKO-Adjacents,96
Allophylus_melanocarpus,58,34,24,Alphahull-PointsKO-Adjacents,1365
Allophylus_melliodorus,19,10,9,Points-PointsKO-Adjacents,79
Allophylus_micrococcus,4,4,0,Points-PointsKO-Adjacents,27
Allophylus_mollis,56,46,10,Alphahull-PointsKO-Adjacents,631
Allophylus_montanus,0,0,0,NA,0
Allophylus_multicostatus,2,2,0,Points-PointsKO-Adjacents,18
Allophylus_myrianthus,44,31,13,Alphahull-PointsKO-Adjacents,209
Allophylus_natalensis,37,13,24,Points-PointsKO-Adjacents,231
Allophylus_ngounyensis,3,3,0,Points-PointsKO-Adjacents,27
Allophylus_nigericus,0,0,0,NA,0
Allophylus_nitidulus,25,10,15,Points-PointsKO-Adjacents,204
Allophylus_obliquus,71,15,56,Points-PointsKO-Adjacents,489
Allophylus_pachyphyllus,0,0,0,NA,0
Allophylus_pallidus,0,0,0,NA,0
Allophylus_paniculatus,49,22,27,Alphahull-PointsKO-Adjacents,1091
Allophylus_parimensis,2,2,0,Points-PointsKO-Adjacents,12
Allophylus_pauciflorus,162,0,162,Points-PointsKO-Adjacents,950
Allophylus_peduncularis,0,0,0,NA,0
Allophylus_persicifolius,2,2,0,Points-PointsKO-Adjacents,18
Allophylus_peruvianus,48,23,25,Alphahull-PointsKO-Adjacents,723
Allophylus_pervillei,29,8,21,Points-PointsKO-Adjacents,187
Allophylus_petelotii,0,0,0,NA,0
Allophylus_pilosus,146,116,30,Alphahull-PointsKO-Adjacents,7121
Allophylus_poungouensis,8,2,6,Points-PointsKO-Adjacents,62
Allophylus_pseudopaniculatus,23,12,11,Points-PointsKO-Adjacents,123
Allophylus_psilospermus,348,296,52,Alphahull-PointsKO-Adjacents,5820
Allophylus_punctatus,243,153,90,Alphahull-PointsKO-Adjacents,18211
Allophylus_quercifolius,177,0,177,Points-PointsKO-Adjacents,1191
Allophylus_quinatus,0,0,0,NA,0
Allophylus_racemosus,810,667,143,Alphahull-PointsKO-Adjacents,38797
Allophylus_rapensis,2,2,0,Points-PointsKO-Adjacents,4
Allophylus_repandifolius,1,1,0,Points-PointsKO-Adjacents,9
Allophylus_repandodentatus,0,0,0,NA,0
Allophylus_reticulatus,3,3,0,Points-PointsKO-Adjacents,26
Allophylus_rheedei,0,0,0,NA,0
Allophylus_rhomboidalis,9,1,8,Points-PointsKO-Adjacents,34
Allophylus_rigidus,7,3,4,Points-PointsKO-Adjacents,53
Allophylus_robustus,22,12,10,Points-PointsKO-Adjacents,146
Allophylus_rubifolius,149,78,71,Alphahull-PointsKO-Adjacents,5570
Allophylus_rutete,0,0,0,NA,0
Allophylus_salignus,5,5,0,Points-PointsKO-Adjacents,44
Allophylus_samarensis,0,0,0,NA,0
Allophylus_sapinii,3,3,0,Points-PointsKO-Adjacents,27
Allophylus_schweinfurthii,10,1,9,Points-PointsKO-Adjacents,75
Allophylus_scrobiculatus,42,22,20,Alphahull-PointsKO-Adjacents,642
Allophylus_sechellensis,0,0,0,NA,0
Allophylus_serratus,3,3,0,Points-PointsKO-Adjacents,27
Allophylus_setulosus,NA,NA,NA,NA,NA
Allophylus_simplicifolius,0,0,0,NA,0
Allophylus_sootepensis,0,0,0,NA,0
Allophylus_spectabilis,0,0,0,NA,0
Allophylus_steinbachii,85,46,39,Alphahull-PointsKO-Adjacents,1325
Allophylus_stenodictyus,20,5,15,Points-PointsKO-Adjacents,157
Allophylus_stenophyllus,0,0,0,NA,0
Allophylus_strictus,273,213,60,Alphahull-PointsKO-Adjacents,21638
Allophylus_subfalcatus,0,0,0,NA,0
Allophylus_subincisodentatus,0,0,0,NA,0
Allophylus_sumatranus,2,2,0,Points-PointsKO-Adjacents,12
Allophylus_talbotii,15,9,6,Points-PointsKO-Adjacents,121
Allophylus_tanzaniensis,15,2,13,Points-PointsKO-Adjacents,119
Allophylus_timorensis,91,45,46,Alphahull-PointsKO-Adjacents,602
Allophylus_torrei,1,0,1,Points-PointsKO-Adjacents,9
Allophylus_transvaalensis,126,70,56,Alphahull-PointsKO-Adjacents,1346
Allophylus_triphyllus,0,0,0,NA,0
Allophylus_ujori,4,4,0,Points-PointsKO-Adjacents,27
Allophylus_umbrinus,0,0,0,NA,0
Allophylus_unifoliatus,NA,NA,NA,NA,NA
Allophylus_unifoliolatus,NA,NA,NA,NA,NA
Allophylus_vestitus,5,5,0,Points-PointsKO-Adjacents,35
Allophylus_villosus,1,1,0,Points-PointsKO-Adjacents,9
Allophylus_zenkeri,5,4,1,Points-PointsKO-Adjacents,39
Allophylus_zeylanicus,4,4,0,Points-PointsKO-Adjacents,27
Allosyncarpia_ternata,230,223,7,Alphahull-PointsKO-Adjacents,404
Allowoodsonia_whitmorei,0,0,0,NA,0
Alloxylon_brachycarpum,24,16,8,Points-PointsKO-Adjacents,98
Alloxylon_flammeum,67,53,14,Alphahull-PointsKO-Adjacents,109
Alloxylon_pinnatum,133,120,13,Alphahull-PointsKO-Adjacents,266
Alloxylon_wickhamii,71,62,9,Alphahull-PointsKO-Adjacents,259
Alluaudia_ascendens,9,6,3,Points-PointsKO-Adjacents,46
Alluaudia_comosa,27,17,10,Points-PointsKO-Adjacents,105
Alluaudia_dumosa,33,25,8,Alphahull-PointsKO-Adjacents,524
Alluaudia_montagnacii,4,4,0,Points-PointsKO-Adjacents,23
Alluaudia_procera,47,38,9,Alphahull-PointsKO-Adjacents,579
Alluaudiopsis_fiherenensis,26,19,7,Points-PointsKO-Adjacents,89
Alluaudiopsis_marnieriana,11,6,5,Points-PointsKO-Adjacents,25
Almeidea_lilacina,39,21,18,Alphahull-PointsKO-Adjacents,724
Almeidea_limae,9,3,6,Points-PointsKO-Adjacents,55
Almeidea_longifolia,62,39,23,Alphahull-PointsKO-Adjacents,484
Almeidea_rubra,182,134,48,Alphahull-PointsKO-Adjacents,2245
Alniphyllum_eberhardtii,13,7,6,Points-PointsKO-Adjacents,117
Alniphyllum_fortunei,174,129,45,Alphahull-PointsKO-Adjacents,10745
Alniphyllum_pterospermum,118,94,24,Alphahull-PointsKO-Adjacents,257
Alnus_acuminata,1507,1346,161,Alphahull-PointsKO-Adjacents,10680
Alnus_alnobetula,2555,2126,429,Alphahull-PointsKO-Adjacents,144166
Alnus_cordata,241,169,72,Alphahull-PointsKO-Adjacents,7855
Alnus_cremastogyne,43,26,17,Alphahull-PointsKO-Adjacents,1865
Alnus_fauriei,90,68,22,Alphahull-PointsKO-Adjacents,397
Alnus_ferdinandi-coburgii,19,10,9,Points-PointsKO-Adjacents,171
Alnus_firma,292,226,66,Alphahull-PointsKO-Adjacents,1868
Alnus_formosana,182,167,15,Alphahull-PointsKO-Adjacents,284
Alnus_glutinosa,16590,14083,2507,Alphahull-PointsKO-Adjacents,60533
Alnus_glutipes,NA,NA,NA,NA,NA
Alnus_hakkodensis,NA,NA,NA,NA,NA
Alnus_henryi,0,0,0,NA,0
Alnus_hirsuta,327,221,106,Alphahull-PointsKO-Adjacents,3748
Alnus_incana,56896,51265,5631,Alphahull-PointsKO-Adjacents,186945
Alnus_japonica,195,67,128,Alphahull-PointsKO-Adjacents,1849
Alnus_jorullensis,560,524,36,Alphahull-PointsKO-Adjacents,4674
Alnus_lanata,3,3,0,Points-PointsKO-Adjacents,27
Alnus_mairei,0,0,0,NA,0
Alnus_mandshurica,5,0,5,Points-PointsKO-Adjacents,45
Alnus_maritima,36,19,17,Points-PointsKO-Adjacents,127
Alnus_matsumurae,80,65,15,Alphahull-PointsKO-Adjacents,570
Alnus_maximowiczii,135,89,46,Alphahull-PointsKO-Adjacents,2206
Alnus_nepalensis,139,109,30,Alphahull-PointsKO-Adjacents,5586
Alnus_nitida,12,6,6,Points-PointsKO-Adjacents,63
Alnus_oblongifolia,203,1,202,Points-PointsKO-Adjacents,916
Alnus_orientalis,0,0,0,NA,0
Alnus_paniculata,NA,NA,NA,NA,NA
Alnus_pendula,318,243,75,Alphahull-PointsKO-Adjacents,2826
Alnus_rhombifolia,1655,1468,187,Alphahull-PointsKO-Adjacents,13915
Alnus_rubra,2360,0,2360,Points-PointsKO-Adjacents,4537
Alnus_serrulata,1599,1249,350,Alphahull-PointsKO-Adjacents,28215
Alnus_serrulatoides,64,37,27,Alphahull-PointsKO-Adjacents,941
Alnus_sieboldiana,361,247,114,Alphahull-PointsKO-Adjacents,2731
Alnus_subcordata,3,2,1,Points-PointsKO-Adjacents,17
Alnus_trabeculosa,36,16,20,Points-PointsKO-Adjacents,322
Alnus_vermicularis,NA,NA,NA,NA,NA
Aloe_africana,15,8,7,Points-PointsKO-Adjacents,106
Aloe_alooides,4,3,1,Points-PointsKO-Adjacents,36
Aloe_angelica,7,0,7,Points-PointsKO-Adjacents,62
Aloe_antonii,2,2,0,Points-PointsKO-Adjacents,18
Aloe_arborescens,154,97,57,Alphahull-PointsKO-Adjacents,3884
Aloe_ballyi,9,4,5,Points-PointsKO-Adjacents,53
Aloe_castanea,21,15,6,Points-PointsKO-Adjacents,162
Aloe_comosa,8,5,3,Points-PointsKO-Adjacents,70
Aloe_elata,3,3,0,Points-PointsKO-Adjacents,27
Aloe_excelsa,6,0,6,Points-PointsKO-Adjacents,48
Aloe_eximia,2,2,0,Points-PointsKO-Adjacents,12
Aloe_ferox,118,84,34,Alphahull-PointsKO-Adjacents,2100
Aloe_gracilicaulis,3,3,0,Points-PointsKO-Adjacents,21
Aloe_helenae,12,5,7,Points-PointsKO-Adjacents,60
Aloe_khamiesensis,0,0,0,NA,0
Aloe_littoralis,65,31,34,Alphahull-PointsKO-Adjacents,3898
Aloe_marlothii,70,49,21,Alphahull-PointsKO-Adjacents,2461
Aloe_mawii,14,4,10,Points-PointsKO-Adjacents,92
Aloe_medishiana,4,4,0,Points-PointsKO-Adjacents,27
Aloe_miskatana,2,2,0,Points-PointsKO-Adjacents,16
Aloe_mubendiensis,4,4,0,Points-PointsKO-Adjacents,26
Aloe_munchii,0,0,0,NA,0
Aloe_peyrierasii,1,1,0,Points-PointsKO-Adjacents,8
Aloe_pluridens,16,7,9,Points-PointsKO-Adjacents,113
Aloe_rupestris,14,1,13,Points-PointsKO-Adjacents,118
Aloe_rupicola,1,1,0,Points-PointsKO-Adjacents,9
Aloe_speciosa,21,12,9,Points-PointsKO-Adjacents,165
Aloe_spectabilis,9,6,3,Points-PointsKO-Adjacents,61
Aloe_spicata,32,22,10,Alphahull-PointsKO-Adjacents,746
Aloe_suzannae,9,2,7,Points-PointsKO-Adjacents,53
Aloe_thraskii,8,0,8,Points-PointsKO-Adjacents,58
Aloe_tororoana,3,3,0,Points-PointsKO-Adjacents,21
Aloe_vaombe,25,12,13,Points-PointsKO-Adjacents,198
Aloe_vaotsanda,8,6,2,Points-PointsKO-Adjacents,39
Aloe_volkensii,29,15,14,Points-PointsKO-Adjacents,209
Aloidendron_barberae,13,3,10,Points-PointsKO-Adjacents,112
Aloidendron_dichotomum,103,85,18,Alphahull-PointsKO-Adjacents,2042
Aloidendron_eminens,11,8,3,Points-PointsKO-Adjacents,32
Aloidendron_pillansii,21,13,8,Points-PointsKO-Adjacents,98
Aloidendron_ramosissimum,19,11,8,Points-PointsKO-Adjacents,121
Aloysia_virgata,1134,991,143,Alphahull-PointsKO-Adjacents,56829
Alphandia_furfuracea,5,5,0,Points-PointsKO-Adjacents,39
Alphandia_resinosa,3,3,0,Points-PointsKO-Adjacents,6
Alphandia_verniciflua,5,5,0,Points-PointsKO-Adjacents,20
Alphitonia_carolinensis,1,1,0,Points-PointsKO-Adjacents,6
Alphitonia_cinerascens,0,0,0,NA,0
Alphitonia_erubescens,6,2,4,Points-PointsKO-Adjacents,33
Alphitonia_excelsa,6692,6360,332,Alphahull-PointsKO-Adjacents,27181
Alphitonia_ferruginea,23,16,7,Points-PointsKO-Adjacents,167
Alphitonia_franguloides,1,1,0,Points-PointsKO-Adjacents,9
Alphitonia_incana,23,2,21,Points-PointsKO-Adjacents,186
Alphitonia_macrocarpa,61,0,61,Points-PointsKO-Adjacents,323
Alphitonia_marquesensis,1,1,0,Points-PointsKO-Adjacents,9
Alphitonia_neocaledonica,25,16,9,Points-PointsKO-Adjacents,101
Alphitonia_oblata,255,183,72,Alphahull-PointsKO-Adjacents,4220
Alphitonia_petriei,291,241,50,Alphahull-PointsKO-Adjacents,1013
Alphitonia_philippinensis,16,2,14,Points-PointsKO-Adjacents,124
Alphitonia_pomaderroides,248,217,31,Alphahull-PointsKO-Adjacents,3951
Alphitonia_ponderosa,6,2,4,Points-PointsKO-Adjacents,47
Alphitonia_vieillardii,0,0,0,NA,0
Alphitonia_whitei,121,102,19,Alphahull-PointsKO-Adjacents,267
Alphonsea_boniana,18,0,18,Points-PointsKO-Adjacents,156
Alphonsea_borneensis,2,2,0,Points-PointsKO-Adjacents,18
Alphonsea_curtisii,0,0,0,NA,0
Alphonsea_cylindrica,3,3,0,Points-PointsKO-Adjacents,25
Alphonsea_elliptica,1,1,0,Points-PointsKO-Adjacents,9
Alphonsea_gaudichaudiana,2,2,0,Points-PointsKO-Adjacents,18
Alphonsea_glabrifolia,16,6,10,Points-PointsKO-Adjacents,138
Alphonsea_hainanensis,8,1,7,Points-PointsKO-Adjacents,63
Alphonsea_havilandii,0,0,0,NA,0
Alphonsea_hortensis,0,0,0,NA,0
Alphonsea_javanica,12,0,12,Points-PointsKO-Adjacents,106
Alphonsea_johorensis,2,0,2,Points-PointsKO-Adjacents,18
Alphonsea_keithii,NA,NA,NA,NA,NA
Alphonsea_kinabaluensis,4,0,4,Points-PointsKO-Adjacents,27
Alphonsea_kingii,0,0,0,NA,0
Alphonsea_lucida,2,2,0,Points-PointsKO-Adjacents,18
Alphonsea_lutea,0,0,0,NA,0
Alphonsea_madraspatana,NA,NA,NA,NA,NA
Alphonsea_maingayi,4,0,4,Points-PointsKO-Adjacents,23
Alphonsea_malayana,1,1,0,Points-PointsKO-Adjacents,9
Alphonsea_mollis,7,1,6,Points-PointsKO-Adjacents,63
Alphonsea_monogyna,17,0,17,Points-PointsKO-Adjacents,144
Alphonsea_philastreana,0,0,0,NA,0
Alphonsea_sclerocarpa,2,0,2,Points-PointsKO-Adjacents,12
Alphonsea_siamensis,2,2,0,Points-PointsKO-Adjacents,18
Alphonsea_sonlaensis,NA,NA,NA,NA,NA
Alphonsea_squamosa,2,2,0,Points-PointsKO-Adjacents,18
Alphonsea_teysmannii,1,0,1,Points-PointsKO-Adjacents,9
Alphonsea_tonquinensis,3,3,0,Points-PointsKO-Adjacents,18
Alphonsea_tsangyanensis,0,0,0,NA,0
Alphonsea_ventricosa,1,1,0,Points-PointsKO-Adjacents,9
Alphonsea_zeylanica,4,3,1,Points-PointsKO-Adjacents,33
Alseis_blackiana,95,73,22,Alphahull-PointsKO-Adjacents,1433
Alseis_costaricensis,40,29,11,Alphahull-PointsKO-Adjacents,365
Alseis_eggersii,33,21,12,Alphahull-PointsKO-Adjacents,779
Alseis_floribunda,758,652,106,Alphahull-PointsKO-Adjacents,22252
Alseis_gardneri,4,4,0,Points-PointsKO-Adjacents,14
Alseis_hondurensis,12,6,6,Points-PointsKO-Adjacents,104
Alseis_involuta,39,15,24,Points-PointsKO-Adjacents,252
Alseis_labatioides,8,2,6,Points-PointsKO-Adjacents,72
Alseis_latifolia,54,1,53,Points-PointsKO-Adjacents,403
Alseis_longifolia,34,0,34,Points-PointsKO-Adjacents,245
Alseis_lugonis,19,12,7,Points-PointsKO-Adjacents,117
Alseis_microcarpa,41,12,29,Points-PointsKO-Adjacents,293
Alseis_mutisii,28,17,11,Points-PointsKO-Adjacents,205
Alseis_peruviana,33,15,18,Points-PointsKO-Adjacents,254
Alseis_pickelii,188,128,60,Alphahull-PointsKO-Adjacents,1471
Alseis_reticulata,30,0,30,Points-PointsKO-Adjacents,246
Alseis_smithii,20,13,7,Points-PointsKO-Adjacents,106
Alseis_yucatanensis,266,247,19,Alphahull-PointsKO-Adjacents,2156
Alseodaphne_albifrons,0,0,0,NA,0
Alseodaphne_andersonii,8,1,7,Points-PointsKO-Adjacents,70
Alseodaphne_archboldiana,6,0,6,Points-PointsKO-Adjacents,52
Alseodaphne_bancana,5,0,5,Points-PointsKO-Adjacents,45
Alseodaphne_birmanica,NA,NA,NA,NA,NA
Alseodaphne_borneensis,3,3,0,Points-PointsKO-Adjacents,27
Alseodaphne_coriacea,1,1,0,Points-PointsKO-Adjacents,9
Alseodaphne_dura,NA,NA,NA,NA,NA
Alseodaphne_elmeri,5,5,0,Points-PointsKO-Adjacents,44
Alseodaphne_elongata,0,0,0,NA,0
Alseodaphne_foxiana,0,0,0,NA,0
Alseodaphne_garciniicarpa,0,0,0,NA,0
Alseodaphne_glauciflora,0,0,0,NA,0
Alseodaphne_glaucina,0,0,0,NA,0
Alseodaphne_gracilis,NA,NA,NA,NA,NA
Alseodaphne_griffithii,0,0,0,NA,0
Alseodaphne_habrotricha,0,0,0,NA,0
Alseodaphne_hainanensis,6,1,5,Points-PointsKO-Adjacents,50
Alseodaphne_himalayana,NA,NA,NA,NA,NA
Alseodaphne_hokouensis,1,1,0,Points-PointsKO-Adjacents,9
Alseodaphne_huanglianshanensis,NA,NA,NA,NA,NA
Alseodaphne_insignis,6,1,5,Points-PointsKO-Adjacents,51
Alseodaphne_intermedia,0,0,0,NA,0
Alseodaphne_keenanii,8,0,8,Points-PointsKO-Adjacents,70
Alseodaphne_khasyana,1,1,0,Points-PointsKO-Adjacents,9
Alseodaphne_kochummenii,0,0,0,NA,0
Alseodaphne_lanuginosa,0,0,0,NA,0
Alseodaphne_longipes,0,0,0,NA,0
Alseodaphne_macrantha,NA,NA,NA,NA,NA
Alseodaphne_marlipoensis,2,2,0,Points-PointsKO-Adjacents,18
Alseodaphne_medogensis,4,4,0,Points-PointsKO-Adjacents,36
Alseodaphne_micrantha,NA,NA,NA,NA,NA
Alseodaphne_montana,1,1,0,Points-PointsKO-Adjacents,9
Alseodaphne_nigrescens,0,0,0,NA,0
Alseodaphne_oblanceolata,2,1,1,Points-PointsKO-Adjacents,16
Alseodaphne_owdenii,0,0,0,NA,0
Alseodaphne_paludosa,1,1,0,Points-PointsKO-Adjacents,9
Alseodaphne_peduncularis,7,0,7,Points-PointsKO-Adjacents,48
Alseodaphne_pendulifolia,1,1,0,Points-PointsKO-Adjacents,9
Alseodaphne_perakensis,2,2,0,Points-PointsKO-Adjacents,18
Alseodaphne_petiolaris,5,0,5,Points-PointsKO-Adjacents,45
Alseodaphne_philippinensis,2,2,0,Points-PointsKO-Adjacents,9
Alseodaphne_ramosii,NA,NA,NA,NA,NA
Alseodaphne_reticulata,1,1,0,Points-PointsKO-Adjacents,9
Alseodaphne_rhododendropsis,0,0,0,NA,0
Alseodaphne_ridleyi,0,0,0,NA,0
Alseodaphne_rubriflora,NA,NA,NA,NA,NA
Alseodaphne_rubrolignea,2,2,0,Points-PointsKO-Adjacents,18
Alseodaphne_rugosa,1,1,0,Points-PointsKO-Adjacents,9
Alseodaphne_semecarpifolia,6,0,6,Points-PointsKO-Adjacents,54
Alseodaphne_siamensis,0,0,0,NA,0
Alseodaphne_sichourensis,5,5,0,Points-PointsKO-Adjacents,45
Alseodaphne_suboppositifolia,0,0,0,NA,0
Alseodaphne_sulcata,NA,NA,NA,NA,NA
Alseodaphne_tomentosa,1,1,0,Points-PointsKO-Adjacents,9
Alseodaphne_tonkinensis,0,0,0,NA,0
Alseodaphne_utilis,1,1,0,Points-PointsKO-Adjacents,9
Alseodaphne_wrayi,2,2,0,Points-PointsKO-Adjacents,18
Alseodaphne_yunnanensis,NA,NA,NA,NA,NA
Alsodeiopsis_poggei,14,4,10,Points-PointsKO-Adjacents,93
Alsodeiopsis_schumannii,46,37,9,Alphahull-PointsKO-Adjacents,310
Alsodeiopsis_staudtii,46,28,18,Alphahull-PointsKO-Adjacents,453
Alsodeiopsis_zenkeri,10,3,7,Points-PointsKO-Adjacents,63
Alstonia_actinophylla,648,586,62,Alphahull-PointsKO-Adjacents,7253
Alstonia_angustifolia,6,0,6,Points-PointsKO-Adjacents,51
Alstonia_angustiloba,4,0,4,Points-PointsKO-Adjacents,36
Alstonia_annamensis,1,1,0,Points-PointsKO-Adjacents,9
Alstonia_balansae,15,6,9,Points-PointsKO-Adjacents,88
Alstonia_beatricis,0,0,0,NA,0
Alstonia_boonei,213,142,71,Alphahull-PointsKO-Adjacents,6395
Alstonia_boulindaensis,1,1,0,Points-PointsKO-Adjacents,9
Alstonia_breviloba,2,2,0,Points-PointsKO-Adjacents,18
Alstonia_congensis,128,85,43,Alphahull-PointsKO-Adjacents,2737
Alstonia_constricta,1073,1032,41,Alphahull-PointsKO-Adjacents,11756
Alstonia_coriacea,12,6,6,Points-PointsKO-Adjacents,53
Alstonia_costata,50,24,26,Alphahull-PointsKO-Adjacents,182
Alstonia_iwahigensis,8,1,7,Points-PointsKO-Adjacents,64
Alstonia_lanceolata,11,7,4,Points-PointsKO-Adjacents,53
Alstonia_lanceolifera,4,4,0,Points-PointsKO-Adjacents,26
Alstonia_legouixiae,16,8,8,Points-PointsKO-Adjacents,64
Alstonia_lenormandii,7,3,4,Points-PointsKO-Adjacents,50
Alstonia_longifolia,195,143,52,Alphahull-PointsKO-Adjacents,3554
Alstonia_macrophylla,27,2,25,Points-PointsKO-Adjacents,222
Alstonia_muelleriana,147,131,16,Alphahull-PointsKO-Adjacents,295
Alstonia_odontophora,6,2,4,Points-PointsKO-Adjacents,36
Alstonia_parvifolia,1,1,0,Points-PointsKO-Adjacents,9
Alstonia_penangiana,0,0,0,NA,0
Alstonia_pneumatophora,6,0,6,Points-PointsKO-Adjacents,52
Alstonia_quaternata,3,3,0,Points-PointsKO-Adjacents,25
Alstonia_rostrata,14,2,12,Points-PointsKO-Adjacents,122
Alstonia_rubiginosa,3,2,1,Points-PointsKO-Adjacents,26
Alstonia_rupestris,0,0,0,NA,0
Alstonia_scholaris,264,154,110,Alphahull-PointsKO-Adjacents,7420
Alstonia_sebusi,4,4,0,Points-PointsKO-Adjacents,36
Alstonia_spatulata,11,0,11,Points-PointsKO-Adjacents,52
Alstonia_spectabilis,330,264,66,Alphahull-PointsKO-Adjacents,4539
Alstonia_sphaerocapitata,0,0,0,NA,0
Alstonia_venenata,3,3,0,Points-PointsKO-Adjacents,27
Alstonia_vieillardii,8,4,4,Points-PointsKO-Adjacents,45
Alternanthera_rugulosa,2,2,0,Points-PointsKO-Adjacents,18
Altingia_chinensis,6,2,4,Points-PointsKO-Adjacents,52
Altingia_excelsa,14,1,13,Points-PointsKO-Adjacents,121
Altingia_gracilipes,8,1,7,Points-PointsKO-Adjacents,72
Altingia_multinervis,NA,NA,NA,NA,NA
Altingia_obovata,1,1,0,Points-PointsKO-Adjacents,9
Altingia_siamensis,5,5,0,Points-PointsKO-Adjacents,39
Altingia_tenuifolia,0,0,0,NA,0
Altingia_yunnanensis,0,0,0,NA,0
Alvaradoa_amorphoides,812,712,100,Alphahull-PointsKO-Adjacents,9151
Alvaradoa_arborescens,13,0,13,Points-PointsKO-Adjacents,70
Alvaradoa_haitiensis,20,12,8,Points-PointsKO-Adjacents,146
Alvaradoa_jamaicensis,3,3,0,Points-PointsKO-Adjacents,25
Alvaradoa_lewisii,3,3,0,Points-PointsKO-Adjacents,24
Alvaradoa_subovata,43,28,15,Alphahull-PointsKO-Adjacents,239
Alyxia_ilicifolia,193,160,33,Alphahull-PointsKO-Adjacents,654
Alyxia_magnifolia,182,147,35,Alphahull-PointsKO-Adjacents,624
Alyxia_orophila,49,39,10,Alphahull-PointsKO-Adjacents,102
Alyxia_sinensis,91,66,25,Alphahull-PointsKO-Adjacents,4856
Alzatea_verticillata,174,120,54,Alphahull-PointsKO-Adjacents,1769
Amaioua_brevidentata,8,0,8,Points-PointsKO-Adjacents,60
Amaioua_contracta,8,0,8,Points-PointsKO-Adjacents,70
Amaioua_glomerulata,825,634,191,Alphahull-PointsKO-Adjacents,44385
Amaioua_guianensis,1326,1167,159,Alphahull-PointsKO-Adjacents,107484
Amaioua_intermedia,720,624,96,Alphahull-PointsKO-Adjacents,15073
Amaioua_magnicarpa,23,11,12,Points-PointsKO-Adjacents,106
Amaioua_monteiroi,7,0,7,Points-PointsKO-Adjacents,63
Amaioua_pedicellata,63,50,13,Alphahull-PointsKO-Adjacents,429
Amaioua_pilosa,74,49,25,Alphahull-PointsKO-Adjacents,3775
Amanoa_almerindae,16,2,14,Points-PointsKO-Adjacents,129
Amanoa_anomala,0,0,0,NA,0
Amanoa_bracteosa,32,19,13,Points-PointsKO-Adjacents,209
Amanoa_caribaea,5,4,1,Points-PointsKO-Adjacents,22
Amanoa_congesta,13,0,13,Points-PointsKO-Adjacents,102
Amanoa_cupatensis,4,4,0,Points-PointsKO-Adjacents,36
Amanoa_glaucophylla,89,49,40,Alphahull-PointsKO-Adjacents,12145
Amanoa_gracillima,6,0,6,Points-PointsKO-Adjacents,53
Amanoa_guianensis,518,386,132,Alphahull-PointsKO-Adjacents,53221
Amanoa_nanayensis,24,12,12,Points-PointsKO-Adjacents,160
Amanoa_neglecta,1,1,0,Points-PointsKO-Adjacents,9
Amanoa_oblongifolia,112,76,36,Alphahull-PointsKO-Adjacents,7622
Amanoa_sinuosa,17,3,14,Points-PointsKO-Adjacents,132
Amanoa_steyermarkii,17,9,8,Points-PointsKO-Adjacents,98
Amanoa_strobilacea,12,5,7,Points-PointsKO-Adjacents,68
Amaracarpus_attenuatus,9,2,7,Points-PointsKO-Adjacents,76
Amaracarpus_belensis,5,5,0,Points-PointsKO-Adjacents,39
Amaracarpus_brassii,3,3,0,Points-PointsKO-Adjacents,21
Amaracarpus_compactus,10,1,9,Points-PointsKO-Adjacents,84
Amaracarpus_grandifolius,23,10,13,Points-PointsKO-Adjacents,160
Amaracarpus_nematopodus,93,83,10,Alphahull-PointsKO-Adjacents,160
Amaracarpus_xanthocarpus,1,1,0,Points-PointsKO-Adjacents,9
Amaroria_soulameoides,0,0,0,NA,0
Ambavia_capuronii,30,16,14,Points-PointsKO-Adjacents,170
Ambavia_gerrardii,94,67,27,Alphahull-PointsKO-Adjacents,585
Ambelania_acida,310,260,50,Alphahull-PointsKO-Adjacents,26926
Ambelania_duckei,32,16,16,Points-PointsKO-Adjacents,212
Ambelania_occidentalis,61,44,17,Alphahull-PointsKO-Adjacents,2418
Ambilobea_madagascariensis,33,23,10,Alphahull-PointsKO-Adjacents,107
Amblygonocarpus_andongensis,69,30,39,Alphahull-PointsKO-Adjacents,772
Amborella_trichopoda,70,60,10,Alphahull-PointsKO-Adjacents,87
Ambrosia_carduacea,50,32,18,Alphahull-PointsKO-Adjacents,820
Amburana_acreana,21,3,18,Points-PointsKO-Adjacents,185
Amburana_cearensis,480,392,88,Alphahull-PointsKO-Adjacents,19736
Amelanchier_alnifolia,3969,3757,212,Alphahull-PointsKO-Adjacents,46416
Amelanchier_arborea,2176,1771,405,Alphahull-PointsKO-Adjacents,45762
Amelanchier_asiatica,100,56,44,Alphahull-PointsKO-Adjacents,1270
Amelanchier_bartramiana,782,655,127,Alphahull-PointsKO-Adjacents,30916
Amelanchier_canadensis,550,373,177,Alphahull-PointsKO-Adjacents,16536
Amelanchier_cusickii,218,132,86,Alphahull-PointsKO-Adjacents,8644
Amelanchier_interior,201,130,71,Alphahull-PointsKO-Adjacents,6770
Amelanchier_laevis,1142,964,178,Alphahull-PointsKO-Adjacents,32436
Amelanchier_pallida,358,323,35,Alphahull-PointsKO-Adjacents,4540
Amelanchier_sanguinea,367,275,92,Alphahull-PointsKO-Adjacents,20116
Amelanchier_sinica,16,6,10,Points-PointsKO-Adjacents,144
Amelanchier_utahensis,2283,2204,79,Alphahull-PointsKO-Adjacents,28355
Amentotaxus_argotaenia,52,22,30,Alphahull-PointsKO-Adjacents,4695
Amentotaxus_assamica,1,1,0,Points-PointsKO-Adjacents,9
Amentotaxus_formosana,24,18,6,Points-PointsKO-Adjacents,57
Amentotaxus_hatuyenensis,0,0,0,NA,0
Amentotaxus_poilanei,1,1,0,Points-PointsKO-Adjacents,9
Amentotaxus_yunnanensis,12,8,4,Points-PointsKO-Adjacents,103
Amesiodendron_chinense,30,8,22,Points-PointsKO-Adjacents,240
Amherstia_nobilis,1,0,1,Points-PointsKO-Adjacents,9
Ammodendron_conollyi,1,1,0,Points-PointsKO-Adjacents,9
Ammodendron_karelinii,0,0,0,NA,0
Ammopiptanthus_nanus,0,0,0,NA,0
Amolinia_heydeana,12,7,5,Points-PointsKO-Adjacents,64
Amomyrtella_guilii,16,0,16,Points-PointsKO-Adjacents,124
Amomyrtella_irregularis,3,3,0,Points-PointsKO-Adjacents,18
Amomyrtus_luma,51,33,18,Alphahull-PointsKO-Adjacents,1362
Amomyrtus_meli,12,0,12,Points-PointsKO-Adjacents,101
Ampelocera_albertiae,8,6,2,Points-PointsKO-Adjacents,39
Ampelocera_cubensis,9,1,8,Points-PointsKO-Adjacents,76
Ampelocera_edentula,561,465,96,Alphahull-PointsKO-Adjacents,65763
Ampelocera_glabra,48,0,48,Points-PointsKO-Adjacents,367
Ampelocera_hottlei,103,92,11,Alphahull-PointsKO-Adjacents,2015
Ampelocera_macphersonii,51,27,24,Alphahull-PointsKO-Adjacents,1274
Ampelocera_macrocarpa,92,67,25,Alphahull-PointsKO-Adjacents,1506
Ampelocera_pubescens,0,0,0,NA,0
Ampelocera_ruizii,182,155,27,Alphahull-PointsKO-Adjacents,6748
Ampelocera_verrucosa,5,5,0,Points-PointsKO-Adjacents,39
Ampelocissus_dekindtiana,NA,NA,NA,NA,NA
Ampelozizyphus_amazonicus,81,41,40,Alphahull-PointsKO-Adjacents,4225
Amphimas_ferrugineus,40,25,15,Alphahull-PointsKO-Adjacents,1456
Amphimas_pterocarpoides,88,47,41,Alphahull-PointsKO-Adjacents,1704
Amphimas_tessmannii,0,0,0,NA,0
Amphiodon_effusus,273,224,49,Alphahull-PointsKO-Adjacents,22098
Amphipterygium_adstringens,418,365,53,Alphahull-PointsKO-Adjacents,3621
Amphipterygium_amplifolium,5,1,4,Points-PointsKO-Adjacents,30
Amphipterygium_glaucum,5,4,1,Points-PointsKO-Adjacents,45
Amphipterygium_molle,9,1,8,Points-PointsKO-Adjacents,52
Amphipterygium_simplicifolium,8,0,8,Points-PointsKO-Adjacents,50
Amphirrhox_longifolia,757,617,140,Alphahull-PointsKO-Adjacents,48447
Amphitecna_apiculata,131,108,23,Alphahull-PointsKO-Adjacents,1374
Amphitecna_breedlovei,40,30,10,Alphahull-PointsKO-Adjacents,613
Amphitecna_costata,3,3,0,Points-PointsKO-Adjacents,27
Amphitecna_donnell-smithii,9,3,6,Points-PointsKO-Adjacents,56
Amphitecna_gentryi,32,22,10,Alphahull-PointsKO-Adjacents,101
Amphitecna_isthmica,69,51,18,Alphahull-PointsKO-Adjacents,806
Amphitecna_kennedyae,58,35,23,Alphahull-PointsKO-Adjacents,436
Amphitecna_latifolia,274,167,107,Alphahull-PointsKO-Adjacents,5537
Amphitecna_lundellii,3,3,0,Points-PointsKO-Adjacents,23
Amphitecna_macrophylla,26,13,13,Points-PointsKO-Adjacents,177
Amphitecna_molinae,10,6,4,Points-PointsKO-Adjacents,55
Amphitecna_montana,41,34,7,Alphahull-PointsKO-Adjacents,116
Amphitecna_regalis,30,22,8,Alphahull-PointsKO-Adjacents,123
Amphitecna_sessilifolia,91,79,12,Alphahull-PointsKO-Adjacents,310
Amphitecna_silvicola,26,19,7,Points-PointsKO-Adjacents,100
Amphitecna_spathicalyx,3,1,2,Points-PointsKO-Adjacents,12
Amphitecna_steyermarkii,14,5,9,Points-PointsKO-Adjacents,108
Amphitecna_tuxtlensis,66,55,11,Alphahull-PointsKO-Adjacents,536
Amphorogyne_celastroides,5,5,0,Points-PointsKO-Adjacents,40
Amphorogyne_spicata,6,3,3,Points-PointsKO-Adjacents,38
Amphorogyne_staufferi,4,4,0,Points-PointsKO-Adjacents,27
Amygdalus_bucharica,2,2,0,Points-PointsKO-Adjacents,18
Amyrea_celastroides,6,3,3,Points-PointsKO-Adjacents,32
Amyrea_grandifolia,8,5,3,Points-PointsKO-Adjacents,42
Amyrea_humbertii,67,50,17,Alphahull-PointsKO-Adjacents,1440
Amyrea_lancifolia,3,3,0,Points-PointsKO-Adjacents,18
Amyrea_remotiflora,5,5,0,Points-PointsKO-Adjacents,42
Amyrea_sambiranensis,22,14,8,Points-PointsKO-Adjacents,96
Amyrea_stenocarpa,8,5,3,Points-PointsKO-Adjacents,15
Amyris_apiculata,2,2,0,Points-PointsKO-Adjacents,18
Amyris_attenuata,23,2,21,Points-PointsKO-Adjacents,129
Amyris_balsamifera,161,75,86,Alphahull-PointsKO-Adjacents,3935
Amyris_brenesii,39,32,7,Alphahull-PointsKO-Adjacents,208
Amyris_chiapensis,3,3,0,Points-PointsKO-Adjacents,21
Amyris_crebrinervis,7,1,6,Points-PointsKO-Adjacents,54
Amyris_diatrypa,52,30,22,Alphahull-PointsKO-Adjacents,436
Amyris_elemifera,350,262,88,Alphahull-PointsKO-Adjacents,5794
Amyris_guatemalensis,6,2,4,Points-PointsKO-Adjacents,54
Amyris_ignea,37,15,22,Points-PointsKO-Adjacents,275
Amyris_lineata,4,4,0,Points-PointsKO-Adjacents,35
Amyris_macrocarpa,37,22,15,Alphahull-PointsKO-Adjacents,637
Amyris_magnifolia,9,1,8,Points-PointsKO-Adjacents,42
Amyris_oblanceolata,8,1,7,Points-PointsKO-Adjacents,67
Amyris_pinnata,173,112,61,Alphahull-PointsKO-Adjacents,2957
Amyris_polymorpha,0,0,0,NA,0
Amyris_purpusii,12,0,12,Points-PointsKO-Adjacents,48
Amyris_rekoi,22,6,16,Points-PointsKO-Adjacents,115
Amyris_rhomboidea,5,4,1,Points-PointsKO-Adjacents,43
Amyris_thyrsiflora,15,7,8,Points-PointsKO-Adjacents,77
Amyris_vestita,9,4,5,Points-PointsKO-Adjacents,57
Amyxa_pluricornis,15,9,6,Points-PointsKO-Adjacents,123
Anacardium_amapaense,8,0,8,Points-PointsKO-Adjacents,63
Anacardium_caracolii,0,0,0,NA,0
Anacardium_curatellifolium,10,3,7,Points-PointsKO-Adjacents,84
Anacardium_excelsum,480,404,76,Alphahull-PointsKO-Adjacents,7664
Anacardium_fruticosum,10,8,2,Points-PointsKO-Adjacents,19
Anacardium_giganteum,335,0,335,Points-PointsKO-Adjacents,2681
Anacardium_humile,351,281,70,Alphahull-PointsKO-Adjacents,21646
Anacardium_kuhlmannianum,49,12,37,Points-PointsKO-Adjacents,362
Anacardium_microsepalum,21,4,17,Points-PointsKO-Adjacents,163
Anacardium_negrense,5,4,1,Points-PointsKO-Adjacents,39
Anacardium_occidentale,1557,1312,245,Alphahull-PointsKO-Adjacents,99144
Anacardium_othonianum,67,0,67,Points-PointsKO-Adjacents,489
Anacardium_parvifolium,64,29,35,Alphahull-PointsKO-Adjacents,1382
Anacardium_rondonianum,49,12,37,Points-PointsKO-Adjacents,362
Anacardium_spruceanum,182,131,51,Alphahull-PointsKO-Adjacents,20811
Anacardium_tenuifolium,10,0,10,Points-PointsKO-Adjacents,72
Anacolosa_casearioides,34,15,19,Points-PointsKO-Adjacents,201
Anacolosa_cauliflora,0,0,0,NA,0
Anacolosa_clarkii,3,3,0,Points-PointsKO-Adjacents,27
Anacolosa_crassipes,NA,NA,NA,NA,NA
Anacolosa_densiflora,1,1,0,Points-PointsKO-Adjacents,9
Anacolosa_frutescens,27,7,20,Points-PointsKO-Adjacents,214
Anacolosa_glochidiiformis,3,3,0,Points-PointsKO-Adjacents,14
Anacolosa_griffithii,2,2,0,Points-PointsKO-Adjacents,18
Anacolosa_ilicoides,2,2,0,Points-PointsKO-Adjacents,18
Anacolosa_insularis,2,2,0,Points-PointsKO-Adjacents,12
Anacolosa_lutea,1,1,0,Points-PointsKO-Adjacents,7
Anacolosa_papuana,16,0,16,Points-PointsKO-Adjacents,117
Anacolosa_pervilleana,82,59,23,Alphahull-PointsKO-Adjacents,1243
Anacolosa_poilanei,1,1,0,Points-PointsKO-Adjacents,9
Anadenanthera_colubrina,2426,2261,165,Alphahull-PointsKO-Adjacents,62480
Anadenanthera_peregrina,1878,1671,207,Alphahull-PointsKO-Adjacents,69751
Anagyris_foetida,820,591,229,Alphahull-PointsKO-Adjacents,3895
Anakasia_simplicifolia,1,1,0,Points-PointsKO-Adjacents,9
Anastrabe_integerrima,31,18,13,Points-PointsKO-Adjacents,249
Anastraphia_buchii,1,0,1,Points-PointsKO-Adjacents,8
Anastraphia_picardae,0,0,0,NA,0
Anaxagorea_acuminata,254,194,60,Alphahull-PointsKO-Adjacents,25233
Anaxagorea_allenii,64,47,17,Alphahull-PointsKO-Adjacents,636
Anaxagorea_angustifolia,8,2,6,Points-PointsKO-Adjacents,68
Anaxagorea_borneensis,5,5,0,Points-PointsKO-Adjacents,43
Anaxagorea_brachycarpa,120,0,120,Points-PointsKO-Adjacents,765
Anaxagorea_brevipedicellata,17,10,7,Points-PointsKO-Adjacents,137
Anaxagorea_brevipes,432,338,94,Alphahull-PointsKO-Adjacents,47191
Anaxagorea_crassipetala,213,167,46,Alphahull-PointsKO-Adjacents,2292
Anaxagorea_dolichocarpa,1082,918,164,Alphahull-PointsKO-Adjacents,80878
Anaxagorea_floribunda,15,0,15,Points-PointsKO-Adjacents,105
Anaxagorea_gigantophylla,23,11,12,Points-PointsKO-Adjacents,157
Anaxagorea_guatemalensis,39,26,13,Alphahull-PointsKO-Adjacents,389
Anaxagorea_javanica,36,11,25,Points-PointsKO-Adjacents,249
Anaxagorea_luzonensis,27,0,27,Points-PointsKO-Adjacents,211
Anaxagorea_macrantha,7,2,5,Points-PointsKO-Adjacents,63
Anaxagorea_manausensis,21,5,16,Points-PointsKO-Adjacents,160
Anaxagorea_pachypetala,8,2,6,Points-PointsKO-Adjacents,72
Anaxagorea_panamensis,18,8,10,Points-PointsKO-Adjacents,99
Anaxagorea_petiolata,79,63,16,Alphahull-PointsKO-Adjacents,2882
Anaxagorea_phaeocarpa,44,31,13,Alphahull-PointsKO-Adjacents,187
Anaxagorea_prinoides,67,36,31,Alphahull-PointsKO-Adjacents,3535
Anaxagorea_rufa,118,90,28,Alphahull-PointsKO-Adjacents,4122
Anaxagorea_silvatica,30,18,12,Points-PointsKO-Adjacents,215
Ancistrocarpus_bequaertii,32,19,13,Points-PointsKO-Adjacents,218
Ancistrocarpus_densispinosus,116,86,30,Alphahull-PointsKO-Adjacents,2337
Ancylobothrys_pyriformis,1,1,0,Points-PointsKO-Adjacents,9
Andeimalva_machupicchensis,3,3,0,Points-PointsKO-Adjacents,27
Andinocleome_magnifica,58,39,19,Alphahull-PointsKO-Adjacents,1939
Andira_anthelmia,256,176,80,Alphahull-PointsKO-Adjacents,3480
Andira_carvalhoi,28,16,12,Points-PointsKO-Adjacents,94
Andira_chigorodensis,7,3,4,Points-PointsKO-Adjacents,57
Andira_cordata,147,122,25,Alphahull-PointsKO-Adjacents,6492
Andira_coriacea,31,22,9,Alphahull-PointsKO-Adjacents,734
Andira_cubensis,12,1,11,Points-PointsKO-Adjacents,99
Andira_cujabensis,443,407,36,Alphahull-PointsKO-Adjacents,20066
Andira_fraxinifolia,1375,1,1374,Points-PointsKO-Adjacents,7016
Andira_galeottiana,82,0,82,Points-PointsKO-Adjacents,404
Andira_grandistipula,11,6,5,Points-PointsKO-Adjacents,64
Andira_humilis,256,189,67,Alphahull-PointsKO-Adjacents,11980
Andira_inermis,357,252,105,Alphahull-PointsKO-Adjacents,51705
Andira_jaliscensis,5,5,0,Points-PointsKO-Adjacents,35
Andira_legalis,184,127,57,Alphahull-PointsKO-Adjacents,2683
Andira_macrocarpa,5,5,0,Points-PointsKO-Adjacents,36
Andira_macrothyrsa,33,9,24,Points-PointsKO-Adjacents,249
Andira_marauensis,15,6,9,Points-PointsKO-Adjacents,73
Andira_micrantha,48,25,23,Alphahull-PointsKO-Adjacents,932
Andira_multistipula,21,10,11,Points-PointsKO-Adjacents,152
Andira_nitida,296,216,80,Alphahull-PointsKO-Adjacents,1492
Andira_ormosioides,155,119,36,Alphahull-PointsKO-Adjacents,5678
Andira_parviflora,64,38,26,Alphahull-PointsKO-Adjacents,1319
Andira_praecox,9,2,7,Points-PointsKO-Adjacents,77
Andira_surinamensis,476,374,102,Alphahull-PointsKO-Adjacents,46285
Andira_taurotesticulata,121,104,17,Alphahull-PointsKO-Adjacents,3422
Andira_tervequinata,6,2,4,Points-PointsKO-Adjacents,52
Andira_trifoliolata,66,47,19,Alphahull-PointsKO-Adjacents,3509
Andira_unifoliolata,40,22,18,Alphahull-PointsKO-Adjacents,1169
Andira_vermifuga,688,618,70,Alphahull-PointsKO-Adjacents,30033
Andradea_floribunda,68,51,17,Alphahull-PointsKO-Adjacents,1521
Andreadoxa_flava,9,4,5,Points-PointsKO-Adjacents,29
Commersonia_perkinsiana,1,1,0,Points-PointsKO-Adjacents,7
Commersonia_rossii,47,38,9,Alphahull-PointsKO-Adjacents,193
Androcalymma_glabrifolium,7,0,7,Points-PointsKO-Adjacents,49
Androsiphonia_adenostegia,66,47,19,Alphahull-PointsKO-Adjacents,1076
Androstachys_johnsonii,23,12,11,Points-PointsKO-Adjacents,168
Androtium_astylum,3,0,3,Points-PointsKO-Adjacents,27
Androya_decaryi,13,5,8,Points-PointsKO-Adjacents,90
Aneulophus_africanus,61,43,18,Alphahull-PointsKO-Adjacents,1481
Angophora_bakeri,988,0,988,Points-PointsKO-Adjacents,497
Angophora_costata,3263,2710,553,Alphahull-PointsKO-Adjacents,4732
Angophora_euryphylla,106,96,10,Alphahull-PointsKO-Adjacents,159
Angophora_exul,7,4,3,Points-PointsKO-Adjacents,15
Angophora_floribunda,6373,6003,370,Alphahull-PointsKO-Adjacents,7056
Angophora_hispida,674,0,674,Points-PointsKO-Adjacents,243
Angophora_inopina,175,150,25,Alphahull-PointsKO-Adjacents,96
Angophora_melanoxylon,182,163,19,Alphahull-PointsKO-Adjacents,2387
Angophora_robur,185,175,10,Alphahull-PointsKO-Adjacents,82
Angophora_subvelutina,1120,1029,91,Alphahull-PointsKO-Adjacents,3213
Angophora_woodsiana,395,0,395,Points-PointsKO-Adjacents,432
Angostura_alipes,4,4,0,Points-PointsKO-Adjacents,36
Angostura_bracteata,95,66,29,Alphahull-PointsKO-Adjacents,1194
Angostura_granulosa,87,75,12,Alphahull-PointsKO-Adjacents,848
Angostura_longiflora,56,0,56,Points-PointsKO-Adjacents,398
Angostura_ossana,1,1,0,Points-PointsKO-Adjacents,9
Angostura_quinquefolia,16,4,12,Points-PointsKO-Adjacents,135
Angostura_resinosa,58,24,34,Alphahull-PointsKO-Adjacents,490
Angostura_silvestris,7,0,7,Points-PointsKO-Adjacents,56
Angostura_simplex,5,5,0,Points-PointsKO-Adjacents,45
Angostura_trifoliata,46,31,15,Alphahull-PointsKO-Adjacents,928
Angostylis_longifolia,7,1,6,Points-PointsKO-Adjacents,57
Angostylis_tabulamontana,1,1,0,Points-PointsKO-Adjacents,9
Angylocalyx_boutiqueanus,21,11,10,Points-PointsKO-Adjacents,168
Angylocalyx_braunii,42,26,16,Alphahull-PointsKO-Adjacents,337
Angylocalyx_oligophyllus,234,190,44,Alphahull-PointsKO-Adjacents,3062
Angylocalyx_pynaertii,60,34,26,Alphahull-PointsKO-Adjacents,2788
Angylocalyx_talbotii,15,0,15,Points-PointsKO-Adjacents,101
Aniba_affinis,112,66,46,Alphahull-PointsKO-Adjacents,3305
Aniba_bracteata,22,8,14,Points-PointsKO-Adjacents,87
Aniba_burchellii,92,52,40,Alphahull-PointsKO-Adjacents,4234
Aniba_canellila,77,33,44,Alphahull-PointsKO-Adjacents,1493
Aniba_cinnamomiflora,37,13,24,Points-PointsKO-Adjacents,250
Aniba_citrifolia,144,85,59,Alphahull-PointsKO-Adjacents,15924
Aniba_coto,86,55,31,Alphahull-PointsKO-Adjacents,768
Aniba_cylindriflora,113,59,54,Alphahull-PointsKO-Adjacents,11033
Aniba_desertorum,109,86,23,Alphahull-PointsKO-Adjacents,8019
Aniba_excelsa,15,5,10,Points-PointsKO-Adjacents,111
Aniba_ferrea,16,0,16,Points-PointsKO-Adjacents,94
Aniba_ferruginea,4,4,0,Points-PointsKO-Adjacents,27
Aniba_firmula,645,567,78,Alphahull-PointsKO-Adjacents,7331
Aniba_guianensis,311,230,81,Alphahull-PointsKO-Adjacents,36112
Aniba_heringeri,184,136,48,Alphahull-PointsKO-Adjacents,13038
Aniba_heterotepala,9,3,6,Points-PointsKO-Adjacents,50
Aniba_hostmanniana,307,218,89,Alphahull-PointsKO-Adjacents,37216
Aniba_hypoglauca,17,9,8,Points-PointsKO-Adjacents,132
Aniba_intermedia,75,47,28,Alphahull-PointsKO-Adjacents,1006
Aniba_jenmanii,18,11,7,Points-PointsKO-Adjacents,110
Aniba_kappleri,34,13,21,Points-PointsKO-Adjacents,251
Aniba_lancifolia,6,2,4,Points-PointsKO-Adjacents,26
Aniba_megaphylla,174,100,74,Alphahull-PointsKO-Adjacents,7441
Aniba_muca,140,94,46,Alphahull-PointsKO-Adjacents,1148
Aniba_novogranatensis,7,2,5,Points-PointsKO-Adjacents,61
Aniba_panurensis,402,306,96,Alphahull-PointsKO-Adjacents,45857
Aniba_parviflora,85,51,34,Alphahull-PointsKO-Adjacents,2987
Aniba_pedicellata,0,0,0,NA,0
Aniba_percoriacea,9,5,4,Points-PointsKO-Adjacents,33
Aniba_permollis,20,2,18,Points-PointsKO-Adjacents,170
Aniba_perutilis,114,78,36,Alphahull-PointsKO-Adjacents,4515
Aniba_pilosa,3,3,0,Points-PointsKO-Adjacents,27
Aniba_puchury-minor,195,149,46,Alphahull-PointsKO-Adjacents,17703
Aniba_ramageana,6,0,6,Points-PointsKO-Adjacents,29
Aniba_riparia,141,66,75,Alphahull-PointsKO-Adjacents,6263
Aniba_robusta,16,7,9,Points-PointsKO-Adjacents,121
Aniba_rosaeodora,53,23,30,Alphahull-PointsKO-Adjacents,3239
Aniba_santalodora,9,5,4,Points-PointsKO-Adjacents,31
Aniba_sulcata,NA,NA,NA,NA,NA
Aniba_taubertiana,227,154,73,Alphahull-PointsKO-Adjacents,10617
Aniba_terminalis,31,9,22,Points-PointsKO-Adjacents,224
Aniba_vaupesiana,3,3,0,Points-PointsKO-Adjacents,27
Aniba_venezuelana,60,40,20,Alphahull-PointsKO-Adjacents,393
Aniba_viridis,104,72,32,Alphahull-PointsKO-Adjacents,2705
Aniba_vulcanicola,4,4,0,Points-PointsKO-Adjacents,28
Aniba_williamsii,143,76,67,Alphahull-PointsKO-Adjacents,9199
Anisocapparis_speciosa,227,200,27,Alphahull-PointsKO-Adjacents,11665
Anisodontea_julii,28,16,12,Points-PointsKO-Adjacents,251
Anisophyllea_apetala,3,0,3,Points-PointsKO-Adjacents,27
Anisophyllea_beccariana,1,0,1,Points-PointsKO-Adjacents,9
Anisophyllea_boehmii,9,4,5,Points-PointsKO-Adjacents,68
Anisophyllea_cabole,3,3,0,Points-PointsKO-Adjacents,12
Anisophyllea_chartacea,NA,NA,NA,NA,NA
Anisophyllea_cinnamomoides,1,1,0,Points-PointsKO-Adjacents,9
Anisophyllea_corneri,10,1,9,Points-PointsKO-Adjacents,69
Anisophyllea_curtisii,NA,NA,NA,NA,NA
Anisophyllea_disticha,19,3,16,Points-PointsKO-Adjacents,155
Anisophyllea_fallax,51,25,26,Alphahull-PointsKO-Adjacents,500
Anisophyllea_ferruginea,8,1,7,Points-PointsKO-Adjacents,66
Anisophyllea_globosa,NA,NA,NA,NA,NA
Anisophyllea_grandis,0,0,0,NA,0
Anisophyllea_griffithii,1,1,0,Points-PointsKO-Adjacents,9
Anisophyllea_guianensis,8,2,6,Points-PointsKO-Adjacents,68
Anisophyllea_impressinervia,0,0,0,NA,0
Anisophyllea_ismailii,2,1,1,Points-PointsKO-Adjacents,18
Anisophyllea_laurina,27,0,27,Points-PointsKO-Adjacents,146
Anisophyllea_manausensis,15,0,15,Points-PointsKO-Adjacents,102
Anisophyllea_meniaudii,35,16,19,Points-PointsKO-Adjacents,274
Anisophyllea_myriosticta,3,3,0,Points-PointsKO-Adjacents,27
Anisophyllea_nitida,NA,NA,NA,NA,NA
Anisophyllea_obtusifolia,6,2,4,Points-PointsKO-Adjacents,24
Anisophyllea_penninervata,NA,NA,NA,NA,NA
Anisophyllea_polyneura,59,41,18,Alphahull-PointsKO-Adjacents,1086
Anisophyllea_pomifera,9,0,9,Points-PointsKO-Adjacents,63
Anisophyllea_purpurascens,111,90,21,Alphahull-PointsKO-Adjacents,1353
Anisophyllea_reticulata,NA,NA,NA,NA,NA
Anisophyllea_scortechinii,3,3,0,Points-PointsKO-Adjacents,18
Anisophyllea_sororia,25,11,14,Points-PointsKO-Adjacents,119
Anisoptera_aurea,0,0,0,NA,0
Anisoptera_costata,13,1,12,Points-PointsKO-Adjacents,95
Anisoptera_curtisii,0,0,0,NA,0
Anisoptera_grossivenia,2,0,2,Points-PointsKO-Adjacents,9
Anisoptera_laevis,2,0,2,Points-PointsKO-Adjacents,18
Anisoptera_marginata,2,0,2,Points-PointsKO-Adjacents,18
Anisoptera_megistocarpa,0,0,0,NA,0
Anisoptera_reticulata,0,0,0,NA,0
Anisoptera_scaphula,0,0,0,NA,0
Anisoptera_thurifera,118,81,37,Alphahull-PointsKO-Adjacents,4670
Anisotes_guineensis,7,5,2,Points-PointsKO-Adjacents,48
Anisotes_ukambensis,1,1,0,Points-PointsKO-Adjacents,9
Annesijoa_novoguineensis,8,3,5,Points-PointsKO-Adjacents,62
Anneslea_donnaiensis,0,0,0,NA,0
Anneslea_fragrans,104,0,104,Points-PointsKO-Adjacents,747
Anneslea_paradoxa,NA,NA,NA,NA,NA
Anneslea_steenisii,0,0,0,NA,0
Annickia_affinis,75,54,21,Alphahull-PointsKO-Adjacents,2409
Annickia_ambigua,29,13,16,Points-PointsKO-Adjacents,189
Annickia_atrocyanescens,14,3,11,Points-PointsKO-Adjacents,104
Annickia_chlorantha,125,0,125,Points-PointsKO-Adjacents,759
Annickia_kummeriae,0,0,0,NA,0
Annickia_kwiluensis,5,5,0,Points-PointsKO-Adjacents,39
Annickia_lebrunii,9,3,6,Points-PointsKO-Adjacents,63
Annickia_le-testui,7,4,3,Points-PointsKO-Adjacents,63
Annickia_olivacea,14,3,11,Points-PointsKO-Adjacents,104
Annickia_pilosa,16,0,16,Points-PointsKO-Adjacents,122
Annickia_polycarpa,84,55,29,Alphahull-PointsKO-Adjacents,2174
Annona_acutiflora,63,35,28,Alphahull-PointsKO-Adjacents,466
Annona_acutifolia,1,1,0,Points-PointsKO-Adjacents,9
Annona_amazonica,114,46,68,Alphahull-PointsKO-Adjacents,2126
Annona_ambotay,389,327,62,Alphahull-PointsKO-Adjacents,47051
Annona_andicola,33,17,16,Points-PointsKO-Adjacents,223
Annona_angustifolia,6,0,6,Points-PointsKO-Adjacents,54
Annona_annonoides,19,1,18,Points-PointsKO-Adjacents,164
Annona_asplundiana,12,4,8,Points-PointsKO-Adjacents,93
Annona_atabapensis,5,5,0,Points-PointsKO-Adjacents,45
Annona_aurantiaca,94,70,24,Alphahull-PointsKO-Adjacents,4679
Annona_bahiensis,54,36,18,Alphahull-PointsKO-Adjacents,551
Annona_bicolor,10,6,4,Points-PointsKO-Adjacents,56
Annona_billbergii,2,2,0,Points-PointsKO-Adjacents,18
Annona_boliviana,45,35,10,Alphahull-PointsKO-Adjacents,292
Annona_bullata,10,1,9,Points-PointsKO-Adjacents,80
Annona_burchellii,3,3,0,Points-PointsKO-Adjacents,26
Annona_cacans,655,577,78,Alphahull-PointsKO-Adjacents,15814
Annona_calcarata,12,7,5,Points-PointsKO-Adjacents,97
Annona_centrantha,32,13,19,Points-PointsKO-Adjacents,254
Annona_cercocarpa,8,2,6,Points-PointsKO-Adjacents,64
Annona_cherimola,537,427,110,Alphahull-PointsKO-Adjacents,7404
Annona_conica,10,7,3,Points-PointsKO-Adjacents,65
Annona_cordifolia,19,8,11,Points-PointsKO-Adjacents,138
Annona_coriacea,1022,946,76,Alphahull-PointsKO-Adjacents,39970
Annona_crassiflora,630,568,62,Alphahull-PointsKO-Adjacents,26145
Annona_crassivenia,4,4,0,Points-PointsKO-Adjacents,29
Annona_cristalensis,4,4,0,Points-PointsKO-Adjacents,31
Annona_crotonifolia,12,5,7,Points-PointsKO-Adjacents,81
Annona_cubensis,1,1,0,Points-PointsKO-Adjacents,9
Annona_cuspidata,189,125,64,Alphahull-PointsKO-Adjacents,14313
Annona_danforthii,37,18,19,Points-PointsKO-Adjacents,261
Annona_deceptrix,9,3,6,Points-PointsKO-Adjacents,76
Annona_deminuta,22,6,16,Points-PointsKO-Adjacents,158
Annona_densicoma,93,46,47,Alphahull-PointsKO-Adjacents,3537
Annona_dioica,232,170,62,Alphahull-PointsKO-Adjacents,14220
Annona_dolabripetala,642,568,74,Alphahull-PointsKO-Adjacents,7620
Annona_dolichopetala,59,44,15,Alphahull-PointsKO-Adjacents,615
Annona_dolichophylla,18,5,13,Points-PointsKO-Adjacents,149
Annona_domingensis,11,4,7,Points-PointsKO-Adjacents,80
Annona_duckei,97,76,21,Alphahull-PointsKO-Adjacents,3069
Annona_dumetorum,12,5,7,Points-PointsKO-Adjacents,73
Annona_echinata,26,4,22,Points-PointsKO-Adjacents,197
Annona_ecuadorensis,0,0,0,NA,0
Annona_edulis,46,21,25,Alphahull-PointsKO-Adjacents,607
Annona_ekmanii,2,2,0,Points-PointsKO-Adjacents,18
Annona_elliptica,3,3,0,Points-PointsKO-Adjacents,26
Annona_emarginata,812,705,107,Alphahull-PointsKO-Adjacents,32005
Annona_excellens,88,48,40,Alphahull-PointsKO-Adjacents,10497
Annona_exsucca,730,638,92,Alphahull-PointsKO-Adjacents,55453
Annona_fendleri,23,11,12,Points-PointsKO-Adjacents,186
Annona_ferruginea,1,1,0,Points-PointsKO-Adjacents,9
Annona_foetida,163,108,55,Alphahull-PointsKO-Adjacents,19084
Annona_fosteri,19,9,10,Points-PointsKO-Adjacents,132
Annona_frutescens,0,0,0,NA,0
Annona_gardneri,8,2,6,Points-PointsKO-Adjacents,57
Annona_gigantophylla,22,0,22,Points-PointsKO-Adjacents,152
Annona_glabra,1056,714,342,Alphahull-PointsKO-Adjacents,27414
Annona_glomerulifera,28,13,15,Points-PointsKO-Adjacents,199
Annona_gracilis,1,1,0,Points-PointsKO-Adjacents,7
Annona_haematantha,20,12,8,Points-PointsKO-Adjacents,156
Annona_havanensis,3,3,0,Points-PointsKO-Adjacents,25
Annona_hayesii,20,9,11,Points-PointsKO-Adjacents,53
Annona_helosioides,9,4,5,Points-PointsKO-Adjacents,40
Annona_herzogii,72,51,21,Alphahull-PointsKO-Adjacents,1971
Annona_hispida,26,7,19,Points-PointsKO-Adjacents,221
Annona_holosericea,69,55,14,Alphahull-PointsKO-Adjacents,997
Annona_humilis,4,4,0,Points-PointsKO-Adjacents,36
Annona_hypoglauca,409,334,75,Alphahull-PointsKO-Adjacents,37773
Annona_hystricoides,NA,NA,NA,NA,NA
Annona_impressivenia,85,37,48,Alphahull-PointsKO-Adjacents,511
Annona_inconformis,11,4,7,Points-PointsKO-Adjacents,63
Annona_insignis,38,14,24,Points-PointsKO-Adjacents,319
Annona_ionophylla,2,2,0,Points-PointsKO-Adjacents,18
Annona_iquitensis,3,3,0,Points-PointsKO-Adjacents,27
Annona_jahnii,144,103,41,Alphahull-PointsKO-Adjacents,5638
Annona_jamaicensis,4,4,0,Points-PointsKO-Adjacents,29
Annona_jucunda,67,42,25,Alphahull-PointsKO-Adjacents,4912
Annona_leptopetala,564,527,37,Alphahull-PointsKO-Adjacents,11422
Annona_liebmanniana,58,36,22,Alphahull-PointsKO-Adjacents,920
Annona_longipes,4,2,2,Points-PointsKO-Adjacents,23
Annona_macrocalyx,8,0,8,Points-PointsKO-Adjacents,72
Annona_macroprophyllata,72,39,33,Alphahull-PointsKO-Adjacents,2805
Annona_mammifera,7,0,7,Points-PointsKO-Adjacents,63
Annona_manabiensis,5,1,4,Points-PointsKO-Adjacents,35
Annona_maritima,34,15,19,Points-PointsKO-Adjacents,231
Annona_micrantha,0,0,0,NA,0
Annona_moaensis,1,1,0,Points-PointsKO-Adjacents,7
Annona_montana,786,562,224,Alphahull-PointsKO-Adjacents,76413
Annona_mucosa,1001,773,228,Alphahull-PointsKO-Adjacents,42092
Annona_muricata,557,408,149,Alphahull-PointsKO-Adjacents,22144
Annona_neglecta,87,57,30,Alphahull-PointsKO-Adjacents,1596
Annona_neoamazonica,6,0,6,Points-PointsKO-Adjacents,32
Annona_neochrysocarpa,27,13,14,Points-PointsKO-Adjacents,189
Annona_neoecuadoarensis,8,4,4,Points-PointsKO-Adjacents,63
Annona_neoelliptica,7,3,4,Points-PointsKO-Adjacents,42
Annona_neoinsignis,77,35,42,Alphahull-PointsKO-Adjacents,882
Annona_neosalicifolia,294,261,33,Alphahull-PointsKO-Adjacents,10267
Annona_neosericea,252,207,45,Alphahull-PointsKO-Adjacents,2276
Annona_neoulei,59,38,21,Alphahull-PointsKO-Adjacents,1251
Annona_neovelutina,7,0,7,Points-PointsKO-Adjacents,54
Annona_nipensis,1,1,0,Points-PointsKO-Adjacents,9
Annona_nutans,206,176,30,Alphahull-PointsKO-Adjacents,9954
Annona_oblongifolia,0,0,0,NA,0
Annona_oligocarpa,44,32,12,Alphahull-PointsKO-Adjacents,1070
Annona_pachyantha,9,6,3,Points-PointsKO-Adjacents,43
Annona_palmeri,10,2,8,Points-PointsKO-Adjacents,60
Annona_paludosa,190,130,60,Alphahull-PointsKO-Adjacents,8096
Annona_papilionella,344,267,77,Alphahull-PointsKO-Adjacents,17181
Annona_paraensis,1,1,0,Points-PointsKO-Adjacents,9
Annona_parviflora,0,0,0,NA,0
Annona_pickelii,107,0,107,Points-PointsKO-Adjacents,459
Annona_pittieri,65,57,8,Alphahull-PointsKO-Adjacents,334
Annona_poeppigii,2,2,0,Points-PointsKO-Adjacents,18
Annona_praetermissa,3,3,0,Points-PointsKO-Adjacents,19
Annona_prevostiae,10,4,6,Points-PointsKO-Adjacents,67
Annona_punicifolia,7,2,5,Points-PointsKO-Adjacents,54
Annona_purpurea,332,246,86,Alphahull-PointsKO-Adjacents,10169
Annona_quinduensis,92,76,16,Alphahull-PointsKO-Adjacents,1083
Annona_rensoniana,227,172,55,Alphahull-PointsKO-Adjacents,2728
Annona_reticulata,552,450,102,Alphahull-PointsKO-Adjacents,11767
Annona_rigida,4,4,0,Points-PointsKO-Adjacents,36
Annona_rosei,14,8,6,Points-PointsKO-Adjacents,93
Annona_rufinervis,5,5,0,Points-PointsKO-Adjacents,45
Annona_rugulosa,265,234,31,Alphahull-PointsKO-Adjacents,4440
Annona_salicifolia,1,1,0,Points-PointsKO-Adjacents,7
Annona_salzmannii,181,131,50,Alphahull-PointsKO-Adjacents,1557
Annona_scandens,25,8,17,Points-PointsKO-Adjacents,200
Annona_schunkei,23,8,15,Points-PointsKO-Adjacents,170
Annona_scleroderma,63,42,21,Alphahull-PointsKO-Adjacents,1130
Annona_sclerophylla,7,2,5,Points-PointsKO-Adjacents,36
Annona_senegalensis,1102,946,156,Alphahull-PointsKO-Adjacents,36624
Annona_sericea,205,135,70,Alphahull-PointsKO-Adjacents,21608
Annona_spinescens,82,0,82,Points-PointsKO-Adjacents,543
Annona_spraguei,73,51,22,Alphahull-PointsKO-Adjacents,832
Annona_squamosa,340,243,97,Alphahull-PointsKO-Adjacents,7447
Annona_sylvatica,1104,1011,93,Alphahull-PointsKO-Adjacents,24250
Annona_symphyocarpa,74,57,17,Alphahull-PointsKO-Adjacents,1543
Annona_tenuiflora,37,9,28,Points-PointsKO-Adjacents,295
Annona_tenuipes,30,23,7,Alphahull-PointsKO-Adjacents,373
Annona_trinitensis,81,32,49,Alphahull-PointsKO-Adjacents,1187
Annona_ubatubensis,5,0,5,Points-PointsKO-Adjacents,42
Annona_urbaniana,3,3,0,Points-PointsKO-Adjacents,27
Annona_vepretorum,132,110,22,Alphahull-PointsKO-Adjacents,2901
Annona_williamsii,55,35,20,Alphahull-PointsKO-Adjacents,2551
Anodopetalum_biglandulosum,1040,1018,22,Alphahull-PointsKO-Adjacents,941
Anogeissus_acuminata,16,2,14,Points-PointsKO-Adjacents,144
Anogeissus_bentii,6,1,5,Points-PointsKO-Adjacents,54
Anogeissus_dhofarica,33,25,8,Alphahull-PointsKO-Adjacents,79
Anogeissus_latifolia,10,1,9,Points-PointsKO-Adjacents,89
Anogeissus_leiocarpa,1729,1646,83,Alphahull-PointsKO-Adjacents,18139
Anogeissus_pendula,3,3,0,Points-PointsKO-Adjacents,27
Anogeissus_rivularis,0,0,0,NA,0
Anogeissus_sericea,1,1,0,Points-PointsKO-Adjacents,9
Anomospermum_grandifolium,32,5,27,Points-PointsKO-Adjacents,261
Anomospermum_reticulatum,209,115,94,Alphahull-PointsKO-Adjacents,6417
Anonidium_floribundum,22,17,5,Points-PointsKO-Adjacents,154
Anonidium_le-testui,1,1,0,Points-PointsKO-Adjacents,9
Anonidium_mannii,174,138,36,Alphahull-PointsKO-Adjacents,5750
Anonidium_usambarense,2,2,0,Points-PointsKO-Adjacents,18
Anopyxis_klaineana,57,36,21,Alphahull-PointsKO-Adjacents,1908
Anteremanthus_hatschbachii,11,6,5,Points-PointsKO-Adjacents,54
Antheroporum_glaucum,5,0,5,Points-PointsKO-Adjacents,45
Antheroporum_harmandii,2,2,0,Points-PointsKO-Adjacents,18
Antheroporum_pierrei,6,1,5,Points-PointsKO-Adjacents,48
Antherostele_banahaensis,1,1,0,Points-PointsKO-Adjacents,9
Antherostele_callophylla,0,0,0,NA,0
Antherostele_grandistipula,0,0,0,NA,0
Anthocarpa_nitidula,0,0,0,NA,0
Anthocleista_amplexicaulis,49,32,17,Alphahull-PointsKO-Adjacents,703
Anthocleista_djalonensis,208,178,30,Alphahull-PointsKO-Adjacents,6057
Anthocleista_grandiflora,123,70,53,Alphahull-PointsKO-Adjacents,1476
Anthocleista_inermis,0,0,0,NA,0
Anthocleista_liebrechtsiana,51,1,50,Points-PointsKO-Adjacents,392
Anthocleista_longifolia,75,49,26,Alphahull-PointsKO-Adjacents,476
Anthocleista_madagascariensis,170,144,26,Alphahull-PointsKO-Adjacents,2519
Anthocleista_microphylla,15,4,11,Points-PointsKO-Adjacents,42
Anthocleista_nobilis,100,75,25,Alphahull-PointsKO-Adjacents,2833
Anthocleista_obanensis,16,6,10,Points-PointsKO-Adjacents,120
Anthocleista_procera,21,11,10,Points-PointsKO-Adjacents,140
Anthocleista_scandens,33,17,16,Points-PointsKO-Adjacents,120
Anthocleista_schweinfurthii,128,72,56,Alphahull-PointsKO-Adjacents,6021
Anthocleista_vogelii,269,207,62,Alphahull-PointsKO-Adjacents,3584
Anthodiscus_amazonicus,66,25,41,Alphahull-PointsKO-Adjacents,1788
Anthodiscus_chocoensis,53,32,21,Alphahull-PointsKO-Adjacents,571
Anthodiscus_fragrans,0,0,0,NA,0
Anthodiscus_klugii,47,26,21,Alphahull-PointsKO-Adjacents,1527
Anthodiscus_mazarunensis,48,31,17,Alphahull-PointsKO-Adjacents,833
Anthodiscus_montanus,3,2,1,Points-PointsKO-Adjacents,27
Anthodiscus_obovatus,64,42,22,Alphahull-PointsKO-Adjacents,5309
Anthodiscus_peruanus,35,16,19,Points-PointsKO-Adjacents,271
Anthodiscus_trifoliatus,6,3,3,Points-PointsKO-Adjacents,31
Anthodon_decussatum,124,50,74,Alphahull-PointsKO-Adjacents,2172
Anthonotha_acuminata,39,17,22,Points-PointsKO-Adjacents,257
Anthonotha_brieyi,5,5,0,Points-PointsKO-Adjacents,41
Anthonotha_cladantha,20,0,20,Points-PointsKO-Adjacents,156
Anthonotha_crassifolia,114,76,38,Alphahull-PointsKO-Adjacents,6075
Anthonotha_ferruginea,20,6,14,Points-PointsKO-Adjacents,146
Anthonotha_fragrans,165,120,45,Alphahull-PointsKO-Adjacents,5179
Anthonotha_gilletii,42,25,17,Alphahull-PointsKO-Adjacents,4336
Anthonotha_lamprophylla,44,30,14,Alphahull-PointsKO-Adjacents,378
Anthonotha_lebrunii,1,1,0,Points-PointsKO-Adjacents,9
Anthonotha_leptorrhachis,12,5,7,Points-PointsKO-Adjacents,87
Anthonotha_macrophylla,716,642,74,Alphahull-PointsKO-Adjacents,21861
Anthonotha_nigerica,2,2,0,Points-PointsKO-Adjacents,17
Anthonotha_noldeae,13,3,10,Points-PointsKO-Adjacents,97
Anthonotha_pellegrinii,4,4,0,Points-PointsKO-Adjacents,32
Anthonotha_pynaertii,89,46,43,Alphahull-PointsKO-Adjacents,4783
Anthonotha_sassandraensis,2,2,0,Points-PointsKO-Adjacents,18
Anthonotha_stipulacea,33,22,11,Alphahull-PointsKO-Adjacents,344
Anthonotha_trunciflora,23,14,9,Points-PointsKO-Adjacents,131
Anthopterus_racemosus,0,0,0,NA,0
Anthopterus_wardii,101,85,16,Alphahull-PointsKO-Adjacents,1122
Anthostema_aubryanum,61,31,30,Alphahull-PointsKO-Adjacents,519
Anthostema_madagascariense,86,53,33,Alphahull-PointsKO-Adjacents,1685
Anthostema_senegalense,72,41,31,Alphahull-PointsKO-Adjacents,3790
Antiaris_toxicaria,968,772,196,Alphahull-PointsKO-Adjacents,11810
Antiaropsis_decipiens,36,0,36,Points-PointsKO-Adjacents,203
Antiaropsis_uniflora,1,1,0,Points-PointsKO-Adjacents,9
Antidesma_acidum,61,26,35,Alphahull-PointsKO-Adjacents,6245
Antidesma_alexiteria,4,4,0,Points-PointsKO-Adjacents,23
Antidesma_baccatum,19,6,13,Points-PointsKO-Adjacents,120
Antidesma_brachybotrys,3,3,0,Points-PointsKO-Adjacents,21
Antidesma_brevipes,NA,NA,NA,NA,NA
Antidesma_bunius,152,71,81,Alphahull-PointsKO-Adjacents,2090
Antidesma_catanduanense,0,0,0,NA,0
Antidesma_celebicum,5,0,5,Points-PointsKO-Adjacents,43
Antidesma_chalaranthum,6,3,3,Points-PointsKO-Adjacents,36
Antidesma_chonmon,0,0,0,NA,0
Antidesma_cochinchinense,2,2,0,Points-PointsKO-Adjacents,13
Antidesma_contractum,26,7,19,Points-PointsKO-Adjacents,129
Antidesma_coriaceum,16,0,16,Points-PointsKO-Adjacents,135
Antidesma_costulatum,4,4,0,Points-PointsKO-Adjacents,36
Antidesma_cruciforme,1,1,0,Points-PointsKO-Adjacents,9
Antidesma_curranii,1,1,0,Points-PointsKO-Adjacents,9
Antidesma_cuspidatum,28,8,20,Points-PointsKO-Adjacents,197
Antidesma_dallachyanum,3,3,0,Points-PointsKO-Adjacents,24
Antidesma_digitaliforme,5,5,0,Points-PointsKO-Adjacents,35
Antidesma_edule,1,1,0,Points-PointsKO-Adjacents,9
Antidesma_elassophyllum,1,1,0,Points-PointsKO-Adjacents,9
Antidesma_elbertii,5,5,0,Points-PointsKO-Adjacents,43
Antidesma_erostre,176,151,25,Alphahull-PointsKO-Adjacents,581
Antidesma_excavatum,319,245,74,Alphahull-PointsKO-Adjacents,4714
Antidesma_ferrugineum,1,1,0,Points-PointsKO-Adjacents,9
Antidesma_forbesii,2,2,0,Points-PointsKO-Adjacents,18
Antidesma_fordii,49,26,23,Alphahull-PointsKO-Adjacents,1556
Antidesma_ghaesembilla,384,286,98,Alphahull-PointsKO-Adjacents,18165
Antidesma_gillespieanum,0,0,0,NA,0
Antidesma_hainanense,5,5,0,Points-PointsKO-Adjacents,45
Antidesma_helferi,7,2,5,Points-PointsKO-Adjacents,54
Antidesma_heterophyllum,1,1,0,Points-PointsKO-Adjacents,8
Antidesma_insulare,0,0,0,NA,0
Antidesma_japonicum,362,257,105,Alphahull-PointsKO-Adjacents,12853
Antidesma_jayasuriyae,NA,NA,NA,NA,NA
Antidesma_jucundum,9,0,9,Points-PointsKO-Adjacents,23
Antidesma_keralense,NA,NA,NA,NA,NA
Antidesma_khasianum,0,0,0,NA,0
Antidesma_kunstleri,0,0,0,NA,0
Antidesma_laciniatum,266,206,60,Alphahull-PointsKO-Adjacents,8400
Antidesma_laurifolium,0,0,0,NA,0
Antidesma_leucocladon,4,4,0,Points-PointsKO-Adjacents,36
Antidesma_leucopodum,54,34,20,Alphahull-PointsKO-Adjacents,3804
Antidesma_macgregorii,2,2,0,Points-PointsKO-Adjacents,10
Antidesma_maclurei,5,1,4,Points-PointsKO-Adjacents,36
Antidesma_madagascariense,387,350,37,Alphahull-PointsKO-Adjacents,6458
Antidesma_membranaceum,373,262,111,Alphahull-PointsKO-Adjacents,15380
Antidesma_messianianum,6,1,5,Points-PointsKO-Adjacents,40
Antidesma_microcarpum,6,0,6,Points-PointsKO-Adjacents,51
Antidesma_minus,2,2,0,Points-PointsKO-Adjacents,18
Antidesma_montanum,264,130,134,Alphahull-PointsKO-Adjacents,19034
Antidesma_montis-silam,0,0,0,NA,0
Antidesma_myriocarpum,23,15,8,Points-PointsKO-Adjacents,109
Antidesma_neurocarpum,102,68,34,Alphahull-PointsKO-Adjacents,3525
Antidesma_nienkui,0,0,0,NA,0
Antidesma_oblongum,41,25,16,Alphahull-PointsKO-Adjacents,862
Antidesma_orthogyne,4,4,0,Points-PointsKO-Adjacents,35
Antidesma_pachybotryum,1,1,0,Points-PointsKO-Adjacents,9
Antidesma_pachystachys,0,0,0,NA,0
Antidesma_pacificum,0,0,0,NA,0
Antidesma_pahangense,0,0,0,NA,0
Antidesma_pendulum,4,4,0,Points-PointsKO-Adjacents,36
Antidesma_petiolatum,10,4,6,Points-PointsKO-Adjacents,64
Antidesma_platyphyllum,24,12,12,Points-PointsKO-Adjacents,122
Antidesma_pleuricum,7,0,7,Points-PointsKO-Adjacents,24
Antidesma_polystylum,1,1,0,Points-PointsKO-Adjacents,9
Antidesma_pulvinatum,11,2,9,Points-PointsKO-Adjacents,66
Antidesma_puncticulatum,10,0,10,Points-PointsKO-Adjacents,78
Antidesma_pyrifolium,1,1,0,Points-PointsKO-Adjacents,9
Antidesma_rhynchophyllum,20,0,20,Points-PointsKO-Adjacents,109
Antidesma_riparium,7,0,7,Points-PointsKO-Adjacents,45
Antidesma_rufescens,68,17,51,Points-PointsKO-Adjacents,556
Antidesma_sootepense,16,7,9,Points-PointsKO-Adjacents,144
Antidesma_spatulifolium,4,4,0,Points-PointsKO-Adjacents,27
Antidesma_stipulare,38,10,28,Points-PointsKO-Adjacents,271
Antidesma_subcordatum,3,3,0,Points-PointsKO-Adjacents,25
Antidesma_tetrandrum,3,0,3,Points-PointsKO-Adjacents,27
Antidesma_tomentosum,67,24,43,Alphahull-PointsKO-Adjacents,2900
Antidesma_trichophyllum,0,0,0,NA,0
Antidesma_vaccinioides,2,2,0,Points-PointsKO-Adjacents,12
Antidesma_velutinosum,46,0,46,Points-PointsKO-Adjacents,318
Antidesma_velutinum,14,1,13,Points-PointsKO-Adjacents,120
Antidesma_venenosum,18,10,8,Points-PointsKO-Adjacents,139
Antidesma_venosum,715,540,175,Alphahull-PointsKO-Adjacents,36042
Antidesma_vogelianum,46,8,38,Points-PointsKO-Adjacents,344
Antirhea_affinis,0,0,0,NA,0
Antirhea_anodon,2,2,0,Points-PointsKO-Adjacents,17
Antirhea_atropurpurea,0,0,0,NA,0
Antirhea_attenuata,0,0,0,NA,0
Antirhea_bifida,0,0,0,NA,0
Antirhea_bombysia,0,0,0,NA,0
Antirhea_borbonica,82,54,28,Alphahull-PointsKO-Adjacents,570
Antirhea_caudata,0,0,0,NA,0
Antirhea_chinensis,8,3,5,Points-PointsKO-Adjacents,63
Antirhea_hexasperma,4,4,0,Points-PointsKO-Adjacents,35
Antirhea_inaequalis,0,0,0,NA,0
Antirhea_inconspicua,2,2,0,Points-PointsKO-Adjacents,8
Antirhea_ioensis,0,0,0,NA,0
Antirhea_livida,0,0,0,NA,0
Antirhea_madagascariensis,47,30,17,Alphahull-PointsKO-Adjacents,215
Antirhea_megacarpa,16,8,8,Points-PointsKO-Adjacents,103
Antirhea_multiflora,4,0,4,Points-PointsKO-Adjacents,20
Antirhea_novobritanniensis,4,4,0,Points-PointsKO-Adjacents,17
Antirhea_ovatifolia,84,71,13,Alphahull-PointsKO-Adjacents,779
Antirhea_putaminosa,71,48,23,Alphahull-PointsKO-Adjacents,474
Antirhea_rhamnoides,5,5,0,Points-PointsKO-Adjacents,42
Antirhea_schmutzii,0,0,0,NA,0
Antirhea_smithii,0,0,0,NA,0
Antirhea_tenuiflora,1,1,0,Points-PointsKO-Adjacents,9
Antonia_ovata,991,905,86,Alphahull-PointsKO-Adjacents,38270
Antrocaryon_amazonicum,54,17,37,Points-PointsKO-Adjacents,435
Antrocaryon_klaineanum,31,16,15,Points-PointsKO-Adjacents,199
Antrocaryon_micraster,69,39,30,Alphahull-PointsKO-Adjacents,2123
Antrocaryon_nannanii,35,14,21,Points-PointsKO-Adjacents,273
Antrocaryon_schorkopfii,9,4,5,Points-PointsKO-Adjacents,71
Aoranthe_cladantha,170,128,42,Alphahull-PointsKO-Adjacents,9073
Aoranthe_nalaensis,33,8,25,Points-PointsKO-Adjacents,269
Aparisthmium_cordatum,1787,1626,161,Alphahull-PointsKO-Adjacents,92301
Apeiba_albiflora,183,104,79,Alphahull-PointsKO-Adjacents,9055
Apeiba_discolor,NA,NA,NA,NA,NA
Apeiba_glabra,478,377,101,Alphahull-PointsKO-Adjacents,35948
Apeiba_intermedia,3,3,0,Points-PointsKO-Adjacents,18
Apeiba_macropetala,218,163,55,Alphahull-PointsKO-Adjacents,29607
Apeiba_membranacea,776,679,97,Alphahull-PointsKO-Adjacents,26070
Apeiba_petoumo,113,96,17,Alphahull-PointsKO-Adjacents,8543
Apeiba_schomburgkii,105,55,50,Alphahull-PointsKO-Adjacents,4812
Apeiba_tibourbou,2170,1922,248,Alphahull-PointsKO-Adjacents,106528
Apeiba_uittienii,18,9,9,Points-PointsKO-Adjacents,141
Apetahia_margaretae,4,4,0,Points-PointsKO-Adjacents,4
Aphanamixis_borneensis,16,0,16,Points-PointsKO-Adjacents,114
Aphanamixis_polystachya,160,73,87,Alphahull-PointsKO-Adjacents,8005
Aphanamixis_sumatrana,3,3,0,Points-PointsKO-Adjacents,27
Aphananthe_aspera,395,173,222,Alphahull-PointsKO-Adjacents,1803
Aphananthe_cuspidata,9,0,9,Points-PointsKO-Adjacents,80
Aphananthe_monoica,418,358,60,Alphahull-PointsKO-Adjacents,6661
Aphananthe_philippinensis,625,555,70,Alphahull-PointsKO-Adjacents,2108
Aphananthe_sakalava,38,19,19,Points-PointsKO-Adjacents,266
Aphandra_natalia,92,74,18,Alphahull-PointsKO-Adjacents,1484
Aphanocalyx_cynometroides,53,31,22,Alphahull-PointsKO-Adjacents,1268
Aphanocalyx_djumaensis,40,26,14,Alphahull-PointsKO-Adjacents,246
Aphanocalyx_hedinii,6,1,5,Points-PointsKO-Adjacents,37
Aphanocalyx_heitzii,59,47,12,Alphahull-PointsKO-Adjacents,812
Aphanocalyx_jenseniae,3,3,0,Points-PointsKO-Adjacents,27
Aphanocalyx_ledermannii,20,5,15,Points-PointsKO-Adjacents,144
Aphanocalyx_libellula,1,1,0,Points-PointsKO-Adjacents,9
Aphanocalyx_margininervatus,50,31,19,Alphahull-PointsKO-Adjacents,836
Aphanocalyx_microphyllus,138,109,29,Alphahull-PointsKO-Adjacents,3905
Aphanocalyx_obscurus,15,6,9,Points-PointsKO-Adjacents,124
Aphanocalyx_pectinatus,6,0,6,Points-PointsKO-Adjacents,50
Aphanocalyx_pteridophyllus,25,1,24,Points-PointsKO-Adjacents,155
Aphanocalyx_richardsiae,39,14,25,Points-PointsKO-Adjacents,235
Aphanocalyx_trapnellii,9,5,4,Points-PointsKO-Adjacents,57
Aphelandra_acanthifolia,34,21,13,Alphahull-PointsKO-Adjacents,376
Aphelandra_acanthus,60,46,14,Alphahull-PointsKO-Adjacents,436
Aphelandra_castanifolia,21,11,10,Points-PointsKO-Adjacents,136
Aphelandra_crispata,44,30,14,Alphahull-PointsKO-Adjacents,485
Aphelandra_formosa,18,0,18,Points-PointsKO-Adjacents,134
Aphelandra_gunnarii,NA,NA,NA,NA,NA
Aphelandra_hartwegiana,46,36,10,Alphahull-PointsKO-Adjacents,1075
Aphelandra_macrophylla,22,11,11,Points-PointsKO-Adjacents,158
Aphelandra_mildbraediana,2,2,0,Points-PointsKO-Adjacents,15
Aphelandra_parvispica,23,13,10,Points-PointsKO-Adjacents,163
Aphelandra_pharangophila,9,4,5,Points-PointsKO-Adjacents,52
Aphelandra_porphyrocarpa,3,3,0,Points-PointsKO-Adjacents,27
Aphelandra_pulcherrima,200,129,71,Alphahull-PointsKO-Adjacents,12871
Aphelandra_taborensis,1,1,0,Points-PointsKO-Adjacents,9
Aphloia_theiformis,512,426,86,Alphahull-PointsKO-Adjacents,5748
Apiopetalum_glabratum,2,2,0,Points-PointsKO-Adjacents,18
Apiopetalum_velutinum,12,4,8,Points-PointsKO-Adjacents,39
Apodiscus_chevalieri,7,3,4,Points-PointsKO-Adjacents,24
Apodocephala_angustifolia,18,7,11,Points-PointsKO-Adjacents,99
Apodocephala_begueana,6,1,5,Points-PointsKO-Adjacents,36
Apodocephala_coursii,1,1,0,Points-PointsKO-Adjacents,9
Apodocephala_multiflora,6,0,6,Points-PointsKO-Adjacents,39
Apodocephala_oliganthoides,10,0,10,Points-PointsKO-Adjacents,62
Apodocephala_pauciflora,86,68,18,Alphahull-PointsKO-Adjacents,481
Apodocephala_urschiana,6,1,5,Points-PointsKO-Adjacents,38
Apodytes_abbottii,13,8,5,Points-PointsKO-Adjacents,33
Apodytes_bebile,9,3,6,Points-PointsKO-Adjacents,43
Apodytes_brachystylis,177,155,22,Alphahull-PointsKO-Adjacents,341
Apodytes_clusiifolia,23,13,10,Points-PointsKO-Adjacents,108
Apodytes_dimidiata,599,424,175,Alphahull-PointsKO-Adjacents,24319
Apodytes_geldenhuysii,6,0,6,Points-PointsKO-Adjacents,32
Apodytes_grandifolia,10,1,9,Points-PointsKO-Adjacents,80
Apodytes_thouvenotii,8,3,5,Points-PointsKO-Adjacents,39
Apollonias_arnottii,0,0,0,NA,0
Apollonias_barbujana,111,4,107,Points-PointsKO-Adjacents,148
Apophyllum_anomalum,1061,1029,32,Alphahull-PointsKO-Adjacents,12711
Apoplanesia_cryptopetala,5,5,0,Points-PointsKO-Adjacents,45
Apoplanesia_paniculata,372,291,81,Alphahull-PointsKO-Adjacents,4521
Aporosa_acuminata,0,0,0,NA,0
Aporosa_alia,2,2,0,Points-PointsKO-Adjacents,18
Aporosa_annulata,2,2,0,Points-PointsKO-Adjacents,18
Aporosa_antennifera,6,1,5,Points-PointsKO-Adjacents,54
Aporosa_arborea,2,0,2,Points-PointsKO-Adjacents,18
Aporosa_aurea,19,9,10,Points-PointsKO-Adjacents,134
Aporosa_banahaensis,5,5,0,Points-PointsKO-Adjacents,34
Aporosa_basilanensis,5,5,0,Points-PointsKO-Adjacents,44
Aporosa_benthamiana,12,1,11,Points-PointsKO-Adjacents,89
Aporosa_bourdillonii,0,0,0,NA,0
Aporosa_brassii,7,1,6,Points-PointsKO-Adjacents,63
Aporosa_brevicaudata,5,5,0,Points-PointsKO-Adjacents,37
Aporosa_bullatissima,1,1,0,Points-PointsKO-Adjacents,9
Aporosa_caloneura,4,4,0,Points-PointsKO-Adjacents,36
Aporosa_cardiosperma,2,0,2,Points-PointsKO-Adjacents,18
Aporosa_carrii,5,0,5,Points-PointsKO-Adjacents,39
Aporosa_chondroneura,7,1,6,Points-PointsKO-Adjacents,61
Aporosa_confusa,14,2,12,Points-PointsKO-Adjacents,120
Aporosa_decipiens,0,0,0,NA,0
Aporosa_dendroidea,2,2,0,Points-PointsKO-Adjacents,15
Aporosa_duthieana,0,0,0,NA,0
Aporosa_egregia,1,1,0,Points-PointsKO-Adjacents,9
Aporosa_elmeri,6,1,5,Points-PointsKO-Adjacents,45
Aporosa_falcifera,12,1,11,Points-PointsKO-Adjacents,93
Aporosa_ficifolia,2,0,2,Points-PointsKO-Adjacents,18
Aporosa_frutescens,24,5,19,Points-PointsKO-Adjacents,186
Aporosa_fulvovittata,0,0,0,NA,0
Aporosa_fusiformis,1,1,0,Points-PointsKO-Adjacents,9
Aporosa_globifera,4,4,0,Points-PointsKO-Adjacents,27
Aporosa_grandistipula,15,0,15,Points-PointsKO-Adjacents,123
Aporosa_granularis,15,5,10,Points-PointsKO-Adjacents,117
Aporosa_hermaphrodita,5,5,0,Points-PointsKO-Adjacents,34
Aporosa_heterodoxa,0,0,0,NA,0
Aporosa_illustris,3,3,0,Points-PointsKO-Adjacents,27
Aporosa_lagenocarpa,4,4,0,Points-PointsKO-Adjacents,27
Aporosa_lamellata,2,2,0,Points-PointsKO-Adjacents,18
Aporosa_lanceolata,1,1,0,Points-PointsKO-Adjacents,9
Aporosa_latifolia,0,0,0,NA,0
Aporosa_laxiflora,8,0,8,Points-PointsKO-Adjacents,56
Aporosa_ledermanniana,4,4,0,Points-PointsKO-Adjacents,32
Aporosa_leptochrysandra,5,5,0,Points-PointsKO-Adjacents,30
Aporosa_leytensis,1,1,0,Points-PointsKO-Adjacents,9
Aporosa_longicaudata,0,0,0,NA,0
Aporosa_lucida,27,7,20,Points-PointsKO-Adjacents,212
Aporosa_lunata,16,2,14,Points-PointsKO-Adjacents,128
Aporosa_macrophylla,0,0,0,NA,0
Aporosa_maingayi,2,2,0,Points-PointsKO-Adjacents,18
Aporosa_microstachya,17,9,8,Points-PointsKO-Adjacents,91
Aporosa_misimana,3,3,0,Points-PointsKO-Adjacents,22
Aporosa_nervosa,10,0,10,Points-PointsKO-Adjacents,84
Aporosa_nigricans,6,2,4,Points-PointsKO-Adjacents,45
Aporosa_nigropunctata,5,5,0,Points-PointsKO-Adjacents,42
Aporosa_nitida,27,17,10,Points-PointsKO-Adjacents,200
Aporosa_octandra,69,0,69,Points-PointsKO-Adjacents,487
Aporosa_papuana,16,7,9,Points-PointsKO-Adjacents,111
Aporosa_parvula,2,2,0,Points-PointsKO-Adjacents,18
Aporosa_penangensis,2,2,0,Points-PointsKO-Adjacents,18
Aporosa_planchoniana,3,3,0,Points-PointsKO-Adjacents,18
Aporosa_praegrandifolia,1,1,0,Points-PointsKO-Adjacents,9
Aporosa_prainiana,20,7,13,Points-PointsKO-Adjacents,146
Aporosa_pseudoficifolia,1,1,0,Points-PointsKO-Adjacents,9
Aporosa_quadrilocularis,1,1,0,Points-PointsKO-Adjacents,9
Aporosa_reticulata,2,2,0,Points-PointsKO-Adjacents,12
Aporosa_rhacostyla,2,2,0,Points-PointsKO-Adjacents,18
Aporosa_sarawakensis,16,6,10,Points-PointsKO-Adjacents,121
Aporosa_sclerophylla,3,3,0,Points-PointsKO-Adjacents,27
Aporosa_selangorica,1,1,0,Points-PointsKO-Adjacents,9
Aporosa_serrata,5,5,0,Points-PointsKO-Adjacents,33
Aporosa_sphaeridiophora,4,0,4,Points-PointsKO-Adjacents,30
Aporosa_stellifera,2,2,0,Points-PointsKO-Adjacents,18
Aporosa_stenostachys,2,2,0,Points-PointsKO-Adjacents,18
Aporosa_subcaudata,22,10,12,Points-PointsKO-Adjacents,174
Aporosa_sylvestri,0,0,0,NA,0
Aporosa_symplocifolia,4,4,0,Points-PointsKO-Adjacents,33
Aporosa_symplocoides,7,0,7,Points-PointsKO-Adjacents,54
Aporosa_tetrapleura,4,0,4,Points-PointsKO-Adjacents,32
Aporosa_vagans,7,2,5,Points-PointsKO-Adjacents,54
Aporosa_villosa,28,10,18,Points-PointsKO-Adjacents,222
Aporosa_wallichii,8,0,8,Points-PointsKO-Adjacents,70
Aporosa_whitmorei,0,0,0,NA,0
Aporosa_yunnanensis,10,1,9,Points-PointsKO-Adjacents,90
Aporrhiza_lastoursvillensis,5,2,3,Points-PointsKO-Adjacents,41
Aporrhiza_le-testui,2,2,0,Points-PointsKO-Adjacents,18
Aporrhiza_paniculata,29,8,21,Points-PointsKO-Adjacents,231
Aporrhiza_talbotii,16,11,5,Points-PointsKO-Adjacents,138
Aporrhiza_tessmannii,0,0,0,NA,0
Aporrhiza_urophylla,59,32,27,Alphahull-PointsKO-Adjacents,1322
Appunia_aurantiaca,5,5,0,Points-PointsKO-Adjacents,45
Appunia_brachycalyx,31,16,15,Points-PointsKO-Adjacents,244
Appunia_debilis,16,10,6,Points-PointsKO-Adjacents,117
Appunia_guatemalensis,100,66,34,Alphahull-PointsKO-Adjacents,1359
Appunia_surinamensis,5,5,0,Points-PointsKO-Adjacents,43
Appunia_tenuiflora,185,156,29,Alphahull-PointsKO-Adjacents,8647
Appunia_triphylla,9,1,8,Points-PointsKO-Adjacents,75
Appunia_venezuelensis,4,4,0,Points-PointsKO-Adjacents,36
Aptandra_caudata,11,6,5,Points-PointsKO-Adjacents,83
Aptandra_liriosmoides,62,27,35,Alphahull-PointsKO-Adjacents,3332
Aptandra_tubicina,305,227,78,Alphahull-PointsKO-Adjacents,28041
Aptandra_zenkeri,127,85,42,Alphahull-PointsKO-Adjacents,4326
Apterokarpos_gardneri,97,78,19,Alphahull-PointsKO-Adjacents,2392
Apterosperma_oblata,1,1,0,Points-PointsKO-Adjacents,9
Apuleia_leiocarpa,1551,1163,388,Alphahull-PointsKO-Adjacents,78856
Apurimacia_boliviana,2,2,0,Points-PointsKO-Adjacents,12
Aquilaria_apiculata,0,0,0,NA,0
Aquilaria_baillonii,0,0,0,NA,0
Aquilaria_banaense,NA,NA,NA,NA,NA
Aquilaria_beccariana,6,0,6,Points-PointsKO-Adjacents,53
Aquilaria_brachyantha,2,2,0,Points-PointsKO-Adjacents,16
Aquilaria_citrinicarpa,2,2,0,Points-PointsKO-Adjacents,12
Aquilaria_crassna,0,0,0,NA,0
Aquilaria_cumingiana,18,5,13,Points-PointsKO-Adjacents,116
Aquilaria_decemcostata,NA,NA,NA,NA,NA
Aquilaria_filaria,10,6,4,Points-PointsKO-Adjacents,55
Aquilaria_hirta,0,0,0,NA,0
Aquilaria_khasiana,0,0,0,NA,0
Aquilaria_malaccensis,8,0,8,Points-PointsKO-Adjacents,72
Aquilaria_microcarpa,3,3,0,Points-PointsKO-Adjacents,27
Aquilaria_parvifolia,0,0,0,NA,0
Aquilaria_rostrata,0,0,0,NA,0
Aquilaria_rugosa,1,1,0,Points-PointsKO-Adjacents,9
Aquilaria_sinensis,21,8,13,Points-PointsKO-Adjacents,185
Aquilaria_subintegra,0,0,0,NA,0
Aquilaria_urdanetensis,3,3,0,Points-PointsKO-Adjacents,21
Aquilaria_yunnanensis,0,0,0,NA,0
Arachnothryx_aspera,40,34,6,Alphahull-PointsKO-Adjacents,61
Arachnothryx_atravesadensis,0,0,0,NA,0
Arachnothryx_bertieroides,135,109,26,Alphahull-PointsKO-Adjacents,701
Arachnothryx_brenesii,35,27,8,Alphahull-PointsKO-Adjacents,129
Arachnothryx_buddleioides,592,539,53,Alphahull-PointsKO-Adjacents,4822
Arachnothryx_calycophylla,5,5,0,Points-PointsKO-Adjacents,39
Arachnothryx_calycosa,28,21,7,Alphahull-PointsKO-Adjacents,86
Arachnothryx_capitellata,162,119,43,Alphahull-PointsKO-Adjacents,1081
Arachnothryx_caucana,1,1,0,Points-PointsKO-Adjacents,9
Arachnothryx_chaconii,14,9,5,Points-PointsKO-Adjacents,45
Arachnothryx_chiapensis,13,5,8,Points-PointsKO-Adjacents,48
Arachnothryx_chimalaparum,1,1,0,Points-PointsKO-Adjacents,9
Arachnothryx_chimboracensis,12,8,4,Points-PointsKO-Adjacents,44
Arachnothryx_chiriquiana,8,3,5,Points-PointsKO-Adjacents,44
Arachnothryx_colombiana,43,28,15,Alphahull-PointsKO-Adjacents,270
Arachnothryx_costanensis,1,1,0,Points-PointsKO-Adjacents,9
Arachnothryx_costaricensis,57,43,14,Alphahull-PointsKO-Adjacents,158
Arachnothryx_cupreiflora,6,0,6,Points-PointsKO-Adjacents,54
Arachnothryx_darienensis,4,3,1,Points-PointsKO-Adjacents,34
Arachnothryx_discolor,11,7,4,Points-PointsKO-Adjacents,80
Arachnothryx_dwyeri,15,9,6,Points-PointsKO-Adjacents,66
Arachnothryx_educta,3,3,0,Points-PointsKO-Adjacents,27
Arachnothryx_euryphylla,8,2,6,Points-PointsKO-Adjacents,39
Arachnothryx_evansii,6,2,4,Points-PointsKO-Adjacents,24
Arachnothryx_galeottii,63,52,11,Alphahull-PointsKO-Adjacents,290
Arachnothryx_gonzaleoides,21,11,10,Points-PointsKO-Adjacents,136
Arachnothryx_gracilis,21,8,13,Points-PointsKO-Adjacents,153
Arachnothryx_gracilispica,18,12,6,Points-PointsKO-Adjacents,77
Arachnothryx_guerrerensis,6,2,4,Points-PointsKO-Adjacents,48
Arachnothryx_guettardioides,1,1,0,Points-PointsKO-Adjacents,9
Arachnothryx_heteranthera,53,38,15,Alphahull-PointsKO-Adjacents,424
Arachnothryx_hondurensis,15,10,5,Points-PointsKO-Adjacents,118
Arachnothryx_izabalensis,10,1,9,Points-PointsKO-Adjacents,72
Arachnothryx_jurgensenii,46,18,28,Points-PointsKO-Adjacents,300
Arachnothryx_laniflora,99,81,18,Alphahull-PointsKO-Adjacents,1455
Arachnothryx_latiloba,NA,NA,NA,NA,NA
Arachnothryx_lineolata,1,1,0,Points-PointsKO-Adjacents,9
Arachnothryx_linguiformis,26,17,9,Points-PointsKO-Adjacents,121
Arachnothryx_macrocalyx,5,5,0,Points-PointsKO-Adjacents,45
Arachnothryx_manantlanensis,25,1,24,Points-PointsKO-Adjacents,63
Arachnothryx_megalantha,0,0,0,NA,0
Arachnothryx_monteverdensis,59,50,9,Alphahull-PointsKO-Adjacents,66
Arachnothryx_monticola,NA,NA,NA,NA,NA
Arachnothryx_myriantha,4,4,0,Points-PointsKO-Adjacents,30
Arachnothryx_nebulosa,33,25,8,Alphahull-PointsKO-Adjacents,403
Arachnothryx_nelsonii,2,2,0,Points-PointsKO-Adjacents,18
Arachnothryx_nitida,27,16,11,Points-PointsKO-Adjacents,117
Arachnothryx_ovandensis,13,5,8,Points-PointsKO-Adjacents,80
Arachnothryx_pauciflora,NA,NA,NA,NA,NA
Arachnothryx_perezii,8,3,5,Points-PointsKO-Adjacents,49
Arachnothryx_peruviana,7,0,7,Points-PointsKO-Adjacents,57
Arachnothryx_povedae,14,8,6,Points-PointsKO-Adjacents,55
Arachnothryx_purpurea,7,3,4,Points-PointsKO-Adjacents,39
Arachnothryx_pyramidalis,39,32,7,Alphahull-PointsKO-Adjacents,217
Arachnothryx_reflexa,150,119,31,Alphahull-PointsKO-Adjacents,3301
Arachnothryx_rekoi,2,2,0,Points-PointsKO-Adjacents,18
Arachnothryx_rubens,3,3,0,Points-PointsKO-Adjacents,27
Arachnothryx_rufescens,34,24,10,Alphahull-PointsKO-Adjacents,288
Arachnothryx_rzedowskii,NA,NA,NA,NA,NA
Arachnothryx_sanchezii,NA,NA,NA,NA,NA
Arachnothryx_scabra,38,27,11,Alphahull-PointsKO-Adjacents,424
Arachnothryx_secundiflora,32,16,16,Points-PointsKO-Adjacents,210
Arachnothryx_septicidalis,8,0,8,Points-PointsKO-Adjacents,53
Arachnothryx_sinaloae,NA,NA,NA,NA,NA
Arachnothryx_skutchii,4,4,0,Points-PointsKO-Adjacents,33
Arachnothryx_sousae,1,1,0,Points-PointsKO-Adjacents,9
Arachnothryx_spectabilis,37,30,7,Alphahull-PointsKO-Adjacents,364
Arachnothryx_stachyoidea,102,88,14,Alphahull-PointsKO-Adjacents,1257
Arachnothryx_tacanensis,26,0,26,Points-PointsKO-Adjacents,89
Arachnothryx_tayloriae,10,3,7,Points-PointsKO-Adjacents,42
Arachnothryx_tenorioi,1,1,0,Points-PointsKO-Adjacents,9
Arachnothryx_thiemei,23,14,9,Points-PointsKO-Adjacents,123
Arachnothryx_torresii,70,56,14,Alphahull-PointsKO-Adjacents,208
Arachnothryx_tuxtlensis,20,0,20,Points-PointsKO-Adjacents,77
Arachnothryx_uxpanapensis,9,0,9,Points-PointsKO-Adjacents,56
Arachnothryx_villosa,41,32,9,Alphahull-PointsKO-Adjacents,564
Arachnothryx_wendtii,5,5,0,Points-PointsKO-Adjacents,31
Aralia_armata,39,15,24,Points-PointsKO-Adjacents,315
Aralia_bahiana,21,9,12,Points-PointsKO-Adjacents,171
Aralia_bipinnata,98,73,25,Alphahull-PointsKO-Adjacents,310
Aralia_caesia,9,1,8,Points-PointsKO-Adjacents,81
Aralia_castanopsiscola,10,6,4,Points-PointsKO-Adjacents,61
Aralia_chinensis,99,71,28,Alphahull-PointsKO-Adjacents,12936
Aralia_dasyphylla,69,39,30,Alphahull-PointsKO-Adjacents,4541
Aralia_delavayi,2,2,0,Points-PointsKO-Adjacents,18
Aralia_echinocaulis,36,14,22,Points-PointsKO-Adjacents,321
Aralia_elata,404,219,185,Alphahull-PointsKO-Adjacents,7261
Aralia_excelsa,184,117,67,Alphahull-PointsKO-Adjacents,4850
Aralia_ferox,1,1,0,Points-PointsKO-Adjacents,9
Aralia_finlaysoniana,10,3,7,Points-PointsKO-Adjacents,90
Aralia_foliolosa,9,0,9,Points-PointsKO-Adjacents,66
Aralia_frodiniana,0,0,0,NA,0
Aralia_gigantea,8,0,8,Points-PointsKO-Adjacents,59
Aralia_gintungensis,9,1,8,Points-PointsKO-Adjacents,52
Aralia_glabrifoliolata,1,1,0,Points-PointsKO-Adjacents,9
Aralia_hiepiana,3,3,0,Points-PointsKO-Adjacents,21
Aralia_humilis,295,242,53,Alphahull-PointsKO-Adjacents,4705
Aralia_leschenaultii,35,0,35,Points-PointsKO-Adjacents,276
Aralia_malabarica,0,0,0,NA,0
Aralia_montana,2,2,0,Points-PointsKO-Adjacents,18
Aralia_officinalis,2,2,0,Points-PointsKO-Adjacents,18
Aralia_plumosa,6,3,3,Points-PointsKO-Adjacents,54
Aralia_regeliana,20,8,12,Points-PointsKO-Adjacents,121
Aralia_rex,4,4,0,Points-PointsKO-Adjacents,36
Aralia_scopulorum,60,0,60,Points-PointsKO-Adjacents,216
Aralia_searelliana,6,0,6,Points-PointsKO-Adjacents,54
Aralia_soratensis,97,67,30,Alphahull-PointsKO-Adjacents,2476
Aralia_spinosa,1145,890,255,Alphahull-PointsKO-Adjacents,23621
Aralia_stellata,1,1,0,Points-PointsKO-Adjacents,9
Aralia_stipulata,9,1,8,Points-PointsKO-Adjacents,81
Aralia_subcordata,3,3,0,Points-PointsKO-Adjacents,27
Aralia_thomsonii,16,0,16,Points-PointsKO-Adjacents,138
Aralia_tomentella,22,0,22,Points-PointsKO-Adjacents,198
Aralia_undulata,18,4,14,Points-PointsKO-Adjacents,145
Aralia_verticillata,3,3,0,Points-PointsKO-Adjacents,27
Aralia_vietnamensis,14,4,10,Points-PointsKO-Adjacents,122
Aralia_warmingiana,303,248,55,Alphahull-PointsKO-Adjacents,16407
Aralia_wilsonii,9,5,4,Points-PointsKO-Adjacents,81
Aralidium_pinnatifidum,29,6,23,Points-PointsKO-Adjacents,186
Arapatiella_emarginata,20,9,11,Points-PointsKO-Adjacents,110
Arapatiella_psilophylla,97,83,14,Alphahull-PointsKO-Adjacents,653
Araucaria_angustifolia,140,0,140,Points-PointsKO-Adjacents,931
Araucaria_araucana,82,77,5,Alphahull-PointsKO-Adjacents,472
Araucaria_bernieri,38,26,12,Alphahull-PointsKO-Adjacents,79
Araucaria_bidwillii,131,85,46,Alphahull-PointsKO-Adjacents,1161
Araucaria_biramulata,24,13,11,Points-PointsKO-Adjacents,100
Araucaria_columnaris,41,31,10,Alphahull-PointsKO-Adjacents,184
Araucaria_cunninghamii,609,0,609,Points-PointsKO-Adjacents,1310
Araucaria_heterophylla,3,1,2,Points-PointsKO-Adjacents,3
Araucaria_humboldtensis,23,18,5,Points-PointsKO-Adjacents,47
Araucaria_hunsteinii,19,15,4,Points-PointsKO-Adjacents,86
Araucaria_luxurians,19,8,11,Points-PointsKO-Adjacents,93
Araucaria_montana,70,53,17,Alphahull-PointsKO-Adjacents,149
Araucaria_nemorosa,7,3,4,Points-PointsKO-Adjacents,20
Araucaria_rulei,35,23,12,Alphahull-PointsKO-Adjacents,101
Araucaria_schmidii,4,4,0,Points-PointsKO-Adjacents,14
Araucaria_scopulorum,18,10,8,Points-PointsKO-Adjacents,63
Araucaria_subulata,32,25,7,Alphahull-PointsKO-Adjacents,56
Arboa_antsingyae,1,1,0,Points-PointsKO-Adjacents,9
Arboa_integrifolia,27,10,17,Points-PointsKO-Adjacents,171
Arbutus_andrachne,352,301,51,Alphahull-PointsKO-Adjacents,3003
Arbutus_arizonica,277,253,24,Alphahull-PointsKO-Adjacents,5362
Arbutus_canariensis,19,0,19,Points-PointsKO-Adjacents,56
Arbutus_madrensis,6,3,3,Points-PointsKO-Adjacents,54
Arbutus_menziesii,2434,2216,218,Alphahull-PointsKO-Adjacents,4698
Arbutus_tessellata,180,165,15,Alphahull-PointsKO-Adjacents,4032
Arbutus_unedo,9445,8704,741,Alphahull-PointsKO-Adjacents,20123
Arbutus_xalapensis,1564,1482,82,Alphahull-PointsKO-Adjacents,14114
Archidendron_alternifoliolatum,1,1,0,Points-PointsKO-Adjacents,9
Archidendron_apoense,3,3,0,Points-PointsKO-Adjacents,12
Archidendron_arborescens,6,1,5,Points-PointsKO-Adjacents,45
Archidendron_aruense,27,14,13,Points-PointsKO-Adjacents,176
Archidendron_balansae,4,4,0,Points-PointsKO-Adjacents,36
Archidendron_bauchei,0,0,0,NA,0
Archidendron_beguinii,3,3,0,Points-PointsKO-Adjacents,14
Archidendron_bellum,4,4,0,Points-PointsKO-Adjacents,36
Archidendron_bigeminum,2,0,2,Points-PointsKO-Adjacents,18
Archidendron_borneense,7,0,7,Points-PointsKO-Adjacents,48
Archidendron_brachycarpum,NA,NA,NA,NA,NA
Archidendron_brevicalyx,NA,NA,NA,NA,NA
Archidendron_brevipes,3,3,0,Points-PointsKO-Adjacents,18
Archidendron_bubalinum,8,5,3,Points-PointsKO-Adjacents,66
Archidendron_calliandrum,5,0,5,Points-PointsKO-Adjacents,27
Archidendron_calycinum,1,1,0,Points-PointsKO-Adjacents,9
Archidendron_chevalieri,8,2,6,Points-PointsKO-Adjacents,59
Archidendron_clypearia,253,134,119,Alphahull-PointsKO-Adjacents,12558
Archidendron_cockburnii,6,0,6,Points-PointsKO-Adjacents,50
Archidendron_conspicuum,NA,NA,NA,NA,NA
Archidendron_contortum,3,3,0,Points-PointsKO-Adjacents,27
Archidendron_cordifolium,NA,NA,NA,NA,NA
Archidendron_crateradenum,0,0,0,NA,0
Archidendron_dalatense,0,0,0,NA,0
Archidendron_eberhardtii,1,1,0,Points-PointsKO-Adjacents,9
Archidendron_ellipticum,22,0,22,Points-PointsKO-Adjacents,177
Archidendron_fagifolium,2,2,0,Points-PointsKO-Adjacents,18
Archidendron_falcatum,0,0,0,NA,0
Archidendron_fallax,NA,NA,NA,NA,NA
Archidendron_forbesii,3,3,0,Points-PointsKO-Adjacents,12
Archidendron_glabrifolium,1,1,0,Points-PointsKO-Adjacents,9
Archidendron_glabrum,34,22,12,Alphahull-PointsKO-Adjacents,137
Archidendron_glandulosum,7,1,6,Points-PointsKO-Adjacents,45
Archidendron_globosum,2,2,0,Points-PointsKO-Adjacents,18
Archidendron_glomeriflorum,6,2,4,Points-PointsKO-Adjacents,45
Archidendron_gogolense,1,1,0,Points-PointsKO-Adjacents,9
Archidendron_grandiflorum,415,357,58,Alphahull-PointsKO-Adjacents,1458
Archidendron_harmsii,0,0,0,NA,0
Archidendron_havilandii,8,1,7,Points-PointsKO-Adjacents,71
Archidendron_hendersonii,192,160,32,Alphahull-PointsKO-Adjacents,415
Archidendron_hirsutum,63,48,15,Alphahull-PointsKO-Adjacents,533
Archidendron_hispidum,3,3,0,Points-PointsKO-Adjacents,27
Archidendron_hooglandii,0,0,0,NA,0
Archidendron_jiringa,19,4,15,Points-PointsKO-Adjacents,144
Archidendron_kalkmanii,3,3,0,Points-PointsKO-Adjacents,18
Archidendron_kerrii,12,2,10,Points-PointsKO-Adjacents,96
Archidendron_kunstleri,1,1,0,Points-PointsKO-Adjacents,9
Archidendron_laoticum,0,0,0,NA,0
Archidendron_lovelliae,24,17,7,Points-PointsKO-Adjacents,50
Archidendron_lucidum,225,162,63,Alphahull-PointsKO-Adjacents,4658
Archidendron_lucyi,85,0,85,Points-PointsKO-Adjacents,379
Archidendron_megaphyllum,3,3,0,Points-PointsKO-Adjacents,27
Archidendron_merrillii,2,2,0,Points-PointsKO-Adjacents,18
Archidendron_microcarpum,17,0,17,Points-PointsKO-Adjacents,110
Archidendron_minahassae,0,0,0,NA,0
Archidendron_molle,7,0,7,Points-PointsKO-Adjacents,47
Archidendron_monopterum,NA,NA,NA,NA,NA
Archidendron_mucronatum,NA,NA,NA,NA,NA
Archidendron_muellerianum,240,0,240,Points-PointsKO-Adjacents,113
Archidendron_multifoliolatum,0,0,0,NA,0
Archidendron_muricarpum,3,3,0,Points-PointsKO-Adjacents,9
Archidendron_nervosum,4,4,0,Points-PointsKO-Adjacents,21
Archidendron_oblongum,1,1,0,Points-PointsKO-Adjacents,9
Archidendron_occultatum,3,3,0,Points-PointsKO-Adjacents,27
Archidendron_oppositum,0,0,0,NA,0
Archidendron_pachycarpum,NA,NA,NA,NA,NA
Archidendron_pahangense,NA,NA,NA,NA,NA
Archidendron_palauense,12,0,12,Points-PointsKO-Adjacents,64
Archidendron_parviflorum,30,9,21,Points-PointsKO-Adjacents,162
Archidendron_pauciflorum,6,0,6,Points-PointsKO-Adjacents,54
Archidendron_pellitum,4,4,0,Points-PointsKO-Adjacents,36
Archidendron_poilanei,0,0,0,NA,0
Archidendron_ptenopum,7,1,6,Points-PointsKO-Adjacents,40
Archidendron_quocense,3,3,0,Points-PointsKO-Adjacents,27
Archidendron_ramiflorum,53,40,13,Alphahull-PointsKO-Adjacents,128
Archidendron_robinsonii,6,1,5,Points-PointsKO-Adjacents,54
Archidendron_royenii,1,1,0,Points-PointsKO-Adjacents,6
Archidendron_rufescens,2,2,0,Points-PointsKO-Adjacents,9
Archidendron_sabahense,NA,NA,NA,NA,NA
Archidendron_scutiferum,16,6,10,Points-PointsKO-Adjacents,123
Archidendron_sessile,1,1,0,Points-PointsKO-Adjacents,8
Archidendron_syringifolium,5,5,0,Points-PointsKO-Adjacents,33
Archidendron_tenuiracemosum,2,2,0,Points-PointsKO-Adjacents,15
Archidendron_tetraphyllum,1,1,0,Points-PointsKO-Adjacents,9
Archidendron_tjendana,1,1,0,Points-PointsKO-Adjacents,9
Archidendron_tonkinense,3,2,1,Points-PointsKO-Adjacents,27
Archidendron_trichophyllum,1,1,0,Points-PointsKO-Adjacents,9
Archidendron_trifoliolatum,4,4,0,Points-PointsKO-Adjacents,9
Archidendron_triplinervium,6,2,4,Points-PointsKO-Adjacents,36
Archidendron_turgidum,21,9,12,Points-PointsKO-Adjacents,189
Archidendron_utile,9,1,8,Points-PointsKO-Adjacents,81
Archidendron_vaillantii,77,63,14,Alphahull-PointsKO-Adjacents,254
Archidendron_whitei,61,53,8,Alphahull-PointsKO-Adjacents,76
Archidendron_xichouense,2,2,0,Points-PointsKO-Adjacents,18
Archidendropsis_basaltica,144,123,21,Alphahull-PointsKO-Adjacents,5056
Archidendropsis_fournieri,5,5,0,Points-PointsKO-Adjacents,36
Archidendropsis_fulgens,3,3,0,Points-PointsKO-Adjacents,17
Archidendropsis_glandulosa,3,3,0,Points-PointsKO-Adjacents,22
Archidendropsis_granulosa,8,3,5,Points-PointsKO-Adjacents,49
Archidendropsis_lentiscifolia,3,3,0,Points-PointsKO-Adjacents,21
Archidendropsis_macradenia,2,2,0,Points-PointsKO-Adjacents,12
Archidendropsis_oblonga,2,2,0,Points-PointsKO-Adjacents,9
Archidendropsis_paivana,10,4,6,Points-PointsKO-Adjacents,65
Archidendropsis_sepikensis,2,2,0,Points-PointsKO-Adjacents,9
Archidendropsis_spicata,3,3,0,Points-PointsKO-Adjacents,23
Archidendropsis_streptocarpa,8,1,7,Points-PointsKO-Adjacents,57
Archidendropsis_thozetiana,78,59,19,Alphahull-PointsKO-Adjacents,1816
Archidendropsis_xanthoxylon,27,17,10,Points-PointsKO-Adjacents,72
Archirhodomyrtus_baladensis,11,5,6,Points-PointsKO-Adjacents,55
Archirhodomyrtus_beckleri,1146,1080,66,Alphahull-PointsKO-Adjacents,1286
Archirhodomyrtus_paitensis,23,14,9,Points-PointsKO-Adjacents,107
Archirhodomyrtus_turbinata,16,9,7,Points-PointsKO-Adjacents,57
Archirhodomyrtus_vieillardii,0,0,0,NA,0
Archontophoenix_alexandrae,122,63,59,Alphahull-PointsKO-Adjacents,756
Archontophoenix_cunninghamiana,1553,1370,183,Alphahull-PointsKO-Adjacents,1937
Archontophoenix_maxima,7,3,4,Points-PointsKO-Adjacents,31
Archontophoenix_myolensis,1,1,0,Points-PointsKO-Adjacents,9
Archontophoenix_purpurea,10,5,5,Points-PointsKO-Adjacents,41
Archontophoenix_tuckeri,19,12,7,Points-PointsKO-Adjacents,111
Archytaea_angustifolia,53,43,10,Alphahull-PointsKO-Adjacents,408
Archytaea_triflora,146,0,146,Points-PointsKO-Adjacents,838
Arcoa_gonavensis,11,6,5,Points-PointsKO-Adjacents,43
Arctostaphylos_andersonii,124,109,15,Alphahull-PointsKO-Adjacents,116
Arctostaphylos_catalinae,29,0,29,Points-PointsKO-Adjacents,19
Arctostaphylos_columbiana,560,1,559,Points-PointsKO-Adjacents,1516
Arctostaphylos_glauca,1205,0,1205,Points-PointsKO-Adjacents,1510
Arctostaphylos_hooveri,62,52,10,Alphahull-PointsKO-Adjacents,86
Arctostaphylos_insularis,53,0,53,Points-PointsKO-Adjacents,48
Arctostaphylos_nortensis,16,12,4,Points-PointsKO-Adjacents,32
Arctostaphylos_obispoensis,77,67,10,Alphahull-PointsKO-Adjacents,86
Arctostaphylos_pajaroensis,68,59,9,Alphahull-PointsKO-Adjacents,81
Arctostaphylos_pringlei,455,423,32,Alphahull-PointsKO-Adjacents,3667
Arctostaphylos_pungens,1887,1830,57,Alphahull-PointsKO-Adjacents,19982
Arctostaphylos_tomentosa,353,296,57,Alphahull-PointsKO-Adjacents,1496
Arctostaphylos_viscida,1191,1125,66,Alphahull-PointsKO-Adjacents,2768
Arctostaphylos_wellsii,7,4,3,Points-PointsKO-Adjacents,25
Arcytophyllum_nitidum,311,281,30,Alphahull-PointsKO-Adjacents,2523
Ardisia_aequilonga,2,1,1,Points-PointsKO-Adjacents,16
Ardisia_alajuelae,0,0,0,NA,0
Ardisia_albisepala,6,2,4,Points-PointsKO-Adjacents,34
Ardisia_alstonii,2,1,1,Points-PointsKO-Adjacents,16
Ardisia_amherstiana,6,1,5,Points-PointsKO-Adjacents,48
Ardisia_amplexicaulis,0,0,0,NA,0
Ardisia_anchicayana,2,2,0,Points-PointsKO-Adjacents,18
Ardisia_angucianensis,3,3,0,Points-PointsKO-Adjacents,18
Ardisia_angustata,3,3,0,Points-PointsKO-Adjacents,18
Ardisia_antonensis,15,10,5,Points-PointsKO-Adjacents,74
Ardisia_apoda,1,1,0,Points-PointsKO-Adjacents,9
Ardisia_applanata,0,0,0,NA,0
Ardisia_argentea,0,0,0,NA,0
Ardisia_attenuata,7,0,7,Points-PointsKO-Adjacents,59
Ardisia_auriculata,90,71,19,Alphahull-PointsKO-Adjacents,580
Ardisia_austin-smithii,61,36,25,Alphahull-PointsKO-Adjacents,1016
Ardisia_awarum,9,3,6,Points-PointsKO-Adjacents,57
Ardisia_bakeri,56,50,6,Alphahull-PointsKO-Adjacents,56
Ardisia_baracoensis,NA,NA,NA,NA,NA
Ardisia_bartletii,50,40,10,Alphahull-PointsKO-Adjacents,337
Ardisia_baviensis,0,0,0,NA,0
Ardisia_betongensis,0,0,0,NA,0
Ardisia_blatteri,0,0,0,NA,0
Ardisia_blepharodes,9,5,4,Points-PointsKO-Adjacents,66
Ardisia_brachypoda,2,2,0,Points-PointsKO-Adjacents,18
Ardisia_brackenridgei,0,0,0,NA,0
Ardisia_bracteosa,96,61,35,Alphahull-PointsKO-Adjacents,1679
Ardisia_breedlovei,8,3,5,Points-PointsKO-Adjacents,60
Ardisia_brenesii,52,42,10,Alphahull-PointsKO-Adjacents,149
Ardisia_brevipedata,166,139,27,Alphahull-PointsKO-Adjacents,333
Ardisia_brevis,12,4,8,Points-PointsKO-Adjacents,90
Ardisia_brittonii,NA,NA,NA,NA,NA
Ardisia_byrsonimae,0,0,0,NA,0
Ardisia_cabrerae,9,5,4,Points-PointsKO-Adjacents,35
Ardisia_calycosa,52,43,9,Alphahull-PointsKO-Adjacents,212
Ardisia_capitellata,22,15,7,Points-PointsKO-Adjacents,59
Ardisia_capuronii,6,0,6,Points-PointsKO-Adjacents,44
Ardisia_cardenasii,5,5,0,Points-PointsKO-Adjacents,18
Ardisia_cartagoana,9,5,4,Points-PointsKO-Adjacents,49
Ardisia_caudifera,5,5,0,Points-PointsKO-Adjacents,36
Ardisia_chiriquiensis,8,2,6,Points-PointsKO-Adjacents,55
Ardisia_chrysophyllifolia,1,1,0,Points-PointsKO-Adjacents,9
Ardisia_clavelligera,1,1,0,Points-PointsKO-Adjacents,9
Ardisia_cogolloi,10,7,3,Points-PointsKO-Adjacents,57
Ardisia_colombiana,16,5,11,Points-PointsKO-Adjacents,99
Ardisia_colonensis,2,0,2,Points-PointsKO-Adjacents,12
Ardisia_coloradoana,4,3,1,Points-PointsKO-Adjacents,25
Ardisia_compressa,1131,996,135,Alphahull-PointsKO-Adjacents,11117
Ardisia_conglomerata,2,1,1,Points-PointsKO-Adjacents,16
Ardisia_copelandii,9,0,9,Points-PointsKO-Adjacents,81
Ardisia_copeyana,102,86,16,Alphahull-PointsKO-Adjacents,372
Ardisia_costaricensis,184,161,23,Alphahull-PointsKO-Adjacents,1271
Ardisia_crassa,3,3,0,Points-PointsKO-Adjacents,21
Ardisia_crassipedicellata,49,42,7,Alphahull-PointsKO-Adjacents,115
Ardisia_crassipes,7,2,5,Points-PointsKO-Adjacents,46
Ardisia_crassiramea,25,18,7,Points-PointsKO-Adjacents,65
Ardisia_croatii,40,32,8,Alphahull-PointsKO-Adjacents,134
Ardisia_crosbyi,9,4,5,Points-PointsKO-Adjacents,51
Ardisia_cuneata,1,1,0,Points-PointsKO-Adjacents,9
Ardisia_curvula,1,1,0,Points-PointsKO-Adjacents,9
Ardisia_daphinifolia,1,1,0,Points-PointsKO-Adjacents,9
Ardisia_darienensis,7,1,6,Points-PointsKO-Adjacents,34
Ardisia_davidsei,7,0,7,Points-PointsKO-Adjacents,31
Ardisia_densilepidotula,6,0,6,Points-PointsKO-Adjacents,45
Ardisia_didymopora,8,2,6,Points-PointsKO-Adjacents,44
Ardisia_divergens,0,0,0,NA,0
Ardisia_dodgei,37,26,11,Alphahull-PointsKO-Adjacents,98
Ardisia_dukei,1,1,0,Points-PointsKO-Adjacents,9
Ardisia_dunlapiana,33,29,4,Alphahull-PointsKO-Adjacents,59
Ardisia_dwyeri,10,7,3,Points-PointsKO-Adjacents,24
Ardisia_eglandulosa,2,2,0,Points-PointsKO-Adjacents,18
Ardisia_elliptica,92,15,77,Points-PointsKO-Adjacents,555
Ardisia_escallonioides,554,462,92,Alphahull-PointsKO-Adjacents,6254
Ardisia_esculenta,3,3,0,Points-PointsKO-Adjacents,27
Ardisia_eugenioides,8,4,4,Points-PointsKO-Adjacents,36
Ardisia_evrardii,0,0,0,NA,0
Ardisia_eximia,3,3,0,Points-PointsKO-Adjacents,27
Ardisia_fimbrillifera,61,46,15,Alphahull-PointsKO-Adjacents,245
Ardisia_flavida,2,2,0,Points-PointsKO-Adjacents,9
Ardisia_foetida,99,77,22,Alphahull-PointsKO-Adjacents,5600
Ardisia_forbesii,30,15,15,Points-PointsKO-Adjacents,195
Ardisia_foveolata,8,4,4,Points-PointsKO-Adjacents,36
Ardisia_fruticosa,3,3,0,Points-PointsKO-Adjacents,27
Ardisia_fuertesii,9,3,6,Points-PointsKO-Adjacents,74
Ardisia_fulva,0,0,0,NA,0
Ardisia_furfuracea,18,14,4,Points-PointsKO-Adjacents,56
Ardisia_furfuracella,38,29,9,Alphahull-PointsKO-Adjacents,293
Ardisia_garcinifolia,0,0,0,NA,0
Ardisia_generalensis,4,4,0,Points-PointsKO-Adjacents,36
Ardisia_geniculata,0,0,0,NA,0
Ardisia_gigantea,2,2,0,Points-PointsKO-Adjacents,18
Ardisia_glandulosomarginata,135,125,10,Alphahull-PointsKO-Adjacents,227
Ardisia_glauciflora,14,7,7,Points-PointsKO-Adjacents,45
Ardisia_glomerata,5,3,2,Points-PointsKO-Adjacents,18
Ardisia_goodenoughii,NA,NA,NA,NA,NA
Ardisia_gordonii,5,5,0,Points-PointsKO-Adjacents,42
Ardisia_gorgonae,0,0,0,NA,0
Ardisia_gracilenta,1,1,0,Points-PointsKO-Adjacents,9
Ardisia_graciliflora,0,0,0,NA,0
Ardisia_granatensis,24,5,19,Points-PointsKO-Adjacents,176
Ardisia_grisebachiana,1,1,0,Points-PointsKO-Adjacents,9
Ardisia_guianensis,583,441,142,Alphahull-PointsKO-Adjacents,19475
Ardisia_hagenii,19,16,3,Points-PointsKO-Adjacents,71
Ardisia_herrerana,2,2,0,Points-PointsKO-Adjacents,18
Ardisia_heterotricha,3,3,0,Points-PointsKO-Adjacents,12
Ardisia_hintonii,17,7,10,Points-PointsKO-Adjacents,128
Ardisia_hosei,0,0,0,NA,0
Ardisia_huallagae,21,7,14,Points-PointsKO-Adjacents,178
Ardisia_hugonensis,1,1,0,Points-PointsKO-Adjacents,9
Ardisia_illicioides,0,0,0,NA,0
Ardisia_intibucana,2,1,1,Points-PointsKO-Adjacents,18
Ardisia_ionantha,0,0,0,NA,0
Ardisia_ixorifolia,0,0,0,NA,0
Ardisia_jamaicensis,NA,NA,NA,NA,NA
Ardisia_jefeana,16,12,4,Points-PointsKO-Adjacents,53
Ardisia_junghuhniana,0,0,0,NA,0
Ardisia_kerrii,0,0,0,NA,0
Ardisia_killipii,3,3,0,Points-PointsKO-Adjacents,24
Ardisia_knappiae,14,0,14,Points-PointsKO-Adjacents,56
Ardisia_korthalsiana,23,8,15,Points-PointsKO-Adjacents,187
Ardisia_lancifolia,10,3,7,Points-PointsKO-Adjacents,57
Ardisia_lankawiensis,NA,NA,NA,NA,NA
Ardisia_lecomtei,0,0,0,NA,0
Ardisia_liebmannii,58,39,19,Alphahull-PointsKO-Adjacents,529
Ardisia_liesneri,27,21,6,Alphahull-PointsKO-Adjacents,32
Ardisia_loretensis,24,14,10,Points-PointsKO-Adjacents,150
Ardisia_lucida,7,2,5,Points-PointsKO-Adjacents,36
Ardisia_lucidula,2,2,0,Points-PointsKO-Adjacents,18
Ardisia_lundelliana,2,2,0,Points-PointsKO-Adjacents,12
Ardisia_luquillensis,7,5,2,Points-PointsKO-Adjacents,18
Ardisia_lurida,7,1,6,Points-PointsKO-Adjacents,63
Ardisia_macrocalyx,9,0,9,Points-PointsKO-Adjacents,76
Ardisia_macrophylla,12,3,9,Points-PointsKO-Adjacents,108
Ardisia_manglillo,3,3,0,Points-PointsKO-Adjacents,26
Ardisia_manitzii,NA,NA,NA,NA,NA
Ardisia_marojejyensis,4,4,0,Points-PointsKO-Adjacents,24
Ardisia_martinensis,4,4,0,Points-PointsKO-Adjacents,32
Ardisia_maxima,0,0,0,NA,0
Ardisia_maxonii,22,11,11,Points-PointsKO-Adjacents,111
Ardisia_mcphersonii,6,3,3,Points-PointsKO-Adjacents,21
Ardisia_megistophylla,32,23,9,Alphahull-PointsKO-Adjacents,116
Ardisia_megistosepala,8,1,7,Points-PointsKO-Adjacents,49
Ardisia_mesoamericana,5,5,0,Points-PointsKO-Adjacents,34
Ardisia_mexicana,17,8,9,Points-PointsKO-Adjacents,91
Ardisia_micranthera,0,0,0,NA,0
Ardisia_missionis,1,1,0,Points-PointsKO-Adjacents,9
Ardisia_monsalveae,0,0,0,NA,0
Ardisia_montana,0,0,0,NA,0
Ardisia_multipunctata,0,0,0,NA,0
Ardisia_murtonii,4,4,0,Points-PointsKO-Adjacents,34
Ardisia_neei,1,0,1,Points-PointsKO-Adjacents,7
Ardisia_neriifolia,0,0,0,NA,0
Ardisia_nervosa,4,4,0,Points-PointsKO-Adjacents,27
Ardisia_nervosissima,8,7,1,Points-PointsKO-Adjacents,25
Ardisia_niambiensis,8,0,8,Points-PointsKO-Adjacents,53
Ardisia_nigrescens,120,95,25,Alphahull-PointsKO-Adjacents,1173
Ardisia_nigropilosa,2,2,0,Points-PointsKO-Adjacents,18
Ardisia_nigropunctata,219,188,31,Alphahull-PointsKO-Adjacents,1800
Ardisia_nigrovirens,5,0,5,Points-PointsKO-Adjacents,45
Ardisia_obovata,77,46,31,Alphahull-PointsKO-Adjacents,518
Ardisia_obovatifolia,8,2,6,Points-PointsKO-Adjacents,63
Ardisia_obscurinervia,0,0,0,NA,0
Ardisia_obtusa,7,3,4,Points-PointsKO-Adjacents,54
Ardisia_oocarpa,2,2,0,Points-PointsKO-Adjacents,18
Ardisia_opaca,8,1,7,Points-PointsKO-Adjacents,55
Ardisia_opegrapha,329,299,30,Alphahull-PointsKO-Adjacents,2032
Ardisia_ototomoensis,5,4,1,Points-PointsKO-Adjacents,37
Ardisia_oxyphylla,5,5,0,Points-PointsKO-Adjacents,45
Ardisia_pachyrhachis,117,108,9,Alphahull-PointsKO-Adjacents,262
Ardisia_pachysandra,2,1,1,Points-PointsKO-Adjacents,18
Ardisia_palmana,140,118,22,Alphahull-PointsKO-Adjacents,575
Ardisia_palustris,1,1,0,Points-PointsKO-Adjacents,6
Ardisia_panamensis,5,5,0,Points-PointsKO-Adjacents,27
Ardisia_paschalis,336,306,30,Alphahull-PointsKO-Adjacents,3324
Ardisia_pauciflora,1,1,0,Points-PointsKO-Adjacents,9
Ardisia_pellucida,153,88,65,Alphahull-PointsKO-Adjacents,2338
Ardisia_perinsignis,18,10,8,Points-PointsKO-Adjacents,116
Ardisia_picardae,6,3,3,Points-PointsKO-Adjacents,28
Ardisia_pitardii,0,0,0,NA,0
Ardisia_pleurobotrya,67,58,9,Alphahull-PointsKO-Adjacents,154
Ardisia_polyactis,3,3,0,Points-PointsKO-Adjacents,27
Ardisia_polycephala,4,4,0,Points-PointsKO-Adjacents,36
Ardisia_polysticta,349,282,67,Alphahull-PointsKO-Adjacents,7659
Ardisia_popayanensis,4,4,0,Points-PointsKO-Adjacents,33
Ardisia_praetervisa,2,2,0,Points-PointsKO-Adjacents,12
Ardisia_premontana,6,0,6,Points-PointsKO-Adjacents,52
Ardisia_procera,3,3,0,Points-PointsKO-Adjacents,18
Ardisia_pseudocuspidata,5,5,0,Points-PointsKO-Adjacents,24
Ardisia_pseudoracemiflora,2,2,0,Points-PointsKO-Adjacents,9
Ardisia_pterocaulis,18,7,11,Points-PointsKO-Adjacents,155
Ardisia_puberula,1,1,0,Points-PointsKO-Adjacents,9
Ardisia_pubicalyx,2,2,0,Points-PointsKO-Adjacents,18
Ardisia_pulverulenta,2,2,0,Points-PointsKO-Adjacents,18
Ardisia_purpurea,21,2,19,Points-PointsKO-Adjacents,184
Ardisia_quangnamensis,1,1,0,Points-PointsKO-Adjacents,9
Ardisia_quinquegona,402,323,79,Alphahull-PointsKO-Adjacents,5985
Ardisia_ravida,1,1,0,Points-PointsKO-Adjacents,9
Ardisia_reflexiflora,5,5,0,Points-PointsKO-Adjacents,38
Ardisia_revoluta,595,507,88,Alphahull-PointsKO-Adjacents,9754
Ardisia_rhodochroa,0,0,0,NA,0
Ardisia_rhomboidea,0,0,0,NA,0
Ardisia_ridleyi,4,4,0,Points-PointsKO-Adjacents,36
Ardisia_rigidifolia,15,6,9,Points-PointsKO-Adjacents,69
Ardisia_rosea,5,5,0,Points-PointsKO-Adjacents,39
Ardisia_ruedae,4,4,0,Points-PointsKO-Adjacents,35
Ardisia_sanmartensis,3,3,0,Points-PointsKO-Adjacents,25
Ardisia_sapida,8,3,5,Points-PointsKO-Adjacents,62
Ardisia_scheryi,13,6,7,Points-PointsKO-Adjacents,67
Ardisia_schippii,10,3,7,Points-PointsKO-Adjacents,87
Ardisia_scortechinii,0,0,0,NA,0
Ardisia_serrata,16,1,15,Points-PointsKO-Adjacents,122
Ardisia_sessilis,0,0,0,NA,0
Ardisia_sieboldii,471,403,68,Alphahull-PointsKO-Adjacents,584
Ardisia_smurfitana,2,2,0,Points-PointsKO-Adjacents,15
Ardisia_solanacea,25,6,19,Points-PointsKO-Adjacents,195
Ardisia_solida,0,0,0,NA,0
Ardisia_sonchifolia,0,0,0,NA,0
Ardisia_staminosa,43,0,43,Points-PointsKO-Adjacents,246
Ardisia_standleyana,139,123,16,Alphahull-PointsKO-Adjacents,1517
Ardisia_staudtii,91,62,29,Alphahull-PointsKO-Adjacents,4301
Ardisia_storkii,1,1,0,Points-PointsKO-Adjacents,9
Ardisia_subcrenulata,8,2,6,Points-PointsKO-Adjacents,70
Ardisia_subsessilifolia,12,5,7,Points-PointsKO-Adjacents,63
Ardisia_sumatrana,3,3,0,Points-PointsKO-Adjacents,22
Ardisia_tarariae,13,11,2,Points-PointsKO-Adjacents,27
Ardisia_tenuis,9,5,4,Points-PointsKO-Adjacents,27
Ardisia_teysmanniana,1,1,0,Points-PointsKO-Adjacents,9
Ardisia_thyrsiflora,51,0,51,Points-PointsKO-Adjacents,456
Ardisia_tomentosa,5,5,0,Points-PointsKO-Adjacents,26
Ardisia_tortuguerensis,2,2,0,Points-PointsKO-Adjacents,11
Ardisia_tuberculata,0,0,0,NA,0
Ardisia_tuerckheimii,112,88,24,Alphahull-PointsKO-Adjacents,1208
Ardisia_tysonii,12,6,6,Points-PointsKO-Adjacents,42
Ardisia_unguiensis,11,5,6,Points-PointsKO-Adjacents,60
Ardisia_urbanii,1,1,0,Points-PointsKO-Adjacents,9
Ardisia_ursina,16,8,8,Points-PointsKO-Adjacents,54
Ardisia_vatteri,8,3,5,Points-PointsKO-Adjacents,48
Ardisia_venosa,138,97,41,Alphahull-PointsKO-Adjacents,1766
Ardisia_venosissima,94,44,50,Alphahull-PointsKO-Adjacents,466
Ardisia_verapazensis,111,91,20,Alphahull-PointsKO-Adjacents,1277
Ardisia_verdisepala,2,2,0,Points-PointsKO-Adjacents,18
Ardisia_vesca,4,3,1,Points-PointsKO-Adjacents,25
Ardisia_viburnifolia,0,0,0,NA,0
Ardisia_waitakii,5,5,0,Points-PointsKO-Adjacents,45
Ardisia_wallichii,0,0,0,NA,0
Ardisia_weberbaueri,90,57,33,Alphahull-PointsKO-Adjacents,5204
Ardisia_websteri,9,5,4,Points-PointsKO-Adjacents,33
Ardisia_wedelii,61,46,15,Alphahull-PointsKO-Adjacents,701
Ardisia_whitei,5,5,0,Points-PointsKO-Adjacents,38
Ardisia_woodsonii,7,1,6,Points-PointsKO-Adjacents,31
Areca_andersonii,0,0,0,NA,0
Areca_caliso,3,3,0,Points-PointsKO-Adjacents,27
Areca_catechu,0,0,0,NA,0
Areca_chaiana,0,0,0,NA,0
Areca_concinna,2,1,1,Points-PointsKO-Adjacents,18
Areca_hutchinsoniana,1,1,0,Points-PointsKO-Adjacents,9
Areca_ipot,0,0,0,NA,0
Areca_laosensis,5,5,0,Points-PointsKO-Adjacents,43
Areca_macrocalyx,53,21,32,Alphahull-PointsKO-Adjacents,2251
Areca_mandacanii,0,0,0,NA,0
Areca_montana,0,0,0,NA,0
Areca_novohibernica,13,1,12,Points-PointsKO-Adjacents,90
Areca_oxycarpa,2,2,0,Points-PointsKO-Adjacents,12
Areca_parens,NA,NA,NA,NA,NA
Areca_triandra,56,0,56,Points-PointsKO-Adjacents,416
Areca_tunku,1,1,0,Points-PointsKO-Adjacents,9
Areca_vestiaria,16,5,11,Points-PointsKO-Adjacents,98
Areca_whitfordii,1,1,0,Points-PointsKO-Adjacents,9
Arenga_australasica,66,40,26,Alphahull-PointsKO-Adjacents,505
Arenga_brevipes,4,4,0,Points-PointsKO-Adjacents,27
Arenga_engleri,31,19,12,Points-PointsKO-Adjacents,134
Arenga_hookeriana,3,3,0,Points-PointsKO-Adjacents,25
Arenga_listeri,5,4,1,Points-PointsKO-Adjacents,7
Arenga_micrantha,0,0,0,NA,0
Arenga_microcarpa,74,54,20,Alphahull-PointsKO-Adjacents,588
Arenga_obtusifolia,2,2,0,Points-PointsKO-Adjacents,18
Arenga_pinnata,5,0,5,Points-PointsKO-Adjacents,36
Arenga_tremula,0,0,0,NA,0
Arenga_westerhoutii,26,0,26,Points-PointsKO-Adjacents,217
Arenga_wightii,1,1,0,Points-PointsKO-Adjacents,9
Arfeuillea_arborescens,3,2,1,Points-PointsKO-Adjacents,27
Argocoffeopsis_eketensis,84,33,51,Alphahull-PointsKO-Adjacents,4469
Argocoffeopsis_lemblinii,2,2,0,Points-PointsKO-Adjacents,12
Argomuellera_lancifolia,1,1,0,Points-PointsKO-Adjacents,9
Argomuellera_macrophylla,195,136,59,Alphahull-PointsKO-Adjacents,3770
Argomuellera_perrieri,15,6,9,Points-PointsKO-Adjacents,77
Argomuellera_pierlotiana,6,2,4,Points-PointsKO-Adjacents,27
Argomuellera_sessilifolia,0,0,0,NA,0
Argyreia_roxburghii,3,3,0,Points-PointsKO-Adjacents,27
Argyrocytisus_battandieri,35,27,8,Alphahull-PointsKO-Adjacents,192
Argythamnia_candicans,63,26,37,Alphahull-PointsKO-Adjacents,695
Arillastrum_gummiferum,41,34,7,Alphahull-PointsKO-Adjacents,81
Aripuana_cullmaniorum,2,2,0,Points-PointsKO-Adjacents,18
Aristeguietia_arborea,9,5,4,Points-PointsKO-Adjacents,68
Aristeguietia_discolor,14,8,6,Points-PointsKO-Adjacents,90
Aristogeitonia_gabonica,2,2,0,Points-PointsKO-Adjacents,9
Aristogeitonia_limoniifolia,1,1,0,Points-PointsKO-Adjacents,9
Aristogeitonia_lophirifolia,8,3,5,Points-PointsKO-Adjacents,44
Aristogeitonia_monophylla,22,11,11,Points-PointsKO-Adjacents,118
Aristogeitonia_perrieri,4,4,0,Points-PointsKO-Adjacents,36
Aristogeitonia_uapacifolia,1,1,0,Points-PointsKO-Adjacents,7
Aristolochia_arborea,27,22,5,Alphahull-PointsKO-Adjacents,118
Aristolochia_tagala,42,0,42,Points-PointsKO-Adjacents,343
Aristolochia_tricaudata,7,0,7,Points-PointsKO-Adjacents,53
Aristotelia_chilensis,31,14,17,Points-PointsKO-Adjacents,257
Aristotelia_gaultheria,50,34,16,Alphahull-PointsKO-Adjacents,440
Aristotelia_serrata,5831,5747,84,Alphahull-PointsKO-Adjacents,4514
Armatocereus_ghiesbreghtii,0,0,0,NA,0
Armatocereus_godingianus,11,6,5,Points-PointsKO-Adjacents,44
Armatocereus_laetus,1,1,0,Points-PointsKO-Adjacents,9
Armatocereus_matucanensis,2,2,0,Points-PointsKO-Adjacents,18
Armatocereus_procerus,1,1,0,Points-PointsKO-Adjacents,9
Armatocereus_rauhii,0,0,0,NA,0
Armeniaca_dasycarpa,NA,NA,NA,NA,NA
Armeniaca_hongpingensis,1,1,0,Points-PointsKO-Adjacents,9
Armeniaca_limeixing,NA,NA,NA,NA,NA
Artabotrys_brachypetalus,90,54,36,Alphahull-PointsKO-Adjacents,6010
Artabotrys_hexapetalus,25,0,25,Points-PointsKO-Adjacents,215
Artabotrys_macrophyllus,1,1,0,Points-PointsKO-Adjacents,9
Artabotrys_monteiroae,122,61,61,Alphahull-PointsKO-Adjacents,2420
Artabotrys_parkinsonii,NA,NA,NA,NA,NA
Artemisia_tridentata,13920,13766,154,Alphahull-PointsKO-Adjacents,39791
Artocarpus_albobrunneus,0,0,0,NA,0
Artocarpus_altilis,59,0,59,Points-PointsKO-Adjacents,337
Artocarpus_altissimus,1,1,0,Points-PointsKO-Adjacents,9
Artocarpus_anisophyllus,17,8,9,Points-PointsKO-Adjacents,114
Artocarpus_annulatus,0,0,0,NA,0
Artocarpus_avatifolius,NA,NA,NA,NA,NA
Artocarpus_blancoi,0,0,0,NA,0
Artocarpus_brevipedunculatus,12,4,8,Points-PointsKO-Adjacents,99
Artocarpus_camansi,3,3,0,Points-PointsKO-Adjacents,27
Artocarpus_chama,5,0,5,Points-PointsKO-Adjacents,43
Artocarpus_corneri,8,0,8,Points-PointsKO-Adjacents,62
Artocarpus_dadah,19,3,16,Points-PointsKO-Adjacents,157
Artocarpus_elasticus,20,5,15,Points-PointsKO-Adjacents,166
Artocarpus_excelsus,3,3,0,Points-PointsKO-Adjacents,21
Artocarpus_fretessii,19,0,19,Points-PointsKO-Adjacents,157
Artocarpus_fulvicortex,1,1,0,Points-PointsKO-Adjacents,9
Artocarpus_glaucus,6,0,6,Points-PointsKO-Adjacents,54
Artocarpus_gomezianus,7,1,6,Points-PointsKO-Adjacents,54
Artocarpus_gongshanensis,2,2,0,Points-PointsKO-Adjacents,18
Artocarpus_heterophyllus,11,0,11,Points-PointsKO-Adjacents,78
Artocarpus_hirsutus,0,0,0,NA,0
Artocarpus_hispidus,3,3,0,Points-PointsKO-Adjacents,18
Artocarpus_horridus,2,2,0,Points-PointsKO-Adjacents,18
Artocarpus_hypargyreus,46,22,24,Alphahull-PointsKO-Adjacents,1607
Artocarpus_integer,44,17,27,Points-PointsKO-Adjacents,351
Artocarpus_jarrettiae,8,0,8,Points-PointsKO-Adjacents,62
Artocarpus_kemando,21,7,14,Points-PointsKO-Adjacents,165
Artocarpus_lacucha,7,0,7,Points-PointsKO-Adjacents,63
Artocarpus_lanceifolius,14,4,10,Points-PointsKO-Adjacents,120
Artocarpus_longifolius,2,2,0,Points-PointsKO-Adjacents,18
Artocarpus_lowii,2,2,0,Points-PointsKO-Adjacents,18
Artocarpus_maingayi,0,0,0,NA,0
Artocarpus_mariannensis,0,0,0,NA,0
Artocarpus_multifidus,0,0,0,NA,0
Artocarpus_nanchuanensis,NA,NA,NA,NA,NA
Artocarpus_nigrifolius,1,1,0,Points-PointsKO-Adjacents,9
Artocarpus_nitidus,71,23,48,Alphahull-PointsKO-Adjacents,660
Artocarpus_nobilis,2,1,1,Points-PointsKO-Adjacents,18
Artocarpus_obtusus,0,0,0,NA,0
Artocarpus_odoratissimus,25,10,15,Points-PointsKO-Adjacents,192
Artocarpus_ovatus,6,1,5,Points-PointsKO-Adjacents,52
Artocarpus_palembanicus,NA,NA,NA,NA,NA
Artocarpus_petelotii,5,5,0,Points-PointsKO-Adjacents,44
Artocarpus_pinnatisectus,0,0,0,NA,0
Artocarpus_pithecogallus,1,1,0,Points-PointsKO-Adjacents,9
Artocarpus_primackii,7,3,4,Points-PointsKO-Adjacents,61
Artocarpus_reticulatus,3,3,0,Points-PointsKO-Adjacents,23
Artocarpus_rigidus,22,8,14,Points-PointsKO-Adjacents,188
Artocarpus_rubrovenius,2,2,0,Points-PointsKO-Adjacents,18
Artocarpus_sarawakensis,1,1,0,Points-PointsKO-Adjacents,9
Artocarpus_scortechinii,1,0,1,Points-PointsKO-Adjacents,9
Artocarpus_sepicanus,7,1,6,Points-PointsKO-Adjacents,50
Artocarpus_sericicarpus,6,0,6,Points-PointsKO-Adjacents,47
Artocarpus_subrotundifolius,0,0,0,NA,0
Artocarpus_sumatranus,9,0,9,Points-PointsKO-Adjacents,72
Artocarpus_tamaran,8,4,4,Points-PointsKO-Adjacents,70
Artocarpus_teysmannii,11,0,11,Points-PointsKO-Adjacents,74
Artocarpus_thailandicus,0,0,0,NA,0
Artocarpus_tomentosulus,7,2,5,Points-PointsKO-Adjacents,61
Artocarpus_tonkinensis,28,10,18,Points-PointsKO-Adjacents,243
Artocarpus_treculianus,1,1,0,Points-PointsKO-Adjacents,8
Artocarpus_vriesianus,34,0,34,Points-PointsKO-Adjacents,239
Artocarpus_xanthocarpus,13,1,12,Points-PointsKO-Adjacents,96
Arytera_arcuata,37,26,11,Alphahull-PointsKO-Adjacents,212
Arytera_bifoliata,NA,NA,NA,NA,NA
Arytera_bifoliolata,93,59,34,Alphahull-PointsKO-Adjacents,711
Arytera_brachyphylla,2,2,0,Points-PointsKO-Adjacents,12
Arytera_brackenridgei,38,15,23,Points-PointsKO-Adjacents,179
Arytera_chartacea,33,24,9,Alphahull-PointsKO-Adjacents,212
Arytera_collina,25,15,10,Points-PointsKO-Adjacents,74
Arytera_densiflora,7,0,7,Points-PointsKO-Adjacents,43
Arytera_dictyoneura,27,16,11,Points-PointsKO-Adjacents,79
Arytera_distylis,252,231,21,Alphahull-PointsKO-Adjacents,334
Arytera_divaricata,628,563,65,Alphahull-PointsKO-Adjacents,2165
Arytera_foveolata,69,57,12,Alphahull-PointsKO-Adjacents,492
Arytera_gracilipes,18,8,10,Points-PointsKO-Adjacents,82
Arytera_lepidota,20,13,7,Points-PointsKO-Adjacents,74
Arytera_lineosquamulata,2,2,0,Points-PointsKO-Adjacents,9
Arytera_littoralis,132,39,93,Alphahull-PointsKO-Adjacents,1629
Arytera_microphylla,58,46,12,Alphahull-PointsKO-Adjacents,246
Arytera_miniata,5,5,0,Points-PointsKO-Adjacents,18
Arytera_morobeana,4,3,1,Points-PointsKO-Adjacents,21
Arytera_multijuga,3,3,0,Points-PointsKO-Adjacents,27
Arytera_musca,5,5,0,Points-PointsKO-Adjacents,35
Arytera_nekorensis,6,3,3,Points-PointsKO-Adjacents,19
Arytera_neoebudensis,22,11,11,Points-PointsKO-Adjacents,112
Arytera_novaebrittanniae,2,2,0,Points-PointsKO-Adjacents,18
Arytera_pauciflora,108,97,11,Alphahull-PointsKO-Adjacents,178
Arytera_pseudofoveolata,3,3,0,Points-PointsKO-Adjacents,27
Ascarina_diffusa,8,1,7,Points-PointsKO-Adjacents,56
Ascarina_lucida,1564,1503,61,Alphahull-PointsKO-Adjacents,1914
Ascarina_maheshwarii,6,0,6,Points-PointsKO-Adjacents,27
Ascarina_marquesensis,4,4,0,Points-PointsKO-Adjacents,23
Ascarina_philippinensis,61,26,35,Alphahull-PointsKO-Adjacents,558
Ascarina_polystachya,13,7,6,Points-PointsKO-Adjacents,28
Ascarina_rubricaulis,44,32,12,Alphahull-PointsKO-Adjacents,117
Ascarina_solmsiana,20,9,11,Points-PointsKO-Adjacents,61
Ascarina_subfalcata,5,5,0,Points-PointsKO-Adjacents,7
Ascarina_swamyana,2,2,0,Points-PointsKO-Adjacents,14
Ashtonia_excelsa,7,4,3,Points-PointsKO-Adjacents,57
Ashtonia_praeterita,1,1,0,Points-PointsKO-Adjacents,9
Asimina_manasota,9,1,8,Points-PointsKO-Adjacents,27
Asimina_obovata,59,43,16,Alphahull-PointsKO-Adjacents,599
Asimina_parviflora,512,412,100,Alphahull-PointsKO-Adjacents,9395
Asimina_tetramera,2,2,0,Points-PointsKO-Adjacents,15
Asimina_triloba,2618,2094,524,Alphahull-PointsKO-Adjacents,30028
Aspalathus_capitata,17,0,17,Points-PointsKO-Adjacents,18
Aspalathus_macrantha,11,3,8,Points-PointsKO-Adjacents,57
Aspalathus_pendula,16,12,4,Points-PointsKO-Adjacents,70
Aspalathus_vulnerans,31,23,8,Alphahull-PointsKO-Adjacents,155
Aspidosperma_album,68,29,39,Alphahull-PointsKO-Adjacents,579
Aspidosperma_araracanga,57,25,32,Alphahull-PointsKO-Adjacents,1199
Aspidosperma_auriculatum,5,4,1,Points-PointsKO-Adjacents,45
Aspidosperma_australe,721,648,73,Alphahull-PointsKO-Adjacents,26861
Aspidosperma_capitatum,12,2,10,Points-PointsKO-Adjacents,94
Aspidosperma_carapanauba,101,55,46,Alphahull-PointsKO-Adjacents,13597
Aspidosperma_cuspa,715,587,128,Alphahull-PointsKO-Adjacents,39235
Aspidosperma_cylindrocarpon,737,636,101,Alphahull-PointsKO-Adjacents,33072
Aspidosperma_darienense,2,2,0,Points-PointsKO-Adjacents,18
Aspidosperma_decussatum,28,18,10,Points-PointsKO-Adjacents,179
Aspidosperma_desmanthum,672,557,115,Alphahull-PointsKO-Adjacents,72422
Aspidosperma_discolor,443,368,75,Alphahull-PointsKO-Adjacents,36015
Aspidosperma_dispermum,79,59,20,Alphahull-PointsKO-Adjacents,1604
Aspidosperma_excelsum,810,732,78,Alphahull-PointsKO-Adjacents,75412
Aspidosperma_fendleri,23,7,16,Points-PointsKO-Adjacents,166
Aspidosperma_glaucum,2,2,0,Points-PointsKO-Adjacents,14
Aspidosperma_helstonei,12,7,5,Points-PointsKO-Adjacents,86
Aspidosperma_illustre,57,30,27,Alphahull-PointsKO-Adjacents,816
Aspidosperma_inundatum,16,3,13,Points-PointsKO-Adjacents,144
Aspidosperma_leucocymosum,0,0,0,NA,0
Aspidosperma_macrocarpon,819,728,91,Alphahull-PointsKO-Adjacents,42464
Aspidosperma_macrophyllum,16,10,6,Points-PointsKO-Adjacents,90
Aspidosperma_megalocarpon,291,225,66,Alphahull-PointsKO-Adjacents,11749
Aspidosperma_megaphyllum,7,3,4,Points-PointsKO-Adjacents,57
Aspidosperma_multiflorum,339,271,68,Alphahull-PointsKO-Adjacents,27156
Aspidosperma_myristicifolium,97,59,38,Alphahull-PointsKO-Adjacents,2586
Aspidosperma_neblinae,6,1,5,Points-PointsKO-Adjacents,29
Aspidosperma_nobile,235,185,50,Alphahull-PointsKO-Adjacents,10914
Aspidosperma_oblongum,17,7,10,Points-PointsKO-Adjacents,153
Aspidosperma_pachypterum,28,16,12,Points-PointsKO-Adjacents,181
Aspidosperma_parvifolium,436,315,121,Alphahull-PointsKO-Adjacents,14275
Aspidosperma_pichonianum,3,3,0,Points-PointsKO-Adjacents,27
Aspidosperma_polyneuron,434,351,83,Alphahull-PointsKO-Adjacents,13320
Aspidosperma_pyricollum,161,79,82,Alphahull-PointsKO-Adjacents,2570
Aspidosperma_pyrifolium,1333,1250,83,Alphahull-PointsKO-Adjacents,33442
Aspidosperma_quebracho-blanco,321,284,37,Alphahull-PointsKO-Adjacents,16913
Aspidosperma_quirandy,21,9,12,Points-PointsKO-Adjacents,142
Aspidosperma_ramiflorum,258,197,61,Alphahull-PointsKO-Adjacents,9369
Aspidosperma_reductum,4,4,0,Points-PointsKO-Adjacents,34
Aspidosperma_resonans,5,5,0,Points-PointsKO-Adjacents,33
Aspidosperma_riedelii,76,30,46,Alphahull-PointsKO-Adjacents,1630
Aspidosperma_rigidum,448,367,81,Alphahull-PointsKO-Adjacents,30903
Aspidosperma_salgadense,2,2,0,Points-PointsKO-Adjacents,9
Aspidosperma_sandwithianum,15,6,9,Points-PointsKO-Adjacents,117
Aspidosperma_schultesii,82,36,46,Alphahull-PointsKO-Adjacents,1182
Aspidosperma_spruceanum,993,832,161,Alphahull-PointsKO-Adjacents,95298
Aspidosperma_steyermarkii,16,8,8,Points-PointsKO-Adjacents,95
Aspidosperma_subincanum,841,768,73,Alphahull-PointsKO-Adjacents,34665
Aspidosperma_thomasii,8,5,3,Points-PointsKO-Adjacents,13
Aspidosperma_tomentosum,918,851,67,Alphahull-PointsKO-Adjacents,33433
Aspidosperma_triternatum,0,0,0,NA,0
Aspidosperma_ulei,98,49,49,Alphahull-PointsKO-Adjacents,4633
Aspidosperma_vargasii,110,47,63,Alphahull-PointsKO-Adjacents,7714
Aspidosperma_williamii,6,0,6,Points-PointsKO-Adjacents,45
Aspidostemon_andohahelensis,5,5,0,Points-PointsKO-Adjacents,30
Aspidostemon_antongilensis,2,2,0,Points-PointsKO-Adjacents,18
Aspidostemon_apiculatus,3,3,0,Points-PointsKO-Adjacents,18
Aspidostemon_capuronii,2,2,0,Points-PointsKO-Adjacents,15
Aspidostemon_caudatus,1,1,0,Points-PointsKO-Adjacents,7
Aspidostemon_conoideus,9,5,4,Points-PointsKO-Adjacents,26
Aspidostemon_dolichocarpus,4,4,0,Points-PointsKO-Adjacents,32
Aspidostemon_fungiformis,4,4,0,Points-PointsKO-Adjacents,21
Aspidostemon_glandulosus,6,1,5,Points-PointsKO-Adjacents,35
Aspidostemon_grayi,3,3,0,Points-PointsKO-Adjacents,27
Aspidostemon_humbertianus,3,3,0,Points-PointsKO-Adjacents,18
Aspidostemon_inconspicuus,1,1,0,Points-PointsKO-Adjacents,9
Aspidostemon_insignis,1,1,0,Points-PointsKO-Adjacents,9
Aspidostemon_lacrimans,2,2,0,Points-PointsKO-Adjacents,18
Aspidostemon_litoralis,1,1,0,Points-PointsKO-Adjacents,6
Aspidostemon_longipedicellatus,9,0,9,Points-PointsKO-Adjacents,74
Aspidostemon_lucens,3,3,0,Points-PointsKO-Adjacents,18
Aspidostemon_macrophyllus,1,1,0,Points-PointsKO-Adjacents,9
Aspidostemon_manongarivensis,1,1,0,Points-PointsKO-Adjacents,9
Aspidostemon_masoalensis,1,1,0,Points-PointsKO-Adjacents,7
Aspidostemon_microphyllus,2,2,0,Points-PointsKO-Adjacents,14
Aspidostemon_occultus,1,1,0,Points-PointsKO-Adjacents,9
Aspidostemon_parvifolius,9,4,5,Points-PointsKO-Adjacents,22
Aspidostemon_percoriaceus,2,2,0,Points-PointsKO-Adjacents,17
Aspidostemon_perrieri,13,0,13,Points-PointsKO-Adjacents,67
Aspidostemon_reticulatus,1,1,0,Points-PointsKO-Adjacents,9
Aspidostemon_synandra,1,1,0,Points-PointsKO-Adjacents,9
Aspidostemon_trianthera,1,1,0,Points-PointsKO-Adjacents,9
Aspidostemon_trichandra,2,2,0,Points-PointsKO-Adjacents,9
Asplundianthus_sagasteguii,5,5,0,Points-PointsKO-Adjacents,43
Asteranthe_asterias,74,59,15,Alphahull-PointsKO-Adjacents,621
Asteranthe_lutea,7,4,3,Points-PointsKO-Adjacents,39
Asteranthos_brasiliensis,68,47,21,Alphahull-PointsKO-Adjacents,1493
Asterogyne_ramosa,2,2,0,Points-PointsKO-Adjacents,16
Asterogyne_spicata,3,3,0,Points-PointsKO-Adjacents,23
Asterogyne_yaracuyense,1,1,0,Points-PointsKO-Adjacents,9
Asteromyrtus_angustifolia,292,255,37,Alphahull-PointsKO-Adjacents,2648
Asteromyrtus_arnhemica,36,22,14,Alphahull-PointsKO-Adjacents,234
Asteromyrtus_brassii,159,140,19,Alphahull-PointsKO-Adjacents,607
Asteromyrtus_symphyocarpa,757,715,42,Alphahull-PointsKO-Adjacents,6957
Asteromyrtus_tranganensis,1,1,0,Points-PointsKO-Adjacents,9
Asteropeia_amblyocarpa,65,47,18,Alphahull-PointsKO-Adjacents,1831
Asteropeia_densiflora,52,44,8,Alphahull-PointsKO-Adjacents,104
Asteropeia_labatii,37,29,8,Alphahull-PointsKO-Adjacents,267
Asteropeia_matrambody,23,15,8,Points-PointsKO-Adjacents,78
Asteropeia_mcphersonii,43,40,3,Alphahull-PointsKO-Adjacents,29
Asteropeia_micraster,33,21,12,Alphahull-PointsKO-Adjacents,272
Asteropeia_multiflora,142,105,37,Alphahull-PointsKO-Adjacents,682
Asteropeia_rhopaloides,59,44,15,Alphahull-PointsKO-Adjacents,629
Astianthus_viminalis,281,223,58,Alphahull-PointsKO-Adjacents,3489
Astiria_rosea,0,0,0,NA,0
Astracantha_arnacanthoides,1,1,0,Points-PointsKO-Adjacents,8
Astragalus_krascheninnikovii,NA,NA,NA,NA,NA
Astragalus_tscharynensis,NA,NA,NA,NA,NA
Astrocaryum_acaule,68,36,32,Alphahull-PointsKO-Adjacents,3084
Astrocaryum_aculeatissimum,273,0,273,Points-PointsKO-Adjacents,1658
Astrocaryum_aculeatum,394,323,71,Alphahull-PointsKO-Adjacents,53650
Astrocaryum_alatum,68,48,20,Alphahull-PointsKO-Adjacents,802
Astrocaryum_carnosum,1,1,0,Points-PointsKO-Adjacents,9
Astrocaryum_chambira,324,297,27,Alphahull-PointsKO-Adjacents,10949
Astrocaryum_chonta,74,47,27,Alphahull-PointsKO-Adjacents,293
Astrocaryum_ciliatum,18,10,8,Points-PointsKO-Adjacents,79
Astrocaryum_confertum,12,7,5,Points-PointsKO-Adjacents,64
Astrocaryum_echinatum,31,10,21,Points-PointsKO-Adjacents,276
Astrocaryum_faranae,53,45,8,Alphahull-PointsKO-Adjacents,87
Astrocaryum_farinosum,2,2,0,Points-PointsKO-Adjacents,18
Astrocaryum_ferrugineum,8,1,7,Points-PointsKO-Adjacents,50
Astrocaryum_giganteum,NA,NA,NA,NA,NA
Astrocaryum_gratum,117,94,23,Alphahull-PointsKO-Adjacents,1080
Astrocaryum_huaimi,108,74,34,Alphahull-PointsKO-Adjacents,10949
Astrocaryum_huicungo,2,2,0,Points-PointsKO-Adjacents,18
Astrocaryum_jauari,353,291,62,Alphahull-PointsKO-Adjacents,45708
Astrocaryum_macrocalyx,86,71,15,Alphahull-PointsKO-Adjacents,587
Astrocaryum_malybo,22,11,11,Points-PointsKO-Adjacents,188
Astrocaryum_mexicanum,119,98,21,Alphahull-PointsKO-Adjacents,1424
Astrocaryum_minus,2,2,0,Points-PointsKO-Adjacents,18
Astrocaryum_murumuru,117,65,52,Alphahull-PointsKO-Adjacents,10883
Astrocaryum_paramaca,26,0,26,Points-PointsKO-Adjacents,184
Astrocaryum_perangustatum,11,6,5,Points-PointsKO-Adjacents,69
Astrocaryum_rodriguesii,13,4,9,Points-PointsKO-Adjacents,108
Astrocaryum_sciophilum,36,0,36,Points-PointsKO-Adjacents,276
Astrocaryum_scopatum,1,1,0,Points-PointsKO-Adjacents,9
Astrocaryum_standleyanum,124,89,35,Alphahull-PointsKO-Adjacents,1243
Astrocaryum_triandrum,2,2,0,Points-PointsKO-Adjacents,18
Astrocaryum_tucuma,2,2,0,Points-PointsKO-Adjacents,18
Astrocaryum_ulei,41,21,20,Alphahull-PointsKO-Adjacents,2596
Astrocaryum_urostachys,158,143,15,Alphahull-PointsKO-Adjacents,2102
Astrocaryum_vulgare,204,148,56,Alphahull-PointsKO-Adjacents,14128
Astrocasia_austinii,3,3,0,Points-PointsKO-Adjacents,27
Astrocasia_jacobinensis,145,103,42,Alphahull-PointsKO-Adjacents,2744
Astrocasia_peltata,13,0,13,Points-PointsKO-Adjacents,82
Astrocasia_tremula,251,190,61,Alphahull-PointsKO-Adjacents,1857
Astrococcus_cornutus,6,0,6,Points-PointsKO-Adjacents,45
Astronia_ferruginea,67,54,13,Alphahull-PointsKO-Adjacents,73
Astronidium_ponapense,4,3,1,Points-PointsKO-Adjacents,9
Astronium_balansae,58,39,19,Alphahull-PointsKO-Adjacents,1672
Astronium_concinnum,152,117,35,Alphahull-PointsKO-Adjacents,5204
Astronium_fraxinifolium,1540,1412,128,Alphahull-PointsKO-Adjacents,50534
Astronium_gardneri,0,0,0,NA,0
Astronium_glaziovii,12,6,6,Points-PointsKO-Adjacents,83
Astronium_graveolens,1781,1527,254,Alphahull-PointsKO-Adjacents,95313
Astronium_lecointei,322,246,76,Alphahull-PointsKO-Adjacents,32456
Astronium_nelson-rosae,34,1,33,Points-PointsKO-Adjacents,261
Astronium_obliquum,5,5,0,Points-PointsKO-Adjacents,36
Astronium_ulei,57,26,31,Alphahull-PointsKO-Adjacents,1915
Astronium_urundeuva,190,131,59,Alphahull-PointsKO-Adjacents,8715
Astrothalamus_reticulatus,0,0,0,NA,0
Astrotricha_obovata,158,151,7,Alphahull-PointsKO-Adjacents,164
Astrotricha_pauciflora,8,6,2,Points-PointsKO-Adjacents,15
Astrotrichilia_asterotricha,53,35,18,Alphahull-PointsKO-Adjacents,2136
Astrotrichilia_diegoensis,3,3,0,Points-PointsKO-Adjacents,18
Astrotrichilia_elegans,3,3,0,Points-PointsKO-Adjacents,25
Astrotrichilia_elliotii,30,16,14,Points-PointsKO-Adjacents,130
Astrotrichilia_masoalensis,9,1,8,Points-PointsKO-Adjacents,77
Astrotrichilia_parvifolia,43,28,15,Alphahull-PointsKO-Adjacents,257
Astrotrichilia_procera,9,3,6,Points-PointsKO-Adjacents,54
Astrotrichilia_rakodomena,4,4,0,Points-PointsKO-Adjacents,33
Astrotrichilia_thouvenotii,21,9,12,Points-PointsKO-Adjacents,137
Astrotrichilia_valiandra,6,0,6,Points-PointsKO-Adjacents,45
Astrotrichilia_voamatata,8,4,4,Points-PointsKO-Adjacents,40
Astrotrichilia_zombitsyensis,4,4,0,Points-PointsKO-Adjacents,32
Atalantia_acuminata,1,1,0,Points-PointsKO-Adjacents,9
Atalantia_buxifolia,52,27,25,Alphahull-PointsKO-Adjacents,193
Atalantia_citroides,1,1,0,Points-PointsKO-Adjacents,9
Atalantia_dasycarpa,6,1,5,Points-PointsKO-Adjacents,48
Atalantia_guillauminii,8,5,3,Points-PointsKO-Adjacents,72
Atalantia_henryi,3,3,0,Points-PointsKO-Adjacents,27
Atalantia_macrophylla,NA,NA,NA,NA,NA
Atalantia_monophylla,6,0,6,Points-PointsKO-Adjacents,54
Atalantia_racemosa,2,2,0,Points-PointsKO-Adjacents,18
Atalantia_rotundifolia,0,0,0,NA,0
Atalantia_roxburghiana,6,0,6,Points-PointsKO-Adjacents,46
Atalantia_simplicifolia,2,2,0,Points-PointsKO-Adjacents,18
Atalantia_wightii,0,0,0,NA,0
Atalaya_alata,17,7,10,Points-PointsKO-Adjacents,147
Atalaya_angustifolia,68,58,10,Alphahull-PointsKO-Adjacents,361
Atalaya_australiana,52,39,13,Alphahull-PointsKO-Adjacents,479
Atalaya_calcicola,45,29,16,Alphahull-PointsKO-Adjacents,233
Atalaya_capensis,9,4,5,Points-PointsKO-Adjacents,65
Atalaya_collina,9,4,5,Points-PointsKO-Adjacents,26
Atalaya_hemiglauca,3283,3216,67,Alphahull-PointsKO-Adjacents,42580
Atalaya_multiflora,87,58,29,Alphahull-PointsKO-Adjacents,632
Atalaya_natalensis,7,1,6,Points-PointsKO-Adjacents,59
Atalaya_oligoclada,10,9,1,Points-PointsKO-Adjacents,18
Atalaya_papuana,7,1,6,Points-PointsKO-Adjacents,22
Atalaya_rigida,67,47,20,Alphahull-PointsKO-Adjacents,224
Atalaya_salicifolia,262,211,51,Alphahull-PointsKO-Adjacents,2442
Atalaya_sericopetala,41,26,15,Alphahull-PointsKO-Adjacents,446
Atalaya_variifolia,213,0,213,Points-PointsKO-Adjacents,1157
Atamisquea_emarginata,160,114,46,Alphahull-PointsKO-Adjacents,7543
Ateleia_albolutescens,19,0,19,Points-PointsKO-Adjacents,101
Ateleia_apetala,7,1,6,Points-PointsKO-Adjacents,56
Ateleia_chiangii,3,3,0,Points-PointsKO-Adjacents,27
Ateleia_chicoasensis,5,4,1,Points-PointsKO-Adjacents,30
Ateleia_cubensis,13,2,11,Points-PointsKO-Adjacents,98
Ateleia_glabrata,1,1,0,Points-PointsKO-Adjacents,9
Ateleia_glazioveana,143,0,143,Points-PointsKO-Adjacents,1017
Ateleia_guaraya,20,11,9,Points-PointsKO-Adjacents,142
Ateleia_gummifera,16,1,15,Points-PointsKO-Adjacents,113
Ateleia_herbert-smithii,26,15,11,Points-PointsKO-Adjacents,102
Ateleia_insularis,8,3,5,Points-PointsKO-Adjacents,28
Ateleia_martinezii,3,3,0,Points-PointsKO-Adjacents,27
Ateleia_mcvaughii,5,5,0,Points-PointsKO-Adjacents,18
Ateleia_microcarpa,3,2,1,Points-PointsKO-Adjacents,27
Ateleia_ovata,3,3,0,Points-PointsKO-Adjacents,18
Ateleia_popenoei,2,2,0,Points-PointsKO-Adjacents,15
Ateleia_pterocarpa,103,71,32,Alphahull-PointsKO-Adjacents,1367
Ateleia_salicifolia,3,3,0,Points-PointsKO-Adjacents,26
Ateleia_sousae,3,3,0,Points-PointsKO-Adjacents,18
Ateleia_standleyana,13,5,8,Points-PointsKO-Adjacents,97
Ateleia_tenorioi,3,3,0,Points-PointsKO-Adjacents,27
Ateleia_tomentosa,5,4,1,Points-PointsKO-Adjacents,41
Ateleia_truncata,1,1,0,Points-PointsKO-Adjacents,9
Ateleia_venezuelensis,7,1,6,Points-PointsKO-Adjacents,57
Atemnosiphon_coriaceus,61,42,19,Alphahull-PointsKO-Adjacents,354
Atherosperma_moschatum,3508,3466,42,Alphahull-PointsKO-Adjacents,2971
Athertonia_diversifolia,79,0,79,Points-PointsKO-Adjacents,125
Athrotaxis_cupressoides,406,271,135,Alphahull-PointsKO-Adjacents,497
Athrotaxis_selaginoides,273,235,38,Alphahull-PointsKO-Adjacents,516
Athyana_weinmannifolia,25,0,25,Points-PointsKO-Adjacents,193
Atkinsia_cubensis,2,1,1,Points-PointsKO-Adjacents,18
Atomostigma_mattogrossense,NA,NA,NA,NA,NA
Atractocarpus_benthamianus,366,348,18,Alphahull-PointsKO-Adjacents,542
Atractocarpus_bracteatus,2,2,0,Points-PointsKO-Adjacents,16
Atractocarpus_carolinensis,0,0,0,NA,0
Atractocarpus_chartaceus,266,237,29,Alphahull-PointsKO-Adjacents,650
Atractocarpus_crosbyi,0,0,0,NA,0
Atractocarpus_decorus,18,7,11,Points-PointsKO-Adjacents,107
Atractocarpus_fitzalanii,310,275,35,Alphahull-PointsKO-Adjacents,720
Atractocarpus_heterophyllus,4,4,0,Points-PointsKO-Adjacents,26
Atractocarpus_hirtus,123,110,13,Alphahull-PointsKO-Adjacents,239
Atractocarpus_longipes,0,0,0,NA,0
Atractocarpus_macarthurii,45,18,27,Points-PointsKO-Adjacents,275
Atractocarpus_merikin,61,50,11,Alphahull-PointsKO-Adjacents,108
Atractocarpus_obscurinervius,1,1,0,Points-PointsKO-Adjacents,7
Atractocarpus_pentagonioides,0,0,0,NA,0
Atractocarpus_pterocarpon,1,1,0,Points-PointsKO-Adjacents,9
Atractocarpus_sessilis,236,198,38,Alphahull-PointsKO-Adjacents,1404
Atractocarpus_stipularis,18,12,6,Points-PointsKO-Adjacents,14
Atractocarpus_tahitiensis,0,0,0,NA,0
Atractocarpus_tenuiflorus,0,0,0,NA,0
Atractocarpus_versteegii,2,2,0,Points-PointsKO-Adjacents,18
Atraphaxis_muschketowii,0,0,0,NA,0
Atraphaxis_teretifolia,NA,NA,NA,NA,NA
Attalea_allenii,74,50,24,Alphahull-PointsKO-Adjacents,929
Attalea_amylacea,1,1,0,Points-PointsKO-Adjacents,9
Attalea_apoda,46,32,14,Alphahull-PointsKO-Adjacents,895
Attalea_bassleriana,3,3,0,Points-PointsKO-Adjacents,27
Attalea_brasiliensis,18,7,11,Points-PointsKO-Adjacents,129
Attalea_brejinhoensis,10,4,6,Points-PointsKO-Adjacents,80
Attalea_burretiana,126,101,25,Alphahull-PointsKO-Adjacents,3030
Attalea_butyracea,541,484,57,Alphahull-PointsKO-Adjacents,27992
Attalea_cephalotus,9,1,8,Points-PointsKO-Adjacents,66
Attalea_cohune,66,44,22,Alphahull-PointsKO-Adjacents,816
Attalea_colenda,34,24,10,Alphahull-PointsKO-Adjacents,381
Attalea_compta,37,22,15,Alphahull-PointsKO-Adjacents,3227
Attalea_crassispatha,2,2,0,Points-PointsKO-Adjacents,18
Attalea_dahlgreniana,24,0,24,Points-PointsKO-Adjacents,207
Attalea_dubia,115,76,39,Alphahull-PointsKO-Adjacents,988
Attalea_fairchildensis,0,0,0,NA,0
Attalea_funifera,148,102,46,Alphahull-PointsKO-Adjacents,1278
Attalea_geraensis,65,33,32,Alphahull-PointsKO-Adjacents,6614
Attalea_guacuyule,11,5,6,Points-PointsKO-Adjacents,69
Attalea_huebneri,5,5,0,Points-PointsKO-Adjacents,45
Attalea_insignis,107,0,107,Points-PointsKO-Adjacents,654
Attalea_kewensis,0,0,0,NA,0
Attalea_leandroana,0,0,0,NA,0
Attalea_macrolepis,0,0,0,NA,0
Attalea_magdalenica,1,1,0,Points-PointsKO-Adjacents,9
Attalea_maracaibensis,3,3,0,Points-PointsKO-Adjacents,27
Attalea_maripa,648,573,75,Alphahull-PointsKO-Adjacents,65932
Attalea_microcarpa,66,34,32,Alphahull-PointsKO-Adjacents,2042
Attalea_moorei,3,3,0,Points-PointsKO-Adjacents,27
Attalea_oleifera,105,62,43,Alphahull-PointsKO-Adjacents,4407
Attalea_osmantha,0,0,0,NA,0
Attalea_peruviana,1,1,0,Points-PointsKO-Adjacents,9
Attalea_phalerata,712,633,79,Alphahull-PointsKO-Adjacents,50982
Attalea_pindobassu,33,24,9,Alphahull-PointsKO-Adjacents,321
Attalea_princeps,9,0,9,Points-PointsKO-Adjacents,81
Attalea_racemosa,101,79,22,Alphahull-PointsKO-Adjacents,3439
Attalea_rostrata,74,34,40,Alphahull-PointsKO-Adjacents,1205
Attalea_salazarii,3,3,0,Points-PointsKO-Adjacents,27
Attalea_seabrensis,30,26,4,Alphahull-PointsKO-Adjacents,490
Attalea_septuagenata,5,5,0,Points-PointsKO-Adjacents,45
Attalea_speciosa,286,211,75,Alphahull-PointsKO-Adjacents,29810
Attalea_spectabilis,4,4,0,Points-PointsKO-Adjacents,36
Attalea_tessmannii,60,46,14,Alphahull-PointsKO-Adjacents,1101
Attalea_vitrivir,49,1,48,Points-PointsKO-Adjacents,369
Attalea_wesselsboeri,0,0,0,NA,0
Attilaea_abalak,5,5,0,Points-PointsKO-Adjacents,43
Atuna_cordata,0,0,0,NA,0
Atuna_elliptica,1,1,0,Points-PointsKO-Adjacents,6
Atuna_indica,1,1,0,Points-PointsKO-Adjacents,9
Atuna_latifrons,2,2,0,Points-PointsKO-Adjacents,18
Atuna_nannodes,13,2,11,Points-PointsKO-Adjacents,113
Atuna_penangiana,17,9,8,Points-PointsKO-Adjacents,128
Atuna_racemosa,186,89,97,Alphahull-PointsKO-Adjacents,6497
Atuna_travancorica,2,2,0,Points-PointsKO-Adjacents,18
Aubletiana_leptostachys,10,1,9,Points-PointsKO-Adjacents,69
Aubletiana_macrostachys,23,15,8,Points-PointsKO-Adjacents,163
Aubregrinia_taiensis,13,7,6,Points-PointsKO-Adjacents,89
Aubrevillea_kerstingii,37,23,14,Alphahull-PointsKO-Adjacents,154
Aubrevillea_platycarpa,68,40,28,Alphahull-PointsKO-Adjacents,1700
Aucoumea_klaineana,145,127,18,Alphahull-PointsKO-Adjacents,2126
Aucuba_albopunctifolia,NA,NA,NA,NA,NA
Aucuba_chinensis,164,120,44,Alphahull-PointsKO-Adjacents,10419
Aucuba_chlorascens,16,6,10,Points-PointsKO-Adjacents,135
Aucuba_confertiflora,2,2,0,Points-PointsKO-Adjacents,18
Aucuba_eriobotryifolia,0,0,0,NA,0
Aucuba_himalaica,65,37,28,Alphahull-PointsKO-Adjacents,7960
Aucuba_obcordata,21,4,17,Points-PointsKO-Adjacents,189
Auerodendron_jamaicense,2,2,0,Points-PointsKO-Adjacents,15
Auerodendron_northropianum,4,4,0,Points-PointsKO-Adjacents,20
Auerodendron_pauciflorum,1,0,1,Points-PointsKO-Adjacents,5
Augouardia_letestui,35,25,10,Alphahull-PointsKO-Adjacents,169
Aulacocalyx_caudata,127,100,27,Alphahull-PointsKO-Adjacents,2286
Aulacocalyx_divergens,15,8,7,Points-PointsKO-Adjacents,119
Aulacocalyx_jasminiflora,210,150,60,Alphahull-PointsKO-Adjacents,7948
Aulacocalyx_laxiflora,16,4,12,Points-PointsKO-Adjacents,115
Aulacocalyx_mapiana,14,9,5,Points-PointsKO-Adjacents,57
Aulacocalyx_pallens,3,3,0,Points-PointsKO-Adjacents,9
Aulacocalyx_talbotii,37,29,8,Alphahull-PointsKO-Adjacents,206
Aulandra_beccarii,0,0,0,NA,0
Aulandra_cauliflora,0,0,0,NA,0
Aulandra_longifolia,5,2,3,Points-PointsKO-Adjacents,45
Auranticarpa_edentata,16,13,3,Points-PointsKO-Adjacents,28
Auranticarpa_ilicifolia,27,14,13,Points-PointsKO-Adjacents,107
Auranticarpa_melanosperma,108,77,31,Alphahull-PointsKO-Adjacents,1367
Auranticarpa_papyracea,44,36,8,Alphahull-PointsKO-Adjacents,86
Auranticarpa_resinosa,6,6,0,Points-PointsKO-Adjacents,27
Auranticarpa_rhombifolia,314,0,314,Points-PointsKO-Adjacents,1298
Aureliana_darcyi,9,3,6,Points-PointsKO-Adjacents,71
Aureliana_fasciculata,932,800,132,Alphahull-PointsKO-Adjacents,10568
Aureliana_sellowiana,9,5,4,Points-PointsKO-Adjacents,50
Aureliana_tomentosa,25,9,16,Points-PointsKO-Adjacents,189
Aureliana_velutina,166,132,34,Alphahull-PointsKO-Adjacents,4557
Aureliana_wettsteiniana,103,85,18,Alphahull-PointsKO-Adjacents,1467
Austrobuxus_alticola,10,6,4,Points-PointsKO-Adjacents,32
Austrobuxus_brevipes,45,31,14,Alphahull-PointsKO-Adjacents,102
Austrobuxus_carunculatus,140,116,24,Alphahull-PointsKO-Adjacents,291
Austrobuxus_celebicus,6,1,5,Points-PointsKO-Adjacents,35
Austrobuxus_clusiaceus,18,12,6,Points-PointsKO-Adjacents,38
Austrobuxus_cracens,3,3,0,Points-PointsKO-Adjacents,14
Austrobuxus_dentatus,4,4,0,Points-PointsKO-Adjacents,36
Austrobuxus_ellipticus,29,17,12,Points-PointsKO-Adjacents,114
Austrobuxus_eugeniifolius,44,35,9,Alphahull-PointsKO-Adjacents,105
Austrobuxus_horneanus,0,0,0,NA,0
Austrobuxus_huerlimannii,12,7,5,Points-PointsKO-Adjacents,26
Austrobuxus_mandjelicus,2,2,0,Points-PointsKO-Adjacents,11
Austrobuxus_megacarpus,41,36,5,Alphahull-PointsKO-Adjacents,35
Austrobuxus_montis-do,4,4,0,Points-PointsKO-Adjacents,21
Austrobuxus_ovalis,10,4,6,Points-PointsKO-Adjacents,32
Austrobuxus_pauciflorus,17,8,9,Points-PointsKO-Adjacents,38
Austrobuxus_petiolaris,NA,NA,NA,NA,NA
Austrobuxus_rubiginosus,25,18,7,Points-PointsKO-Adjacents,37
Austrobuxus_swainii,199,185,14,Alphahull-PointsKO-Adjacents,230
Austrobuxus_vieillardii,21,13,8,Points-PointsKO-Adjacents,56
Austrocedrus_chilensis,101,85,16,Alphahull-PointsKO-Adjacents,1287
Austrocritonia_angulicaulis,49,27,22,Alphahull-PointsKO-Adjacents,798
Austrocylindropuntia_subulata,23,5,18,Points-PointsKO-Adjacents,197
Austroeupatorium_inulaefolium,902,724,178,Alphahull-PointsKO-Adjacents,35945
Austromuellera_trinervia,54,44,10,Alphahull-PointsKO-Adjacents,65
Austromyrtus_lotoides,8,2,6,Points-PointsKO-Adjacents,47
Austromyrtus_mendute,6,2,4,Points-PointsKO-Adjacents,28
Austromyrtus_ploumensis,1,1,0,Points-PointsKO-Adjacents,8
Austromyrtus_poimbailensis,5,5,0,Points-PointsKO-Adjacents,40
Austromyrtus_styphelioides,3,3,0,Points-PointsKO-Adjacents,18
Austrotaxus_spicata,46,36,10,Alphahull-PointsKO-Adjacents,89
Autranella_congolensis,32,13,19,Points-PointsKO-Adjacents,255
Averrhoa_bilimbi,12,0,12,Points-PointsKO-Adjacents,96
Averrhoa_carambola,7,0,7,Points-PointsKO-Adjacents,62
Averrhoa_dolichocarpa,NA,NA,NA,NA,NA
Averrhoa_leucopetala,NA,NA,NA,NA,NA
Averrhoidium_gardnerianum,136,101,35,Alphahull-PointsKO-Adjacents,4201
Averrhoidium_paraguaiense,52,35,17,Alphahull-PointsKO-Adjacents,867
Avicennia_bicolor,71,46,25,Alphahull-PointsKO-Adjacents,900
Avicennia_germinans,1540,1084,456,Alphahull-PointsKO-Adjacents,26085
Avicennia_marina,717,394,323,Alphahull-PointsKO-Adjacents,11188
Avicennia_officinalis,25,5,20,Points-PointsKO-Adjacents,184
Avicennia_schaueriana,226,108,118,Alphahull-PointsKO-Adjacents,1600
Axinaea_affinis,45,23,22,Alphahull-PointsKO-Adjacents,343
Axinaea_costaricensis,62,52,10,Alphahull-PointsKO-Adjacents,137
Axinaea_crassinoda,17,8,9,Points-PointsKO-Adjacents,113
Axinaea_fallax,0,0,0,NA,0
Axinaea_flava,3,3,0,Points-PointsKO-Adjacents,12
Axinaea_floribunda,18,7,11,Points-PointsKO-Adjacents,113
Axinaea_glandulosa,9,1,8,Points-PointsKO-Adjacents,81
Axinaea_grandifolia,20,4,16,Points-PointsKO-Adjacents,123
Axinaea_lanceolata,42,15,27,Points-PointsKO-Adjacents,235
Axinaea_lehmannii,50,31,19,Alphahull-PointsKO-Adjacents,470
Axinaea_macrophylla,279,246,33,Alphahull-PointsKO-Adjacents,2691
Axinaea_merianiae,49,42,7,Alphahull-PointsKO-Adjacents,105
Axinaea_mertensioides,5,5,0,Points-PointsKO-Adjacents,36
Axinaea_nitida,15,7,8,Points-PointsKO-Adjacents,106
Axinaea_oblongifolia,18,13,5,Points-PointsKO-Adjacents,90
Axinaea_pauciflora,18,11,7,Points-PointsKO-Adjacents,79
Axinaea_pennellii,7,0,7,Points-PointsKO-Adjacents,63
Axinaea_quitensis,55,42,13,Alphahull-PointsKO-Adjacents,394
Axinaea_sclerophylla,36,28,8,Alphahull-PointsKO-Adjacents,130
Axinaea_scutigera,77,53,24,Alphahull-PointsKO-Adjacents,1041
Axinaea_sessilifolia,11,6,5,Points-PointsKO-Adjacents,56
Axinaea_sodiroi,6,1,5,Points-PointsKO-Adjacents,32
Axinaea_tomentosa,5,5,0,Points-PointsKO-Adjacents,45
Axinaea_tovarii,3,3,0,Points-PointsKO-Adjacents,27
Axinaea_weberbaueri,4,4,0,Points-PointsKO-Adjacents,36
Axinandra_alata,0,0,0,NA,0
Axinandra_beccariana,1,1,0,Points-PointsKO-Adjacents,9
Axinandra_coriacea,4,4,0,Points-PointsKO-Adjacents,32
Axinandra_zeylanica,3,3,0,Points-PointsKO-Adjacents,27
Ayapanopsis_wurdackiana,5,5,0,Points-PointsKO-Adjacents,36
Ayenia_cuatrecasae,1,1,0,Points-PointsKO-Adjacents,9
Ayenia_klugii,2,2,0,Points-PointsKO-Adjacents,18
Ayenia_laevigata,1,1,0,Points-PointsKO-Adjacents,9
Ayenia_praeclara,1,1,0,Points-PointsKO-Adjacents,9
Ayenia_stipularis,3,3,0,Points-PointsKO-Adjacents,27
Azadirachta_excelsa,2,2,0,Points-PointsKO-Adjacents,18
Azadirachta_indica,43,8,35,Points-PointsKO-Adjacents,320
Azara_integrifolia,39,0,39,Points-PointsKO-Adjacents,269
Azara_lanceolata,49,35,14,Alphahull-PointsKO-Adjacents,1291
Azara_microphylla,27,13,14,Points-PointsKO-Adjacents,226
Azara_petiolaris,34,25,9,Alphahull-PointsKO-Adjacents,387
Azara_salicifolia,26,11,15,Points-PointsKO-Adjacents,201
Azara_serrata,33,14,19,Points-PointsKO-Adjacents,219
Azara_uruguayensis,109,70,39,Alphahull-PointsKO-Adjacents,2492
Azima_sarmentosa,3,3,0,Points-PointsKO-Adjacents,20
Azima_tetracantha,222,0,222,Points-PointsKO-Adjacents,1508
Baccaurea_airyshawii,NA,NA,NA,NA,NA
Baccaurea_angulata,12,5,7,Points-PointsKO-Adjacents,96
Baccaurea_annamensis,2,2,0,Points-PointsKO-Adjacents,18
Baccaurea_bracteata,24,6,18,Points-PointsKO-Adjacents,183
Baccaurea_brevipes,7,3,4,Points-PointsKO-Adjacents,47
Baccaurea_carinata,1,1,0,Points-PointsKO-Adjacents,9
Baccaurea_celebica,NA,NA,NA,NA,NA
Baccaurea_costulata,2,0,2,Points-PointsKO-Adjacents,18
Baccaurea_courtallensis,1,0,1,Points-PointsKO-Adjacents,9
Baccaurea_dasystachya,1,1,0,Points-PointsKO-Adjacents,9
Baccaurea_deflexa,4,0,4,Points-PointsKO-Adjacents,36
Baccaurea_dolichobotrys,1,1,0,Points-PointsKO-Adjacents,9
Baccaurea_dulcis,2,2,0,Points-PointsKO-Adjacents,18
Baccaurea_edulis,8,2,6,Points-PointsKO-Adjacents,72
Baccaurea_javanica,6,0,6,Points-PointsKO-Adjacents,54
Baccaurea_lanceolata,42,10,32,Points-PointsKO-Adjacents,328
Baccaurea_macrocarpa,25,12,13,Points-PointsKO-Adjacents,197
Baccaurea_macrophylla,7,0,7,Points-PointsKO-Adjacents,60
Baccaurea_maingayi,3,0,3,Points-PointsKO-Adjacents,27
Baccaurea_malayana,NA,NA,NA,NA,NA
Baccaurea_microcarpa,2,2,0,Points-PointsKO-Adjacents,9
Baccaurea_minor,4,1,3,Points-PointsKO-Adjacents,36
Baccaurea_mollis,2,2,0,Points-PointsKO-Adjacents,18
Baccaurea_motleyana,10,0,10,Points-PointsKO-Adjacents,88
Baccaurea_multiflora,1,1,0,Points-PointsKO-Adjacents,9
Baccaurea_nanihua,24,4,20,Points-PointsKO-Adjacents,155
Baccaurea_nesophila,4,4,0,Points-PointsKO-Adjacents,26
Baccaurea_odoratissima,3,3,0,Points-PointsKO-Adjacents,25
Baccaurea_papuana,47,30,17,Alphahull-PointsKO-Adjacents,1171
Baccaurea_parviflora,39,17,22,Points-PointsKO-Adjacents,250
Baccaurea_philippinensis,9,0,9,Points-PointsKO-Adjacents,64
Baccaurea_polyneura,2,1,1,Points-PointsKO-Adjacents,18
Baccaurea_ptychopyxis,0,0,0,NA,0
Baccaurea_pubera,8,2,6,Points-PointsKO-Adjacents,71
Baccaurea_purpurea,2,2,0,Points-PointsKO-Adjacents,15
Baccaurea_pyriformis,6,0,6,Points-PointsKO-Adjacents,54
Baccaurea_racemosa,41,16,25,Points-PointsKO-Adjacents,310
Baccaurea_ramiflora,75,0,75,Points-PointsKO-Adjacents,585
Baccaurea_reniformis,NA,NA,NA,NA,NA
Baccaurea_reticulata,6,2,4,Points-PointsKO-Adjacents,39
Baccaurea_sarawakensis,12,4,8,Points-PointsKO-Adjacents,102
Baccaurea_seemannii,3,3,0,Points-PointsKO-Adjacents,9
Baccaurea_simaloerensis,0,0,0,NA,0
Baccaurea_sumatrana,17,3,14,Points-PointsKO-Adjacents,138
Baccaurea_sylvestris,0,0,0,NA,0
Baccaurea_taitensis,1,1,0,Points-PointsKO-Adjacents,9
Baccaurea_tetrandra,50,31,19,Alphahull-PointsKO-Adjacents,3418
Baccaurea_trigonocarpa,13,3,10,Points-PointsKO-Adjacents,109
Baccaurea_velutina,0,0,0,NA,0
Baccharis_buchtienii,54,35,19,Alphahull-PointsKO-Adjacents,256
Baccharis_darwinii,89,35,54,Alphahull-PointsKO-Adjacents,8946
Baccharis_dioica,2,1,1,Points-PointsKO-Adjacents,16
Baccharis_haitiensis,0,0,0,NA,0
Baccharis_halimifolia,1044,768,276,Alphahull-PointsKO-Adjacents,16170
Baccharis_latifolia,909,812,97,Alphahull-PointsKO-Adjacents,9303
Baccharis_longiattenuata,36,14,22,Points-PointsKO-Adjacents,239
Baccharis_macrantha,126,100,26,Alphahull-PointsKO-Adjacents,984
Baccharis_montana,190,152,38,Alphahull-PointsKO-Adjacents,5223
Baccharis_myrsinites,58,49,9,Alphahull-PointsKO-Adjacents,187
Baccharis_nitida,437,359,78,Alphahull-PointsKO-Adjacents,7872
Baccharis_oreophila,107,83,24,Alphahull-PointsKO-Adjacents,1442
Baccharis_oxyodonta,101,0,101,Points-PointsKO-Adjacents,681
Baccharis_papillosa,75,54,21,Alphahull-PointsKO-Adjacents,543
Baccharis_pseudovaccinioides,4,4,0,Points-PointsKO-Adjacents,21
Baccharis_punctulata,218,152,66,Alphahull-PointsKO-Adjacents,11413
Baccharis_semiserrata,355,314,41,Alphahull-PointsKO-Adjacents,6793
Baccharoides_calvoana,89,62,27,Alphahull-PointsKO-Adjacents,1881
Baccharoides_filigera,2,1,1,Points-PointsKO-Adjacents,18
Bachmannia_woodii,22,9,13,Points-PointsKO-Adjacents,163
Backebergia_militaris,28,12,16,Points-PointsKO-Adjacents,130
Backhousia_angustifolia,185,161,24,Alphahull-PointsKO-Adjacents,2986
Backhousia_bancroftii,63,48,15,Alphahull-PointsKO-Adjacents,112
Backhousia_citriodora,84,50,34,Alphahull-PointsKO-Adjacents,529
Backhousia_enata,5,5,0,Points-PointsKO-Adjacents,12
Backhousia_hughesii,51,1,50,Points-PointsKO-Adjacents,115
Backhousia_kingii,67,46,21,Alphahull-PointsKO-Adjacents,368
Backhousia_myrtifolia,2248,0,2248,Points-PointsKO-Adjacents,1938
Backhousia_oligantha,9,3,6,Points-PointsKO-Adjacents,38
Backhousia_sciadophora,344,327,17,Alphahull-PointsKO-Adjacents,828
Bactris_acanthocarpa,321,217,104,Alphahull-PointsKO-Adjacents,22004
Bactris_acanthocarpoides,70,30,40,Alphahull-PointsKO-Adjacents,6679
Bactris_balanophora,91,65,26,Alphahull-PointsKO-Adjacents,5079
Bactris_barronis,100,80,20,Alphahull-PointsKO-Adjacents,1666
Bactris_bidentula,145,87,58,Alphahull-PointsKO-Adjacents,13399
Bactris_bifida,179,148,31,Alphahull-PointsKO-Adjacents,12643
Bactris_brongniartii,330,238,92,Alphahull-PointsKO-Adjacents,33979
Bactris_campestris,92,53,39,Alphahull-PointsKO-Adjacents,4756
Bactris_caudata,30,17,13,Points-PointsKO-Adjacents,212
Bactris_coloniata,68,49,19,Alphahull-PointsKO-Adjacents,372
Bactris_coloradonis,196,156,40,Alphahull-PointsKO-Adjacents,1746
Bactris_concinna,397,353,44,Alphahull-PointsKO-Adjacents,16083
Bactris_constanciae,39,25,14,Alphahull-PointsKO-Adjacents,706
Bactris_corossilla,303,250,53,Alphahull-PointsKO-Adjacents,15021
Bactris_cubensis,4,4,0,Points-PointsKO-Adjacents,31
Bactris_dianeura,71,56,15,Alphahull-PointsKO-Adjacents,354
Bactris_elegans,96,40,56,Alphahull-PointsKO-Adjacents,6912
Bactris_ferruginea,142,103,39,Alphahull-PointsKO-Adjacents,1452
Bactris_fissifrons,118,88,30,Alphahull-PointsKO-Adjacents,7479
Bactris_gasipaes,500,395,105,Alphahull-PointsKO-Adjacents,32803
Bactris_glandulosa,106,89,17,Alphahull-PointsKO-Adjacents,1285
Bactris_glaucescens,81,40,41,Alphahull-PointsKO-Adjacents,2438
Bactris_gracilior,85,69,16,Alphahull-PointsKO-Adjacents,673
Bactris_guineensis,168,126,42,Alphahull-PointsKO-Adjacents,7272
Bactris_halmoorei,49,31,18,Alphahull-PointsKO-Adjacents,937
Bactris_hatschbachii,29,13,16,Points-PointsKO-Adjacents,175
Bactris_herrerana,14,7,7,Points-PointsKO-Adjacents,56
Bactris_hirta,439,339,100,Alphahull-PointsKO-Adjacents,23577
Bactris_horridispatha,23,7,16,Points-PointsKO-Adjacents,147
Bactris_jamaicana,0,0,0,NA,0
Bactris_kunorum,9,3,6,Points-PointsKO-Adjacents,46
Bactris_longiseta,13,9,4,Points-PointsKO-Adjacents,50
Bactris_macroacantha,176,137,39,Alphahull-PointsKO-Adjacents,5605
Bactris_major,697,544,153,Alphahull-PointsKO-Adjacents,71924
Bactris_maraja,1087,1001,86,Alphahull-PointsKO-Adjacents,66390
Bactris_martiana,42,19,23,Points-PointsKO-Adjacents,372
Bactris_mexicana,131,107,24,Alphahull-PointsKO-Adjacents,2355
Bactris_militaris,20,11,9,Points-PointsKO-Adjacents,106
Bactris_nancibaensis,1,0,1,Points-PointsKO-Adjacents,6
Bactris_oligoclada,40,26,14,Alphahull-PointsKO-Adjacents,570
Bactris_pickelii,37,17,20,Points-PointsKO-Adjacents,231
Bactris_pilosa,114,90,24,Alphahull-PointsKO-Adjacents,3077
Bactris_plumeriana,14,6,8,Points-PointsKO-Adjacents,110
Bactris_polystachya,14,8,6,Points-PointsKO-Adjacents,67
Bactris_ptariana,30,19,11,Points-PointsKO-Adjacents,214
Bactris_riparia,142,0,142,Points-PointsKO-Adjacents,1166
Bactris_rostrata,0,0,0,NA,0
Bactris_setiflora,5,5,0,Points-PointsKO-Adjacents,32
Bactris_setosa,442,0,442,Points-PointsKO-Adjacents,2351
Bactris_setulosa,254,200,54,Alphahull-PointsKO-Adjacents,6895
Bactris_sphaerocarpa,32,19,13,Points-PointsKO-Adjacents,176
Bactris_timbuiensis,12,7,5,Points-PointsKO-Adjacents,26
Bactris_tomentosa,21,5,16,Points-PointsKO-Adjacents,178
Bactris_turbinocarpa,4,4,0,Points-PointsKO-Adjacents,34
Badiera_fuertesii,30,22,8,Alphahull-PointsKO-Adjacents,111
Badiera_penaea,55,40,15,Alphahull-PointsKO-Adjacents,353
Badiera_propinqua,8,3,5,Points-PointsKO-Adjacents,53
Badiera_virgata,12,4,8,Points-PointsKO-Adjacents,74
Badula_balfouriana,0,0,0,NA,0
Badula_crassa,0,0,0,NA,0
Badula_fragilis,0,0,0,NA,0
Badula_grammisticta,1,1,0,Points-PointsKO-Adjacents,9
Badula_insularis,2,2,0,Points-PointsKO-Adjacents,16
Badula_multiflora,0,0,0,NA,0
Badula_nitida,0,0,0,NA,0
Badula_ovalifolia,1,1,0,Points-PointsKO-Adjacents,9
Badula_pervilleana,0,0,0,NA,0
Badula_platyphylla,0,0,0,NA,0
Badula_reticulata,0,0,0,NA,0
Badula_richardiana,NA,NA,NA,NA,NA
Badula_sieberi,2,2,0,Points-PointsKO-Adjacents,14
Badusa_corymbifera,6,0,6,Points-PointsKO-Adjacents,43
Badusa_palauensis,2,2,0,Points-PointsKO-Adjacents,7
Baeckea_frutescens,423,304,119,Alphahull-PointsKO-Adjacents,3282
Bafodeya_benna,10,5,5,Points-PointsKO-Adjacents,81
Bagassa_guianensis,123,74,49,Alphahull-PointsKO-Adjacents,10920
Baikiaea_ghesquiereana,NA,NA,NA,NA,NA
Baikiaea_insignis,149,105,44,Alphahull-PointsKO-Adjacents,9697
Baikiaea_plurijuga,84,57,27,Alphahull-PointsKO-Adjacents,1327
Baikiaea_robynsii,33,17,16,Points-PointsKO-Adjacents,170
Baikiaea_suzannae,1,1,0,Points-PointsKO-Adjacents,9
Baikiaea_zenkeri,1,1,0,Points-PointsKO-Adjacents,9
Baillonella_toxisperma,243,216,27,Alphahull-PointsKO-Adjacents,4443
Bakeridesia_bakeriana,43,26,17,Alphahull-PointsKO-Adjacents,147
Bakeridesia_esculenta,44,19,25,Points-PointsKO-Adjacents,324
Bakeridesia_gaumeri,121,0,121,Points-PointsKO-Adjacents,341
Bakeridesia_gloriosa,34,21,13,Alphahull-PointsKO-Adjacents,97
Bakeridesia_integerrima,13,3,10,Points-PointsKO-Adjacents,104
Bakeridesia_molinae,1,1,0,Points-PointsKO-Adjacents,9
Bakeridesia_nelsonii,5,5,0,Points-PointsKO-Adjacents,40
Bakeridesia_notolophium,47,21,26,Alphahull-PointsKO-Adjacents,264
Bakeridesia_vulcanicola,6,0,6,Points-PointsKO-Adjacents,30
Balaka_diffusa,NA,NA,NA,NA,NA
Balaka_longirostris,0,0,0,NA,0
Balaka_macrocarpa,0,0,0,NA,0
Balaka_microcarpa,0,0,0,NA,0
Balaka_pauciflora,0,0,0,NA,0
Balaka_samoensis,1,1,0,Points-PointsKO-Adjacents,9
Balaka_seemannii,1,1,0,Points-PointsKO-Adjacents,9
Balaka_streptostachys,0,0,0,NA,0
Balaka_tahitensis,2,2,0,Points-PointsKO-Adjacents,12
Balakata_baccata,37,10,27,Points-PointsKO-Adjacents,296
Balakata_luzonica,1,1,0,Points-PointsKO-Adjacents,8
Balanites_aegyptiaca,74,55,19,Alphahull-PointsKO-Adjacents,1105
Balanites_angolensis,16,2,14,Points-PointsKO-Adjacents,139
Balanites_glabra,74,55,19,Alphahull-PointsKO-Adjacents,888
Balanites_maughamii,69,43,26,Alphahull-PointsKO-Adjacents,1938
Balanites_rotundifolia,17,7,10,Points-PointsKO-Adjacents,139
Balanites_roxburghii,0,0,0,NA,0
Balanites_triflora,0,0,0,NA,0
Balanites_wilsoniana,39,7,32,Points-PointsKO-Adjacents,291
Balanops_australiana,141,115,26,Alphahull-PointsKO-Adjacents,392
Balanops_balansae,6,2,4,Points-PointsKO-Adjacents,36
Balanops_microstachya,3,3,0,Points-PointsKO-Adjacents,26
Balanops_oliviformis,8,3,5,Points-PointsKO-Adjacents,61
Balanops_pachyphylla,9,2,7,Points-PointsKO-Adjacents,53
Balanops_pancheri,16,4,12,Points-PointsKO-Adjacents,95
Balanops_pedicellata,8,1,7,Points-PointsKO-Adjacents,59
Balanops_sparsifolia,12,5,7,Points-PointsKO-Adjacents,78
Balanops_vieillardii,6,1,5,Points-PointsKO-Adjacents,31
Balfourodendron_molle,298,266,32,Alphahull-PointsKO-Adjacents,7024
Balfourodendron_riedelianum,320,275,45,Alphahull-PointsKO-Adjacents,8228
Baliospermum_angustifolium,NA,NA,NA,NA,NA
Baliospermum_bilobatum,NA,NA,NA,NA,NA
Baliospermum_calycinum,39,18,21,Points-PointsKO-Adjacents,321
Baliospermum_solanifolium,45,0,45,Points-PointsKO-Adjacents,381
Balmea_stormiae,17,6,11,Points-PointsKO-Adjacents,96
Baloghia_alternifolia,52,40,12,Alphahull-PointsKO-Adjacents,148
Baloghia_anisomera,6,0,6,Points-PointsKO-Adjacents,36
Baloghia_balansae,9,6,3,Points-PointsKO-Adjacents,30
Baloghia_brongniartii,5,1,4,Points-PointsKO-Adjacents,25
Baloghia_buchholzii,34,24,10,Alphahull-PointsKO-Adjacents,81
Baloghia_bureavii,35,22,13,Alphahull-PointsKO-Adjacents,130
Baloghia_drimiflora,46,36,10,Alphahull-PointsKO-Adjacents,85
Baloghia_inophylla,1272,1169,103,Alphahull-PointsKO-Adjacents,3225
Baloghia_marmorata,36,26,10,Alphahull-PointsKO-Adjacents,64
Baloghia_montana,11,11,0,Points-PointsKO-Adjacents,25
Baloghia_parviflora,75,66,9,Alphahull-PointsKO-Adjacents,105
Baloghia_pininsularis,2,2,0,Points-PointsKO-Adjacents,9
Baloghia_pulchella,9,3,6,Points-PointsKO-Adjacents,15
Balsamocitrus_camerunensis,6,0,6,Points-PointsKO-Adjacents,54
Balsamocitrus_dawei,14,4,10,Points-PointsKO-Adjacents,75
Balsamocitrus_gabonensis,1,1,0,Points-PointsKO-Adjacents,9
Balthasaria_mannii,0,0,0,NA,0
Balthasaria_schliebenii,31,17,14,Points-PointsKO-Adjacents,133
Banara_arguta,201,103,98,Alphahull-PointsKO-Adjacents,15931
Banara_axilliflora,26,7,19,Points-PointsKO-Adjacents,208
Banara_boliviana,23,16,7,Points-PointsKO-Adjacents,127
Banara_brasiliensis,33,9,24,Points-PointsKO-Adjacents,224
Banara_brittonii,1,1,0,Points-PointsKO-Adjacents,9
Banara_caymanensis,NA,NA,NA,NA,NA
Banara_cordifolia,0,0,0,NA,0
Banara_domingensis,3,2,1,Points-PointsKO-Adjacents,25
Banara_excisa,0,0,0,NA,0
Banara_glauca,72,53,19,Alphahull-PointsKO-Adjacents,1644
Banara_guianensis,1351,1158,193,Alphahull-PointsKO-Adjacents,45463
Banara_ibaguensis,9,1,8,Points-PointsKO-Adjacents,68
Banara_larensis,2,2,0,Points-PointsKO-Adjacents,18
Banara_minutiflora,17,5,12,Points-PointsKO-Adjacents,120
Banara_nitida,240,174,66,Alphahull-PointsKO-Adjacents,20306
Banara_orinocensis,25,10,15,Points-PointsKO-Adjacents,219
Banara_parviflora,247,210,37,Alphahull-PointsKO-Adjacents,6598
Banara_portoricensis,13,8,5,Points-PointsKO-Adjacents,37
Banara_quinquenervis,NA,NA,NA,NA,NA
Banara_regia,11,4,7,Points-PointsKO-Adjacents,65
Banara_riparia,5,5,0,Points-PointsKO-Adjacents,43
Banara_riscoi,NA,NA,NA,NA,NA
Banara_selleana,0,0,0,NA,0
Banara_serrata,73,51,22,Alphahull-PointsKO-Adjacents,1520
Banara_splendens,8,3,5,Points-PointsKO-Adjacents,62
Banara_tomentosa,534,488,46,Alphahull-PointsKO-Adjacents,9412
Banara_trinitatis,1,1,0,Points-PointsKO-Adjacents,4
Banara_ulmifolia,13,7,6,Points-PointsKO-Adjacents,91
Banara_umbraticola,29,10,19,Points-PointsKO-Adjacents,249
Banara_vanderbiltii,2,1,1,Points-PointsKO-Adjacents,14
Banara_wilsonii,NA,NA,NA,NA,NA
Banisteriopsis_arborea,26,19,7,Points-PointsKO-Adjacents,101
Banisteriopsis_latifolia,154,121,33,Alphahull-PointsKO-Adjacents,4102
Banisteriopsis_malifolia,437,380,57,Alphahull-PointsKO-Adjacents,13413
Banksia_aemula,644,575,69,Alphahull-PointsKO-Adjacents,801
Banksia_anatona,9,5,4,Points-PointsKO-Adjacents,53
Banksia_arborea,38,29,9,Alphahull-PointsKO-Adjacents,162
Banksia_ashbyi,182,154,28,Alphahull-PointsKO-Adjacents,1292
Banksia_attenuata,1675,1401,274,Alphahull-PointsKO-Adjacents,2593
Banksia_baxteri,251,0,251,Points-PointsKO-Adjacents,320
Banksia_benthamiana,33,0,33,Points-PointsKO-Adjacents,152
Banksia_brownii,38,0,38,Points-PointsKO-Adjacents,151
Banksia_burdettii,106,95,11,Alphahull-PointsKO-Adjacents,163
Banksia_coccinea,248,226,22,Alphahull-PointsKO-Adjacents,322
Banksia_conferta,110,81,29,Alphahull-PointsKO-Adjacents,644
Banksia_cuneata,30,22,8,Alphahull-PointsKO-Adjacents,377
Banksia_dentata,902,0,902,Points-PointsKO-Adjacents,2382
Banksia_ericifolia,1861,1580,281,Alphahull-PointsKO-Adjacents,1085
Banksia_grandis,1730,1651,79,Alphahull-PointsKO-Adjacents,1388
Banksia_ilicifolia,638,556,82,Alphahull-PointsKO-Adjacents,1070
Banksia_integrifolia,3312,3001,311,Alphahull-PointsKO-Adjacents,5622
Banksia_littoralis,731,684,47,Alphahull-PointsKO-Adjacents,1201
Banksia_marginata,13155,12653,502,Alphahull-PointsKO-Adjacents,9366
Banksia_media,463,434,29,Alphahull-PointsKO-Adjacents,1280
Banksia_menziesii,575,0,575,Points-PointsKO-Adjacents,658
Banksia_occidentalis,165,144,21,Alphahull-PointsKO-Adjacents,495
Banksia_penicillata,113,0,113,Points-PointsKO-Adjacents,169
Banksia_plagiocarpa,24,19,5,Points-PointsKO-Adjacents,37
Banksia_praemorsa,33,22,11,Alphahull-PointsKO-Adjacents,134
Banksia_prionotes,553,0,553,Points-PointsKO-Adjacents,1180
Banksia_saxicola,111,102,9,Alphahull-PointsKO-Adjacents,86
Banksia_seminuda,240,224,16,Alphahull-PointsKO-Adjacents,503
Banksia_serrata,4299,3931,368,Alphahull-PointsKO-Adjacents,2322
Banksia_sessilis,509,434,75,Alphahull-PointsKO-Adjacents,2052
Banksia_solandrii,13,11,2,Points-PointsKO-Adjacents,72
Banksia_speciosa,273,246,27,Alphahull-PointsKO-Adjacents,528
Banksia_sphaerocarpa,778,748,30,Alphahull-PointsKO-Adjacents,2061
Banksia_spinulosa,5919,5535,384,Alphahull-PointsKO-Adjacents,664
Banksia_tricuspis,7,0,7,Points-PointsKO-Adjacents,37
Banksia_verticiliata,19,12,7,Points-PointsKO-Adjacents,90
Banksia_verticillata,21,0,21,Points-PointsKO-Adjacents,96
Banksia_victoriae,3154,2888,266,Alphahull-PointsKO-Adjacents,13037
Baphia_abyssinica,7,3,4,Points-PointsKO-Adjacents,53
Baphia_angolensis,7,0,7,Points-PointsKO-Adjacents,60
Baphia_bequaertii,24,10,14,Points-PointsKO-Adjacents,119
Baphia_bergeri,9,3,6,Points-PointsKO-Adjacents,77
Baphia_breteleriana,1,1,0,Points-PointsKO-Adjacents,9
Baphia_buettneri,72,54,18,Alphahull-PointsKO-Adjacents,1794
Baphia_chrysophylla,6,2,4,Points-PointsKO-Adjacents,52
Baphia_cordifolia,10,5,5,Points-PointsKO-Adjacents,78
Baphia_cymosa,2,2,0,Points-PointsKO-Adjacents,14
Baphia_dewevrei,20,5,15,Points-PointsKO-Adjacents,124
Baphia_dewildeana,2,2,0,Points-PointsKO-Adjacents,18
Baphia_dubia,7,0,7,Points-PointsKO-Adjacents,63
Baphia_gossweileri,1,1,0,Points-PointsKO-Adjacents,9
Baphia_heudelotiana,2,2,0,Points-PointsKO-Adjacents,17
Baphia_incerta,8,1,7,Points-PointsKO-Adjacents,66
Baphia_kirkii,42,23,19,Alphahull-PointsKO-Adjacents,304
Baphia_latiloi,3,3,0,Points-PointsKO-Adjacents,27
Baphia_laurentii,29,14,15,Points-PointsKO-Adjacents,215
Baphia_laurifolia,164,127,37,Alphahull-PointsKO-Adjacents,6027
Baphia_leptobotrys,53,35,18,Alphahull-PointsKO-Adjacents,1854
Baphia_leptostemma,82,64,18,Alphahull-PointsKO-Adjacents,2604
Baphia_longipedicellata,6,0,6,Points-PointsKO-Adjacents,45
Baphia_macrocalyx,22,14,8,Points-PointsKO-Adjacents,164
Baphia_mambillensis,2,2,0,Points-PointsKO-Adjacents,18
Baphia_massaiensis,135,83,52,Alphahull-PointsKO-Adjacents,5347
Baphia_maxima,43,25,18,Alphahull-PointsKO-Adjacents,868
Baphia_nitida,235,190,45,Alphahull-PointsKO-Adjacents,4234
Baphia_obanensis,11,7,4,Points-PointsKO-Adjacents,81
Baphia_pauloi,5,5,0,Points-PointsKO-Adjacents,21
Baphia_pubescens,138,101,37,Alphahull-PointsKO-Adjacents,2937
Baphia_puguensis,9,6,3,Points-PointsKO-Adjacents,27
Baphia_punctulata,15,4,11,Points-PointsKO-Adjacents,106
Baphia_racemosa,19,7,12,Points-PointsKO-Adjacents,155
Baphia_semseiana,7,0,7,Points-PointsKO-Adjacents,30
Baphia_spathacea,14,10,4,Points-PointsKO-Adjacents,61
Baphia_speciosa,6,3,3,Points-PointsKO-Adjacents,36
Baphia_wollastonii,28,17,11,Points-PointsKO-Adjacents,155
Baphiopsis_parviflora,79,49,30,Alphahull-PointsKO-Adjacents,3155
Barbacenia_longiscapa,4,4,0,Points-PointsKO-Adjacents,31
Barbeya_oleoides,13,2,11,Points-PointsKO-Adjacents,105
Barleria_popovii,1,1,0,Points-PointsKO-Adjacents,9
Barnadesia_corymbosa,71,43,28,Alphahull-PointsKO-Adjacents,788
Barnadesia_odorata,82,0,82,Points-PointsKO-Adjacents,489
Barnadesia_parviflora,96,80,16,Alphahull-PointsKO-Adjacents,434
Barnadesia_polyacantha,79,60,19,Alphahull-PointsKO-Adjacents,471
Barnebya_dispar,24,7,17,Points-PointsKO-Adjacents,163
Barnebya_harleyi,124,107,17,Alphahull-PointsKO-Adjacents,4193
Barnebydendron_riedelii,103,50,53,Alphahull-PointsKO-Adjacents,1861
Barongia_lophandra,15,10,5,Points-PointsKO-Adjacents,29
Baronia_taratana,117,101,16,Alphahull-PointsKO-Adjacents,1389
Barringtonia_acutangula,984,867,117,Alphahull-PointsKO-Adjacents,8165
Barringtonia_apiculata,23,0,23,Points-PointsKO-Adjacents,149
Barringtonia_ashtonii,7,0,7,Points-PointsKO-Adjacents,62
Barringtonia_asiatica,89,41,48,Alphahull-PointsKO-Adjacents,338
Barringtonia_augusta,2,2,0,Points-PointsKO-Adjacents,18
Barringtonia_belagaensis,NA,NA,NA,NA,NA
Barringtonia_calyptrata,116,88,28,Alphahull-PointsKO-Adjacents,834
Barringtonia_calyptrocalyx,36,0,36,Points-PointsKO-Adjacents,231
Barringtonia_chaniana,1,1,0,Points-PointsKO-Adjacents,9
Barringtonia_conoidea,1,1,0,Points-PointsKO-Adjacents,9
Barringtonia_corneri,NA,NA,NA,NA,NA
Barringtonia_curranii,8,3,5,Points-PointsKO-Adjacents,66
Barringtonia_edulis,35,21,14,Alphahull-PointsKO-Adjacents,173
Barringtonia_filirachis,0,0,0,NA,0
Barringtonia_fusiformis,5,5,0,Points-PointsKO-Adjacents,45
Barringtonia_gigantostachya,1,1,0,Points-PointsKO-Adjacents,9
Barringtonia_glomerata,0,0,0,NA,0
Barringtonia_hallieri,1,1,0,Points-PointsKO-Adjacents,9
Barringtonia_havilandii,5,5,0,Points-PointsKO-Adjacents,34
Barringtonia_integrifolia,1,1,0,Points-PointsKO-Adjacents,9
Barringtonia_jebbiana,2,2,0,Points-PointsKO-Adjacents,18
Barringtonia_khaoluangensis,0,0,0,NA,0
Barringtonia_lanceolata,31,17,14,Points-PointsKO-Adjacents,210
Barringtonia_latiffiana,NA,NA,NA,NA,NA
Barringtonia_lauterbachii,6,1,5,Points-PointsKO-Adjacents,45
Barringtonia_longifolia,7,0,7,Points-PointsKO-Adjacents,34
Barringtonia_longisepala,7,0,7,Points-PointsKO-Adjacents,47
Barringtonia_lumina,2,2,0,Points-PointsKO-Adjacents,12
Barringtonia_macrocarpa,9,2,7,Points-PointsKO-Adjacents,71
Barringtonia_macrostachya,56,18,38,Points-PointsKO-Adjacents,444
Barringtonia_maxwelliana,0,0,0,NA,0
Barringtonia_monticola,4,4,0,Points-PointsKO-Adjacents,32
Barringtonia_neocaledonica,4,4,0,Points-PointsKO-Adjacents,34
Barringtonia_niedenzuana,10,1,9,Points-PointsKO-Adjacents,85
Barringtonia_norshamiae,1,1,0,Points-PointsKO-Adjacents,9
Barringtonia_novae-hiberniae,21,3,18,Points-PointsKO-Adjacents,154
Barringtonia_palawanensis,0,0,0,NA,0
Barringtonia_papeh,3,3,0,Points-PointsKO-Adjacents,25
Barringtonia_papuana,3,3,0,Points-PointsKO-Adjacents,27
Barringtonia_pauciflora,3,3,0,Points-PointsKO-Adjacents,27
Barringtonia_payensiana,0,0,0,NA,0
Barringtonia_pendula,17,3,14,Points-PointsKO-Adjacents,121
Barringtonia_pinnifolia,3,3,0,Points-PointsKO-Adjacents,16
Barringtonia_procera,17,1,16,Points-PointsKO-Adjacents,119
Barringtonia_pseudoglomerata,0,0,0,NA,0
Barringtonia_pterita,1,1,0,Points-PointsKO-Adjacents,9
Barringtonia_racemosa,224,88,136,Alphahull-PointsKO-Adjacents,1967
Barringtonia_reticulata,15,3,12,Points-PointsKO-Adjacents,115
Barringtonia_revoluta,5,5,0,Points-PointsKO-Adjacents,38
Barringtonia_ridsdalei,NA,NA,NA,NA,NA
Barringtonia_rimata,NA,NA,NA,NA,NA
Barringtonia_samoensis,20,1,19,Points-PointsKO-Adjacents,90
Barringtonia_sarawakensis,0,0,0,NA,0
Barringtonia_sarcostachys,13,3,10,Points-PointsKO-Adjacents,100
Barringtonia_scortechinii,21,5,16,Points-PointsKO-Adjacents,173
Barringtonia_seaturae,0,0,0,NA,0
Barringtonia_serenae,2,2,0,Points-PointsKO-Adjacents,9
Barringtonia_tagala,2,2,0,Points-PointsKO-Adjacents,9
Barringtonia_terengganuensis,0,0,0,NA,0
Barringtonia_waasii,0,0,0,NA,0
Barringtonia_zainudiniana,NA,NA,NA,NA,NA
Barteria_dewevrei,114,74,40,Alphahull-PointsKO-Adjacents,5167
Barteria_fistulosa,608,0,608,Points-PointsKO-Adjacents,1748
Barteria_nigritana,151,112,39,Alphahull-PointsKO-Adjacents,2502
Barteria_solida,25,11,14,Points-PointsKO-Adjacents,163
Bartholomaea_mollis,5,5,0,Points-PointsKO-Adjacents,45
Bartholomaea_paniculata,4,4,0,Points-PointsKO-Adjacents,36
Bartholomaea_sessiliflora,16,6,10,Points-PointsKO-Adjacents,125
Bartlettina_platyphylla,45,23,22,Alphahull-PointsKO-Adjacents,287
Bartlettina_prionophylla,12,4,8,Points-PointsKO-Adjacents,71
Basananthe_berberoides,1,1,0,Points-PointsKO-Adjacents,9
Basiloxylon_brasiliensis,128,0,128,Points-PointsKO-Adjacents,960
Basisperma_lanceolata,6,2,4,Points-PointsKO-Adjacents,24
Basselinia_deplanchei,34,25,9,Alphahull-PointsKO-Adjacents,83
Basselinia_eriostachys,5,5,0,Points-PointsKO-Adjacents,42
Basselinia_favieri,3,3,0,Points-PointsKO-Adjacents,7
Basselinia_glabrata,12,4,8,Points-PointsKO-Adjacents,34
Basselinia_gracilis,81,67,14,Alphahull-PointsKO-Adjacents,155
Basselinia_humboldtiana,6,1,5,Points-PointsKO-Adjacents,35
Basselinia_iterata,3,3,0,Points-PointsKO-Adjacents,8
Basselinia_moorei,1,1,0,Points-PointsKO-Adjacents,8
Basselinia_pancheri,72,52,20,Alphahull-PointsKO-Adjacents,186
Basselinia_porphyrea,3,3,0,Points-PointsKO-Adjacents,18
Basselinia_sordida,9,2,7,Points-PointsKO-Adjacents,48
Basselinia_tomentosa,5,5,0,Points-PointsKO-Adjacents,15
Basselinia_velutina,7,5,2,Points-PointsKO-Adjacents,37
Basselinia_vestita,3,3,0,Points-PointsKO-Adjacents,12
Bastardiopsis_densiflora,287,254,33,Alphahull-PointsKO-Adjacents,8825
Bastardiopsis_eggersii,2,2,0,Points-PointsKO-Adjacents,12
Bastardiopsis_grewiifolia,7,0,7,Points-PointsKO-Adjacents,57
Bastardiopsis_myrianthus,43,22,21,Alphahull-PointsKO-Adjacents,463
Batesia_floribunda,152,89,63,Alphahull-PointsKO-Adjacents,10414
Bathiorhamnus_capuronii,11,3,8,Points-PointsKO-Adjacents,75
Bathiorhamnus_cryptophorus,10,4,6,Points-PointsKO-Adjacents,49
Bathiorhamnus_dentatus,14,8,6,Points-PointsKO-Adjacents,90
Bathiorhamnus_louvelii,38,24,14,Alphahull-PointsKO-Adjacents,320
Bathiorhamnus_macrocarpus,19,7,12,Points-PointsKO-Adjacents,97
Bathiorhamnus_reticulatus,24,12,12,Points-PointsKO-Adjacents,173
Bathiorhamnus_vohemarensis,2,2,0,Points-PointsKO-Adjacents,14
Bathysa_australis,570,501,69,Alphahull-PointsKO-Adjacents,6540
Bathysa_bathysoides,15,1,14,Points-PointsKO-Adjacents,134
Bathysa_gymnocarpa,75,45,30,Alphahull-PointsKO-Adjacents,320
Bathysa_mendoncae,119,86,33,Alphahull-PointsKO-Adjacents,1416
Bathysa_nicholsonii,112,0,112,Points-PointsKO-Adjacents,787
Bathysa_perijaensis,2,2,0,Points-PointsKO-Adjacents,18
Bathysa_pittieri,9,3,6,Points-PointsKO-Adjacents,46
Bathysa_stipulata,126,0,126,Points-PointsKO-Adjacents,547
Bathysa_sylvestrae,10,6,4,Points-PointsKO-Adjacents,39
Batocarpus_amazonicus,199,125,74,Alphahull-PointsKO-Adjacents,13183
Batocarpus_costaricensis,225,177,48,Alphahull-PointsKO-Adjacents,6196
Batocarpus_orinocensis,180,151,29,Alphahull-PointsKO-Adjacents,9151
Baudouinia_capuronii,2,2,0,Points-PointsKO-Adjacents,13
Baudouinia_fluggeiformis,216,180,36,Alphahull-PointsKO-Adjacents,2464
Baudouinia_louvelii,14,12,2,Points-PointsKO-Adjacents,21
Baudouinia_orientalis,2,2,0,Points-PointsKO-Adjacents,15
Baudouinia_rouxevillei,15,13,2,Points-PointsKO-Adjacents,67
Bauhinia_acreana,215,152,63,Alphahull-PointsKO-Adjacents,15832
Bauhinia_aculeata,308,214,94,Alphahull-PointsKO-Adjacents,7617
Bauhinia_acuminata,9,0,9,Points-PointsKO-Adjacents,60
Bauhinia_acuruana,524,484,40,Alphahull-PointsKO-Adjacents,14336
Bauhinia_andrieuxii,23,10,13,Points-PointsKO-Adjacents,139
Bauhinia_arborea,29,24,5,Alphahull-PointsKO-Adjacents,348
Bauhinia_augustii,2,2,0,Points-PointsKO-Adjacents,18
Bauhinia_aurantiaca,5,5,0,Points-PointsKO-Adjacents,40
Bauhinia_aureopunctata,13,1,12,Points-PointsKO-Adjacents,117
Bauhinia_ayabacensis,3,3,0,Points-PointsKO-Adjacents,18
Bauhinia_bartlettii,8,3,5,Points-PointsKO-Adjacents,44
Bauhinia_bauhinioides,82,50,32,Alphahull-PointsKO-Adjacents,1830
Bauhinia_beguinotii,82,51,31,Alphahull-PointsKO-Adjacents,1116
Bauhinia_bicolor,14,3,11,Points-PointsKO-Adjacents,116
Bauhinia_bombaciflora,84,60,24,Alphahull-PointsKO-Adjacents,5592
Bauhinia_bowkeri,11,1,10,Points-PointsKO-Adjacents,96
Bauhinia_brachycalyx,91,63,28,Alphahull-PointsKO-Adjacents,2870
Bauhinia_brachycarpa,146,113,33,Alphahull-PointsKO-Adjacents,10248
Bauhinia_brevicalyx,11,5,6,Points-PointsKO-Adjacents,65
Bauhinia_caloneura,3,2,1,Points-PointsKO-Adjacents,27
Bauhinia_catingae,243,215,28,Alphahull-PointsKO-Adjacents,7693
Bauhinia_cercidifolia,NA,NA,NA,NA,NA
Bauhinia_chapulhuacania,17,13,4,Points-PointsKO-Adjacents,67
Bauhinia_cheilantha,734,668,66,Alphahull-PointsKO-Adjacents,27923
Bauhinia_cinnamomea,66,25,41,Alphahull-PointsKO-Adjacents,3417
Bauhinia_coclensis,3,3,0,Points-PointsKO-Adjacents,12
Bauhinia_conwayi,27,5,22,Points-PointsKO-Adjacents,206
Bauhinia_cookii,49,0,49,Points-PointsKO-Adjacents,285
Bauhinia_coulteri,107,96,11,Alphahull-PointsKO-Adjacents,459
Bauhinia_cunninghamii,1663,1618,45,Alphahull-PointsKO-Adjacents,11894
Bauhinia_cupulata,344,290,54,Alphahull-PointsKO-Adjacents,16550
Bauhinia_curvula,102,70,32,Alphahull-PointsKO-Adjacents,6090
Bauhinia_decandra,34,26,8,Alphahull-PointsKO-Adjacents,1172
Bauhinia_deserti,69,0,69,Points-PointsKO-Adjacents,196
Bauhinia_dipetala,69,49,20,Alphahull-PointsKO-Adjacents,1395
Bauhinia_divaricata,1738,1546,192,Alphahull-PointsKO-Adjacents,15127
Bauhinia_eilertsii,18,6,12,Points-PointsKO-Adjacents,129
Bauhinia_ellenbeckii,10,3,7,Points-PointsKO-Adjacents,54
Bauhinia_erythrocalyx,83,75,8,Alphahull-PointsKO-Adjacents,353
Bauhinia_flagelliflora,1,1,0,Points-PointsKO-Adjacents,9
Bauhinia_forficata,1462,1276,186,Alphahull-PointsKO-Adjacents,41013
Bauhinia_foveolata,NA,NA,NA,NA,NA
Bauhinia_galpinii,147,103,44,Alphahull-PointsKO-Adjacents,3058
Bauhinia_gardneri,37,21,16,Alphahull-PointsKO-Adjacents,732
Bauhinia_glaziovii,5,5,0,Points-PointsKO-Adjacents,45
Bauhinia_goyazensis,25,16,9,Points-PointsKO-Adjacents,184
Bauhinia_grandifolia,9,1,8,Points-PointsKO-Adjacents,71
Bauhinia_grevei,64,48,16,Alphahull-PointsKO-Adjacents,1953
Bauhinia_hagenbeckii,32,13,19,Points-PointsKO-Adjacents,210
Bauhinia_haughtii,6,1,5,Points-PointsKO-Adjacents,45
Bauhinia_hildebrandtii,106,82,24,Alphahull-PointsKO-Adjacents,904
Bauhinia_integerrima,33,0,33,Points-PointsKO-Adjacents,196
Bauhinia_japonica,10,0,10,Points-PointsKO-Adjacents,75
Bauhinia_jenningsii,245,0,245,Points-PointsKO-Adjacents,683
Bauhinia_leptantha,24,14,10,Points-PointsKO-Adjacents,100
Bauhinia_loeseneriana,8,3,5,Points-PointsKO-Adjacents,57
Bauhinia_longicuspis,500,405,95,Alphahull-PointsKO-Adjacents,56970
Bauhinia_longifolia,915,816,99,Alphahull-PointsKO-Adjacents,33712
Bauhinia_longipedicellata,43,19,24,Points-PointsKO-Adjacents,335
Bauhinia_lunarioides,38,23,15,Alphahull-PointsKO-Adjacents,1150
Bauhinia_macranthera,186,160,26,Alphahull-PointsKO-Adjacents,1340
Bauhinia_madagascariensis,104,83,21,Alphahull-PointsKO-Adjacents,885
Bauhinia_malabarica,203,170,33,Alphahull-PointsKO-Adjacents,1033
Bauhinia_membranacea,70,45,25,Alphahull-PointsKO-Adjacents,1772
Bauhinia_mendoncae,5,4,1,Points-PointsKO-Adjacents,43
Bauhinia_mollis,291,238,53,Alphahull-PointsKO-Adjacents,16271
Bauhinia_monandra,51,34,17,Alphahull-PointsKO-Adjacents,1119
Bauhinia_morondavensis,24,16,8,Points-PointsKO-Adjacents,137
Bauhinia_multinervia,29,9,20,Points-PointsKO-Adjacents,154
Bauhinia_nitida,15,0,15,Points-PointsKO-Adjacents,122
Bauhinia_ombrophila,8,4,4,Points-PointsKO-Adjacents,61
Bauhinia_ovata,81,57,24,Alphahull-PointsKO-Adjacents,1843
Bauhinia_pansamalana,14,6,8,Points-PointsKO-Adjacents,102
Bauhinia_pauletia,298,203,95,Alphahull-PointsKO-Adjacents,4659
Bauhinia_pentandra,559,486,73,Alphahull-PointsKO-Adjacents,29330
Bauhinia_pes-caprae,5,1,4,Points-PointsKO-Adjacents,37
Bauhinia_petersiana,83,42,41,Alphahull-PointsKO-Adjacents,7037
Bauhinia_petiolata,53,30,23,Alphahull-PointsKO-Adjacents,450
Bauhinia_pichinchensis,25,16,9,Points-PointsKO-Adjacents,146
Bauhinia_picta,108,84,24,Alphahull-PointsKO-Adjacents,2434
Bauhinia_platypetala,147,106,41,Alphahull-PointsKO-Adjacents,9018
Bauhinia_podopetala,41,21,20,Alphahull-PointsKO-Adjacents,446
Bauhinia_pottsii,27,7,20,Points-PointsKO-Adjacents,217
Bauhinia_prainiana,1,1,0,Points-PointsKO-Adjacents,9
Bauhinia_pringlei,54,24,30,Alphahull-PointsKO-Adjacents,761
Bauhinia_pulchella,668,596,72,Alphahull-PointsKO-Adjacents,33446
Bauhinia_purpurea,29,4,25,Points-PointsKO-Adjacents,246
Bauhinia_racemosa,2,1,1,Points-PointsKO-Adjacents,18
Bauhinia_ramosissima,123,96,27,Alphahull-PointsKO-Adjacents,1851
Bauhinia_retifolia,92,0,92,Points-PointsKO-Adjacents,345
Bauhinia_richardiana,NA,NA,NA,NA,NA
Bauhinia_roxburghiana,1,0,1,Points-PointsKO-Adjacents,9
Bauhinia_rubeleruziana,87,72,15,Alphahull-PointsKO-Adjacents,585
Bauhinia_rufa,1010,900,110,Alphahull-PointsKO-Adjacents,35154
Bauhinia_rufescens,116,68,48,Alphahull-PointsKO-Adjacents,4895
Bauhinia_saccocalyx,6,3,3,Points-PointsKO-Adjacents,48
Bauhinia_seleriana,13,8,5,Points-PointsKO-Adjacents,101
Bauhinia_stenantha,6,1,5,Points-PointsKO-Adjacents,36
Bauhinia_subrotundifolia,54,25,29,Alphahull-PointsKO-Adjacents,295
Bauhinia_tarapotensis,215,175,40,Alphahull-PointsKO-Adjacents,10650
Bauhinia_thonningii,1083,928,155,Alphahull-PointsKO-Adjacents,32165
Bauhinia_tomentosa,101,40,61,Alphahull-PointsKO-Adjacents,2825
Bauhinia_tuichiensis,18,13,5,Points-PointsKO-Adjacents,28
Bauhinia_ungulata,1795,1570,225,Alphahull-PointsKO-Adjacents,85947
Bauhinia_urbaniana,42,25,17,Alphahull-PointsKO-Adjacents,1473
Bauhinia_uruguayensis,56,30,26,Alphahull-PointsKO-Adjacents,2146
Bauhinia_variegata,35,12,23,Points-PointsKO-Adjacents,300
Bauhinia_viridescens,9,0,9,Points-PointsKO-Adjacents,66
Bauhinia_weberbaueri,19,10,9,Points-PointsKO-Adjacents,111
Bauhinia_wunderlinii,4,4,0,Points-PointsKO-Adjacents,36
Bauhinia_wuzhengyii,NA,NA,NA,NA,NA
Beaucarnea_goldmanii,44,31,13,Alphahull-PointsKO-Adjacents,200
Beaucarnea_gracilis,140,127,13,Alphahull-PointsKO-Adjacents,112
Beaucarnea_guatemalensis,6,0,6,Points-PointsKO-Adjacents,43
Beaucarnea_hiriartiae,3,3,0,Points-PointsKO-Adjacents,21
Beaucarnea_pliabilis,61,42,19,Alphahull-PointsKO-Adjacents,1578
Beaucarnea_recurvata,67,52,15,Alphahull-PointsKO-Adjacents,610
Beaucarnea_sanctomariana,0,0,0,NA,0
Beaucarnea_stricta,29,22,7,Alphahull-PointsKO-Adjacents,132
Beauprea_asplenioides,5,5,0,Points-PointsKO-Adjacents,30
Beauprea_balansae,1,1,0,Points-PointsKO-Adjacents,9
Beauprea_comptonii,3,3,0,Points-PointsKO-Adjacents,13
Beauprea_congesta,4,4,0,Points-PointsKO-Adjacents,23
Beauprea_crassifolia,1,1,0,Points-PointsKO-Adjacents,7
Beauprea_filipes,5,5,0,Points-PointsKO-Adjacents,28
Beauprea_montana,11,6,5,Points-PointsKO-Adjacents,52
Beauprea_pancheri,18,10,8,Points-PointsKO-Adjacents,80
Beauprea_spathulifolia,8,2,6,Points-PointsKO-Adjacents,39
Beaupreopsis_paniculata,19,15,4,Points-PointsKO-Adjacents,51
Beautempsia_avicenniifolia,38,27,11,Alphahull-PointsKO-Adjacents,429
Beccariophoenix_alfredii,2,2,0,Points-PointsKO-Adjacents,18
Beccariophoenix_madagascariensis,19,6,13,Points-PointsKO-Adjacents,87
Beguea_apetala,15,3,12,Points-PointsKO-Adjacents,107
Behaimia_cubensis,2,1,1,Points-PointsKO-Adjacents,18
Behuria_insignis,30,0,30,Points-PointsKO-Adjacents,149
Beilschmiedia_aborensis,0,0,0,NA,0
Beilschmiedia_acuta,6,3,3,Points-PointsKO-Adjacents,35
Beilschmiedia_acutifolia,9,1,8,Points-PointsKO-Adjacents,68
Beilschmiedia_alata,9,1,8,Points-PointsKO-Adjacents,39
Beilschmiedia_alloiophylla,87,54,33,Alphahull-PointsKO-Adjacents,894
Beilschmiedia_ambigua,0,0,0,NA,0
Beilschmiedia_anacardioides,6,1,5,Points-PointsKO-Adjacents,54
Beilschmiedia_andamanensis,NA,NA,NA,NA,NA
Beilschmiedia_angustielliptica,3,2,1,Points-PointsKO-Adjacents,27
Beilschmiedia_angustifolia,15,5,10,Points-PointsKO-Adjacents,105
Beilschmiedia_appendiculata,9,2,7,Points-PointsKO-Adjacents,81
Beilschmiedia_argentata,1,0,1,Points-PointsKO-Adjacents,9
Beilschmiedia_assamica,2,1,1,Points-PointsKO-Adjacents,18
Beilschmiedia_atrata,0,0,0,NA,0
Beilschmiedia_auriculata,6,2,4,Points-PointsKO-Adjacents,50
Beilschmiedia_balansae,0,0,0,NA,0
Beilschmiedia_bancroftii,158,147,11,Alphahull-PointsKO-Adjacents,224
Beilschmiedia_bangkae,0,0,0,NA,0
Beilschmiedia_baotingensis,1,1,0,Points-PointsKO-Adjacents,9
Beilschmiedia_barensis,0,0,0,NA,0
Beilschmiedia_batangensis,NA,NA,NA,NA,NA
Beilschmiedia_berteroana,28,14,14,Points-PointsKO-Adjacents,159
Beilschmiedia_bhutanica,NA,NA,NA,NA,NA
Beilschmiedia_brachystachys,2,2,0,Points-PointsKO-Adjacents,16
Beilschmiedia_brachythyrsa,2,2,0,Points-PointsKO-Adjacents,18
Beilschmiedia_bracteata,1,1,0,Points-PointsKO-Adjacents,9
Beilschmiedia_brandisii,0,0,0,NA,0
Beilschmiedia_brassii,1,1,0,Points-PointsKO-Adjacents,9
Beilschmiedia_brenesii,71,60,11,Alphahull-PointsKO-Adjacents,365
Beilschmiedia_brevifolia,1,1,0,Points-PointsKO-Adjacents,9
Beilschmiedia_brevipaniculata,6,0,6,Points-PointsKO-Adjacents,54
Beilschmiedia_brunnea,60,51,9,Alphahull-PointsKO-Adjacents,70
Beilschmiedia_calcitranthera,8,2,6,Points-PointsKO-Adjacents,70
Beilschmiedia_caloneura,8,2,6,Points-PointsKO-Adjacents,55
Beilschmiedia_castrisinensis,42,38,4,Alphahull-PointsKO-Adjacents,23
Beilschmiedia_caudata,5,1,4,Points-PointsKO-Adjacents,41
Beilschmiedia_chevalieri,13,6,7,Points-PointsKO-Adjacents,93
Beilschmiedia_cinnamomea,4,4,0,Points-PointsKO-Adjacents,36
Beilschmiedia_clarkei,0,0,0,NA,0
Beilschmiedia_collina,134,119,15,Alphahull-PointsKO-Adjacents,248
Beilschmiedia_congestiflora,NA,NA,NA,NA,NA
Beilschmiedia_congolana,10,0,10,Points-PointsKO-Adjacents,90
Beilschmiedia_corbisieri,8,2,6,Points-PointsKO-Adjacents,72
Beilschmiedia_costaricensis,321,263,58,Alphahull-PointsKO-Adjacents,5163
Beilschmiedia_crassa,NA,NA,NA,NA,NA
Beilschmiedia_crassifolia,0,0,0,NA,0
Beilschmiedia_crassipes,NA,NA,NA,NA,NA
Beilschmiedia_cryptocaryoides,5,1,4,Points-PointsKO-Adjacents,44
Beilschmiedia_curviramea,17,6,11,Points-PointsKO-Adjacents,117
Beilschmiedia_cuspidata,4,4,0,Points-PointsKO-Adjacents,24
Beilschmiedia_cylindrica,NA,NA,NA,NA,NA
Beilschmiedia_dalzellii,0,0,0,NA,0
Beilschmiedia_dawei,13,8,5,Points-PointsKO-Adjacents,77
Beilschmiedia_descoingsii,0,0,0,NA,0
Beilschmiedia_dictyoneura,2,1,1,Points-PointsKO-Adjacents,17
Beilschmiedia_dielsiana,NA,NA,NA,NA,NA
Beilschmiedia_dilmyana,0,0,0,NA,0
Beilschmiedia_dinklagei,10,5,5,Points-PointsKO-Adjacents,87
Beilschmiedia_discolor,3,3,0,Points-PointsKO-Adjacents,27
Beilschmiedia_diversiflora,3,2,1,Points-PointsKO-Adjacents,27
Beilschmiedia_djalonensis,6,1,5,Points-PointsKO-Adjacents,33
Beilschmiedia_donisii,1,1,0,Points-PointsKO-Adjacents,9
Beilschmiedia_elata,1,1,0,Points-PointsKO-Adjacents,9
Beilschmiedia_elegantissima,0,0,0,NA,0
Beilschmiedia_elliptica,327,302,25,Alphahull-PointsKO-Adjacents,801
Beilschmiedia_emarginata,64,0,64,Points-PointsKO-Adjacents,389
Beilschmiedia_erythrophloia,318,300,18,Alphahull-PointsKO-Adjacents,344
Beilschmiedia_fasciata,3,3,0,Points-PointsKO-Adjacents,27
Beilschmiedia_ferruginea,0,0,0,NA,0
Beilschmiedia_fluminensis,23,8,15,Points-PointsKO-Adjacents,171
Beilschmiedia_fordii,11,3,8,Points-PointsKO-Adjacents,99
Beilschmiedia_fruticosa,3,3,0,Points-PointsKO-Adjacents,27
Beilschmiedia_fulva,19,11,8,Points-PointsKO-Adjacents,146
Beilschmiedia_furfuracea,1,1,0,Points-PointsKO-Adjacents,9
Beilschmiedia_gaboonensis,11,3,8,Points-PointsKO-Adjacents,88
Beilschmiedia_gallatlyi,NA,NA,NA,NA,NA
Beilschmiedia_gammieana,0,0,0,NA,0
Beilschmiedia_gemmiflora,1,1,0,Points-PointsKO-Adjacents,9
Beilschmiedia_gigantocarpa,0,0,0,NA,0
Beilschmiedia_gilbertii,6,3,3,Points-PointsKO-Adjacents,39
Beilschmiedia_giorgii,1,1,0,Points-PointsKO-Adjacents,9
Beilschmiedia_gitingensis,2,2,0,Points-PointsKO-Adjacents,8
Beilschmiedia_glabra,6,0,6,Points-PointsKO-Adjacents,48
Beilschmiedia_glandulosa,NA,NA,NA,NA,NA
Beilschmiedia_glauca,4,4,0,Points-PointsKO-Adjacents,27
Beilschmiedia_glauciphylla,2,2,0,Points-PointsKO-Adjacents,18
Beilschmiedia_glaucoides,4,4,0,Points-PointsKO-Adjacents,27
Beilschmiedia_globularia,0,0,0,NA,0
Beilschmiedia_glomerata,3,3,0,Points-PointsKO-Adjacents,24
Beilschmiedia_grandibracteata,3,2,1,Points-PointsKO-Adjacents,27
Beilschmiedia_grandifolia,8,1,7,Points-PointsKO-Adjacents,54
Beilschmiedia_grandiosa,12,0,12,Points-PointsKO-Adjacents,99
Beilschmiedia_gynotrochioides,0,0,0,NA,0
Beilschmiedia_hartonoana,2,2,0,Points-PointsKO-Adjacents,18
Beilschmiedia_henghsienensis,1,1,0,Points-PointsKO-Adjacents,9
Beilschmiedia_hermanii,2,2,0,Points-PointsKO-Adjacents,18
Beilschmiedia_hexanthera,2,2,0,Points-PointsKO-Adjacents,18
Beilschmiedia_hondurensis,42,29,13,Alphahull-PointsKO-Adjacents,987
Beilschmiedia_hutchinsoniana,1,1,0,Points-PointsKO-Adjacents,9
Beilschmiedia_immersinervis,9,4,5,Points-PointsKO-Adjacents,33
Beilschmiedia_inconspicua,3,3,0,Points-PointsKO-Adjacents,18
Beilschmiedia_insignis,2,2,0,Points-PointsKO-Adjacents,9
Beilschmiedia_insularum,4,4,0,Points-PointsKO-Adjacents,36
Beilschmiedia_intermedia,13,0,13,Points-PointsKO-Adjacents,104
Beilschmiedia_jabassensis,1,1,0,Points-PointsKO-Adjacents,9
Beilschmiedia_jacques-felixii,4,4,0,Points-PointsKO-Adjacents,36
Beilschmiedia_javanica,0,0,0,NA,0
Beilschmiedia_kinabaluensis,2,1,1,Points-PointsKO-Adjacents,18
Beilschmiedia_klainei,13,5,8,Points-PointsKO-Adjacents,93
Beilschmiedia_kostermansiana,1,1,0,Points-PointsKO-Adjacents,9
Beilschmiedia_kunstleri,2,0,2,Points-PointsKO-Adjacents,15
Beilschmiedia_kwangsiensis,2,2,0,Points-PointsKO-Adjacents,18
Beilschmiedia_kweichowensis,9,0,9,Points-PointsKO-Adjacents,81
Beilschmiedia_kweo,12,6,6,Points-PointsKO-Adjacents,58
Beilschmiedia_laevis,5,3,2,Points-PointsKO-Adjacents,36
Beilschmiedia_lanatella,NA,NA,NA,NA,NA
Beilschmiedia_lancifolia,0,0,0,NA,0
Beilschmiedia_lancilimba,0,0,0,NA,0
Beilschmiedia_latifolia,63,35,28,Alphahull-PointsKO-Adjacents,280
Beilschmiedia_lebrunii,1,1,0,Points-PointsKO-Adjacents,9
Beilschmiedia_ledermannii,NA,NA,NA,NA,NA
Beilschmiedia_le-testui,0,0,0,NA,0
Beilschmiedia_letouzeyi,0,0,0,NA,0
Beilschmiedia_linharensis,23,13,10,Points-PointsKO-Adjacents,128
Beilschmiedia_linocieroides,3,3,0,Points-PointsKO-Adjacents,27
Beilschmiedia_longepetiolata,1,1,0,Points-PointsKO-Adjacents,9
Beilschmiedia_longifolia,NA,NA,NA,NA,NA
Beilschmiedia_louisii,3,3,0,Points-PointsKO-Adjacents,12
Beilschmiedia_lucidula,2,0,2,Points-PointsKO-Adjacents,18
Beilschmiedia_lumutensis,0,0,0,NA,0
Beilschmiedia_macrocarpa,0,0,0,NA,0
Beilschmiedia_macrophylla,0,0,0,NA,0
Beilschmiedia_macropoda,3,3,0,Points-PointsKO-Adjacents,27
Beilschmiedia_madagascariensis,45,0,45,Points-PointsKO-Adjacents,116
Beilschmiedia_madang,10,3,7,Points-PointsKO-Adjacents,79
Beilschmiedia_maingayi,4,0,4,Points-PointsKO-Adjacents,34
Beilschmiedia_manantlanensis,8,0,8,Points-PointsKO-Adjacents,33
Beilschmiedia_mannii,88,54,34,Alphahull-PointsKO-Adjacents,2721
Beilschmiedia_mannioides,6,1,5,Points-PointsKO-Adjacents,45
Beilschmiedia_marginata,0,0,0,NA,0
Beilschmiedia_mayumbensis,3,3,0,Points-PointsKO-Adjacents,25
Beilschmiedia_membranacea,1,1,0,Points-PointsKO-Adjacents,9
Beilschmiedia_membranifolia,2,2,0,Points-PointsKO-Adjacents,18
Beilschmiedia_mexicana,115,97,18,Alphahull-PointsKO-Adjacents,1704
Beilschmiedia_michelsonii,6,2,4,Points-PointsKO-Adjacents,39
Beilschmiedia_micrantha,4,0,4,Points-PointsKO-Adjacents,36
Beilschmiedia_microcarpa,NA,NA,NA,NA,NA
Beilschmiedia_microphylla,8,7,1,Points-PointsKO-Adjacents,33
Beilschmiedia_miersii,12,6,6,Points-PointsKO-Adjacents,87
Beilschmiedia_minutiflora,11,2,9,Points-PointsKO-Adjacents,83
Beilschmiedia_montanoides,0,0,0,NA,0
Beilschmiedia_moratii,19,0,19,Points-PointsKO-Adjacents,118
Beilschmiedia_morobensis,6,2,4,Points-PointsKO-Adjacents,27
Beilschmiedia_muricata,0,0,0,NA,0
Beilschmiedia_murutensis,0,0,0,NA,0
Beilschmiedia_myrciifolia,1,1,0,Points-PointsKO-Adjacents,9
Beilschmiedia_myrmecophila,0,0,0,NA,0
Beilschmiedia_ndongensis,NA,NA,NA,NA,NA
Beilschmiedia_neocaledonica,3,3,0,Points-PointsKO-Adjacents,23
Beilschmiedia_neoletestui,3,3,0,Points-PointsKO-Adjacents,27
Beilschmiedia_ningmingensis,NA,NA,NA,NA,NA
Beilschmiedia_nitida,1,1,0,Points-PointsKO-Adjacents,9
Beilschmiedia_novae-britanniae,1,1,0,Points-PointsKO-Adjacents,6
Beilschmiedia_novo-guineensis,0,0,0,NA,0
Beilschmiedia_obconica,2,2,0,Points-PointsKO-Adjacents,18
Beilschmiedia_oblonga,0,0,0,NA,0
Beilschmiedia_oblongifolia,9,3,6,Points-PointsKO-Adjacents,75
Beilschmiedia_obovalifoliosa,1,1,0,Points-PointsKO-Adjacents,9
Beilschmiedia_obovata,2,2,0,Points-PointsKO-Adjacents,18
Beilschmiedia_obovatifoliosa,NA,NA,NA,NA,NA
Beilschmiedia_obscurinervia,2,2,0,Points-PointsKO-Adjacents,18
Beilschmiedia_obtusifolia,424,367,57,Alphahull-PointsKO-Adjacents,2087
Beilschmiedia_oligandra,66,55,11,Alphahull-PointsKO-Adjacents,70
Beilschmiedia_oligantha,1,1,0,Points-PointsKO-Adjacents,9
Beilschmiedia_olivacea,3,3,0,Points-PointsKO-Adjacents,27
Beilschmiedia_opposita,13,7,6,Points-PointsKO-Adjacents,72
Beilschmiedia_oreophila,22,9,13,Points-PointsKO-Adjacents,116
Beilschmiedia_ovalioides,15,6,9,Points-PointsKO-Adjacents,57
Beilschmiedia_ovalis,37,22,15,Alphahull-PointsKO-Adjacents,220
Beilschmiedia_ovoidea,NA,NA,NA,NA,NA
Beilschmiedia_pahangensis,0,0,0,NA,0
Beilschmiedia_palembanica,4,0,4,Points-PointsKO-Adjacents,36
Beilschmiedia_papyracea,1,0,1,Points-PointsKO-Adjacents,9
Beilschmiedia_parvifolia,0,0,0,NA,0
Beilschmiedia_pauciflora,1,1,0,Points-PointsKO-Adjacents,9
Beilschmiedia_paulocordata,3,3,0,Points-PointsKO-Adjacents,27
Beilschmiedia_pedicellata,32,23,9,Alphahull-PointsKO-Adjacents,198
Beilschmiedia_pellegrinii,2,2,0,Points-PointsKO-Adjacents,18
Beilschmiedia_penangiana,0,0,0,NA,0
Beilschmiedia_pendula,448,357,91,Alphahull-PointsKO-Adjacents,5935
Beilschmiedia_peninsularis,45,38,7,Alphahull-PointsKO-Adjacents,86
Beilschmiedia_percoriacea,10,0,10,Points-PointsKO-Adjacents,81
Beilschmiedia_pergamentacea,5,5,0,Points-PointsKO-Adjacents,45
Beilschmiedia_phoebeopsis,0,0,0,NA,0
Beilschmiedia_pierreana,8,1,7,Points-PointsKO-Adjacents,53
Beilschmiedia_pilosa,1,1,0,Points-PointsKO-Adjacents,9
Beilschmiedia_podagrica,1,1,0,Points-PointsKO-Adjacents,9
Beilschmiedia_poilanei,0,0,0,NA,0
Beilschmiedia_preussii,1,1,0,Points-PointsKO-Adjacents,9
Beilschmiedia_preussioides,1,1,0,Points-PointsKO-Adjacents,9
Beilschmiedia_pubescens,NA,NA,NA,NA,NA
Beilschmiedia_pullenii,0,0,0,NA,0
Beilschmiedia_punctilimba,1,1,0,Points-PointsKO-Adjacents,9
Beilschmiedia_purpurascens,2,2,0,Points-PointsKO-Adjacents,18
Beilschmiedia_purpurea,1,1,0,Points-PointsKO-Adjacents,9
Beilschmiedia_recurva,115,104,11,Alphahull-PointsKO-Adjacents,174
Beilschmiedia_reticulata,0,0,0,NA,0
Beilschmiedia_rigida,25,13,12,Points-PointsKO-Adjacents,182
Beilschmiedia_riparia,76,47,29,Alphahull-PointsKO-Adjacents,963
Beilschmiedia_rivularis,0,0,0,NA,0
Beilschmiedia_robertsonii,0,0,0,NA,0
Beilschmiedia_robusta,10,4,6,Points-PointsKO-Adjacents,90
Beilschmiedia_robynsiana,NA,NA,NA,NA,NA
Beilschmiedia_rosseliana,0,0,0,NA,0
Beilschmiedia_roxburghiana,8,0,8,Points-PointsKO-Adjacents,72
Beilschmiedia_rufohirtella,6,1,5,Points-PointsKO-Adjacents,54
Beilschmiedia_rufolanata,0,0,0,NA,0
Beilschmiedia_rufoperulata,0,0,0,NA,0
Beilschmiedia_rugosa,7,2,5,Points-PointsKO-Adjacents,42
Beilschmiedia_rwandensis,1,1,0,Points-PointsKO-Adjacents,9
Beilschmiedia_sary,11,0,11,Points-PointsKO-Adjacents,63
Beilschmiedia_schmitzii,7,1,6,Points-PointsKO-Adjacents,43
Beilschmiedia_scintillans,7,2,5,Points-PointsKO-Adjacents,55
Beilschmiedia_sericans,4,4,0,Points-PointsKO-Adjacents,33
Beilschmiedia_sericea,NA,NA,NA,NA,NA
Beilschmiedia_sessilifolia,4,3,1,Points-PointsKO-Adjacents,36
Beilschmiedia_shangsiensis,NA,NA,NA,NA,NA
Beilschmiedia_sichourensis,0,0,0,NA,0
Beilschmiedia_sikkimensis,0,0,0,NA,0
Beilschmiedia_staudtii,5,4,1,Points-PointsKO-Adjacents,30
Beilschmiedia_steyermarkii,4,4,0,Points-PointsKO-Adjacents,36
Beilschmiedia_stricta,2,2,0,Points-PointsKO-Adjacents,18
Beilschmiedia_sulcata,35,7,28,Points-PointsKO-Adjacents,294
Beilschmiedia_sumatrensis,0,0,0,NA,0
Beilschmiedia_superba,0,0,0,NA,0
Beilschmiedia_supraglandulosa,NA,NA,NA,NA,NA
Beilschmiedia_talbotiae,2,2,0,Points-PointsKO-Adjacents,18
Beilschmiedia_tarairi,486,449,37,Alphahull-PointsKO-Adjacents,657
Beilschmiedia_taubertiana,52,39,13,Alphahull-PointsKO-Adjacents,1251
Beilschmiedia_tawa,5625,5560,65,Alphahull-PointsKO-Adjacents,2132
Beilschmiedia_tawaensis,1,1,0,Points-PointsKO-Adjacents,9
Beilschmiedia_tawaroa,106,0,106,Points-PointsKO-Adjacents,214
Beilschmiedia_telupidensis,NA,NA,NA,NA,NA
Beilschmiedia_thollonii,0,0,0,NA,0
Beilschmiedia_tilaranensis,14,5,9,Points-PointsKO-Adjacents,75
Beilschmiedia_tirunelvelica,NA,NA,NA,NA,NA
Beilschmiedia_tooram,121,109,12,Alphahull-PointsKO-Adjacents,188
Beilschmiedia_tovarensis,335,251,84,Alphahull-PointsKO-Adjacents,5973
Beilschmiedia_triplinervis,NA,NA,NA,NA,NA
Beilschmiedia_troupinii,1,1,0,Points-PointsKO-Adjacents,9
Beilschmiedia_tsangii,64,33,31,Alphahull-PointsKO-Adjacents,286
Beilschmiedia_tungfangensis,NA,NA,NA,NA,NA
Beilschmiedia_ugandensis,27,13,14,Points-PointsKO-Adjacents,146
Beilschmiedia_variabilis,30,18,12,Points-PointsKO-Adjacents,227
Beilschmiedia_velutina,39,24,15,Alphahull-PointsKO-Adjacents,160
Beilschmiedia_velutionsa,NA,NA,NA,NA,NA
Beilschmiedia_vermoesenii,1,1,0,Points-PointsKO-Adjacents,9
Beilschmiedia_versicolor,2,2,0,Points-PointsKO-Adjacents,18
Beilschmiedia_vidalii,2,1,1,Points-PointsKO-Adjacents,18
Beilschmiedia_villosa,1,1,0,Points-PointsKO-Adjacents,9
Beilschmiedia_volckii,51,44,7,Alphahull-PointsKO-Adjacents,45
Beilschmiedia_wallichiana,2,2,0,Points-PointsKO-Adjacents,18
Beilschmiedia_wangii,9,1,8,Points-PointsKO-Adjacents,81
Beilschmiedia_wieringae,3,3,0,Points-PointsKO-Adjacents,27
Beilschmiedia_wightii,0,0,0,NA,0
Beilschmiedia_wilczekii,3,3,0,Points-PointsKO-Adjacents,27
Beilschmiedia_xizangensis,6,1,5,Points-PointsKO-Adjacents,54
Beilschmiedia_yangambiensis,2,2,0,Points-PointsKO-Adjacents,18
Beilschmiedia_yunnanensis,8,1,7,Points-PointsKO-Adjacents,59
Beilschmiedia_zahnii,1,1,0,Points-PointsKO-Adjacents,9
Beilschmiedia_zapoteoides,3,3,0,Points-PointsKO-Adjacents,23
Beilschmiedia_zenkeri,24,10,14,Points-PointsKO-Adjacents,186
Beilschmiedia_zeylanica,1,1,0,Points-PointsKO-Adjacents,9
Beiselia_mexicana,6,3,3,Points-PointsKO-Adjacents,27
Bejaria_aestuans,1073,943,130,Alphahull-PointsKO-Adjacents,21186
Bejaria_infundibula,11,6,5,Points-PointsKO-Adjacents,46
Bejaria_mathewsii,120,91,29,Alphahull-PointsKO-Adjacents,1682
Bejaria_resinosa,377,325,52,Alphahull-PointsKO-Adjacents,3053
Bejaria_sprucei,263,225,38,Alphahull-PointsKO-Adjacents,5011
Belencita_nemorosa,72,50,22,Alphahull-PointsKO-Adjacents,1063
Bellucia_acutata,106,73,33,Alphahull-PointsKO-Adjacents,4387
Bellucia_aequiloba,67,34,33,Alphahull-PointsKO-Adjacents,3492
Bellucia_dichotoma,101,56,45,Alphahull-PointsKO-Adjacents,4525
Bellucia_egensis,108,52,56,Alphahull-PointsKO-Adjacents,9641
Bellucia_gracilis,8,0,8,Points-PointsKO-Adjacents,53
Bellucia_grossularioides,1268,1148,120,Alphahull-PointsKO-Adjacents,85132
Bellucia_huberi,7,1,6,Points-PointsKO-Adjacents,44
Bellucia_klugii,11,3,8,Points-PointsKO-Adjacents,99
Bellucia_nigricans,9,0,9,Points-PointsKO-Adjacents,54
Bellucia_ovata,66,35,31,Alphahull-PointsKO-Adjacents,3825
Bellucia_pentamera,1008,870,138,Alphahull-PointsKO-Adjacents,52732
Bellucia_riparia,5,5,0,Points-PointsKO-Adjacents,42
Bellucia_spruceana,157,90,67,Alphahull-PointsKO-Adjacents,6124
Bellucia_strigosa,73,41,32,Alphahull-PointsKO-Adjacents,3802
Bellucia_subandina,78,46,32,Alphahull-PointsKO-Adjacents,1444
Bellucia_wurdackiana,4,4,0,Points-PointsKO-Adjacents,35
Belonophora_coffeoides,3,3,0,Points-PointsKO-Adjacents,15
Belonophora_coriacea,162,120,42,Alphahull-PointsKO-Adjacents,7610
Belonophora_ongensis,13,6,7,Points-PointsKO-Adjacents,73
Belonophora_talbotii,0,0,0,NA,0
Belonophora_wernhamii,41,31,10,Alphahull-PointsKO-Adjacents,327
Bembicia_axillaris,56,30,26,Alphahull-PointsKO-Adjacents,903
Benkara_armigera,5,5,0,Points-PointsKO-Adjacents,36
Benkara_fasciculata,3,3,0,Points-PointsKO-Adjacents,27
Benkara_forrestii,1,1,0,Points-PointsKO-Adjacents,9
Benkara_griffithii,21,8,13,Points-PointsKO-Adjacents,180
Benkara_malabarica,1,0,1,Points-PointsKO-Adjacents,9
Benkara_parviflora,0,0,0,NA,0
Benkara_sinensis,65,40,25,Alphahull-PointsKO-Adjacents,401
Bennettiodendron_cordatum,0,0,0,NA,0
Bennettiodendron_leprosipes,48,21,27,Alphahull-PointsKO-Adjacents,2453
Bennettiodendron_longipes,37,16,21,Points-PointsKO-Adjacents,333
Bennettiodendron_macrophyllum,37,16,21,Points-PointsKO-Adjacents,333
Bennettiodendron_subracemosum,37,16,21,Points-PointsKO-Adjacents,333
Benoistia_orientalis,37,1,36,Points-PointsKO-Adjacents,185
Benoistia_perrieri,12,5,7,Points-PointsKO-Adjacents,106
Benoistia_sambiranensis,6,1,5,Points-PointsKO-Adjacents,43
Benstonea_adinobotrys,17,3,14,Points-PointsKO-Adjacents,140
Benstonea_affinis,5,5,0,Points-PointsKO-Adjacents,45
Benstonea_ashtonii,NA,NA,NA,NA,NA
Benstonea_atrocarpa,3,2,1,Points-PointsKO-Adjacents,27
Benstonea_beccata,NA,NA,NA,NA,NA
Benstonea_brevistylis,3,3,0,Points-PointsKO-Adjacents,18
Benstonea_brunigii,1,1,0,Points-PointsKO-Adjacents,9
Benstonea_calcinacta,1,1,0,Points-PointsKO-Adjacents,9
Benstonea_celebica,4,4,0,Points-PointsKO-Adjacents,30
Benstonea_copelandii,7,0,7,Points-PointsKO-Adjacents,51
Benstonea_dumetorum,NA,NA,NA,NA,NA
Benstonea_ellipsoidea,5,5,0,Points-PointsKO-Adjacents,41
Benstonea_elostigma,NA,NA,NA,NA,NA
Benstonea_foetida,3,3,0,Points-PointsKO-Adjacents,27
Benstonea_gibbsiana,1,1,0,Points-PointsKO-Adjacents,9
Benstonea_glaucophylla,NA,NA,NA,NA,NA
Benstonea_herbacea,2,2,0,Points-PointsKO-Adjacents,18
Benstonea_inquilina,2,2,0,Points-PointsKO-Adjacents,18
Benstonea_korthalsii,7,3,4,Points-PointsKO-Adjacents,57
Benstonea_kurzii,0,0,0,NA,0
Benstonea_lauterbachii,33,14,19,Points-PointsKO-Adjacents,220
Benstonea_lepatophila,2,2,0,Points-PointsKO-Adjacents,18
Benstonea_microglottis,2,2,0,Points-PointsKO-Adjacents,12
Benstonea_monticola,77,63,14,Alphahull-PointsKO-Adjacents,172
Benstonea_odoardoi,18,5,13,Points-PointsKO-Adjacents,149
Benstonea_ornata,4,3,1,Points-PointsKO-Adjacents,34
Benstonea_ornithocephala,NA,NA,NA,NA,NA
Benstonea_parva,5,0,5,Points-PointsKO-Adjacents,45
Benstonea_pectinata,7,0,7,Points-PointsKO-Adjacents,39
Benstonea_permicron,1,1,0,Points-PointsKO-Adjacents,9
Benstonea_pilaris,NA,NA,NA,NA,NA
Benstonea_platystigma,4,4,0,Points-PointsKO-Adjacents,35
Benstonea_poronaliva,NA,NA,NA,NA,NA
Benstonea_pseudosyncarpa,3,3,0,Points-PointsKO-Adjacents,26
Benstonea_pumila,1,1,0,Points-PointsKO-Adjacents,9
Benstonea_rupestris,1,1,0,Points-PointsKO-Adjacents,9
Benstonea_rustica,4,4,0,Points-PointsKO-Adjacents,30
Benstonea_saint-johnii,1,1,0,Points-PointsKO-Adjacents,9
Benstonea_setistyla,2,2,0,Points-PointsKO-Adjacents,12
Benstonea_sobolifera,NA,NA,NA,NA,NA
Benstonea_stenocarpa,22,4,18,Points-PointsKO-Adjacents,143
Benstonea_sylvatica,3,3,0,Points-PointsKO-Adjacents,27
Benstonea_thomissophylla,4,4,0,Points-PointsKO-Adjacents,30
Benstonea_thurstonii,1,1,0,Points-PointsKO-Adjacents,9
Benstonea_toei,NA,NA,NA,NA,NA
Benstonea_tunicata,5,5,0,Points-PointsKO-Adjacents,24
Benstonea_undulifolia,1,1,0,Points-PointsKO-Adjacents,9
Benstonea_unguiculata,NA,NA,NA,NA,NA
Benstonea_verruculosa,3,3,0,Points-PointsKO-Adjacents,22
Benstonea_vriensii,NA,NA,NA,NA,NA
Bentinckia_condapanna,0,0,0,NA,0
Bentinckia_nicobarica,0,0,0,NA,0
Berberis_acutinervia,4,4,0,Points-PointsKO-Adjacents,20
Berberis_agapatensis,24,10,14,Points-PointsKO-Adjacents,122
Berberis_aristata,72,52,20,Alphahull-PointsKO-Adjacents,795
Berberis_beauverdiana,11,7,4,Points-PointsKO-Adjacents,98
Berberis_bergeriana,8,5,3,Points-PointsKO-Adjacents,44
Berberis_carupensis,4,4,0,Points-PointsKO-Adjacents,36
Berberis_chochoco,47,39,8,Alphahull-PointsKO-Adjacents,133
Berberis_dryandriphylla,2,2,0,Points-PointsKO-Adjacents,16
Berberis_floribunda,97,64,33,Alphahull-PointsKO-Adjacents,879
Berberis_fremontii,144,116,28,Alphahull-PointsKO-Adjacents,4295
Berberis_glaucocarpa,6,3,3,Points-PointsKO-Adjacents,48
Berberis_gracilis,140,119,21,Alphahull-PointsKO-Adjacents,896
Berberis_grandiflora,33,0,33,Points-PointsKO-Adjacents,175
Berberis_hartwegii,45,34,11,Alphahull-PointsKO-Adjacents,233
Berberis_hemsleyi,56,26,30,Alphahull-PointsKO-Adjacents,289
Berberis_huertasii,6,1,5,Points-PointsKO-Adjacents,50
Berberis_iliensis,5,5,0,Points-PointsKO-Adjacents,45
Berberis_incerta,16,8,8,Points-PointsKO-Adjacents,97
Berberis_jobii,6,3,3,Points-PointsKO-Adjacents,39
Berberis_johnstonii,13,0,13,Points-PointsKO-Adjacents,88
Berberis_julianae,24,3,21,Points-PointsKO-Adjacents,216
Berberis_karkaralensis,NA,NA,NA,NA,NA
Berberis_kaschgarica,17,5,12,Points-PointsKO-Adjacents,123
Berberis_latifolia,8,0,8,Points-PointsKO-Adjacents,72
Berberis_laurina,264,224,40,Alphahull-PointsKO-Adjacents,5285
Berberis_lehmannii,21,10,11,Points-PointsKO-Adjacents,157
Berberis_lilloana,11,5,6,Points-PointsKO-Adjacents,75
Berberis_littoralis,NA,NA,NA,NA,NA
Berberis_lobbiana,70,44,26,Alphahull-PointsKO-Adjacents,648
Berberis_lutea,46,29,17,Alphahull-PointsKO-Adjacents,750
Berberis_medellinensis,7,5,2,Points-PointsKO-Adjacents,35
Berberis_meollacensis,0,0,0,NA,0
Berberis_mikuna,70,41,29,Alphahull-PointsKO-Adjacents,915
Berberis_moranensis,164,124,40,Alphahull-PointsKO-Adjacents,1571
Berberis_multiflora,24,11,13,Points-PointsKO-Adjacents,160
Berberis_nilghiriensis,0,0,0,NA,0
Berberis_paniculata,21,8,13,Points-PointsKO-Adjacents,115
Berberis_petiolaris,8,0,8,Points-PointsKO-Adjacents,63
Berberis_polyantha,13,7,6,Points-PointsKO-Adjacents,117
Berberis_sanctipetrii,3,3,0,Points-PointsKO-Adjacents,27
Berberis_tabiensis,12,3,9,Points-PointsKO-Adjacents,99
Berberis_tenuifolia,33,18,15,Points-PointsKO-Adjacents,155
Berberis_volcania,71,51,20,Alphahull-PointsKO-Adjacents,116
Berberis_vulgaris,18500,15582,2918,Alphahull-PointsKO-Adjacents,69404
Berberis_wallichiana,12,0,12,Points-PointsKO-Adjacents,78
Berchemia_discolor,191,113,78,Alphahull-PointsKO-Adjacents,4294
Berchemia_floribunda,216,164,52,Alphahull-PointsKO-Adjacents,21998
Berchemia_zeyheri,130,105,25,Alphahull-PointsKO-Adjacents,2918
Berchemiella_wilsonii,5,5,0,Points-PointsKO-Adjacents,45
Berchemiella_yunnanensis,NA,NA,NA,NA,NA
Berlinia_auriculata,106,86,20,Alphahull-PointsKO-Adjacents,3084
Berlinia_bracteosa,189,169,20,Alphahull-PointsKO-Adjacents,3866
Berlinia_bruneelii,97,63,34,Alphahull-PointsKO-Adjacents,9301
Berlinia_confusa,169,122,47,Alphahull-PointsKO-Adjacents,3229
Berlinia_congolensis,66,42,24,Alphahull-PointsKO-Adjacents,1056
Berlinia_coriacea,8,3,5,Points-PointsKO-Adjacents,62
Berlinia_craibiana,56,39,17,Alphahull-PointsKO-Adjacents,1731
Berlinia_giorgii,73,48,25,Alphahull-PointsKO-Adjacents,5061
Berlinia_grandiflora,484,409,75,Alphahull-PointsKO-Adjacents,19717
Berlinia_hollandii,1,1,0,Points-PointsKO-Adjacents,9
Berlinia_lundensis,0,0,0,NA,0
Berlinia_occidentalis,76,58,18,Alphahull-PointsKO-Adjacents,1110
Berlinia_orientalis,31,22,9,Alphahull-PointsKO-Adjacents,248
Berlinia_sapinii,9,1,8,Points-PointsKO-Adjacents,81
Berlinia_tomentella,80,59,21,Alphahull-PointsKO-Adjacents,1327
Berlinia_viridicans,16,0,16,Points-PointsKO-Adjacents,119
Bernardia_chiapensis,3,2,1,Points-PointsKO-Adjacents,27
Bernardia_chinantlensis,1,1,0,Points-PointsKO-Adjacents,9
Bernardia_corensis,14,4,10,Points-PointsKO-Adjacents,57
Bernardia_dodecandra,222,195,27,Alphahull-PointsKO-Adjacents,3840
Bernardia_fonsecae,6,2,4,Points-PointsKO-Adjacents,38
Bernardia_gentryana,25,4,21,Points-PointsKO-Adjacents,167
Bernardia_hassleriana,2,2,0,Points-PointsKO-Adjacents,15
Bernardia_heteropilosa,2,2,0,Points-PointsKO-Adjacents,18
Bernardia_jacquiniana,8,2,6,Points-PointsKO-Adjacents,67
Bernardia_macrocarpa,3,3,0,Points-PointsKO-Adjacents,27
Bernardia_mollis,9,1,8,Points-PointsKO-Adjacents,54
Bernardia_nicaraguensis,75,54,21,Alphahull-PointsKO-Adjacents,551
Bernardia_oblanceolata,3,3,0,Points-PointsKO-Adjacents,21
Bernardia_pulchella,414,370,44,Alphahull-PointsKO-Adjacents,7672
Bernardia_spongiosa,15,8,7,Points-PointsKO-Adjacents,69
Bernardia_tamanduana,77,53,24,Alphahull-PointsKO-Adjacents,1789
Bernardia_trelawniensis,0,0,0,NA,0
Bernardia_valdesii,1,1,0,Points-PointsKO-Adjacents,9
Bernardia_venezuelana,4,4,0,Points-PointsKO-Adjacents,36
Bernardia_viridis,25,14,11,Points-PointsKO-Adjacents,126
Bernardia_wilburii,7,3,4,Points-PointsKO-Adjacents,39
Bernardinia_fluminensis,84,40,44,Alphahull-PointsKO-Adjacents,1098
Bernoullia_flammea,156,113,43,Alphahull-PointsKO-Adjacents,3094
Bernoullia_jaliscana,2,2,0,Points-PointsKO-Adjacents,18
Bernoullia_uribeana,3,3,0,Points-PointsKO-Adjacents,21
Berrya_cordifolia,7,0,7,Points-PointsKO-Adjacents,42
Berrya_javanica,60,35,25,Alphahull-PointsKO-Adjacents,257
Berrya_mollis,0,0,0,NA,0
Berrya_pacifica,0,0,0,NA,0
Berrya_papuana,3,3,0,Points-PointsKO-Adjacents,12
Berrya_rotundifolia,8,1,7,Points-PointsKO-Adjacents,47
Bersama_abyssinica,297,227,70,Alphahull-PointsKO-Adjacents,16339
Bersama_lucens,28,12,16,Points-PointsKO-Adjacents,234
Bersama_palustris,8,3,5,Points-PointsKO-Adjacents,29
Bersama_swinnyi,10,2,8,Points-PointsKO-Adjacents,81
Bersama_swynnertonii,0,0,0,NA,0
Bersama_yangambiensis,9,2,7,Points-PointsKO-Adjacents,62
Bertholletia_excelsa,385,314,71,Alphahull-PointsKO-Adjacents,39647
Bertiera_angustifolia,135,95,40,Alphahull-PointsKO-Adjacents,3567
Bertiera_bistipulata,0,0,0,NA,0
Bertiera_borbonica,0,0,0,NA,0
Bertiera_bracteosa,226,191,35,Alphahull-PointsKO-Adjacents,1702
Bertiera_brevithyrsa,4,4,0,Points-PointsKO-Adjacents,26
Bertiera_congolana,50,21,29,Alphahull-PointsKO-Adjacents,338
Bertiera_crinita,35,15,20,Points-PointsKO-Adjacents,151
Bertiera_globiceps,77,56,21,Alphahull-PointsKO-Adjacents,2364
Bertiera_guianensis,1058,935,123,Alphahull-PointsKO-Adjacents,88565
Bertiera_longithyrsa,32,26,6,Alphahull-PointsKO-Adjacents,124
Bertiera_naucleoides,36,14,22,Points-PointsKO-Adjacents,273
Bertiera_parviflora,55,23,32,Alphahull-PointsKO-Adjacents,2209
Bertiera_pauloi,22,15,7,Points-PointsKO-Adjacents,101
Bertiera_racemosa,400,317,83,Alphahull-PointsKO-Adjacents,11180
Bertiera_retrofracta,128,113,15,Alphahull-PointsKO-Adjacents,853
Bertiera_rosseeliana,14,7,7,Points-PointsKO-Adjacents,68
Bertiera_spicata,76,0,76,Points-PointsKO-Adjacents,490
Bertiera_subsessilis,78,56,22,Alphahull-PointsKO-Adjacents,3764
Berylsimpsonia_vanillosma,20,14,6,Points-PointsKO-Adjacents,77
Besleria_arborescens,38,28,10,Alphahull-PointsKO-Adjacents,143
Besleria_decipiens,2,1,1,Points-PointsKO-Adjacents,18
Besleria_laxiflora,450,364,86,Alphahull-PointsKO-Adjacents,7792
Besleria_lutea,34,18,16,Points-PointsKO-Adjacents,153
Besleria_solanoides,631,560,71,Alphahull-PointsKO-Adjacents,5413
Betula_albosinensis,99,61,38,Alphahull-PointsKO-Adjacents,7907
Betula_alleghaniensis,11261,10907,354,Alphahull-PointsKO-Adjacents,32795
Betula_alnoides,66,33,33,Alphahull-PointsKO-Adjacents,2036
Betula_ashburneri,1,1,0,Points-PointsKO-Adjacents,9
Betula_baschkirica,NA,NA,NA,NA,NA
Betula_bomiensis,3,3,0,Points-PointsKO-Adjacents,27
Betula_calcicola,18,8,10,Points-PointsKO-Adjacents,147
Betula_chichibuensis,1,1,0,Points-PointsKO-Adjacents,9
Betula_chinensis,27,3,24,Points-PointsKO-Adjacents,236
Betula_cordifolia,271,201,70,Alphahull-PointsKO-Adjacents,13208
Betula_coriaceifolia,NA,NA,NA,NA,NA
Betula_corylifolia,73,59,14,Alphahull-PointsKO-Adjacents,578
Betula_costata,23,1,22,Points-PointsKO-Adjacents,198
Betula_cylindrostachya,22,0,22,Points-PointsKO-Adjacents,164
Betula_dahurica,251,193,58,Alphahull-PointsKO-Adjacents,8983
Betula_delavayi,28,19,9,Points-PointsKO-Adjacents,221
Betula_ermanii,222,0,222,Points-PointsKO-Adjacents,1030
Betula_falcata,0,0,0,NA,0
Betula_fargesii,1,1,0,Points-PointsKO-Adjacents,9
Betula_globispica,40,32,8,Alphahull-PointsKO-Adjacents,116
Betula_grossa,358,306,52,Alphahull-PointsKO-Adjacents,2420
Betula_gynoterminalis,NA,NA,NA,NA,NA
Betula_honanensis,NA,NA,NA,NA,NA
Betula_insignis,16,5,11,Points-PointsKO-Adjacents,144
Betula_jiulungensis,NA,NA,NA,NA,NA
Betula_karagandensis,NA,NA,NA,NA,NA
Betula_kirghisorum,0,0,0,NA,0
Betula_klokovii,NA,NA,NA,NA,NA
Betula_kotulae,NA,NA,NA,NA,NA
Betula_lenta,6132,5860,272,Alphahull-PointsKO-Adjacents,10966
Betula_luminifera,151,121,30,Alphahull-PointsKO-Adjacents,15326
Betula_maximowicziana,125,102,23,Alphahull-PointsKO-Adjacents,1279
Betula_medwediewii,2,2,0,Points-PointsKO-Adjacents,18
Betula_megrelica,0,0,0,NA,0
Betula_michauxii,79,41,38,Alphahull-PointsKO-Adjacents,3465
Betula_microphylla,2,2,0,Points-PointsKO-Adjacents,18
Betula_murrayana,6,2,4,Points-PointsKO-Adjacents,51
Betula_nigra,3083,2578,505,Alphahull-PointsKO-Adjacents,35141
Betula_occidentalis,1136,984,152,Alphahull-PointsKO-Adjacents,37216
Betula_pamirica,4,4,0,Points-PointsKO-Adjacents,34
Betula_papyrifera,15452,14724,728,Alphahull-PointsKO-Adjacents,92486
Betula_pendula,15387,13331,2056,Alphahull-PointsKO-Adjacents,67564
Betula_populifolia,2121,0,2121,Points-PointsKO-Adjacents,5441
Betula_potamophila,NA,NA,NA,NA,NA
Betula_potaninii,22,10,12,Points-PointsKO-Adjacents,176
Betula_psammophila,NA,NA,NA,NA,NA
Betula_pubescens,19512,17868,1644,Alphahull-PointsKO-Adjacents,67226
Betula_raddeana,11,7,4,Points-PointsKO-Adjacents,64
Betula_saksarensis,NA,NA,NA,NA,NA
Betula_saviczii,NA,NA,NA,NA,NA
Betula_schmidtii,84,56,28,Alphahull-PointsKO-Adjacents,357
Betula_sunanensis,NA,NA,NA,NA,NA
Betula_tianschanica,7,1,6,Points-PointsKO-Adjacents,55
Betula_utilis,324,239,85,Alphahull-PointsKO-Adjacents,13860
Betula_wuyiensis,NA,NA,NA,NA,NA
Betula_zinserlingii,NA,NA,NA,NA,NA
Beyeria_lanceolata,80,69,11,Alphahull-PointsKO-Adjacents,201
Beyeria_viscosa,1846,1753,93,Alphahull-PointsKO-Adjacents,14378
Bhesa_ceylanica,2,1,1,Points-PointsKO-Adjacents,18
Bhesa_indica,26,12,14,Points-PointsKO-Adjacents,210
Bhesa_nitidissima,1,1,0,Points-PointsKO-Adjacents,9
Bhesa_paniculata,48,25,23,Alphahull-PointsKO-Adjacents,2310
Bhesa_robusta,8,2,6,Points-PointsKO-Adjacents,71
Bhesa_sinica,1,0,1,Points-PointsKO-Adjacents,9
Bicuiba_oleifera,43,19,24,Points-PointsKO-Adjacents,322
Bidens_hendersonensis,2,2,0,Points-PointsKO-Adjacents,4
Bikinia_aciculifera,10,6,4,Points-PointsKO-Adjacents,48
Bikinia_breynei,3,3,0,Points-PointsKO-Adjacents,24
Bikinia_congensis,14,8,6,Points-PointsKO-Adjacents,94
Bikinia_coriacea,18,6,12,Points-PointsKO-Adjacents,112
Bikinia_durandii,44,29,15,Alphahull-PointsKO-Adjacents,293
Bikinia_evrardii,33,23,10,Alphahull-PointsKO-Adjacents,1308
Bikinia_grisea,47,41,6,Alphahull-PointsKO-Adjacents,574
Bikinia_le-testui,108,88,20,Alphahull-PointsKO-Adjacents,2273
Bikinia_media,41,34,7,Alphahull-PointsKO-Adjacents,935
Bikinia_pellegrinii,102,89,13,Alphahull-PointsKO-Adjacents,2276
Bikkia_pancheri,0,0,0,NA,0
Billia_hippocastanum,204,164,40,Alphahull-PointsKO-Adjacents,2333
Billia_rosea,719,656,63,Alphahull-PointsKO-Adjacents,6897
Bischofia_javanica,494,288,206,Alphahull-PointsKO-Adjacents,11275
Bischofia_polycarpa,36,14,22,Points-PointsKO-Adjacents,315
Bismarckia_nobilis,20,4,16,Points-PointsKO-Adjacents,129
Bivinia_jalbertii,79,52,27,Alphahull-PointsKO-Adjacents,2165
Bixa_arborea,250,160,90,Alphahull-PointsKO-Adjacents,25512
Bixa_excelsa,52,19,33,Points-PointsKO-Adjacents,439
Bixa_orellana,2339,1975,364,Alphahull-PointsKO-Adjacents,155711
Bixa_platycarpa,34,17,17,Points-PointsKO-Adjacents,251
Bixa_urucurana,215,128,87,Alphahull-PointsKO-Adjacents,13225
Bizonula_le-testui,1,1,0,Points-PointsKO-Adjacents,9
Blachia_andamanica,14,2,12,Points-PointsKO-Adjacents,81
Blachia_calycina,3,2,1,Points-PointsKO-Adjacents,27
Blachia_jatrophifolia,0,0,0,NA,0
Blachia_pentzii,8,0,8,Points-PointsKO-Adjacents,63
Blachia_siamensis,7,1,6,Points-PointsKO-Adjacents,33
Blachia_umbellata,3,3,0,Points-PointsKO-Adjacents,27
Blakea_acostae,3,3,0,Points-PointsKO-Adjacents,27
Blakea_andreana,8,1,7,Points-PointsKO-Adjacents,54
Blakea_austin-smithii,29,22,7,Alphahull-PointsKO-Adjacents,47
Blakea_brasiliensis,10,3,7,Points-PointsKO-Adjacents,75
Blakea_brunnea,18,10,8,Points-PointsKO-Adjacents,63
Blakea_calyptrata,48,32,16,Alphahull-PointsKO-Adjacents,1266
Blakea_castanedae,9,3,6,Points-PointsKO-Adjacents,48
Blakea_chlorantha,25,16,9,Points-PointsKO-Adjacents,61
Blakea_ciliata,26,16,10,Points-PointsKO-Adjacents,131
Blakea_crinita,9,3,6,Points-PointsKO-Adjacents,18
Blakea_cuatrecasasii,45,25,20,Alphahull-PointsKO-Adjacents,1849
Blakea_cuneata,29,23,6,Alphahull-PointsKO-Adjacents,173
Blakea_cuprina,6,2,4,Points-PointsKO-Adjacents,30
Blakea_discolor,26,19,7,Points-PointsKO-Adjacents,132
Blakea_ferruginea,37,23,14,Alphahull-PointsKO-Adjacents,1467
Blakea_foliacea,102,87,15,Alphahull-PointsKO-Adjacents,423
Blakea_glabrescens,54,38,16,Alphahull-PointsKO-Adjacents,611
Blakea_glandulosa,34,28,6,Alphahull-PointsKO-Adjacents,216
Blakea_granatensis,26,15,11,Points-PointsKO-Adjacents,169
Blakea_grandiflora,77,69,8,Alphahull-PointsKO-Adjacents,129
Blakea_hammelii,6,2,4,Points-PointsKO-Adjacents,12
Blakea_harlingii,7,2,5,Points-PointsKO-Adjacents,54
Blakea_henripittieri,230,194,36,Alphahull-PointsKO-Adjacents,1244
Blakea_hirsuta,13,9,4,Points-PointsKO-Adjacents,71
Blakea_hirsutissima,19,0,19,Points-PointsKO-Adjacents,133
Blakea_holtonii,42,31,11,Alphahull-PointsKO-Adjacents,565
Blakea_inflata,15,10,5,Points-PointsKO-Adjacents,121
Blakea_jativae,14,8,6,Points-PointsKO-Adjacents,72
Blakea_killipii,1,1,0,Points-PointsKO-Adjacents,9
Blakea_latifolia,5,5,0,Points-PointsKO-Adjacents,41
Blakea_longipes,8,1,7,Points-PointsKO-Adjacents,36
Blakea_mexiae,27,14,13,Points-PointsKO-Adjacents,187
Blakea_oldemanii,26,15,11,Points-PointsKO-Adjacents,146
Blakea_orientalis,21,8,13,Points-PointsKO-Adjacents,149
Blakea_paludosa,8,3,5,Points-PointsKO-Adjacents,61
Blakea_parasitica,274,216,58,Alphahull-PointsKO-Adjacents,4074
Blakea_pauciflora,74,61,13,Alphahull-PointsKO-Adjacents,328
Blakea_podagrica,29,21,8,Alphahull-PointsKO-Adjacents,298
Blakea_princeps,18,12,6,Points-PointsKO-Adjacents,108
Blakea_punctulata,97,79,18,Alphahull-PointsKO-Adjacents,1613
Blakea_purpusii,17,0,17,Points-PointsKO-Adjacents,64
Blakea_quadrangularis,127,107,20,Alphahull-PointsKO-Adjacents,553
Blakea_repens,127,84,43,Alphahull-PointsKO-Adjacents,1427
Blakea_rosea,291,1,290,Points-PointsKO-Adjacents,1636
Blakea_rotundifolia,34,26,8,Alphahull-PointsKO-Adjacents,144
Blakea_sawadae,58,40,18,Alphahull-PointsKO-Adjacents,782
Blakea_setosa,21,11,10,Points-PointsKO-Adjacents,105
Blakea_spruceana,58,40,18,Alphahull-PointsKO-Adjacents,1217
Blakea_storkii,102,88,14,Alphahull-PointsKO-Adjacents,182
Blakea_subbarbata,11,6,5,Points-PointsKO-Adjacents,55
Blakea_subconnata,170,146,24,Alphahull-PointsKO-Adjacents,2899
Blakea_subscabrula,24,10,14,Points-PointsKO-Adjacents,173
Blakea_subvaginata,38,27,11,Alphahull-PointsKO-Adjacents,217
Blakea_superba,20,9,11,Points-PointsKO-Adjacents,145
Blakea_trianae,14,5,9,Points-PointsKO-Adjacents,108
Blakea_watsonii,174,138,36,Alphahull-PointsKO-Adjacents,2071
Blakea_wilsoniorum,15,11,4,Points-PointsKO-Adjacents,62
Blanchetiodendron_blanchetii,174,158,16,Alphahull-PointsKO-Adjacents,4058
Blastemanthus_gemmiflorus,60,33,27,Alphahull-PointsKO-Adjacents,3928
Blastemanthus_grandiflorus,18,0,18,Points-PointsKO-Adjacents,148
Bleasdalea_bleasdalei,113,98,15,Alphahull-PointsKO-Adjacents,215
Bleasdalea_papuana,17,5,12,Points-PointsKO-Adjacents,115
Bleekrodea_insignis,NA,NA,NA,NA,NA
Bleekrodea_malayana,0,0,0,NA,0
Bleekrodea_tonkinensis,7,1,6,Points-PointsKO-Adjacents,59
Blepharandra_angustifolia,21,0,21,Points-PointsKO-Adjacents,143
Blepharandra_heteropetala,44,0,44,Points-PointsKO-Adjacents,319
Blepharandra_hypoleuca,93,76,17,Alphahull-PointsKO-Adjacents,2730
Blepharandra_intermedia,15,7,8,Points-PointsKO-Adjacents,117
Blepharidium_guatemalense,24,17,7,Points-PointsKO-Adjacents,144
Blepharis_dhofarensis,8,2,6,Points-PointsKO-Adjacents,12
Blepharispermum_hirtum,10,6,4,Points-PointsKO-Adjacents,43
Blepharistemma_serratum,0,0,0,NA,0
Blepharocalyx_cruckshanksii,37,16,21,Points-PointsKO-Adjacents,268
Blepharocalyx_eggersii,90,28,62,Alphahull-PointsKO-Adjacents,1038
Blepharocalyx_salicifolius,1766,1609,157,Alphahull-PointsKO-Adjacents,51343
Blepharocarya_involucrigera,181,165,16,Alphahull-PointsKO-Adjacents,1019
Blighia_kamerunensis,8,1,7,Points-PointsKO-Adjacents,66
Blighia_laurentii,26,9,17,Points-PointsKO-Adjacents,178
Blighia_mildbraedii,NA,NA,NA,NA,NA
Blighia_sapida,554,513,41,Alphahull-PointsKO-Adjacents,6936
Blighia_unijugata,258,147,111,Alphahull-PointsKO-Adjacents,3897
Blighia_welwitschii,180,121,59,Alphahull-PointsKO-Adjacents,13404
Blighiopsis_gabonica,11,4,7,Points-PointsKO-Adjacents,97
Blighiopsis_pseudostipularis,4,4,0,Points-PointsKO-Adjacents,30
Blomia_prisca,52,42,10,Alphahull-PointsKO-Adjacents,801
Blumea_balsamifera,156,62,94,Alphahull-PointsKO-Adjacents,1863
Blumeodendron_bullatum,1,1,0,Points-PointsKO-Adjacents,9
Blumeodendron_kurzii,55,14,41,Points-PointsKO-Adjacents,453
Blumeodendron_subrotundifolium,43,11,32,Points-PointsKO-Adjacents,354
Blumeodendron_tokbrai,125,59,66,Alphahull-PointsKO-Adjacents,3970
Bobea_brevipes,4,4,0,Points-PointsKO-Adjacents,26
Bobea_gaudichaudii,4,1,3,Points-PointsKO-Adjacents,27
Bobea_sandwicensis,4,4,0,Points-PointsKO-Adjacents,27
Bobea_timonioides,5,0,5,Points-PointsKO-Adjacents,28
Bobgunnia_fistuloides,75,49,26,Alphahull-PointsKO-Adjacents,4285
Bobgunnia_madagascariensis,360,270,90,Alphahull-PointsKO-Adjacents,23771
Bocagea_longipedunculata,2,2,0,Points-PointsKO-Adjacents,18
Bocagea_viridis,8,0,8,Points-PointsKO-Adjacents,61
Bocageopsis_canescens,114,83,31,Alphahull-PointsKO-Adjacents,8250
Bocageopsis_mattogrossensis,120,80,40,Alphahull-PointsKO-Adjacents,8971
Bocageopsis_multiflora,516,466,50,Alphahull-PointsKO-Adjacents,40913
Bocageopsis_pleiosperma,42,13,29,Points-PointsKO-Adjacents,346
Bocconia_arborea,427,347,80,Alphahull-PointsKO-Adjacents,6616
Bocconia_frutescens,897,740,157,Alphahull-PointsKO-Adjacents,12118
Bocconia_glaucifolia,10,3,7,Points-PointsKO-Adjacents,57
Bocconia_gracilis,51,42,9,Alphahull-PointsKO-Adjacents,283
Bocconia_hintoniorum,5,5,0,Points-PointsKO-Adjacents,24
Bocconia_integrifolia,175,121,54,Alphahull-PointsKO-Adjacents,2250
Bocconia_pubibractea,11,0,11,Points-PointsKO-Adjacents,93
Bocconia_vulcanica,8,5,3,Points-PointsKO-Adjacents,47
Bocoa_prouacensis,27,21,6,Alphahull-PointsKO-Adjacents,695
Bocoa_ratteri,4,4,0,Points-PointsKO-Adjacents,36
Bocoa_viridiflora,68,45,23,Alphahull-PointsKO-Adjacents,2735
Bocquillonia_arborea,1,1,0,Points-PointsKO-Adjacents,6
Bocquillonia_castaneifolia,5,5,0,Points-PointsKO-Adjacents,9
Bocquillonia_codonostylis,2,2,0,Points-PointsKO-Adjacents,13
Bocquillonia_grandidens,8,2,6,Points-PointsKO-Adjacents,49
Bocquillonia_longipes,2,2,0,Points-PointsKO-Adjacents,17
Bocquillonia_lucidula,28,18,10,Points-PointsKO-Adjacents,79
Bocquillonia_nervosa,10,0,10,Points-PointsKO-Adjacents,42
Bocquillonia_phenacostigma,4,4,0,Points-PointsKO-Adjacents,17
Bocquillonia_sessiliflora,87,69,18,Alphahull-PointsKO-Adjacents,282
Bocquillonia_spicata,21,9,12,Points-PointsKO-Adjacents,77
Boehmeria_aspera,104,74,30,Alphahull-PointsKO-Adjacents,1450
Boehmeria_brevirostris,22,6,16,Points-PointsKO-Adjacents,154
Boehmeria_caudata,1563,1331,232,Alphahull-PointsKO-Adjacents,30824
Boehmeria_celtidifolia,90,52,38,Alphahull-PointsKO-Adjacents,1692
Boehmeria_excelsa,4,4,0,Points-PointsKO-Adjacents,14
Boehmeria_grandis,13,2,11,Points-PointsKO-Adjacents,76
Boehmeria_listeri,0,0,0,NA,0
Boehmeria_macrophylla,59,0,59,Points-PointsKO-Adjacents,327
Boehmeria_multiflora,5,4,1,Points-PointsKO-Adjacents,39
Boehmeria_pavonii,216,147,69,Alphahull-PointsKO-Adjacents,5975
Boehmeria_pilosiuscula,47,0,47,Points-PointsKO-Adjacents,251
Boehmeria_radiata,36,0,36,Points-PointsKO-Adjacents,269
Boehmeria_ramiflora,151,78,73,Alphahull-PointsKO-Adjacents,2734
Boehmeria_siamensis,26,9,17,Points-PointsKO-Adjacents,234
Boehmeria_subintegra,5,5,0,Points-PointsKO-Adjacents,45
Boehmeria_ulmifolia,423,308,115,Alphahull-PointsKO-Adjacents,7983
Boehmeria_virgata,62,14,48,Points-PointsKO-Adjacents,373
Boehmeria_zollingeriana,186,1,185,Points-PointsKO-Adjacents,471
Boerlagella_spectabilis,0,0,0,NA,0
Bolusanthus_speciosus,85,53,32,Alphahull-PointsKO-Adjacents,2747
Bombax_albidum,2,2,0,Points-PointsKO-Adjacents,16
Bombax_anceps,3,0,3,Points-PointsKO-Adjacents,27
Bombax_blancoanum,1,1,0,Points-PointsKO-Adjacents,9
Bombax_buonopozense,162,105,57,Alphahull-PointsKO-Adjacents,8112
Bombax_ceiba,57,12,45,Points-PointsKO-Adjacents,432
Bombax_costatum,926,876,50,Alphahull-PointsKO-Adjacents,8259
Bombax_insigne,2,0,2,Points-PointsKO-Adjacents,18
Bombax_rhodognaphalon,44,22,22,Alphahull-PointsKO-Adjacents,944
Bombycidendron_vidalianum,4,4,0,Points-PointsKO-Adjacents,33
Bonellia_albiflora,46,32,14,Alphahull-PointsKO-Adjacents,725
Bonellia_brevifolia,1,1,0,Points-PointsKO-Adjacents,6
Bonellia_flammea,46,0,46,Points-PointsKO-Adjacents,255
Bonellia_frutescens,63,33,30,Alphahull-PointsKO-Adjacents,559
Bonellia_loeflingii,1,1,0,Points-PointsKO-Adjacents,9
Bonellia_longifolia,29,16,13,Points-PointsKO-Adjacents,170
Bonellia_macrocarpa,1058,899,159,Alphahull-PointsKO-Adjacents,11309
Bonellia_montana,8,2,6,Points-PointsKO-Adjacents,51
Bonellia_mucronata,13,0,13,Points-PointsKO-Adjacents,73
Bonellia_nervosa,230,185,45,Alphahull-PointsKO-Adjacents,1625
Bonellia_nitida,15,6,9,Points-PointsKO-Adjacents,93
Bonellia_paludicola,7,3,4,Points-PointsKO-Adjacents,48
Bonellia_pauciflora,2,2,0,Points-PointsKO-Adjacents,18
Bonellia_seleriana,6,4,2,Points-PointsKO-Adjacents,30
Bonellia_shaferi,3,3,0,Points-PointsKO-Adjacents,27
Bonellia_umbellata,25,17,8,Points-PointsKO-Adjacents,71
Boniodendron_minus,2,2,0,Points-PointsKO-Adjacents,18
Boniodendron_parviflorum,4,4,0,Points-PointsKO-Adjacents,27
Bonnetia_bolivarensis,5,5,0,Points-PointsKO-Adjacents,21
Bonnetia_celiae,7,3,4,Points-PointsKO-Adjacents,25
Bonnetia_chimantensis,3,3,0,Points-PointsKO-Adjacents,21
Bonnetia_cordifolia,2,2,0,Points-PointsKO-Adjacents,9
Bonnetia_crassa,30,22,8,Alphahull-PointsKO-Adjacents,407
Bonnetia_fasciculata,8,2,6,Points-PointsKO-Adjacents,39
Bonnetia_holostyla,2,2,0,Points-PointsKO-Adjacents,18
Bonnetia_jauaensis,5,5,0,Points-PointsKO-Adjacents,27
Bonnetia_katleeniae,NA,NA,NA,NA,NA
Bonnetia_lanceifolia,12,8,4,Points-PointsKO-Adjacents,50
Bonnetia_maguireorum,4,4,0,Points-PointsKO-Adjacents,23
Bonnetia_multinervia,6,1,5,Points-PointsKO-Adjacents,33
Bonnetia_paniculata,189,138,51,Alphahull-PointsKO-Adjacents,9226
Bonnetia_ptariensis,1,1,0,Points-PointsKO-Adjacents,9
Bonnetia_roraimae,47,34,13,Alphahull-PointsKO-Adjacents,182
Bonnetia_rubicunda,5,5,0,Points-PointsKO-Adjacents,30
Bonnetia_sessilis,217,0,217,Points-PointsKO-Adjacents,1143
Bonnetia_steyermarkii,20,12,8,Points-PointsKO-Adjacents,65
Bonnetia_stricta,262,210,52,Alphahull-PointsKO-Adjacents,2423
Bonnetia_tepuiensis,33,26,7,Alphahull-PointsKO-Adjacents,189
Bonnetia_tristyla,34,22,12,Alphahull-PointsKO-Adjacents,228
Bonnetia_wurdackii,15,9,6,Points-PointsKO-Adjacents,36
Bontia_daphnoides,46,11,35,Points-PointsKO-Adjacents,284
Bonyunia_antoniifolia,61,25,36,Alphahull-PointsKO-Adjacents,2159
Bonyunia_aquatica,75,50,25,Alphahull-PointsKO-Adjacents,3597
Bonyunia_excelsa,3,3,0,Points-PointsKO-Adjacents,23
Bonyunia_minor,43,25,18,Alphahull-PointsKO-Adjacents,473
Bonyunia_nobilis,5,5,0,Points-PointsKO-Adjacents,36
Bonyunia_superba,19,7,12,Points-PointsKO-Adjacents,158
Borassodendron_borneense,3,3,0,Points-PointsKO-Adjacents,18
Borassodendron_machadonis,2,2,0,Points-PointsKO-Adjacents,18
Borassus_aethiopum,1152,1027,125,Alphahull-PointsKO-Adjacents,5652
Borassus_akeassii,20,7,13,Points-PointsKO-Adjacents,107
Borassus_flabellifer,13,1,12,Points-PointsKO-Adjacents,58
Borassus_heineanus,7,1,6,Points-PointsKO-Adjacents,42
Borassus_madagascariensis,18,11,7,Points-PointsKO-Adjacents,114
Borneodendron_aenigmaticum,0,0,0,NA,0
Borojoa_duckei,7,0,7,Points-PointsKO-Adjacents,62
Boronella_koniambiensis,9,4,5,Points-PointsKO-Adjacents,18
Boronia_muelleri,217,192,25,Alphahull-PointsKO-Adjacents,387
Boronia_pinnata,810,628,182,Alphahull-PointsKO-Adjacents,1262
Borrichia_arborescens,135,82,53,Alphahull-PointsKO-Adjacents,1543
Borthwickia_trifoliata,3,3,0,Points-PointsKO-Adjacents,27
Boschia_excelsa,2,2,0,Points-PointsKO-Adjacents,18
Boschia_grandiflora,13,0,13,Points-PointsKO-Adjacents,93
Boschia_griffithii,21,5,16,Points-PointsKO-Adjacents,172
Boschia_mansonii,4,4,0,Points-PointsKO-Adjacents,36
Boschia_oblongifolia,0,0,0,NA,0
Boscia_albitrunca,206,152,54,Alphahull-PointsKO-Adjacents,19551
Boscia_angustifolia,87,50,37,Alphahull-PointsKO-Adjacents,2831
Boscia_arabica,15,6,9,Points-PointsKO-Adjacents,103
Boscia_cauliflora,1,1,0,Points-PointsKO-Adjacents,9
Boscia_coriacea,35,12,23,Points-PointsKO-Adjacents,274
Boscia_foetida,108,81,27,Alphahull-PointsKO-Adjacents,4446
Boscia_longifolia,39,28,11,Alphahull-PointsKO-Adjacents,386
Boscia_madagascariensis,19,7,12,Points-PointsKO-Adjacents,89
Boscia_mazzocchii,1,1,0,Points-PointsKO-Adjacents,9
Boscia_microphylla,14,7,7,Points-PointsKO-Adjacents,124
Boscia_minimifolia,4,4,0,Points-PointsKO-Adjacents,36
Boscia_mossambicensis,70,36,34,Alphahull-PointsKO-Adjacents,1631
Boscia_oleoides,35,23,12,Alphahull-PointsKO-Adjacents,573
Boscia_polyantha,2,2,0,Points-PointsKO-Adjacents,18
Boscia_praecox,1,1,0,Points-PointsKO-Adjacents,9
Boscia_rotundifolia,NA,NA,NA,NA,NA
Boscia_salicifolia,81,23,58,Alphahull-PointsKO-Adjacents,5735
Boscia_senegalensis,93,42,51,Alphahull-PointsKO-Adjacents,3612
Boscia_tomentosa,3,2,1,Points-PointsKO-Adjacents,27
Bosistoa_brassii,73,41,32,Alphahull-PointsKO-Adjacents,356
Bosistoa_floydii,53,42,11,Alphahull-PointsKO-Adjacents,128
Bosistoa_medicinalis,181,134,47,Alphahull-PointsKO-Adjacents,714
Bosistoa_monostylis,78,48,30,Alphahull-PointsKO-Adjacents,421
Bosistoa_pentacocca,200,174,26,Alphahull-PointsKO-Adjacents,471
Bosistoa_selwynii,70,55,15,Alphahull-PointsKO-Adjacents,311
Bosistoa_transversa,188,0,188,Points-PointsKO-Adjacents,392
Bosqueiopsis_gilletii,30,10,20,Points-PointsKO-Adjacents,214
Bossiaea_aquifolium,278,260,18,Alphahull-PointsKO-Adjacents,604
Boswellia_ameero,7,1,6,Points-PointsKO-Adjacents,14
Boswellia_boranensis,1,1,0,Points-PointsKO-Adjacents,9
Boswellia_bricchettii,0,0,0,NA,0
Boswellia_bullata,2,2,0,Points-PointsKO-Adjacents,8
Boswellia_chariensis,1,1,0,Points-PointsKO-Adjacents,9
Boswellia_dalzielii,71,44,27,Alphahull-PointsKO-Adjacents,1024
Boswellia_dioscoridis,3,3,0,Points-PointsKO-Adjacents,14
Boswellia_elongata,15,7,8,Points-PointsKO-Adjacents,47
Boswellia_frereana,20,10,10,Points-PointsKO-Adjacents,128
Boswellia_globosa,2,2,0,Points-PointsKO-Adjacents,18
Boswellia_hildebrandtii,27,5,22,Points-PointsKO-Adjacents,241
Boswellia_holstii,0,0,0,NA,0
Boswellia_microphylla,8,1,7,Points-PointsKO-Adjacents,72
Boswellia_multifoliolata,7,0,7,Points-PointsKO-Adjacents,63
Boswellia_nana,0,0,0,NA,0
Boswellia_neglecta,22,4,18,Points-PointsKO-Adjacents,188
Boswellia_odorata,8,0,8,Points-PointsKO-Adjacents,46
Boswellia_ogadensis,3,3,0,Points-PointsKO-Adjacents,27
Boswellia_ovalifoliolata,0,0,0,NA,0
Boswellia_pirottae,5,5,0,Points-PointsKO-Adjacents,39
Boswellia_popoviana,4,4,0,Points-PointsKO-Adjacents,19
Boswellia_rivae,12,3,9,Points-PointsKO-Adjacents,98
Boswellia_ruspoliana,1,1,0,Points-PointsKO-Adjacents,9
Boswellia_sacra,32,16,16,Points-PointsKO-Adjacents,232
Boswellia_serrata,4,3,1,Points-PointsKO-Adjacents,36
Boswellia_socotrana,17,10,7,Points-PointsKO-Adjacents,43
Bothriospora_corymbosa,223,167,56,Alphahull-PointsKO-Adjacents,19080
Botryarrhena_pendula,65,40,25,Alphahull-PointsKO-Adjacents,7210
Botryarrhena_venezuelensis,12,2,10,Points-PointsKO-Adjacents,102
Botryophora_geniculata,8,0,8,Points-PointsKO-Adjacents,72
Bottegoa_insignis,6,2,4,Points-PointsKO-Adjacents,54
Bouchardatia_neurococca,186,158,28,Alphahull-PointsKO-Adjacents,663
Bouea_macrophylla,7,2,5,Points-PointsKO-Adjacents,51
Bouea_oppositifolia,19,0,19,Points-PointsKO-Adjacents,167
Bouea_poilanei,0,0,0,NA,0
Bougainvillea_campanulata,49,36,13,Alphahull-PointsKO-Adjacents,2728
Bougainvillea_glabra,252,183,69,Alphahull-PointsKO-Adjacents,10514
Bougainvillea_infesta,21,8,13,Points-PointsKO-Adjacents,183
Bougainvillea_modesta,58,38,20,Alphahull-PointsKO-Adjacents,1210
Bougainvillea_pachyphylla,18,12,6,Points-PointsKO-Adjacents,114
Bougainvillea_pomacea,7,1,6,Points-PointsKO-Adjacents,56
Bougainvillea_praecox,77,50,27,Alphahull-PointsKO-Adjacents,4823
Bougainvillea_spinosa,33,11,22,Points-PointsKO-Adjacents,269
Bougainvillea_stipitata,159,133,26,Alphahull-PointsKO-Adjacents,4718
Bourreria_andrieuxii,20,15,5,Points-PointsKO-Adjacents,38
Bourreria_baccata,3,2,1,Points-PointsKO-Adjacents,25
Bourreria_bolivarensis,25,17,8,Points-PointsKO-Adjacents,199
Bourreria_costaricensis,130,114,16,Alphahull-PointsKO-Adjacents,553
Bourreria_cumanensis,229,176,53,Alphahull-PointsKO-Adjacents,3892
Bourreria_cuneifolia,0,0,0,NA,0
Bourreria_domingensis,10,3,7,Points-PointsKO-Adjacents,58
Bourreria_grandicalyx,10,5,5,Points-PointsKO-Adjacents,29
Bourreria_grayumii,26,21,5,Alphahull-PointsKO-Adjacents,229
Bourreria_havanensis,13,4,9,Points-PointsKO-Adjacents,83
Bourreria_hintonii,23,7,16,Points-PointsKO-Adjacents,122
Bourreria_huanita,152,94,58,Alphahull-PointsKO-Adjacents,4360
Bourreria_litoralis,4,4,0,Points-PointsKO-Adjacents,13
Bourreria_longiflora,58,30,28,Alphahull-PointsKO-Adjacents,679
Bourreria_mollis,291,254,37,Alphahull-PointsKO-Adjacents,3250
Bourreria_motaguensis,7,3,4,Points-PointsKO-Adjacents,31
Bourreria_nashii,0,0,0,NA,0
Bourreria_pulchra,203,173,30,Alphahull-PointsKO-Adjacents,1172
Bourreria_purpusii,85,55,30,Alphahull-PointsKO-Adjacents,766
Bourreria_quirosii,66,55,11,Alphahull-PointsKO-Adjacents,219
Bourreria_radula,3,2,1,Points-PointsKO-Adjacents,27
Bourreria_rinconensis,12,9,3,Points-PointsKO-Adjacents,42
Bourreria_rowellii,5,5,0,Points-PointsKO-Adjacents,29
Bourreria_rubra,22,13,9,Points-PointsKO-Adjacents,27
Bourreria_sonorae,129,0,129,Points-PointsKO-Adjacents,375
Bourreria_succulenta,684,521,163,Alphahull-PointsKO-Adjacents,4363
Bourreria_superba,69,50,19,Alphahull-PointsKO-Adjacents,659
Bourreria_tomentosa,50,30,20,Alphahull-PointsKO-Adjacents,408
Bourreria_velutina,1,1,0,Points-PointsKO-Adjacents,9
Bourreria_venosa,6,2,4,Points-PointsKO-Adjacents,46
Bourreria_virgata,187,119,68,Alphahull-PointsKO-Adjacents,1557
Boutiquea_platypetala,20,12,8,Points-PointsKO-Adjacents,118
Bouvardia_loeseneriana,37,26,11,Alphahull-PointsKO-Adjacents,757
Bouvardia_multiflora,336,266,70,Alphahull-PointsKO-Adjacents,5502
Bowdichia_nitida,165,116,49,Alphahull-PointsKO-Adjacents,16346
Bowdichia_virgilioides,2215,2011,204,Alphahull-PointsKO-Adjacents,70812
Bowkeria_verticillata,44,31,13,Alphahull-PointsKO-Adjacents,542
Bowringia_callicarpa,41,28,13,Alphahull-PointsKO-Adjacents,2127
Brabejum_stellatifolium,63,45,18,Alphahull-PointsKO-Adjacents,465
Brachistus_affinis,2,2,0,Points-PointsKO-Adjacents,18
Brachistus_stramoniifolius,239,168,71,Alphahull-PointsKO-Adjacents,3880
Brachychiton_acerifolius,998,734,264,Alphahull-PointsKO-Adjacents,2244
Brachychiton_acuminatus,58,47,11,Alphahull-PointsKO-Adjacents,417
Brachychiton_albidus,63,53,10,Alphahull-PointsKO-Adjacents,388
Brachychiton_australis,176,139,37,Alphahull-PointsKO-Adjacents,5163
Brachychiton_bidwillii,128,105,23,Alphahull-PointsKO-Adjacents,1377
Brachychiton_carruthersii,31,24,7,Alphahull-PointsKO-Adjacents,246
Brachychiton_chillagoensis,81,71,10,Alphahull-PointsKO-Adjacents,614
Brachychiton_collinus,82,64,18,Alphahull-PointsKO-Adjacents,499
Brachychiton_compactus,24,19,5,Points-PointsKO-Adjacents,47
Brachychiton_discolor,265,0,265,Points-PointsKO-Adjacents,874
Brachychiton_diversifolius,1669,1611,58,Alphahull-PointsKO-Adjacents,11164
Brachychiton_fitzgeraldianus,124,111,13,Alphahull-PointsKO-Adjacents,1354
Brachychiton_garrawayae,58,48,10,Alphahull-PointsKO-Adjacents,500
Brachychiton_grandiflorus,35,29,6,Alphahull-PointsKO-Adjacents,81
Brachychiton_gregorii,354,315,39,Alphahull-PointsKO-Adjacents,13562
Brachychiton_incanus,20,15,5,Points-PointsKO-Adjacents,98
Brachychiton_megaphyllus,898,866,32,Alphahull-PointsKO-Adjacents,3499
Brachychiton_muellerianus,52,42,10,Alphahull-PointsKO-Adjacents,460
Brachychiton_obtusilobus,11,6,5,Points-PointsKO-Adjacents,39
Brachychiton_paradoxus,1367,1333,34,Alphahull-PointsKO-Adjacents,7204
Brachychiton_populneus,4655,4468,187,Alphahull-PointsKO-Adjacents,20440
Brachychiton_rupestris,180,160,20,Alphahull-PointsKO-Adjacents,4380
Brachychiton_spectabilis,96,88,8,Alphahull-PointsKO-Adjacents,278
Brachychiton_tridentatus,24,16,8,Points-PointsKO-Adjacents,121
Brachychiton_tuberculatus,122,114,8,Alphahull-PointsKO-Adjacents,211
Brachychiton_velutinosus,37,26,11,Alphahull-PointsKO-Adjacents,176
Brachychiton_viridiflorus,46,36,10,Alphahull-PointsKO-Adjacents,597
Brachychiton_viscidulus,155,141,14,Alphahull-PointsKO-Adjacents,1229
Brachychiton_vitifolius,94,83,11,Alphahull-PointsKO-Adjacents,494
Brachychiton_xanthophyllus,12,6,6,Points-PointsKO-Adjacents,56
Brachycylix_vageleri,14,9,5,Points-PointsKO-Adjacents,107
Brachyglottis_arborescens,123,89,34,Alphahull-PointsKO-Adjacents,1756
Brachyglottis_huntii,11,0,11,Points-PointsKO-Adjacents,65
Brachyglottis_pentacopa,6,2,4,Points-PointsKO-Adjacents,28
Brachyglottis_perdicioides,22,15,7,Points-PointsKO-Adjacents,94
Brachyglottis_repanda,3807,3719,88,Alphahull-PointsKO-Adjacents,3356
Brachyglottis_rotundifolia,158,138,20,Alphahull-PointsKO-Adjacents,1493
Brachyglottis_stewartiae,2,2,0,Points-PointsKO-Adjacents,11
Brachylaena_discolor,128,0,128,Points-PointsKO-Adjacents,991
Brachylaena_elliptica,42,29,13,Alphahull-PointsKO-Adjacents,588
Brachylaena_glabra,16,6,10,Points-PointsKO-Adjacents,134
Brachylaena_ilicifolia,36,16,20,Points-PointsKO-Adjacents,311
Brachylaena_merana,102,85,17,Alphahull-PointsKO-Adjacents,2411
Brachylaena_microphylla,23,14,9,Points-PointsKO-Adjacents,183
Brachylaena_neriifolia,82,62,20,Alphahull-PointsKO-Adjacents,751
Brachylaena_perrieri,62,40,22,Alphahull-PointsKO-Adjacents,2657
Brachylaena_ramiflora,113,92,21,Alphahull-PointsKO-Adjacents,1681
Brachylaena_rotundata,106,74,32,Alphahull-PointsKO-Adjacents,4696
Brachylaena_stellulifera,4,4,0,Points-PointsKO-Adjacents,33
Brachylaena_transvaalensis,108,78,30,Alphahull-PointsKO-Adjacents,3180
Brachylaena_uniflora,17,9,8,Points-PointsKO-Adjacents,149
Brachylophon_curtisii,2,2,0,Points-PointsKO-Adjacents,18
Brachynema_axillare,11,4,7,Points-PointsKO-Adjacents,75
Brachynema_ramiflorum,28,5,23,Points-PointsKO-Adjacents,225
Brachyotum_gleasonii,27,16,11,Points-PointsKO-Adjacents,180
Brachystegia_allenii,37,22,15,Alphahull-PointsKO-Adjacents,973
Brachystegia_angustistipulata,9,1,8,Points-PointsKO-Adjacents,81
Brachystegia_bakeriana,6,2,4,Points-PointsKO-Adjacents,50
Brachystegia_bequaertii,NA,NA,NA,NA,NA
Brachystegia_boehmii,164,121,43,Alphahull-PointsKO-Adjacents,15127
Brachystegia_bussei,35,11,24,Points-PointsKO-Adjacents,255
Brachystegia_cynometroides,27,16,11,Points-PointsKO-Adjacents,187
Brachystegia_eurycoma,9,0,9,Points-PointsKO-Adjacents,68
Brachystegia_floribunda,20,7,13,Points-PointsKO-Adjacents,158
Brachystegia_glaberrima,4,4,0,Points-PointsKO-Adjacents,36
Brachystegia_gossweileri,14,4,10,Points-PointsKO-Adjacents,102
Brachystegia_kennedyi,1,1,0,Points-PointsKO-Adjacents,9
Brachystegia_laurentii,48,21,27,Alphahull-PointsKO-Adjacents,1541
Brachystegia_leonensis,27,19,8,Points-PointsKO-Adjacents,170
Brachystegia_longifolia,70,38,32,Alphahull-PointsKO-Adjacents,5832
Brachystegia_lujae,2,2,0,Points-PointsKO-Adjacents,18
Brachystegia_manga,51,31,20,Alphahull-PointsKO-Adjacents,2645
Brachystegia_microphylla,71,24,47,Alphahull-PointsKO-Adjacents,4341
Brachystegia_mildbraedii,26,11,15,Points-PointsKO-Adjacents,191
Brachystegia_nigerica,1,1,0,Points-PointsKO-Adjacents,9
Brachystegia_oblonga,3,3,0,Points-PointsKO-Adjacents,26
Brachystegia_puberula,19,3,16,Points-PointsKO-Adjacents,148
Brachystegia_russelliae,1,1,0,Points-PointsKO-Adjacents,9
Brachystegia_spiciformis,296,231,65,Alphahull-PointsKO-Adjacents,19873
Brachystegia_stipulata,24,10,14,Points-PointsKO-Adjacents,176
Brachystegia_tamarindoides,8,3,5,Points-PointsKO-Adjacents,72
Brachystegia_taxifolia,20,5,15,Points-PointsKO-Adjacents,147
Brachystegia_utilis,71,39,32,Alphahull-PointsKO-Adjacents,4845
Brachystegia_wangermeeana,30,6,24,Points-PointsKO-Adjacents,232
Brachytome_russellii,NA,NA,NA,NA,NA
Brachytome_scortechinii,3,3,0,Points-PointsKO-Adjacents,27
Brachytome_wallichii,21,7,14,Points-PointsKO-Adjacents,145
Brackenridgea_alboserrata,45,14,31,Points-PointsKO-Adjacents,360
Brackenridgea_elegantissima,9,0,9,Points-PointsKO-Adjacents,71
Brackenridgea_fascicularis,2,2,0,Points-PointsKO-Adjacents,10
Brackenridgea_forbesii,11,2,9,Points-PointsKO-Adjacents,49
Brackenridgea_nitida,1,1,0,Points-PointsKO-Adjacents,9
Brackenridgea_palustris,11,0,11,Points-PointsKO-Adjacents,80
Brackenridgea_zanguebarica,46,16,30,Points-PointsKO-Adjacents,367
Brahea_aculeata,47,0,47,Points-PointsKO-Adjacents,202
Brahea_armata,72,54,18,Alphahull-PointsKO-Adjacents,968
Brahea_brandegeei,47,32,15,Alphahull-PointsKO-Adjacents,156
Brahea_calcarea,105,77,28,Alphahull-PointsKO-Adjacents,1031
Brahea_decumbens,24,19,5,Points-PointsKO-Adjacents,95
Brahea_dulcis,365,322,43,Alphahull-PointsKO-Adjacents,9931
Brahea_edulis,5,5,0,Points-PointsKO-Adjacents,18
Brahea_pimo,47,27,20,Alphahull-PointsKO-Adjacents,562
Brahea_salvadorensis,7,2,5,Points-PointsKO-Adjacents,48
Brahea_sarukhanii,8,0,8,Points-PointsKO-Adjacents,45
Brandzeia_filicifolia,29,15,14,Points-PointsKO-Adjacents,157
Brasiliocroton_mamoninha,64,49,15,Alphahull-PointsKO-Adjacents,372
Brasiliopuntia_brasiliensis,529,447,82,Alphahull-PointsKO-Adjacents,22556
Brassaiopsis_aculeata,2,2,0,Points-PointsKO-Adjacents,18
Brassaiopsis_acuminata,1,1,0,Points-PointsKO-Adjacents,9
Brassaiopsis_bodinieri,10,3,7,Points-PointsKO-Adjacents,69
Brassaiopsis_castaneifolia,2,2,0,Points-PointsKO-Adjacents,18
Brassaiopsis_chengkangensis,6,0,6,Points-PointsKO-Adjacents,45
Brassaiopsis_ciliata,16,7,9,Points-PointsKO-Adjacents,129
Brassaiopsis_dumicola,7,0,7,Points-PointsKO-Adjacents,52
Brassaiopsis_fatsioides,36,16,20,Points-PointsKO-Adjacents,228
Brassaiopsis_ferruginea,16,4,12,Points-PointsKO-Adjacents,144
Brassaiopsis_ficifolia,4,4,0,Points-PointsKO-Adjacents,36
Brassaiopsis_ficifolioides,NA,NA,NA,NA,NA
Brassaiopsis_gigantea,0,0,0,NA,0
Brassaiopsis_glomerulata,83,43,40,Alphahull-PointsKO-Adjacents,3757
Brassaiopsis_gracilis,9,1,8,Points-PointsKO-Adjacents,81
Brassaiopsis_griffithii,1,0,1,Points-PointsKO-Adjacents,9
Brassaiopsis_grushvitzkyi,7,0,7,Points-PointsKO-Adjacents,35
Brassaiopsis_hainla,23,0,23,Points-PointsKO-Adjacents,158
Brassaiopsis_hispida,15,10,5,Points-PointsKO-Adjacents,71
Brassaiopsis_magnifica,0,0,0,NA,0
Brassaiopsis_minor,0,0,0,NA,0
Brassaiopsis_mitis,0,0,0,NA,0
Brassaiopsis_phanrangensis,0,0,0,NA,0
Brassaiopsis_producta,8,0,8,Points-PointsKO-Adjacents,70
Brassaiopsis_pseudoficifolia,3,3,0,Points-PointsKO-Adjacents,27
Brassaiopsis_quercifolia,1,1,0,Points-PointsKO-Adjacents,9
Brassaiopsis_resecta,0,0,0,NA,0
Brassaiopsis_rufosetosa,1,1,0,Points-PointsKO-Adjacents,9
Brassaiopsis_shweliensis,7,0,7,Points-PointsKO-Adjacents,36
Brassaiopsis_simplex,2,2,0,Points-PointsKO-Adjacents,18
Brassaiopsis_simplicifolia,0,0,0,NA,0
Brassaiopsis_stellata,9,4,5,Points-PointsKO-Adjacents,50
Brassaiopsis_sumatrana,2,2,0,Points-PointsKO-Adjacents,18
Brassaiopsis_tibetana,NA,NA,NA,NA,NA
Brassiantha_pentamera,8,2,6,Points-PointsKO-Adjacents,47
Brassiophoenix_drymophloeoides,9,1,8,Points-PointsKO-Adjacents,69
Brassiophoenix_schumannii,6,0,6,Points-PointsKO-Adjacents,37
Bravaisia_berlandieriana,294,238,56,Alphahull-PointsKO-Adjacents,2376
Bravaisia_grandiflora,20,11,9,Points-PointsKO-Adjacents,139
Bravaisia_integerrima,455,338,117,Alphahull-PointsKO-Adjacents,11802
Brazzeia_congoensis,37,12,25,Points-PointsKO-Adjacents,253
Brazzeia_longipedicellata,0,0,0,NA,0
Brazzeia_soyauxii,72,56,16,Alphahull-PointsKO-Adjacents,1167
Bredemeyera_altissima,58,28,30,Alphahull-PointsKO-Adjacents,509
Bredemeyera_floribunda,902,748,154,Alphahull-PointsKO-Adjacents,62344
Bredemeyera_hebeclada,204,146,58,Alphahull-PointsKO-Adjacents,10447
Bremeria_erectiloba,35,21,14,Alphahull-PointsKO-Adjacents,106
Bremeria_humblotii,30,17,13,Points-PointsKO-Adjacents,163
Bremeria_hymenopogonoides,29,19,10,Points-PointsKO-Adjacents,148
Bremeria_landia,1,0,1,Points-PointsKO-Adjacents,8
Bremeria_pervillei,51,39,12,Alphahull-PointsKO-Adjacents,344
Bremeria_scabrella,2,2,0,Points-PointsKO-Adjacents,18
Bremeria_scabridior,6,1,5,Points-PointsKO-Adjacents,52
Bremeria_trichophlebia,29,17,12,Points-PointsKO-Adjacents,181
Bremeria_vestita,18,8,10,Points-PointsKO-Adjacents,123
Brenandendron_donianum,41,31,10,Alphahull-PointsKO-Adjacents,304
Brenandendron_frondosum,13,5,8,Points-PointsKO-Adjacents,102
Brenandendron_titanophyllum,33,7,26,Points-PointsKO-Adjacents,244
Brenania_brieyi,34,14,20,Points-PointsKO-Adjacents,253
Brenania_rhomboideifolia,7,2,5,Points-PointsKO-Adjacents,53
Brenierea_insignis,30,21,9,Alphahull-PointsKO-Adjacents,216
Breonadia_salicina,276,177,99,Alphahull-PointsKO-Adjacents,6604
Breonia_boivinii,24,18,6,Points-PointsKO-Adjacents,78
Breonia_capuronii,24,13,11,Points-PointsKO-Adjacents,128
Breonia_chinensis,70,46,24,Alphahull-PointsKO-Adjacents,1028
Breonia_cuspidata,1,1,0,Points-PointsKO-Adjacents,9
Breonia_decaryana,28,14,14,Points-PointsKO-Adjacents,178
Breonia_fragifera,51,28,23,Alphahull-PointsKO-Adjacents,680
Breonia_havilandiana,9,3,6,Points-PointsKO-Adjacents,65
Breonia_louvelii,8,0,8,Points-PointsKO-Adjacents,30
Breonia_lowryi,6,1,5,Points-PointsKO-Adjacents,42
Breonia_macrocarpa,22,14,8,Points-PointsKO-Adjacents,111
Breonia_madagascariensis,7,4,3,Points-PointsKO-Adjacents,36
Breonia_membranacea,2,2,0,Points-PointsKO-Adjacents,18
Breonia_perrieri,77,60,17,Alphahull-PointsKO-Adjacents,847
Breonia_richardsonii,1,1,0,Points-PointsKO-Adjacents,9
Breonia_sambiranensis,33,26,7,Alphahull-PointsKO-Adjacents,544
Breonia_sphaerantha,22,16,6,Points-PointsKO-Adjacents,144
Breonia_stipulata,10,2,8,Points-PointsKO-Adjacents,73
Breonia_taolagnaroensis,9,1,8,Points-PointsKO-Adjacents,53
Breonia_tayloriana,8,0,8,Points-PointsKO-Adjacents,61
Breonia_tsaratananensis,7,3,4,Points-PointsKO-Adjacents,41
Bretschneidera_sinensis,57,28,29,Alphahull-PointsKO-Adjacents,2595
Breviea_sericea,13,5,8,Points-PointsKO-Adjacents,98
Brexia_alaticarpa,13,0,13,Points-PointsKO-Adjacents,70
Brexia_australis,7,2,5,Points-PointsKO-Adjacents,23
Brexia_madagascariensis,145,99,46,Alphahull-PointsKO-Adjacents,2037
Brexia_marioniae,11,4,7,Points-PointsKO-Adjacents,49
Brexiella_cymosa,7,0,7,Points-PointsKO-Adjacents,52
Brexiella_ilicifolia,33,21,12,Alphahull-PointsKO-Adjacents,581
Breynia_cernua,2524,2310,214,Alphahull-PointsKO-Adjacents,24751
Breynia_collaris,28,19,9,Points-PointsKO-Adjacents,150
Breynia_coronata,24,7,17,Points-PointsKO-Adjacents,178
Breynia_discigera,16,4,12,Points-PointsKO-Adjacents,128
Breynia_disticha,41,23,18,Alphahull-PointsKO-Adjacents,305
Breynia_fruticosa,119,72,47,Alphahull-PointsKO-Adjacents,8977
Breynia_indosinensis,0,0,0,NA,0
Breynia_microphylla,22,7,15,Points-PointsKO-Adjacents,181
Breynia_podocarpa,2,2,0,Points-PointsKO-Adjacents,13
Breynia_racemosa,102,27,75,Alphahull-PointsKO-Adjacents,1896
Breynia_retusa,81,30,51,Alphahull-PointsKO-Adjacents,3538
Breynia_rostrata,24,7,17,Points-PointsKO-Adjacents,216
Breynia_septata,1,1,0,Points-PointsKO-Adjacents,9
Breynia_subindochinensis,NA,NA,NA,NA,NA
Breynia_vestita,57,43,14,Alphahull-PointsKO-Adjacents,2372
Breynia_vitis-idaea,91,0,91,Points-PointsKO-Adjacents,739
Bridelia_adusta,1,1,0,Points-PointsKO-Adjacents,9
Bridelia_affinis,8,0,8,Points-PointsKO-Adjacents,66
Bridelia_alnifolia,NA,NA,NA,NA,NA
Bridelia_assamica,0,0,0,NA,0
Bridelia_atroviridis,133,73,60,Alphahull-PointsKO-Adjacents,4774
Bridelia_balansae,202,142,60,Alphahull-PointsKO-Adjacents,581
Bridelia_brideliifolia,50,26,24,Alphahull-PointsKO-Adjacents,813
Bridelia_cathartica,194,132,62,Alphahull-PointsKO-Adjacents,13604
Bridelia_cinnamomea,3,3,0,Points-PointsKO-Adjacents,27
Bridelia_curtisii,5,5,0,Points-PointsKO-Adjacents,39
Bridelia_duvigneaudii,17,4,13,Points-PointsKO-Adjacents,108
Bridelia_erapensis,3,3,0,Points-PointsKO-Adjacents,21
Bridelia_exaltata,272,243,29,Alphahull-PointsKO-Adjacents,953
Bridelia_ferruginea,1289,1214,75,Alphahull-PointsKO-Adjacents,19065
Bridelia_glauca,29,1,28,Points-PointsKO-Adjacents,237
Bridelia_grandis,56,25,31,Alphahull-PointsKO-Adjacents,850
Bridelia_insulana,139,71,68,Alphahull-PointsKO-Adjacents,2450
Bridelia_leichhardtii,260,229,31,Alphahull-PointsKO-Adjacents,3814
Bridelia_macrocarpa,12,9,3,Points-PointsKO-Adjacents,55
Bridelia_micrantha,574,421,153,Alphahull-PointsKO-Adjacents,30883
Bridelia_mollis,91,72,19,Alphahull-PointsKO-Adjacents,2283
Bridelia_montana,1,1,0,Points-PointsKO-Adjacents,9
Bridelia_moonii,2,2,0,Points-PointsKO-Adjacents,18
Bridelia_ndellensis,8,0,8,Points-PointsKO-Adjacents,72
Bridelia_oligantha,1,1,0,Points-PointsKO-Adjacents,9
Bridelia_ovata,17,0,17,Points-PointsKO-Adjacents,117
Bridelia_pervilleana,116,87,29,Alphahull-PointsKO-Adjacents,3348
Bridelia_pustulata,1,1,0,Points-PointsKO-Adjacents,9
Bridelia_retusa,58,13,45,Points-PointsKO-Adjacents,490
Bridelia_rhomboidalis,NA,NA,NA,NA,NA
Bridelia_ripicola,20,6,14,Points-PointsKO-Adjacents,114
Bridelia_scleroneura,299,233,66,Alphahull-PointsKO-Adjacents,6999
Bridelia_sikkimensis,2,2,0,Points-PointsKO-Adjacents,18
Bridelia_somalensis,1,1,0,Points-PointsKO-Adjacents,9
Bridelia_speciosa,14,7,7,Points-PointsKO-Adjacents,106
Bridelia_stipularis,75,23,52,Alphahull-PointsKO-Adjacents,6669
Bridelia_taitensis,39,27,12,Alphahull-PointsKO-Adjacents,287
Bridelia_tenuifolia,17,9,8,Points-PointsKO-Adjacents,149
Bridelia_tomentosa,1414,1260,154,Alphahull-PointsKO-Adjacents,14843
Bridelia_triplocarya,0,0,0,NA,0
Bridelia_tulasneana,103,84,19,Alphahull-PointsKO-Adjacents,1034
Bridelia_verrucosa,0,0,0,NA,0
Brochoneura_acuminata,80,50,30,Alphahull-PointsKO-Adjacents,414
Brochoneura_chapelieri,45,32,13,Alphahull-PointsKO-Adjacents,457
Brochoneura_dardainii,NA,NA,NA,NA,NA
Brochoneura_humblotii,61,39,22,Alphahull-PointsKO-Adjacents,399
Brochoneura_rarabe,12,1,11,Points-PointsKO-Adjacents,88
Brodriguesia_santosii,74,50,24,Alphahull-PointsKO-Adjacents,296
Brongniartia_alamosana,54,0,54,Points-PointsKO-Adjacents,242
Brongniartia_cuneata,6,4,2,Points-PointsKO-Adjacents,27
Brongniartia_glabrata,48,22,26,Alphahull-PointsKO-Adjacents,226
Brongniartia_goldmanii,34,19,15,Points-PointsKO-Adjacents,186
Brongniartia_guerrerensis,3,3,0,Points-PointsKO-Adjacents,18
Brongniartia_guiengolensis,3,3,0,Points-PointsKO-Adjacents,27
Brongniartia_montalvoana,9,6,3,Points-PointsKO-Adjacents,51
Brongniartia_pacifica,10,0,10,Points-PointsKO-Adjacents,56
Brongniartia_parryi,24,14,10,Points-PointsKO-Adjacents,163
Brongniartia_podalyrioides,60,43,17,Alphahull-PointsKO-Adjacents,420
Brongniartia_proteranthera,4,4,0,Points-PointsKO-Adjacents,36
Brongniartia_trifoliata,7,3,4,Points-PointsKO-Adjacents,23
Brosimum_acutifolium,244,188,56,Alphahull-PointsKO-Adjacents,28926
Brosimum_alicastrum,1245,1077,168,Alphahull-PointsKO-Adjacents,16956
Brosimum_costaricanum,67,51,16,Alphahull-PointsKO-Adjacents,322
Brosimum_gaudichaudii,1359,1243,116,Alphahull-PointsKO-Adjacents,52761
Brosimum_glaucum,24,11,13,Points-PointsKO-Adjacents,180
Brosimum_glaziovii,90,64,26,Alphahull-PointsKO-Adjacents,2365
Brosimum_guianense,1587,1395,192,Alphahull-PointsKO-Adjacents,106659
Brosimum_lactescens,1273,1111,162,Alphahull-PointsKO-Adjacents,89130
Brosimum_longifolium,8,2,6,Points-PointsKO-Adjacents,51
Brosimum_multinervium,39,23,16,Alphahull-PointsKO-Adjacents,1846
Brosimum_parinarioides,217,164,53,Alphahull-PointsKO-Adjacents,21125
Brosimum_potabile,77,29,48,Alphahull-PointsKO-Adjacents,2982
Brosimum_rubescens,746,641,105,Alphahull-PointsKO-Adjacents,78266
Brosimum_utile,428,356,72,Alphahull-PointsKO-Adjacents,15958
Broussaisia_arguta,25,11,14,Points-PointsKO-Adjacents,107
Broussonetia_greveana,27,11,16,Points-PointsKO-Adjacents,164
Broussonetia_harmandii,NA,NA,NA,NA,NA
Broussonetia_integrifolia,NA,NA,NA,NA,NA
Broussonetia_kaempferi,19,5,14,Points-PointsKO-Adjacents,139
Broussonetia_luzonica,7,0,7,Points-PointsKO-Adjacents,58
Broussonetia_papyrifera,400,283,117,Alphahull-PointsKO-Adjacents,33253
Broussonetia_rupicola,NA,NA,NA,NA,NA
Broussonetia_zeylanica,0,0,0,NA,0
Brownea_birschellii,21,8,13,Points-PointsKO-Adjacents,167
Brownea_bolivarensis,6,2,4,Points-PointsKO-Adjacents,39
Brownea_coccinea,193,149,44,Alphahull-PointsKO-Adjacents,13160
Brownea_enricii,11,6,5,Points-PointsKO-Adjacents,89
Brownea_gladysrojasiae,1,1,0,Points-PointsKO-Adjacents,9
Brownea_grandiceps,249,0,249,Points-PointsKO-Adjacents,1292
Brownea_leucantha,19,5,14,Points-PointsKO-Adjacents,157
Brownea_longipedicellata,30,0,30,Points-PointsKO-Adjacents,253
Brownea_macrophylla,167,123,44,Alphahull-PointsKO-Adjacents,7474
Brownea_multijuga,45,30,15,Alphahull-PointsKO-Adjacents,268
Brownea_puberula,1,1,0,Points-PointsKO-Adjacents,9
Brownea_rosa-de-monte,133,97,36,Alphahull-PointsKO-Adjacents,3273
Brownea_santanderensis,1,1,0,Points-PointsKO-Adjacents,9
Brownea_similis,9,4,5,Points-PointsKO-Adjacents,72
Brownea_stenantha,46,30,16,Alphahull-PointsKO-Adjacents,935
Brownea_tillettiana,4,4,0,Points-PointsKO-Adjacents,30
Browneopsis_cauliflora,14,8,6,Points-PointsKO-Adjacents,83
Browneopsis_disepala,11,6,5,Points-PointsKO-Adjacents,77
Browneopsis_excelsa,43,29,14,Alphahull-PointsKO-Adjacents,160
Browneopsis_macrofoliolata,1,1,0,Points-PointsKO-Adjacents,9
Browneopsis_peruviana,9,1,8,Points-PointsKO-Adjacents,81
Browneopsis_ucayalina,95,84,11,Alphahull-PointsKO-Adjacents,1188
Browningia_altissima,4,4,0,Points-PointsKO-Adjacents,31
Browningia_amstutziae,0,0,0,NA,0
Browningia_candelaris,8,0,8,Points-PointsKO-Adjacents,59
Browningia_columnaris,0,0,0,NA,0
Browningia_hernandezii,1,0,1,Points-PointsKO-Adjacents,9
Browningia_hertlingiana,0,0,0,NA,0
Browningia_microsperma,8,2,6,Points-PointsKO-Adjacents,47
Browningia_pilleifera,1,1,0,Points-PointsKO-Adjacents,9
Browningia_viridis,0,0,0,NA,0
Brownlowia_arachnoidea,0,0,0,NA,0
Brownlowia_argentata,29,11,18,Points-PointsKO-Adjacents,199
Brownlowia_calciphila,0,0,0,NA,0
Brownlowia_cuspidata,0,0,0,NA,0
Brownlowia_denysiana,0,0,0,NA,0
Brownlowia_eberhardtii,0,0,0,NA,0
Brownlowia_elata,0,0,0,NA,0
Brownlowia_elliptica,0,0,0,NA,0
Brownlowia_emarginata,0,0,0,NA,0
Brownlowia_ferruginea,0,0,0,NA,0
Brownlowia_fluminensis,0,0,0,NA,0
Brownlowia_glabrata,1,1,0,Points-PointsKO-Adjacents,9
Brownlowia_grandistipulata,0,0,0,NA,0
Brownlowia_havilandii,0,0,0,NA,0
Brownlowia_helferiana,1,1,0,Points-PointsKO-Adjacents,9
Brownlowia_kleinhovioidea,0,0,0,NA,0
Brownlowia_macrophylla,0,0,0,NA,0
Brownlowia_ovalis,0,0,0,NA,0
Brownlowia_paludosa,0,0,0,NA,0
Brownlowia_palustris,0,0,0,NA,0
Brownlowia_peltata,5,0,5,Points-PointsKO-Adjacents,45
Brownlowia_riparia,0,0,0,NA,0
Brownlowia_rubra,NA,NA,NA,NA,NA
Brownlowia_sarawhensis,0,0,0,NA,0
Brownlowia_sarwonoi,NA,NA,NA,NA,NA
Brownlowia_stipulata,0,0,0,NA,0
Brownlowia_tabularis,0,0,0,NA,0
Brownlowia_tersa,3,3,0,Points-PointsKO-Adjacents,26
Brownlowia_velutina,0,0,0,NA,0
Brucea_antidysenterica,71,47,24,Alphahull-PointsKO-Adjacents,1947
Brucea_guineensis,44,22,22,Alphahull-PointsKO-Adjacents,607
Brucea_javanica,438,299,139,Alphahull-PointsKO-Adjacents,10648
Brucea_macrocarpa,3,2,1,Points-PointsKO-Adjacents,23
Brucea_mollis,28,3,25,Points-PointsKO-Adjacents,234
Brucea_tonkinensis,0,0,0,NA,0
Brucea_trichotoma,1,1,0,Points-PointsKO-Adjacents,9
Brugmansia_arborea,451,281,170,Alphahull-PointsKO-Adjacents,11631
Brugmansia_x_insignis,26,0,26,Points-PointsKO-Adjacents,220
Brugmansia_sanguinea,246,0,246,Points-PointsKO-Adjacents,1352
Brugmansia_suaveolens,572,0,572,Points-PointsKO-Adjacents,3666
Brugmansia_versicolor,47,0,47,Points-PointsKO-Adjacents,319
Bruguiera_cylindrica,60,0,60,Points-PointsKO-Adjacents,376
Bruguiera_exaristata,351,264,87,Alphahull-PointsKO-Adjacents,5422
Bruguiera_gymnorhiza,334,0,334,Points-PointsKO-Adjacents,1710
Bruguiera_hainesii,3,2,1,Points-PointsKO-Adjacents,14
Bruguiera_parviflora,206,121,85,Alphahull-PointsKO-Adjacents,1920
Bruguiera_sexangula,120,37,83,Alphahull-PointsKO-Adjacents,1419
Bruinsmia_polysperma,0,0,0,NA,0
Bruinsmia_styracoides,18,1,17,Points-PointsKO-Adjacents,138
Brunellia_acostae,32,24,8,Alphahull-PointsKO-Adjacents,158
Brunellia_acutangula,42,25,17,Alphahull-PointsKO-Adjacents,574
Brunellia_almaguerensis,2,2,0,Points-PointsKO-Adjacents,18
Brunellia_amayensis,5,5,0,Points-PointsKO-Adjacents,42
Brunellia_antioquensis,44,30,14,Alphahull-PointsKO-Adjacents,872
Brunellia_boliviana,48,36,12,Alphahull-PointsKO-Adjacents,350
Brunellia_boqueronensis,17,9,8,Points-PointsKO-Adjacents,74
Brunellia_briquetii,3,3,0,Points-PointsKO-Adjacents,27
Brunellia_brunnea,6,0,6,Points-PointsKO-Adjacents,54
Brunellia_cayambensis,8,2,6,Points-PointsKO-Adjacents,65
Brunellia_colombiana,64,51,13,Alphahull-PointsKO-Adjacents,229
Brunellia_comocladifolia,239,166,73,Alphahull-PointsKO-Adjacents,4230
Brunellia_coroicoana,10,5,5,Points-PointsKO-Adjacents,50
Brunellia_costaricensis,81,66,15,Alphahull-PointsKO-Adjacents,128
Brunellia_cuatrecasana,3,3,0,Points-PointsKO-Adjacents,27
Brunellia_cutervensis,4,4,0,Points-PointsKO-Adjacents,24
Brunellia_cuzcoensis,6,1,5,Points-PointsKO-Adjacents,54
Brunellia_dichapetaloides,4,4,0,Points-PointsKO-Adjacents,36
Brunellia_dulcis,14,6,8,Points-PointsKO-Adjacents,97
Brunellia_ecuadoriensis,1,1,0,Points-PointsKO-Adjacents,9
Brunellia_elliptica,2,2,0,Points-PointsKO-Adjacents,18
Brunellia_espinalii,9,3,6,Points-PointsKO-Adjacents,61
Brunellia_farallonensis,3,3,0,Points-PointsKO-Adjacents,27
Brunellia_foreroi,1,1,0,Points-PointsKO-Adjacents,9
Brunellia_glabra,2,2,0,Points-PointsKO-Adjacents,18
Brunellia_goudotii,82,65,17,Alphahull-PointsKO-Adjacents,1372
Brunellia_hexasepala,2,2,0,Points-PointsKO-Adjacents,18
Brunellia_hiltyana,1,1,0,Points-PointsKO-Adjacents,9
Brunellia_hygrothermica,13,3,10,Points-PointsKO-Adjacents,99
Brunellia_integrifolia,79,51,28,Alphahull-PointsKO-Adjacents,1394
Brunellia_latifolia,5,5,0,Points-PointsKO-Adjacents,43
Brunellia_littlei,17,5,12,Points-PointsKO-Adjacents,140
Brunellia_macrophylla,7,2,5,Points-PointsKO-Adjacents,59
Brunellia_mexicana,171,138,33,Alphahull-PointsKO-Adjacents,2847
Brunellia_morii,3,3,0,Points-PointsKO-Adjacents,18
Brunellia_neblinensis,2,2,0,Points-PointsKO-Adjacents,14
Brunellia_occidentalis,14,8,6,Points-PointsKO-Adjacents,91
Brunellia_oliveri,8,4,4,Points-PointsKO-Adjacents,68
Brunellia_ovalifolia,9,3,6,Points-PointsKO-Adjacents,79
Brunellia_pallida,4,4,0,Points-PointsKO-Adjacents,30
Brunellia_pauciflora,4,4,0,Points-PointsKO-Adjacents,18
Brunellia_penderiscana,3,3,0,Points-PointsKO-Adjacents,27
Brunellia_pitayensis,5,5,0,Points-PointsKO-Adjacents,42
Brunellia_propinqua,98,85,13,Alphahull-PointsKO-Adjacents,728
Brunellia_putumayensis,25,17,8,Points-PointsKO-Adjacents,153
Brunellia_racemifera,7,2,5,Points-PointsKO-Adjacents,57
Brunellia_rhoides,36,24,12,Alphahull-PointsKO-Adjacents,322
Brunellia_rufa,1,1,0,Points-PointsKO-Adjacents,9
Brunellia_sibundoya,101,82,19,Alphahull-PointsKO-Adjacents,1866
Brunellia_standleyana,27,19,8,Points-PointsKO-Adjacents,113
Brunellia_stenoptera,18,10,8,Points-PointsKO-Adjacents,135
Brunellia_stuebelii,3,3,0,Points-PointsKO-Adjacents,27
Brunellia_subsessilis,35,27,8,Alphahull-PointsKO-Adjacents,142
Brunellia_tomentosa,55,43,12,Alphahull-PointsKO-Adjacents,714
Brunellia_trianae,39,25,14,Alphahull-PointsKO-Adjacents,283
Brunellia_trigyna,26,19,7,Points-PointsKO-Adjacents,147
Brunellia_velutina,3,3,0,Points-PointsKO-Adjacents,27
Brunellia_weberbaueri,18,8,10,Points-PointsKO-Adjacents,156
Brunellia_zamorensis,2,2,0,Points-PointsKO-Adjacents,18
Brunfelsia_americana,52,21,31,Alphahull-PointsKO-Adjacents,402
Brunfelsia_australis,134,99,35,Alphahull-PointsKO-Adjacents,5987
Brunfelsia_clandestina,74,0,74,Points-PointsKO-Adjacents,404
Brunfelsia_clarensis,0,0,0,NA,0
Brunfelsia_densifolia,7,5,2,Points-PointsKO-Adjacents,28
Brunfelsia_dwyeri,13,11,2,Points-PointsKO-Adjacents,22
Brunfelsia_grandiflora,459,0,459,Points-PointsKO-Adjacents,3078
Brunfelsia_imatacana,5,5,0,Points-PointsKO-Adjacents,45
Brunfelsia_jamaicensis,4,4,0,Points-PointsKO-Adjacents,26
Brunfelsia_lactea,16,10,6,Points-PointsKO-Adjacents,47
Brunfelsia_macrocarpa,9,1,8,Points-PointsKO-Adjacents,71
Brunfelsia_membranacea,3,3,0,Points-PointsKO-Adjacents,24
Brunfelsia_nitida,4,2,2,Points-PointsKO-Adjacents,30
Brunfelsia_pauciflora,230,187,43,Alphahull-PointsKO-Adjacents,4277
Brunfelsia_plowmaniana,39,24,15,Alphahull-PointsKO-Adjacents,288
Brunfelsia_portoricensis,4,1,3,Points-PointsKO-Adjacents,18
Brunfelsia_splendida,4,4,0,Points-PointsKO-Adjacents,30
Brunfelsia_undulata,2,1,1,Points-PointsKO-Adjacents,17
Brunfelsia_uniflora,283,183,100,Alphahull-PointsKO-Adjacents,8930
Brya_buxifolia,12,8,4,Points-PointsKO-Adjacents,84
Brya_chrysogonii,0,0,0,NA,0
Brya_ebenus,35,17,18,Points-PointsKO-Adjacents,230
Brya_hirsuta,NA,NA,NA,NA,NA
Brya_microphylla,NA,NA,NA,NA,NA
Brya_subinermis,1,1,0,Points-PointsKO-Adjacents,9
Buchanania_amboinensis,19,9,10,Points-PointsKO-Adjacents,102
Buchanania_arborescens,879,717,162,Alphahull-PointsKO-Adjacents,8549
Buchanania_attenuata,0,0,0,NA,0
Buchanania_axillaris,3,3,0,Points-PointsKO-Adjacents,23
Buchanania_barberi,0,0,0,NA,0
Buchanania_cochinchinensis,7,2,5,Points-PointsKO-Adjacents,49
Buchanania_engleriana,1,1,0,Points-PointsKO-Adjacents,7
Buchanania_evrardii,0,0,0,NA,0
Buchanania_ferruginea,0,0,0,NA,0
Buchanania_glabra,7,1,6,Points-PointsKO-Adjacents,63
Buchanania_insignis,27,8,19,Points-PointsKO-Adjacents,201
Buchanania_lanceolata,0,0,0,NA,0
Buchanania_lancifolia,NA,NA,NA,NA,NA
Buchanania_macrocarpa,74,0,74,Points-PointsKO-Adjacents,457
Buchanania_mangoides,6,2,4,Points-PointsKO-Adjacents,36
Buchanania_merrillii,6,0,6,Points-PointsKO-Adjacents,33
Buchanania_microphylla,8,0,8,Points-PointsKO-Adjacents,63
Buchanania_nitida,2,2,0,Points-PointsKO-Adjacents,13
Buchanania_obovata,3083,3050,33,Alphahull-PointsKO-Adjacents,6832
Buchanania_palawensis,4,4,0,Points-PointsKO-Adjacents,15
Buchanania_reticulata,6,2,4,Points-PointsKO-Adjacents,46
Buchanania_sessilifolia,101,0,101,Points-PointsKO-Adjacents,673
Buchanania_siamensis,4,4,0,Points-PointsKO-Adjacents,35
Buchanania_splendens,2,0,2,Points-PointsKO-Adjacents,17
Buchanania_vitiensis,1,1,0,Points-PointsKO-Adjacents,9
Buchanania_yunnanensis,NA,NA,NA,NA,NA
Buchenavia_acuminata,12,0,12,Points-PointsKO-Adjacents,36
Buchenavia_amazonia,82,45,37,Alphahull-PointsKO-Adjacents,2545
Buchenavia_callistachya,6,1,5,Points-PointsKO-Adjacents,46
Buchenavia_congesta,70,31,39,Alphahull-PointsKO-Adjacents,1066
Buchenavia_costaricensis,16,9,7,Points-PointsKO-Adjacents,57
Buchenavia_discolor,55,30,25,Alphahull-PointsKO-Adjacents,1618
Buchenavia_fanshawei,27,5,22,Points-PointsKO-Adjacents,213
Buchenavia_grandis,260,166,94,Alphahull-PointsKO-Adjacents,44238
Buchenavia_guianensis,52,21,31,Alphahull-PointsKO-Adjacents,1023
Buchenavia_hoehneana,45,15,30,Points-PointsKO-Adjacents,341
Buchenavia_huberi,40,11,29,Points-PointsKO-Adjacents,294
Buchenavia_igarataensis,40,16,24,Points-PointsKO-Adjacents,310
Buchenavia_kleinii,155,122,33,Alphahull-PointsKO-Adjacents,2175
Buchenavia_longibracteata,16,1,15,Points-PointsKO-Adjacents,119
Buchenavia_macrophylla,271,210,61,Alphahull-PointsKO-Adjacents,34070
Buchenavia_megalophylla,22,16,6,Points-PointsKO-Adjacents,123
Buchenavia_nitidissima,6,2,4,Points-PointsKO-Adjacents,54
Buchenavia_ochroprumna,129,91,38,Alphahull-PointsKO-Adjacents,6857
Buchenavia_oxycarpa,331,231,100,Alphahull-PointsKO-Adjacents,36454
Buchenavia_pabstii,6,0,6,Points-PointsKO-Adjacents,46
Buchenavia_pallidovirens,47,14,33,Points-PointsKO-Adjacents,376
Buchenavia_parvifolia,169,103,66,Alphahull-PointsKO-Adjacents,12846
Buchenavia_pulcherrima,1,1,0,Points-PointsKO-Adjacents,9
Buchenavia_rabelloana,13,6,7,Points-PointsKO-Adjacents,88
Buchenavia_reticulata,92,53,39,Alphahull-PointsKO-Adjacents,2475
Buchenavia_sericocarpa,58,23,35,Alphahull-PointsKO-Adjacents,841
Buchenavia_suaveolens,64,0,64,Points-PointsKO-Adjacents,461
Buchenavia_tetraphylla,692,508,184,Alphahull-PointsKO-Adjacents,67488
Buchenavia_tomentosa,659,564,95,Alphahull-PointsKO-Adjacents,34066
Buchenavia_viridiflora,126,57,69,Alphahull-PointsKO-Adjacents,4611
Buchholzia_coriacea,68,37,31,Alphahull-PointsKO-Adjacents,990
Buchholzia_tholloniana,10,1,9,Points-PointsKO-Adjacents,90
Buchnerodendron_speciosum,24,1,23,Points-PointsKO-Adjacents,155
Bucida_buceras,30,12,18,Points-PointsKO-Adjacents,155
Bucida_molinetii,14,0,14,Points-PointsKO-Adjacents,110
Bucida_palustris,4,4,0,Points-PointsKO-Adjacents,35
Bucida_subinermis,5,5,0,Points-PointsKO-Adjacents,43
Bucida_umbellata,NA,NA,NA,NA,NA
Buckinghamia_celsissima,134,0,134,Points-PointsKO-Adjacents,338
Buckinghamia_ferruginiflora,28,0,28,Points-PointsKO-Adjacents,48
Bucquetia_glutinosa,269,250,19,Alphahull-PointsKO-Adjacents,1189
Buddleja_alternifolia,18,0,18,Points-PointsKO-Adjacents,156
Buddleja_americana,915,748,167,Alphahull-PointsKO-Adjacents,16647
Buddleja_asiatica,372,243,129,Alphahull-PointsKO-Adjacents,15831
Buddleja_auriculata,48,30,18,Alphahull-PointsKO-Adjacents,767
Buddleja_bullata,144,114,30,Alphahull-PointsKO-Adjacents,1760
Buddleja_chenopodiifolia,2,2,0,Points-PointsKO-Adjacents,18
Buddleja_colvilei,4,4,0,Points-PointsKO-Adjacents,36
Buddleja_cordata,961,859,102,Alphahull-PointsKO-Adjacents,8814
Buddleja_coriacea,26,15,11,Points-PointsKO-Adjacents,192
Buddleja_crotonoides,168,119,49,Alphahull-PointsKO-Adjacents,1212
Buddleja_domingensis,28,24,4,Alphahull-PointsKO-Adjacents,86
Buddleja_euryphylla,5,1,4,Points-PointsKO-Adjacents,45
Buddleja_formosana,7,2,5,Points-PointsKO-Adjacents,38
Buddleja_globosa,160,71,89,Alphahull-PointsKO-Adjacents,3103
Buddleja_hookeri,11,0,11,Points-PointsKO-Adjacents,82
Buddleja_incana,173,126,47,Alphahull-PointsKO-Adjacents,1979
Buddleja_longifolia,8,0,8,Points-PointsKO-Adjacents,68
Buddleja_macrostachya,17,2,15,Points-PointsKO-Adjacents,127
Buddleja_madagascariensis,295,178,117,Alphahull-PointsKO-Adjacents,4583
Buddleja_megalocephala,13,8,5,Points-PointsKO-Adjacents,49
Buddleja_montana,33,17,16,Points-PointsKO-Adjacents,223
Buddleja_nitida,190,158,32,Alphahull-PointsKO-Adjacents,536
Buddleja_officinalis,93,66,27,Alphahull-PointsKO-Adjacents,11171
Buddleja_paniculata,17,4,13,Points-PointsKO-Adjacents,151
Buddleja_parviflora,797,711,86,Alphahull-PointsKO-Adjacents,5539
Buddleja_pichinchensis,50,36,14,Alphahull-PointsKO-Adjacents,251
Buddleja_polycephala,4,4,0,Points-PointsKO-Adjacents,36
Buddleja_rufescens,8,0,8,Points-PointsKO-Adjacents,72
Buddleja_saligna,158,111,47,Alphahull-PointsKO-Adjacents,8482
Buddleja_salviifolia,189,0,189,Points-PointsKO-Adjacents,1390
Buddleja_sessiliflora,685,585,100,Alphahull-PointsKO-Adjacents,9820
Buddleja_skutchii,109,94,15,Alphahull-PointsKO-Adjacents,817
Buddleja_soratae,4,4,0,Points-PointsKO-Adjacents,36
Buddleja_vexans,2,2,0,Points-PointsKO-Adjacents,18
Bullockia_dyscritos,6,4,2,Points-PointsKO-Adjacents,54
Bullockia_fadenii,1,0,1,Points-PointsKO-Adjacents,9
Bullockia_impressinervia,5,5,0,Points-PointsKO-Adjacents,32
Bullockia_mombazensis,25,14,11,Points-PointsKO-Adjacents,158
Bulnesia_arborea,89,64,25,Alphahull-PointsKO-Adjacents,2247
Bulnesia_bonariensis,66,43,23,Alphahull-PointsKO-Adjacents,3066
Bulnesia_carrapo,20,16,4,Points-PointsKO-Adjacents,79
Bulnesia_retamo,1,1,0,Points-PointsKO-Adjacents,9
Bulnesia_sarmientoi,56,1,55,Points-PointsKO-Adjacents,426
Bunchosia_angustifolia,8,3,5,Points-PointsKO-Adjacents,60
Bunchosia_anomala,6,1,5,Points-PointsKO-Adjacents,49
Bunchosia_argentea,351,275,76,Alphahull-PointsKO-Adjacents,14892
Bunchosia_armeniaca,219,159,60,Alphahull-PointsKO-Adjacents,6752
Bunchosia_articulata,8,2,6,Points-PointsKO-Adjacents,59
Bunchosia_berlinii,16,0,16,Points-PointsKO-Adjacents,49
Bunchosia_biocellata,177,126,51,Alphahull-PointsKO-Adjacents,2630
Bunchosia_cauliflora,16,10,6,Points-PointsKO-Adjacents,91
Bunchosia_cestrifolia,28,18,10,Points-PointsKO-Adjacents,233
Bunchosia_costaricensis,21,14,7,Points-PointsKO-Adjacents,88
Bunchosia_decussiflora,27,0,27,Points-PointsKO-Adjacents,209
Bunchosia_deflexa,13,5,8,Points-PointsKO-Adjacents,105
Bunchosia_diphylla,35,22,13,Alphahull-PointsKO-Adjacents,1085
Bunchosia_dwyeri,123,103,20,Alphahull-PointsKO-Adjacents,1346
Bunchosia_ekmanii,5,5,0,Points-PointsKO-Adjacents,41
Bunchosia_elliptica,5,5,0,Points-PointsKO-Adjacents,45
Bunchosia_emarginata,1,1,0,Points-PointsKO-Adjacents,8
Bunchosia_glandulifera,137,0,137,Points-PointsKO-Adjacents,1115
Bunchosia_glandulosa,132,89,43,Alphahull-PointsKO-Adjacents,1668
Bunchosia_grayumii,20,14,6,Points-PointsKO-Adjacents,78
Bunchosia_guatemalensis,68,40,28,Alphahull-PointsKO-Adjacents,1279
Bunchosia_haitiensis,2,2,0,Points-PointsKO-Adjacents,18
Bunchosia_hartwegiana,45,34,11,Alphahull-PointsKO-Adjacents,696
Bunchosia_hookeriana,41,19,22,Points-PointsKO-Adjacents,329
Bunchosia_jamaicensis,2,2,0,Points-PointsKO-Adjacents,16
Bunchosia_lanieri,8,1,7,Points-PointsKO-Adjacents,54
Bunchosia_lindeniana,793,690,103,Alphahull-PointsKO-Adjacents,8636
Bunchosia_linearifolia,2,2,0,Points-PointsKO-Adjacents,18
Bunchosia_macilenta,27,1,26,Points-PointsKO-Adjacents,157
Bunchosia_macrophylla,187,159,28,Alphahull-PointsKO-Adjacents,1052
Bunchosia_maritima,171,129,42,Alphahull-PointsKO-Adjacents,2643
Bunchosia_mesoamericana,37,24,13,Alphahull-PointsKO-Adjacents,159
Bunchosia_mollis,86,61,25,Alphahull-PointsKO-Adjacents,2910
Bunchosia_nitida,364,279,85,Alphahull-PointsKO-Adjacents,7020
Bunchosia_odorata,49,24,25,Alphahull-PointsKO-Adjacents,1573
Bunchosia_pallescens,70,45,25,Alphahull-PointsKO-Adjacents,3764
Bunchosia_palmeri,200,144,56,Alphahull-PointsKO-Adjacents,2687
Bunchosia_paraguariensis,65,0,65,Points-PointsKO-Adjacents,383
Bunchosia_plowmanii,28,1,27,Points-PointsKO-Adjacents,196
Bunchosia_polystachia,99,60,39,Alphahull-PointsKO-Adjacents,1577
Bunchosia_pseudonitida,101,74,27,Alphahull-PointsKO-Adjacents,2033
Bunchosia_sonorensis,26,0,26,Points-PointsKO-Adjacents,149
Bunchosia_strigosa,8,0,8,Points-PointsKO-Adjacents,53
Bunchosia_swartziana,414,359,55,Alphahull-PointsKO-Adjacents,2503
Bunchosia_systyla,0,0,0,NA,0
Bunchosia_ternata,39,30,9,Alphahull-PointsKO-Adjacents,109
Bunchosia_tuberculata,3,2,1,Points-PointsKO-Adjacents,27
Bunchosia_tutensis,4,4,0,Points-PointsKO-Adjacents,22
Bunchosia_ursana,51,44,7,Alphahull-PointsKO-Adjacents,184
Bunchosia_veluticarpa,22,13,9,Points-PointsKO-Adjacents,76
Bunchosia_volcanica,17,11,6,Points-PointsKO-Adjacents,44
Bungarimba_kahayanensis,2,2,0,Points-PointsKO-Adjacents,18
Bungarimba_papuana,1,1,0,Points-PointsKO-Adjacents,9
Bungarimba_ridsdalei,3,3,0,Points-PointsKO-Adjacents,23
Bungarimba_sessiliflora,1,1,0,Points-PointsKO-Adjacents,9
Burasaia_australis,26,0,26,Points-PointsKO-Adjacents,72
Burasaia_gracilis,8,2,6,Points-PointsKO-Adjacents,64
Burasaia_madagascariensis,141,113,28,Alphahull-PointsKO-Adjacents,1326
Burchellia_bubalina,122,85,37,Alphahull-PointsKO-Adjacents,3793
Burckella_banikiensis,NA,NA,NA,NA,NA
Burckella_erythrophylla,0,0,0,NA,0
Burckella_fijiensis,0,0,0,NA,0
Burckella_hillii,0,0,0,NA,0
Burckella_macropoda,3,3,0,Points-PointsKO-Adjacents,22
Burckella_magusum,0,0,0,NA,0
Burckella_obovata,32,0,32,Points-PointsKO-Adjacents,194
Burckella_parvifolia,NA,NA,NA,NA,NA
Burckella_polymera,1,1,0,Points-PointsKO-Adjacents,9
Burckella_poolei,1,1,0,Points-PointsKO-Adjacents,9
Burckella_richii,2,2,0,Points-PointsKO-Adjacents,6
Burckella_sorei,0,0,0,NA,0
Burckella_thurstonii,0,0,0,NA,0
Burdachia_duckei,35,0,35,Points-PointsKO-Adjacents,279
Burdachia_prismatocarpa,236,200,36,Alphahull-PointsKO-Adjacents,16317
Burdachia_sphaerocarpa,78,50,28,Alphahull-PointsKO-Adjacents,3253
Burkea_africana,1624,1512,112,Alphahull-PointsKO-Adjacents,17720
Burkillanthus_malaccensis,3,3,0,Points-PointsKO-Adjacents,27
Burkilliodendron_album,NA,NA,NA,NA,NA
Burmeistera_racemiflora,3,3,0,Points-PointsKO-Adjacents,18
Burretiodendron_brilletii,0,0,0,NA,0
Burretiodendron_esquirolii,8,0,8,Points-PointsKO-Adjacents,57
Burretiodendron_hsienmu,11,4,7,Points-PointsKO-Adjacents,98
Burretiodendron_kydiifolium,2,2,0,Points-PointsKO-Adjacents,18
Burretiodendron_obconicum,1,1,0,Points-PointsKO-Adjacents,9
Burretiodendron_siamense,5,5,0,Points-PointsKO-Adjacents,30
Burretiokentia_dumasii,1,1,0,Points-PointsKO-Adjacents,9
Burretiokentia_grandiflora,3,3,0,Points-PointsKO-Adjacents,9
Burretiokentia_hapala,6,2,4,Points-PointsKO-Adjacents,20
Burretiokentia_koghiensis,2,2,0,Points-PointsKO-Adjacents,9
Burretiokentia_vieillardii,44,30,14,Alphahull-PointsKO-Adjacents,112
Bursaria_incana,483,424,59,Alphahull-PointsKO-Adjacents,7813
Bursaria_occidentalis,185,165,20,Alphahull-PointsKO-Adjacents,2488
Bursaria_spinosa,18114,17126,988,Alphahull-PointsKO-Adjacents,20238
Bursaria_tenuifolia,267,3,264,Points-PointsKO-Adjacents,741
Bursera_amplifolia,75,33,42,Alphahull-PointsKO-Adjacents,1368
Bursera_angustata,2,2,0,Points-PointsKO-Adjacents,18
Bursera_aptera,437,410,27,Alphahull-PointsKO-Adjacents,1219
Bursera_arida,102,89,13,Alphahull-PointsKO-Adjacents,111
Bursera_ariensis,323,290,33,Alphahull-PointsKO-Adjacents,2012
Bursera_aromatica,6,3,3,Points-PointsKO-Adjacents,36
Bursera_aspleniifolia,91,82,9,Alphahull-PointsKO-Adjacents,236
Bursera_attenuata,51,38,13,Alphahull-PointsKO-Adjacents,350
Bursera_bicolor,290,269,21,Alphahull-PointsKO-Adjacents,1401
Bursera_biflora,218,200,18,Alphahull-PointsKO-Adjacents,231
Bursera_bipinnata,1014,894,120,Alphahull-PointsKO-Adjacents,5079
Bursera_bolivarii,109,96,13,Alphahull-PointsKO-Adjacents,247
Bursera_bonetii,56,40,16,Alphahull-PointsKO-Adjacents,225
Bursera_brunea,2,2,0,Points-PointsKO-Adjacents,16
Bursera_chemapodicta,37,32,5,Alphahull-PointsKO-Adjacents,38
Bursera_cinerea,151,129,22,Alphahull-PointsKO-Adjacents,659
Bursera_citronella,45,32,13,Alphahull-PointsKO-Adjacents,298
Bursera_collina,7,1,6,Points-PointsKO-Adjacents,48
Bursera_confusa,83,55,28,Alphahull-PointsKO-Adjacents,1484
Bursera_copallifera,606,545,61,Alphahull-PointsKO-Adjacents,3520
Bursera_coyucensis,83,71,12,Alphahull-PointsKO-Adjacents,468
Bursera_crenata,87,68,19,Alphahull-PointsKO-Adjacents,331
Bursera_cuneata,242,197,45,Alphahull-PointsKO-Adjacents,1478
Bursera_denticulata,57,36,21,Alphahull-PointsKO-Adjacents,870
Bursera_discolor,155,131,24,Alphahull-PointsKO-Adjacents,1013
Bursera_diversifolia,97,64,33,Alphahull-PointsKO-Adjacents,1416
Bursera_dubia,86,61,25,Alphahull-PointsKO-Adjacents,722
Bursera_epinnata,173,147,26,Alphahull-PointsKO-Adjacents,578
Bursera_excelsa,852,732,120,Alphahull-PointsKO-Adjacents,5859
Bursera_fagaroides,1770,0,1770,Points-PointsKO-Adjacents,4883
Bursera_filicifolia,53,34,19,Alphahull-PointsKO-Adjacents,204
Bursera_fragrantissima,35,23,12,Alphahull-PointsKO-Adjacents,138
Bursera_frenningiae,2,2,0,Points-PointsKO-Adjacents,15
Bursera_galeottiana,235,206,29,Alphahull-PointsKO-Adjacents,500
Bursera_glabra,38,18,20,Points-PointsKO-Adjacents,192
Bursera_glabrifolia,547,480,67,Alphahull-PointsKO-Adjacents,2147
Bursera_glauca,15,2,13,Points-PointsKO-Adjacents,106
Bursera_gracilipes,2,2,0,Points-PointsKO-Adjacents,18
Bursera_grandifolia,644,562,82,Alphahull-PointsKO-Adjacents,4749
Bursera_graveolens,423,327,96,Alphahull-PointsKO-Adjacents,8841
Bursera_heliae,39,33,6,Alphahull-PointsKO-Adjacents,105
Bursera_heteresthes,306,258,48,Alphahull-PointsKO-Adjacents,2007
Bursera_heterophylla,1,1,0,Points-PointsKO-Adjacents,9
Bursera_hindsiana,85,73,12,Alphahull-PointsKO-Adjacents,1141
Bursera_hintonii,89,0,89,Points-PointsKO-Adjacents,378
Bursera_hollickii,1,1,0,Points-PointsKO-Adjacents,9
Bursera_icicariba,NA,NA,NA,NA,NA
Bursera_infernidialis,57,0,57,Points-PointsKO-Adjacents,212
Bursera_instabilis,101,83,18,Alphahull-PointsKO-Adjacents,1867
Bursera_inversa,17,4,13,Points-PointsKO-Adjacents,134
Bursera_isthmica,18,10,8,Points-PointsKO-Adjacents,96
Bursera_itzae,4,4,0,Points-PointsKO-Adjacents,30
Bursera_karsteniana,38,17,21,Points-PointsKO-Adjacents,292
Bursera_karwinskii,2,1,1,Points-PointsKO-Adjacents,18
Bursera_kerberi,232,187,45,Alphahull-PointsKO-Adjacents,1320
Bursera_klugii,34,14,20,Points-PointsKO-Adjacents,251
Bursera_krusei,51,33,18,Alphahull-PointsKO-Adjacents,411
Bursera_lancifolia,325,295,30,Alphahull-PointsKO-Adjacents,2276
Bursera_laurihuertae,67,52,15,Alphahull-PointsKO-Adjacents,227
Bursera_laxiflora,201,177,24,Alphahull-PointsKO-Adjacents,2136
Bursera_linanoe,228,212,16,Alphahull-PointsKO-Adjacents,1127
Bursera_longipes,224,189,35,Alphahull-PointsKO-Adjacents,973
Bursera_lunanii,6,1,5,Points-PointsKO-Adjacents,18
Bursera_macvaughiana,14,8,6,Points-PointsKO-Adjacents,43
Bursera_madrigalii,5,5,0,Points-PointsKO-Adjacents,36
Bursera_martae,3,3,0,Points-PointsKO-Adjacents,18
Bursera_medranoana,8,0,8,Points-PointsKO-Adjacents,32
Bursera_microphylla,630,587,43,Alphahull-PointsKO-Adjacents,4432
Bursera_mirandae,118,0,118,Points-PointsKO-Adjacents,297
Bursera_morelensis,499,456,43,Alphahull-PointsKO-Adjacents,2602
Bursera_multifolia,42,30,12,Alphahull-PointsKO-Adjacents,226
Bursera_multijuga,227,188,39,Alphahull-PointsKO-Adjacents,1454
Bursera_occulta,8,0,8,Points-PointsKO-Adjacents,58
Bursera_oerstedii,2,2,0,Points-PointsKO-Adjacents,18
Bursera_ovalifolia,166,121,45,Alphahull-PointsKO-Adjacents,1694
Bursera_palaciosii,19,13,6,Points-PointsKO-Adjacents,45
Bursera_palmeri,278,229,49,Alphahull-PointsKO-Adjacents,2689
Bursera_paradoxa,50,46,4,Alphahull-PointsKO-Adjacents,114
Bursera_penicillata,441,369,72,Alphahull-PointsKO-Adjacents,4190
Bursera_permollis,20,12,8,Points-PointsKO-Adjacents,163
Bursera_roseana,143,122,21,Alphahull-PointsKO-Adjacents,1707
Bursera_rzedowskii,6,4,2,Points-PointsKO-Adjacents,30
Bursera_sarcopoda,93,69,24,Alphahull-PointsKO-Adjacents,662
Bursera_sarukhanii,70,61,9,Alphahull-PointsKO-Adjacents,191
Bursera_schlechtendalii,865,768,97,Alphahull-PointsKO-Adjacents,9770
Bursera_sellowii,NA,NA,NA,NA,NA
Bursera_shaferi,2,2,0,Points-PointsKO-Adjacents,17
Bursera_silviae,6,2,4,Points-PointsKO-Adjacents,26
Bursera_simaruba,3396,3016,380,Alphahull-PointsKO-Adjacents,40025
Bursera_simplex,6,3,3,Points-PointsKO-Adjacents,23
Bursera_spinescens,10,6,4,Points-PointsKO-Adjacents,54
Bursera_standleyana,28,22,6,Alphahull-PointsKO-Adjacents,71
Bursera_staphyleoides,13,6,7,Points-PointsKO-Adjacents,83
Bursera_stenophylla,31,21,10,Alphahull-PointsKO-Adjacents,511
Bursera_submoniliformis,395,374,21,Alphahull-PointsKO-Adjacents,1004
Bursera_subtrifoliata,6,2,4,Points-PointsKO-Adjacents,43
Bursera_suntui,46,40,6,Alphahull-PointsKO-Adjacents,99
Bursera_tecomaca,44,0,44,Points-PointsKO-Adjacents,169
Bursera_toledoana,7,0,7,Points-PointsKO-Adjacents,42
Bursera_tomentosa,276,199,77,Alphahull-PointsKO-Adjacents,7969
Bursera_trifoliolata,49,43,6,Alphahull-PointsKO-Adjacents,233
Bursera_trimera,98,81,17,Alphahull-PointsKO-Adjacents,623
Bursera_vejar-vazquezii,110,97,13,Alphahull-PointsKO-Adjacents,397
Bursera_velutina,71,65,6,Alphahull-PointsKO-Adjacents,520
Bursera_xochipalensis,148,133,15,Alphahull-PointsKO-Adjacents,297
Burttia_prunoides,18,9,9,Points-PointsKO-Adjacents,99
Bussea_eggelingii,1,1,0,Points-PointsKO-Adjacents,9
Bussea_gossweileri,8,2,6,Points-PointsKO-Adjacents,63
Bussea_massaiensis,35,24,11,Alphahull-PointsKO-Adjacents,347
Bussea_occidentalis,109,88,21,Alphahull-PointsKO-Adjacents,2804
Bussea_perrieri,17,11,6,Points-PointsKO-Adjacents,98
Bussea_sakalava,33,23,10,Alphahull-PointsKO-Adjacents,119
Bussea_xylocarpa,1,1,0,Points-PointsKO-Adjacents,9
Butea_braamiana,1,1,0,Points-PointsKO-Adjacents,9
Butea_monosperma,18,0,18,Points-PointsKO-Adjacents,147
Butea_superba,7,0,7,Points-PointsKO-Adjacents,63
Butia_capitata,111,80,31,Alphahull-PointsKO-Adjacents,3018
Butia_catarinensis,44,30,14,Alphahull-PointsKO-Adjacents,324
Butia_eriospatha,82,60,22,Alphahull-PointsKO-Adjacents,1831
Butia_exilata,2,2,0,Points-PointsKO-Adjacents,14
Butia_lepidotispatha,0,0,0,NA,0
Butia_odorata,72,55,17,Alphahull-PointsKO-Adjacents,2600
Butia_paraguayensis,225,196,29,Alphahull-PointsKO-Adjacents,8588
Butia_purpurascens,25,17,8,Points-PointsKO-Adjacents,158
Butia_yatay,87,68,19,Alphahull-PointsKO-Adjacents,3985
Buxus_acuminata,1,1,0,Points-PointsKO-Adjacents,8
Buxus_acutata,30,7,23,Points-PointsKO-Adjacents,221
Buxus_arborea,2,2,0,Points-PointsKO-Adjacents,16
Buxus_bahamensis,7,2,5,Points-PointsKO-Adjacents,42
Buxus_bartlettii,51,33,18,Alphahull-PointsKO-Adjacents,498
Buxus_benguellensis,2,2,0,Points-PointsKO-Adjacents,18
Buxus_bissei,1,1,0,Points-PointsKO-Adjacents,8
Buxus_braimbridgeorum,NA,NA,NA,NA,NA
Buxus_brevipes,0,0,0,NA,0
Buxus_calcarea,5,5,0,Points-PointsKO-Adjacents,39
Buxus_capuronii,2,2,0,Points-PointsKO-Adjacents,15
Buxus_citrifolia,32,17,15,Points-PointsKO-Adjacents,181
Buxus_conzattii,2,2,0,Points-PointsKO-Adjacents,18
Buxus_crassifolia,1,1,0,Points-PointsKO-Adjacents,8
Buxus_ekmanii,2,2,0,Points-PointsKO-Adjacents,17
Buxus_glomerata,16,7,9,Points-PointsKO-Adjacents,100
Buxus_gonoclada,1,1,0,Points-PointsKO-Adjacents,9
Buxus_hildebrandtii,15,2,13,Points-PointsKO-Adjacents,125
Buxus_humbertii,5,5,0,Points-PointsKO-Adjacents,33
Buxus_liukiuensis,20,11,9,Points-PointsKO-Adjacents,81
Buxus_macowanii,25,6,19,Points-PointsKO-Adjacents,216
Buxus_macrocarpa,8,3,5,Points-PointsKO-Adjacents,66
Buxus_madagascarica,50,33,17,Alphahull-PointsKO-Adjacents,338
Buxus_marginalis,6,2,4,Points-PointsKO-Adjacents,31
Buxus_megistophylla,14,3,11,Points-PointsKO-Adjacents,122
Buxus_microphylla,60,31,29,Alphahull-PointsKO-Adjacents,1618
Buxus_moctezumae,11,5,6,Points-PointsKO-Adjacents,36
Buxus_monticola,21,7,14,Points-PointsKO-Adjacents,126
Buxus_moratii,18,10,8,Points-PointsKO-Adjacents,73
Buxus_natalensis,26,0,26,Points-PointsKO-Adjacents,201
Buxus_nyasica,2,2,0,Points-PointsKO-Adjacents,18
Buxus_obtusifolia,28,19,9,Points-PointsKO-Adjacents,150
Buxus_olivacea,2,2,0,Points-PointsKO-Adjacents,12
Buxus_portoricensis,8,4,4,Points-PointsKO-Adjacents,42
Buxus_rabenantoandroi,9,3,6,Points-PointsKO-Adjacents,40
Buxus_retusa,1,1,0,Points-PointsKO-Adjacents,8
Buxus_rolfei,2,2,0,Points-PointsKO-Adjacents,18
Buxus_sempervirens,11648,10401,1247,Alphahull-PointsKO-Adjacents,30706
Buxus_sinica,99,41,58,Alphahull-PointsKO-Adjacents,4077
Buxus_triptera,NA,NA,NA,NA,NA
Buxus_vahlii,2,0,2,Points-PointsKO-Adjacents,16
Buxus_yunquensis,NA,NA,NA,NA,NA
Byrsanthus_brownii,35,23,12,Alphahull-PointsKO-Adjacents,936
Byrsonima_aerugo,191,127,64,Alphahull-PointsKO-Adjacents,10994
Byrsonima_affinis,107,75,32,Alphahull-PointsKO-Adjacents,6777
Byrsonima_altissima,25,4,21,Points-PointsKO-Adjacents,195
Byrsonima_alvimii,28,12,16,Points-PointsKO-Adjacents,175
Byrsonima_amoena,65,0,65,Points-PointsKO-Adjacents,429
Byrsonima_arbutifolia,7,1,6,Points-PointsKO-Adjacents,60
Byrsonima_arctostaphyloides,37,0,37,Points-PointsKO-Adjacents,234
Byrsonima_arthropoda,470,350,120,Alphahull-PointsKO-Adjacents,29741
Byrsonima_baccae,3,3,0,Points-PointsKO-Adjacents,15
Byrsonima_bahiana,72,29,43,Alphahull-PointsKO-Adjacents,1053
Byrsonima_basiliana,2,2,0,Points-PointsKO-Adjacents,18
Byrsonima_basiloba,210,167,43,Alphahull-PointsKO-Adjacents,7482
Byrsonima_brachystachya,3,3,0,Points-PointsKO-Adjacents,27
Byrsonima_bronweniana,18,0,18,Points-PointsKO-Adjacents,132
Byrsonima_bucidifolia,266,245,21,Alphahull-PointsKO-Adjacents,2052
Byrsonima_cacaophila,40,27,13,Alphahull-PointsKO-Adjacents,260
Byrsonima_carraoana,33,19,14,Points-PointsKO-Adjacents,138
Byrsonima_chalcophylla,9,4,5,Points-PointsKO-Adjacents,53
Byrsonima_christianeae,29,12,17,Points-PointsKO-Adjacents,207
Byrsonima_clausseniana,186,147,39,Alphahull-PointsKO-Adjacents,9765
Byrsonima_coccolobifolia,1286,1120,166,Alphahull-PointsKO-Adjacents,47842
Byrsonima_concinna,120,94,26,Alphahull-PointsKO-Adjacents,4888
Byrsonima_coniophylla,89,67,22,Alphahull-PointsKO-Adjacents,2739
Byrsonima_cordifolia,3,3,0,Points-PointsKO-Adjacents,27
Byrsonima_correifolia,485,455,30,Alphahull-PointsKO-Adjacents,12295
Byrsonima_cowanii,9,5,4,Points-PointsKO-Adjacents,69
Byrsonima_crassa,233,197,36,Alphahull-PointsKO-Adjacents,13825
Byrsonima_crassifolia,4030,3621,409,Alphahull-PointsKO-Adjacents,124458
Byrsonima_crispa,654,507,147,Alphahull-PointsKO-Adjacents,59406
Byrsonima_cuprea,45,29,16,Alphahull-PointsKO-Adjacents,657
Byrsonima_cydoniifolia,461,391,70,Alphahull-PointsKO-Adjacents,29407
Byrsonima_dealbata,247,213,34,Alphahull-PointsKO-Adjacents,3707
Byrsonima_decipiens,31,11,20,Points-PointsKO-Adjacents,197
Byrsonima_densa,99,59,40,Alphahull-PointsKO-Adjacents,4302
Byrsonima_dubia,1,1,0,Points-PointsKO-Adjacents,9
Byrsonima_duckeana,44,27,17,Alphahull-PointsKO-Adjacents,339
Byrsonima_duidana,8,4,4,Points-PointsKO-Adjacents,55
Byrsonima_eriopoda,1,1,0,Points-PointsKO-Adjacents,9
Byrsonima_eugeniifolia,66,39,27,Alphahull-PointsKO-Adjacents,3927
Byrsonima_euryphylla,7,1,6,Points-PointsKO-Adjacents,63
Byrsonima_fanshawei,1,1,0,Points-PointsKO-Adjacents,9
Byrsonima_fernandezii,34,9,25,Points-PointsKO-Adjacents,239
Byrsonima_flexipes,9,5,4,Points-PointsKO-Adjacents,77
Byrsonima_fonsecae,6,1,5,Points-PointsKO-Adjacents,39
Byrsonima_formosa,7,0,7,Points-PointsKO-Adjacents,49
Byrsonima_frondosa,9,0,9,Points-PointsKO-Adjacents,75
Byrsonima_garcibarrigae,47,22,25,Alphahull-PointsKO-Adjacents,366
Byrsonima_gardneriana,459,374,85,Alphahull-PointsKO-Adjacents,10003
Byrsonima_grisebachiana,84,58,26,Alphahull-PointsKO-Adjacents,6785
Byrsonima_guilleminiana,134,102,32,Alphahull-PointsKO-Adjacents,4657
Byrsonima_gymnocalycina,17,7,10,Points-PointsKO-Adjacents,115
Byrsonima_herrerae,12,6,6,Points-PointsKO-Adjacents,73
Byrsonima_hirsuta,2,2,0,Points-PointsKO-Adjacents,18
Byrsonima_homeieri,5,5,0,Points-PointsKO-Adjacents,18
Byrsonima_huberi,1,1,0,Points-PointsKO-Adjacents,9
Byrsonima_hypoleuca,28,13,15,Points-PointsKO-Adjacents,234
Byrsonima_incarnata,8,4,4,Points-PointsKO-Adjacents,42
Byrsonima_intermedia,982,864,118,Alphahull-PointsKO-Adjacents,30652
Byrsonima_japurensis,471,391,80,Alphahull-PointsKO-Adjacents,37555
Byrsonima_kariniana,2,2,0,Points-PointsKO-Adjacents,12
Byrsonima_karstenii,7,4,3,Points-PointsKO-Adjacents,30
Byrsonima_krukoffii,27,0,27,Points-PointsKO-Adjacents,232
Byrsonima_laevigata,69,30,39,Alphahull-PointsKO-Adjacents,1754
Byrsonima_laevis,101,60,41,Alphahull-PointsKO-Adjacents,3046
Byrsonima_lancifolia,190,141,49,Alphahull-PointsKO-Adjacents,6821
Byrsonima_laxiflora,478,412,66,Alphahull-PointsKO-Adjacents,19299
Byrsonima_leucophlebia,31,13,18,Points-PointsKO-Adjacents,244
Byrsonima_ligustrifolia,417,366,51,Alphahull-PointsKO-Adjacents,6176
Byrsonima_linguifera,69,37,32,Alphahull-PointsKO-Adjacents,2095
Byrsonima_lucida,104,62,42,Alphahull-PointsKO-Adjacents,1136
Byrsonima_luetzelburgii,9,5,4,Points-PointsKO-Adjacents,78
Byrsonima_lyoniifolia,86,58,28,Alphahull-PointsKO-Adjacents,3693
Byrsonima_macrophylla,86,52,34,Alphahull-PointsKO-Adjacents,360
Byrsonima_macrostachya,5,5,0,Points-PointsKO-Adjacents,35
Byrsonima_maguirei,3,3,0,Points-PointsKO-Adjacents,23
Byrsonima_martiana,7,0,7,Points-PointsKO-Adjacents,54
Byrsonima_myricifolia,124,98,26,Alphahull-PointsKO-Adjacents,1623
Byrsonima_nemoralis,18,11,7,Points-PointsKO-Adjacents,106
Byrsonima_nitidifolia,63,36,27,Alphahull-PointsKO-Adjacents,1293
Byrsonima_nitidissima,40,32,8,Alphahull-PointsKO-Adjacents,425
Byrsonima_oaxacana,5,3,2,Points-PointsKO-Adjacents,45
Byrsonima_oblanceolata,6,2,4,Points-PointsKO-Adjacents,50
Byrsonima_obversa,46,15,31,Points-PointsKO-Adjacents,351
Byrsonima_pachyphylla,792,737,55,Alphahull-PointsKO-Adjacents,24695
Byrsonima_pachypoda,9,6,3,Points-PointsKO-Adjacents,39
Byrsonima_pedunculata,3,3,0,Points-PointsKO-Adjacents,27
Byrsonima_perseifolia,40,26,14,Alphahull-PointsKO-Adjacents,776
Byrsonima_piresii,16,4,12,Points-PointsKO-Adjacents,117
Byrsonima_poeppigiana,123,61,62,Alphahull-PointsKO-Adjacents,5925
Byrsonima_punctulata,136,91,45,Alphahull-PointsKO-Adjacents,9090
Byrsonima_putumayensis,11,3,8,Points-PointsKO-Adjacents,99
Byrsonima_riparia,42,19,23,Points-PointsKO-Adjacents,255
Byrsonima_rodriguesii,24,18,6,Points-PointsKO-Adjacents,96
Byrsonima_rotunda,82,51,31,Alphahull-PointsKO-Adjacents,1743
Byrsonima_rubrobracteata,5,5,0,Points-PointsKO-Adjacents,30
Byrsonima_salzmanniana,32,0,32,Points-PointsKO-Adjacents,226
Byrsonima_schomburgkiana,79,0,79,Points-PointsKO-Adjacents,537
Byrsonima_schunkei,43,23,20,Alphahull-PointsKO-Adjacents,1648
Byrsonima_sericea,1758,1603,155,Alphahull-PointsKO-Adjacents,37042
Byrsonima_smallii,NA,NA,NA,NA,NA
Byrsonima_souzae,4,4,0,Points-PointsKO-Adjacents,35
Byrsonima_spicata,1068,898,170,Alphahull-PointsKO-Adjacents,75540
Byrsonima_spinensis,19,0,19,Points-PointsKO-Adjacents,112
Byrsonima_stannardii,82,59,23,Alphahull-PointsKO-Adjacents,583
Byrsonima_steyermarkii,4,4,0,Points-PointsKO-Adjacents,30
Byrsonima_stipulacea,464,360,104,Alphahull-PointsKO-Adjacents,26869
Byrsonima_subcordata,3,3,0,Points-PointsKO-Adjacents,27
Byrsonima_surinamensis,12,7,5,Points-PointsKO-Adjacents,56
Byrsonima_tenuifolia,0,0,0,NA,0
Byrsonima_tillettii,7,1,6,Points-PointsKO-Adjacents,54
Byrsonima_trinitensis,19,9,10,Points-PointsKO-Adjacents,74
Byrsonima_umbellata,212,174,38,Alphahull-PointsKO-Adjacents,14891
Byrsonima_vacciniifolia,370,334,36,Alphahull-PointsKO-Adjacents,11555
Byrsonima_variabilis,269,225,44,Alphahull-PointsKO-Adjacents,6540
Byrsonima_verbascifolia,1145,991,154,Alphahull-PointsKO-Adjacents,42911
Byrsonima_vernicosa,19,11,8,Points-PointsKO-Adjacents,109
Byrsonima_wadsworthii,8,5,3,Points-PointsKO-Adjacents,42
Byrsonima_wurdackii,4,4,0,Points-PointsKO-Adjacents,27
Byrsophyllum_ellipticum,0,0,0,NA,0
Byrsophyllum_tetrandrum,1,1,0,Points-PointsKO-Adjacents,9
Byttneria_aculeata,1233,1000,233,Alphahull-PointsKO-Adjacents,21045
Byttneria_ancistrodonta,12,3,9,Points-PointsKO-Adjacents,104
Byttneria_aurantiaca,16,0,16,Points-PointsKO-Adjacents,143
Byttneria_crenulata,0,0,0,NA,0
Byttneria_divaricata,91,48,43,Alphahull-PointsKO-Adjacents,3020
Byttneria_filipes,121,77,44,Alphahull-PointsKO-Adjacents,7012
Byttneria_flexuosa,1,1,0,Points-PointsKO-Adjacents,9
Byttneria_fluvialis,2,2,0,Points-PointsKO-Adjacents,18
Byttneria_fruticosa,12,0,12,Points-PointsKO-Adjacents,49
Byttneria_gracilipes,36,0,36,Points-PointsKO-Adjacents,278
Byttneria_hirsuta,29,13,16,Points-PointsKO-Adjacents,171
Byttneria_ivorensis,2,2,0,Points-PointsKO-Adjacents,18
Byttneria_morii,9,4,5,Points-PointsKO-Adjacents,65
Byttneria_parviflora,51,36,15,Alphahull-PointsKO-Adjacents,582
Byttneria_rhamnifolia,48,16,32,Points-PointsKO-Adjacents,355
Byttneria_urticifolia,55,0,55,Points-PointsKO-Adjacents,404
Cabralea_canjerana,2093,1914,179,Alphahull-PointsKO-Adjacents,42206
Cadaba_aphylla,145,106,39,Alphahull-PointsKO-Adjacents,9900
Cadaba_barbigera,2,2,0,Points-PointsKO-Adjacents,18
Cadaba_farinosa,205,123,82,Alphahull-PointsKO-Adjacents,7936
Cadaba_gillettii,3,3,0,Points-PointsKO-Adjacents,27
Cadaba_glandulosa,41,4,37,Points-PointsKO-Adjacents,315
Cadaba_insularis,1,1,0,Points-PointsKO-Adjacents,7
Cadaba_kirkii,24,6,18,Points-PointsKO-Adjacents,195
Cadaba_linearifolia,7,0,7,Points-PointsKO-Adjacents,53
Cadaba_longifolia,12,0,12,Points-PointsKO-Adjacents,79
Cadaba_natalensis,44,28,16,Alphahull-PointsKO-Adjacents,775
Cadaba_trifoliata,2,2,0,Points-PointsKO-Adjacents,18
Cadaba_virgata,49,38,11,Alphahull-PointsKO-Adjacents,388
Cadia_ellisiana,35,25,10,Alphahull-PointsKO-Adjacents,136
Cadia_pedicellata,15,10,5,Points-PointsKO-Adjacents,82
Cadia_purpurea,47,19,28,Points-PointsKO-Adjacents,241
Caesalpinia_angulata,18,0,18,Points-PointsKO-Adjacents,99
Caesalpinia_bahamensis,8,1,7,Points-PointsKO-Adjacents,57
Caesalpinia_barahonensis,7,1,6,Points-PointsKO-Adjacents,32
Caesalpinia_barkeriana,0,0,0,NA,0
Caesalpinia_buchii,0,0,0,NA,0
Caesalpinia_cacalaco,223,165,58,Alphahull-PointsKO-Adjacents,3880
Caesalpinia_caesia,0,0,0,NA,0
Caesalpinia_cassioides,52,26,26,Alphahull-PointsKO-Adjacents,834
Caesalpinia_ciliata,4,1,3,Points-PointsKO-Adjacents,22
Caesalpinia_coccinea,11,7,4,Points-PointsKO-Adjacents,46
Caesalpinia_colimensis,2,2,0,Points-PointsKO-Adjacents,16
Caesalpinia_coluteifolia,16,7,9,Points-PointsKO-Adjacents,125
Caesalpinia_coriaria,370,256,114,Alphahull-PointsKO-Adjacents,6369
Caesalpinia_ebano,9,0,9,Points-PointsKO-Adjacents,66
Caesalpinia_echinata,181,0,181,Points-PointsKO-Adjacents,899
Caesalpinia_enneaphylla,9,1,8,Points-PointsKO-Adjacents,81
Caesalpinia_epifanioi,3,3,0,Points-PointsKO-Adjacents,18
Caesalpinia_fimbriata,26,15,11,Points-PointsKO-Adjacents,136
Caesalpinia_glabrata,69,44,25,Alphahull-PointsKO-Adjacents,507
Caesalpinia_glandulosopedicellata,2,2,0,Points-PointsKO-Adjacents,18
Caesalpinia_hintonii,30,18,12,Points-PointsKO-Adjacents,176
Caesalpinia_hughesii,14,6,8,Points-PointsKO-Adjacents,73
Caesalpinia_kavaiensis,1,1,0,Points-PointsKO-Adjacents,8
Caesalpinia_latisiliqua,23,1,22,Points-PointsKO-Adjacents,199
Caesalpinia_macvaughii,5,5,0,Points-PointsKO-Adjacents,21
Caesalpinia_madagascariensis,14,9,5,Points-PointsKO-Adjacents,68
Caesalpinia_major,17,4,13,Points-PointsKO-Adjacents,104
Caesalpinia_mimosoides,18,5,13,Points-PointsKO-Adjacents,162
Caesalpinia_monensis,1,1,0,Points-PointsKO-Adjacents,4
Caesalpinia_nhatrangensis,2,2,0,Points-PointsKO-Adjacents,16
Caesalpinia_nicaraguensis,15,9,6,Points-PointsKO-Adjacents,56
Caesalpinia_nipensis,3,3,0,Points-PointsKO-Adjacents,20
Caesalpinia_paipai,71,46,25,Alphahull-PointsKO-Adjacents,880
Caesalpinia_paraguariensis,182,150,32,Alphahull-PointsKO-Adjacents,10234
Caesalpinia_parviflora,1,1,0,Points-PointsKO-Adjacents,7
Caesalpinia_pringlei,60,0,60,Points-PointsKO-Adjacents,253
Caesalpinia_pubescens,2,2,0,Points-PointsKO-Adjacents,16
Caesalpinia_pulcherrima,882,656,226,Alphahull-PointsKO-Adjacents,15011
Caesalpinia_robinsoniana,1,1,0,Points-PointsKO-Adjacents,9
Caesalpinia_rubicunda,59,41,18,Alphahull-PointsKO-Adjacents,1792
Caesalpinia_sappan,67,18,49,Points-PointsKO-Adjacents,566
Caesalpinia_standleyi,6,0,6,Points-PointsKO-Adjacents,45
Caesalpinia_tortuosa,6,0,6,Points-PointsKO-Adjacents,43
Caesalpinia_trichocarpa,29,11,18,Points-PointsKO-Adjacents,197
Caesalpinia_velutina,166,120,46,Alphahull-PointsKO-Adjacents,1614
Caesalpinia_vesicaria,271,188,83,Alphahull-PointsKO-Adjacents,2459
Caesalpinia_violacea,130,100,30,Alphahull-PointsKO-Adjacents,2020
Calamus_arborescens,7,0,7,Points-PointsKO-Adjacents,51
Calamus_ciliaris,1,1,0,Points-PointsKO-Adjacents,9
Calamus_compsostachys,1,1,0,Points-PointsKO-Adjacents,9
Calamus_egregius,1,1,0,Points-PointsKO-Adjacents,9
Calamus_erectus,7,0,7,Points-PointsKO-Adjacents,63
Calamus_filipendulus,2,2,0,Points-PointsKO-Adjacents,12
Calamus_gibbsianus,24,17,7,Points-PointsKO-Adjacents,80
Calamus_modestus,7,1,6,Points-PointsKO-Adjacents,37
Calamus_nambariensis,24,0,24,Points-PointsKO-Adjacents,192
Calamus_nematospadix,1,1,0,Points-PointsKO-Adjacents,9
Calamus_perakensis,1,1,0,Points-PointsKO-Adjacents,9
Calamus_poensis,2,2,0,Points-PointsKO-Adjacents,18
Calamus_poilanei,8,0,8,Points-PointsKO-Adjacents,71
Calamus_psilocladus,1,1,0,Points-PointsKO-Adjacents,9
Calamus_rotang,2,2,0,Points-PointsKO-Adjacents,18
Calamus_salicifolius,20,12,8,Points-PointsKO-Adjacents,146
Calamus_siamensis,5,5,0,Points-PointsKO-Adjacents,45
Calamus_simplex,NA,NA,NA,NA,NA
Calamus_temii,1,1,0,Points-PointsKO-Adjacents,9
Calamus_thysanolepis,14,0,14,Points-PointsKO-Adjacents,117
Calamus_viridispinus,3,3,0,Points-PointsKO-Adjacents,27
Calanthea_pulcherrima,10,4,6,Points-PointsKO-Adjacents,83
Calanthea_stenosepala,4,3,1,Points-PointsKO-Adjacents,25
Calantica_biseriata,13,0,13,Points-PointsKO-Adjacents,87
Calantica_capuronii,3,3,0,Points-PointsKO-Adjacents,27
Calantica_cerasifolia,86,61,25,Alphahull-PointsKO-Adjacents,2187
Calantica_decaryana,8,3,5,Points-PointsKO-Adjacents,48
Calantica_grandiflora,25,8,17,Points-PointsKO-Adjacents,126
Calantica_lucida,4,4,0,Points-PointsKO-Adjacents,24
Calatola_costaricensis,782,689,93,Alphahull-PointsKO-Adjacents,15594
Calatola_laevigata,65,48,17,Alphahull-PointsKO-Adjacents,1296
Calatola_mollis,38,30,8,Alphahull-PointsKO-Adjacents,192
Calatola_uxpanapensis,8,0,8,Points-PointsKO-Adjacents,69
Calaunia_negrosensis,1,1,0,Points-PointsKO-Adjacents,9
Calceolaria_perfoliata,158,114,44,Alphahull-PointsKO-Adjacents,1185
Calceolaria_vaccinioides,10,2,8,Points-PointsKO-Adjacents,82
Caldcluvia_australiensis,122,101,21,Alphahull-PointsKO-Adjacents,307
Caldcluvia_brassii,56,41,15,Alphahull-PointsKO-Adjacents,620
Caldcluvia_clemensiae,16,9,7,Points-PointsKO-Adjacents,59
Caldcluvia_fulva,30,11,19,Points-PointsKO-Adjacents,195
Caldcluvia_nymanii,118,89,29,Alphahull-PointsKO-Adjacents,2035
Caldcluvia_paniculata,46,30,16,Alphahull-PointsKO-Adjacents,1262
Caldcluvia_papuana,30,18,12,Points-PointsKO-Adjacents,181
Caldcluvia_rosifolia,51,1,50,Points-PointsKO-Adjacents,118
Caldcluvia_rufa,46,27,19,Alphahull-PointsKO-Adjacents,315
Callaeum_macropterum,316,259,57,Alphahull-PointsKO-Adjacents,9094
Callaeum_psilophyllum,113,41,72,Alphahull-PointsKO-Adjacents,2941
Callerya_atropurpurea,21,9,12,Points-PointsKO-Adjacents,158
Callerya_bonatiana,2,2,0,Points-PointsKO-Adjacents,18
Callerya_neocaledonica,0,0,0,NA,0
Callerya_vasta,4,4,0,Points-PointsKO-Adjacents,30
Calliandra_angustifolia,143,0,143,Points-PointsKO-Adjacents,998
Calliandra_antioquiae,5,5,0,Points-PointsKO-Adjacents,29
Calliandra_asplenioides,233,207,26,Alphahull-PointsKO-Adjacents,1371
Calliandra_belizensis,51,0,51,Points-PointsKO-Adjacents,280
Calliandra_bijuga,38,21,17,Alphahull-PointsKO-Adjacents,303
Calliandra_bombycina,9,0,9,Points-PointsKO-Adjacents,77
Calliandra_brenesii,45,34,11,Alphahull-PointsKO-Adjacents,248
Calliandra_brevicaulis,35,21,14,Alphahull-PointsKO-Adjacents,1328
Calliandra_caeciliae,85,54,31,Alphahull-PointsKO-Adjacents,734
Calliandra_carcerea,1,1,0,Points-PointsKO-Adjacents,9
Calliandra_carrascana,7,3,4,Points-PointsKO-Adjacents,36
Calliandra_chulumania,25,21,4,Alphahull-PointsKO-Adjacents,23
Calliandra_comosa,1,1,0,Points-PointsKO-Adjacents,9
Calliandra_coriacea,118,71,47,Alphahull-PointsKO-Adjacents,2699
Calliandra_cruegeri,36,17,19,Points-PointsKO-Adjacents,280
Calliandra_cynometroides,NA,NA,NA,NA,NA
Calliandra_depauperata,123,106,17,Alphahull-PointsKO-Adjacents,4448
Calliandra_duckei,5,4,1,Points-PointsKO-Adjacents,31
Calliandra_enervis,5,5,0,Points-PointsKO-Adjacents,23
Calliandra_erythrocephala,15,10,5,Points-PointsKO-Adjacents,64
Calliandra_falcata,32,10,22,Points-PointsKO-Adjacents,244
Calliandra_foliolosa,387,348,39,Alphahull-PointsKO-Adjacents,11455
Calliandra_glomerulata,82,55,27,Alphahull-PointsKO-Adjacents,4943
Calliandra_glyphoxylon,5,5,0,Points-PointsKO-Adjacents,36
Calliandra_goldmanii,6,2,4,Points-PointsKO-Adjacents,29
Calliandra_grandifolia,10,8,2,Points-PointsKO-Adjacents,32
Calliandra_guildingii,63,24,39,Alphahull-PointsKO-Adjacents,1119
Calliandra_haematocephala,58,45,13,Alphahull-PointsKO-Adjacents,1192
Calliandra_haematomma,43,26,17,Alphahull-PointsKO-Adjacents,320
Calliandra_harrisii,58,0,58,Points-PointsKO-Adjacents,377
Calliandra_hirsuta,122,89,33,Alphahull-PointsKO-Adjacents,1369
Calliandra_houstoniana,2033,1856,177,Alphahull-PointsKO-Adjacents,13582
Calliandra_hymenaeoides,16,8,8,Points-PointsKO-Adjacents,102
Calliandra_jariensis,7,0,7,Points-PointsKO-Adjacents,47
Calliandra_juzepczukii,64,52,12,Alphahull-PointsKO-Adjacents,667
Calliandra_laevis,34,25,9,Alphahull-PointsKO-Adjacents,165
Calliandra_laxa,162,100,62,Alphahull-PointsKO-Adjacents,8725
Calliandra_leptopoda,49,32,17,Alphahull-PointsKO-Adjacents,1223
Calliandra_longipedicellata,56,29,27,Alphahull-PointsKO-Adjacents,369
Calliandra_magdalenae,171,119,52,Alphahull-PointsKO-Adjacents,4584
Calliandra_medellinensis,4,3,1,Points-PointsKO-Adjacents,36
Calliandra_molinae,20,16,4,Points-PointsKO-Adjacents,107
Calliandra_mollissima,6,4,2,Points-PointsKO-Adjacents,36
Calliandra_paniculata,3,3,0,Points-PointsKO-Adjacents,25
Calliandra_parvifolia,176,93,83,Alphahull-PointsKO-Adjacents,22659
Calliandra_pedicellata,20,8,12,Points-PointsKO-Adjacents,96
Calliandra_physocalyx,7,4,3,Points-PointsKO-Adjacents,38
Calliandra_pilosa,0,0,0,NA,0
Calliandra_pittieri,348,315,33,Alphahull-PointsKO-Adjacents,3328
Calliandra_purdiei,29,16,13,Points-PointsKO-Adjacents,168
Calliandra_purpurea,30,3,27,Points-PointsKO-Adjacents,200
Calliandra_rhodocephala,56,37,19,Alphahull-PointsKO-Adjacents,770
Calliandra_riparia,45,25,20,Alphahull-PointsKO-Adjacents,1954
Calliandra_rubescens,157,124,33,Alphahull-PointsKO-Adjacents,1570
Calliandra_samik,1,1,0,Points-PointsKO-Adjacents,9
Calliandra_spinosa,88,65,23,Alphahull-PointsKO-Adjacents,4013
Calliandra_surinamensis,286,194,92,Alphahull-PointsKO-Adjacents,23385
Calliandra_tergemina,109,69,40,Alphahull-PointsKO-Adjacents,620
Calliandra_tolimensis,7,5,2,Points-PointsKO-Adjacents,51
Calliandra_trinervia,511,425,86,Alphahull-PointsKO-Adjacents,34997
Calliandra_tsugoides,40,27,13,Alphahull-PointsKO-Adjacents,2928
Calliandra_tumbeziana,7,0,7,Points-PointsKO-Adjacents,47
Calliandra_tweediei,114,0,114,Points-PointsKO-Adjacents,775
Calliandra_umbrosa,0,0,0,NA,0
Callianthe_andrade-limae,4,4,0,Points-PointsKO-Adjacents,21
Callianthe_bezerrae,3,3,0,Points-PointsKO-Adjacents,27
Callianthe_cyclonervosa,6,0,6,Points-PointsKO-Adjacents,54
Callianthe_jaliscana,5,0,5,Points-PointsKO-Adjacents,45
Callianthe_lanata,6,0,6,Points-PointsKO-Adjacents,36
Callianthe_latipetala,6,2,4,Points-PointsKO-Adjacents,44
Callianthe_pickelii,8,2,6,Points-PointsKO-Adjacents,60
Callianthe_picta,12,2,10,Points-PointsKO-Adjacents,101
Callianthe_rufinerva,225,180,45,Alphahull-PointsKO-Adjacents,3339
Callianthe_sylvatica,48,23,25,Alphahull-PointsKO-Adjacents,481
Callianthe_torrendii,1,1,0,Points-PointsKO-Adjacents,9
Callianthe_ulbrichii,3,3,0,Points-PointsKO-Adjacents,27
Callicarpa_acuminata,1092,970,122,Alphahull-PointsKO-Adjacents,14924
Callicarpa_ampla,4,2,2,Points-PointsKO-Adjacents,28
Callicarpa_angustifolia,3,3,0,Points-PointsKO-Adjacents,25
Callicarpa_anomala,0,0,0,NA,0
Callicarpa_apoensis,2,2,0,Points-PointsKO-Adjacents,18
Callicarpa_arborea,33,0,33,Points-PointsKO-Adjacents,250
Callicarpa_argentii,3,3,0,Points-PointsKO-Adjacents,21
Callicarpa_barbata,3,3,0,Points-PointsKO-Adjacents,27
Callicarpa_basilanensis,0,0,0,NA,0
Callicarpa_bracteata,0,0,0,NA,0
Callicarpa_brevipes,33,1,32,Points-PointsKO-Adjacents,288
Callicarpa_candicans,355,282,73,Alphahull-PointsKO-Adjacents,8885
Callicarpa_caudata,47,0,47,Points-PointsKO-Adjacents,356
Callicarpa_cubensis,7,0,7,Points-PointsKO-Adjacents,41
Callicarpa_dolichophylla,28,12,16,Points-PointsKO-Adjacents,201
Callicarpa_endertii,0,0,0,NA,0
Callicarpa_erioclona,13,3,10,Points-PointsKO-Adjacents,65
Callicarpa_flavida,1,1,0,Points-PointsKO-Adjacents,9
Callicarpa_fulvohirsuta,2,2,0,Points-PointsKO-Adjacents,18
Callicarpa_furfuracea,3,3,0,Points-PointsKO-Adjacents,21
Callicarpa_glabrifolia,8,0,8,Points-PointsKO-Adjacents,58
Callicarpa_havilandii,23,10,13,Points-PointsKO-Adjacents,173
Callicarpa_hispida,0,0,0,NA,0
Callicarpa_integerrima,0,0,0,NA,0
Callicarpa_involucrata,16,5,11,Points-PointsKO-Adjacents,119
Callicarpa_kerrii,0,0,0,NA,0
Callicarpa_kinabaluensis,1,0,1,Points-PointsKO-Adjacents,9
Callicarpa_longifolia,73,27,46,Alphahull-PointsKO-Adjacents,3929
Callicarpa_longipetiolata,0,0,0,NA,0
Callicarpa_macrophylla,41,0,41,Points-PointsKO-Adjacents,357
Callicarpa_magnifolia,0,0,0,NA,0
Callicarpa_maingayi,1,1,0,Points-PointsKO-Adjacents,9
Callicarpa_micrantha,6,1,5,Points-PointsKO-Adjacents,33
Callicarpa_moldenkeana,NA,NA,NA,NA,NA
Callicarpa_nudiflora,29,11,18,Points-PointsKO-Adjacents,251
Callicarpa_paloensis,0,0,0,NA,0
Callicarpa_pentandra,72,33,39,Alphahull-PointsKO-Adjacents,2212
Callicarpa_platyphylla,0,0,0,NA,0
Callicarpa_psilocalyx,0,0,0,NA,0
Callicarpa_rubella,229,167,62,Alphahull-PointsKO-Adjacents,17113
Callicarpa_saccata,8,3,5,Points-PointsKO-Adjacents,72
Callicarpa_scandens,1,1,0,Points-PointsKO-Adjacents,9
Callicarpa_selleana,0,0,0,NA,0
Callicarpa_stapfii,3,3,0,Points-PointsKO-Adjacents,24
Callicarpa_subaequalis,1,1,0,Points-PointsKO-Adjacents,9
Callicarpa_subintegra,0,0,0,NA,0
Callicarpa_subpubescens,4,4,0,Points-PointsKO-Adjacents,5
Callicarpa_surigaensis,0,0,0,NA,0
Callicarpa_teneriflora,5,0,5,Points-PointsKO-Adjacents,36
Callicarpa_tomentosa,5,0,5,Points-PointsKO-Adjacents,45
Callicarpa_vestita,1,1,0,Points-PointsKO-Adjacents,9
Callicarpa_yunnanensis,NA,NA,NA,NA,NA
Callichlamys_latifolia,583,412,171,Alphahull-PointsKO-Adjacents,31323
Callicoma_serratifolia,2106,1829,277,Alphahull-PointsKO-Adjacents,2643
Calligonum_arborescens,1,1,0,Points-PointsKO-Adjacents,9
Calligonum_azel,0,0,0,NA,0
Calligonum_calcareum,NA,NA,NA,NA,NA
Calligonum_elegans,NA,NA,NA,NA,NA
Calligonum_eriopodum,0,0,0,NA,0
Calligonum_matteianum,NA,NA,NA,NA,NA
Calligonum_molle,1,1,0,Points-PointsKO-Adjacents,9
Calligonum_paletzkianum,NA,NA,NA,NA,NA
Calligonum_triste,0,0,0,NA,0
Callilepis_caerulea,7,7,0,Points-PointsKO-Adjacents,58
Callistachys_lanceolata,262,218,44,Alphahull-PointsKO-Adjacents,2484
Callistemon_phoeniceus,299,274,25,Alphahull-PointsKO-Adjacents,5445
Callistemon_salignus,1847,1554,293,Alphahull-PointsKO-Adjacents,3253
Callistemon_viminalis,1096,0,1096,Points-PointsKO-Adjacents,3451
Callisthene_dryadum,5,0,5,Points-PointsKO-Adjacents,35
Callisthene_erythroclada,25,0,25,Points-PointsKO-Adjacents,153
Callisthene_fasciculata,835,766,69,Alphahull-PointsKO-Adjacents,35688
Callisthene_inundata,10,6,4,Points-PointsKO-Adjacents,78
Callisthene_major,549,493,56,Alphahull-PointsKO-Adjacents,17019
Callisthene_microphylla,204,162,42,Alphahull-PointsKO-Adjacents,12019
Callisthene_minor,159,100,59,Alphahull-PointsKO-Adjacents,10132
Callisthene_mollissima,80,67,13,Alphahull-PointsKO-Adjacents,1992
Callitris_baileyi,118,0,118,Points-PointsKO-Adjacents,368
Callitris_canescens,595,561,34,Alphahull-PointsKO-Adjacents,4573
Callitris_columellaris,9994,9829,165,Alphahull-PointsKO-Adjacents,53834
Callitris_drummondii,96,83,13,Alphahull-PointsKO-Adjacents,680
Callitris_endlicheri,4177,4102,75,Alphahull-PointsKO-Adjacents,9875
Callitris_macleayana,212,186,26,Alphahull-PointsKO-Adjacents,659
Callitris_monticola,91,83,8,Alphahull-PointsKO-Adjacents,320
Callitris_muelleri,179,139,40,Alphahull-PointsKO-Adjacents,371
Callitris_neocaledonica,25,19,6,Points-PointsKO-Adjacents,63
Callitris_oblonga,219,197,22,Alphahull-PointsKO-Adjacents,344
Callitris_preissii,3549,3365,184,Alphahull-PointsKO-Adjacents,18167
Callitris_rhomboidea,1727,1618,109,Alphahull-PointsKO-Adjacents,6566
Callitris_roei,213,0,213,Points-PointsKO-Adjacents,840
Callitris_sulcata,23,19,4,Points-PointsKO-Adjacents,52
Callitris_verrucosa,1695,1632,63,Alphahull-PointsKO-Adjacents,12533
Calocedrus_decurrens,2695,2602,93,Alphahull-PointsKO-Adjacents,6306
Calocedrus_formosana,35,24,11,Alphahull-PointsKO-Adjacents,100
Calocedrus_macrolepis,32,11,21,Points-PointsKO-Adjacents,231
Calocedrus_rupestris,7,3,4,Points-PointsKO-Adjacents,48
Calodendrum_capense,133,85,48,Alphahull-PointsKO-Adjacents,4037
Calodendrum_eichii,NA,NA,NA,NA,NA
Caloncoba_crepiniana,30,15,15,Points-PointsKO-Adjacents,165
Caloncoba_echinata,92,60,32,Alphahull-PointsKO-Adjacents,1694
Caloncoba_flagelliflora,47,26,21,Alphahull-PointsKO-Adjacents,1448
Caloncoba_gilgiana,39,21,18,Alphahull-PointsKO-Adjacents,399
Caloncoba_glauca,151,123,28,Alphahull-PointsKO-Adjacents,4188
Caloncoba_lophocarpa,25,19,6,Points-PointsKO-Adjacents,74
Caloncoba_welwitschii,136,91,45,Alphahull-PointsKO-Adjacents,5522
Calophaca_soongorica,1,1,0,Points-PointsKO-Adjacents,9
Calophyllum_acidus,0,0,0,NA,0
Calophyllum_acutiputamen,1,1,0,Points-PointsKO-Adjacents,9
Calophyllum_aerarium,NA,NA,NA,NA,NA
Capnophyllum_africanum,9,5,4,Points-PointsKO-Adjacents,60
Calophyllum_alboramulum,1,1,0,Points-PointsKO-Adjacents,9
Calophyllum_amblyphyllum,2,2,0,Points-PointsKO-Adjacents,3
Calophyllum_andersonii,0,0,0,NA,0
Calophyllum_angulare,21,0,21,Points-PointsKO-Adjacents,163
Calophyllum_apetalum,0,0,0,NA,0
Calophyllum_archipelagi,0,0,0,NA,0
Calophyllum_ardens,0,0,0,NA,0
Calophyllum_articulatum,3,3,0,Points-PointsKO-Adjacents,12
Calophyllum_aurantiacum,0,0,0,NA,0
Calophyllum_aureobrunnescens,0,0,0,NA,0
Calophyllum_aureum,1,1,0,Points-PointsKO-Adjacents,9
Calophyllum_austroindicum,0,0,0,NA,0
Calophyllum_balansae,6,3,3,Points-PointsKO-Adjacents,30
Calophyllum_banyengii,0,0,0,NA,0
Calophyllum_bicolor,41,0,41,Points-PointsKO-Adjacents,179
Calophyllum_biflorum,7,0,7,Points-PointsKO-Adjacents,55
Calophyllum_bifurcatum,0,0,0,NA,0
Calophyllum_blancoi,10,0,10,Points-PointsKO-Adjacents,63
Calophyllum_brachyphyllum,0,0,0,NA,0
Calophyllum_bracteatum,0,0,0,NA,0
Calophyllum_brasiliense,2768,2576,192,Alphahull-PointsKO-Adjacents,1849
Calophyllum_brassii,2,2,0,Points-PointsKO-Adjacents,18
Calophyllum_calaba,5,2,3,Points-PointsKO-Adjacents,44
Calophyllum_calcicola,0,0,0,NA,0
Calophyllum_caledonicum,14,7,7,Points-PointsKO-Adjacents,100
Calophyllum_canum,3,0,3,Points-PointsKO-Adjacents,27
Calophyllum_carrii,5,5,0,Points-PointsKO-Adjacents,19
Calophyllum_castaneum,1,1,0,Points-PointsKO-Adjacents,9
Calophyllum_caudatum,0,0,0,NA,0
Calophyllum_celebicum,0,0,0,NA,0
Calophyllum_cerasiferum,0,0,0,NA,0
Calophyllum_ceriferum,0,0,0,NA,0
Calophyllum_chapelieri,29,8,21,Points-PointsKO-Adjacents,114
Calophyllum_clemensorum,0,0,0,NA,0
Calophyllum_collinum,2,2,0,Points-PointsKO-Adjacents,18
Calophyllum_comorense,2,2,0,Points-PointsKO-Adjacents,13
Calophyllum_complanatum,NA,NA,NA,NA,NA
Calophyllum_confertum,0,0,0,NA,0
Calophyllum_confusum,0,0,0,NA,0
Calophyllum_cordato-oblongum,2,2,0,Points-PointsKO-Adjacents,18
Calophyllum_coriaceum,NA,NA,NA,NA,NA
Calophyllum_costatum,38,31,7,Alphahull-PointsKO-Adjacents,74
Calophyllum_costulatum,1,1,0,Points-PointsKO-Adjacents,9
Calophyllum_cucullatum,1,1,0,Points-PointsKO-Adjacents,9
Calophyllum_cuneifolium,1,1,0,Points-PointsKO-Adjacents,9
Calophyllum_dasypodium,0,0,0,NA,0
Calophyllum_depressinervosum,0,0,0,NA,0
Calophyllum_dioscurii,2,2,0,Points-PointsKO-Adjacents,12
Calophyllum_dispar,1,1,0,Points-PointsKO-Adjacents,9
Calophyllum_dongnaiense,0,0,0,NA,0
Calophyllum_drouhardii,13,8,5,Points-PointsKO-Adjacents,56
Calophyllum_dryobalanoides,3,3,0,Points-PointsKO-Adjacents,27
Calophyllum_echinatum,NA,NA,NA,NA,NA
Calophyllum_elegans,1,0,1,Points-PointsKO-Adjacents,9
Calophyllum_ellipticum,74,22,52,Alphahull-PointsKO-Adjacents,1208
Calophyllum_enervosum,0,0,0,NA,0
Calophyllum_eputamen,1,0,1,Points-PointsKO-Adjacents,9
Calophyllum_euryphyllum,9,1,8,Points-PointsKO-Adjacents,48
Calophyllum_exiticostatum,0,0,0,NA,0
Calophyllum_ferrugineum,0,0,0,NA,0
Calophyllum_fibrosum,9,0,9,Points-PointsKO-Adjacents,46
Calophyllum_flavoramulum,0,0,0,NA,0
Calophyllum_fraseri,0,0,0,NA,0
Calophyllum_garcinioides,1,0,1,Points-PointsKO-Adjacents,9
Calophyllum_glaucescens,0,0,0,NA,0
Calophyllum_goniocarpum,9,0,9,Points-PointsKO-Adjacents,57
Calophyllum_gracilipes,5,0,5,Points-PointsKO-Adjacents,45
Calophyllum_gracillimum,0,0,0,NA,0
Calophyllum_grandiflorum,0,0,0,NA,0
Calophyllum_griseum,0,0,0,NA,0
Calophyllum_havilandii,1,0,1,Points-PointsKO-Adjacents,9
Calophyllum_heterophyllum,2,2,0,Points-PointsKO-Adjacents,18
Calophyllum_hirasimum,0,0,0,NA,0
Calophyllum_hosei,3,0,3,Points-PointsKO-Adjacents,27
Calophyllum_humbertii,4,4,0,Points-PointsKO-Adjacents,30
Calophyllum_incumbens,1,1,0,Points-PointsKO-Adjacents,9
Calophyllum_inophyllum,318,137,181,Alphahull-PointsKO-Adjacents,3589
Calophyllum_insularum,0,0,0,NA,0
Calophyllum_lanigerum,3,3,0,Points-PointsKO-Adjacents,27
Calophyllum_lankaensis,NA,NA,NA,NA,NA
Calophyllum_laticostatum,6,0,6,Points-PointsKO-Adjacents,45
Calophyllum_laxiflorum,7,2,5,Points-PointsKO-Adjacents,50
Calophyllum_leleanii,4,4,0,Points-PointsKO-Adjacents,15
Calophyllum_leptocladum,0,0,0,NA,0
Calophyllum_leucocarpum,0,0,0,NA,0
Calophyllum_lingulatum,2,2,0,Points-PointsKO-Adjacents,18
Calophyllum_lonchophyllum,NA,NA,NA,NA,NA
Calophyllum_longifolium,85,49,36,Alphahull-PointsKO-Adjacents,453
Calophyllum_lowei,0,0,0,NA,0
Calophyllum_macrocarpum,3,0,3,Points-PointsKO-Adjacents,27
Calophyllum_macrophyllum,1,1,0,Points-PointsKO-Adjacents,7
Calophyllum_membranaceum,32,17,15,Points-PointsKO-Adjacents,269
Calophyllum_milvum,24,17,7,Points-PointsKO-Adjacents,114
Calophyllum_molle,4,0,4,Points-PointsKO-Adjacents,30
Calophyllum_moonii,0,0,0,NA,0
Calophyllum_morobensis,6,3,3,Points-PointsKO-Adjacents,42
Calophyllum_mukunense,0,0,0,NA,0
Calophyllum_multitudinis,1,1,0,Points-PointsKO-Adjacents,9
Calophyllum_neoebudicum,20,2,18,Points-PointsKO-Adjacents,122
Calophyllum_nodosum,5,1,4,Points-PointsKO-Adjacents,45
Calophyllum_novoguineense,1,1,0,Points-PointsKO-Adjacents,9
Calophyllum_nubicola,6,0,6,Points-PointsKO-Adjacents,23
Calophyllum_obliquinervium,2,2,0,Points-PointsKO-Adjacents,17
Calophyllum_obscurum,0,0,0,NA,0
Calophyllum_oliganthum,1,1,0,Points-PointsKO-Adjacents,9
Calophyllum_pachyphyllum,13,0,13,Points-PointsKO-Adjacents,117
Calophyllum_paniculatum,27,13,14,Points-PointsKO-Adjacents,142
Calophyllum_papuanum,39,23,16,Alphahull-PointsKO-Adjacents,364
Calophyllum_parkeri,0,0,0,NA,0
Calophyllum_parviflorum,0,0,0,NA,0
Calophyllum_parvifolium,0,0,0,NA,0
Calophyllum_pauciflorum,15,6,9,Points-PointsKO-Adjacents,90
Calophyllum_peekelii,25,14,11,Points-PointsKO-Adjacents,124
Calophyllum_pelewense,0,0,0,NA,0
Calophyllum_pentapetalum,3,3,0,Points-PointsKO-Adjacents,27
Calophyllum_persimile,2,2,0,Points-PointsKO-Adjacents,17
Calophyllum_pervillei,23,8,15,Points-PointsKO-Adjacents,129
Calophyllum_piluliferum,3,3,0,Points-PointsKO-Adjacents,12
Calophyllum_pinetorum,3,3,0,Points-PointsKO-Adjacents,24
Calophyllum_pisiferum,8,0,8,Points-PointsKO-Adjacents,71
Calophyllum_poilanei,0,0,0,NA,0
Calophyllum_polyanthum,6,0,6,Points-PointsKO-Adjacents,50
Calophyllum_praetermissum,NA,NA,NA,NA,NA
Calophyllum_pulcherrimum,3,0,3,Points-PointsKO-Adjacents,18
Calophyllum_pyriforme,1,1,0,Points-PointsKO-Adjacents,9
Calophyllum_recedens,0,0,0,NA,0
Calophyllum_recurvatum,1,1,0,Points-PointsKO-Adjacents,9
Calophyllum_rigidulum,0,0,0,NA,0
Calophyllum_rigidum,4,4,0,Points-PointsKO-Adjacents,30
Calophyllum_rivulare,NA,NA,NA,NA,NA
Calophyllum_robustum,3,3,0,Points-PointsKO-Adjacents,17
Calophyllum_roseocostatum,0,0,0,NA,0
Calophyllum_rotundifolium,0,0,0,NA,0
Calophyllum_rubiginosum,3,3,0,Points-PointsKO-Adjacents,27
Calophyllum_rufigemmatum,0,0,0,NA,0
Calophyllum_rufinerve,0,0,0,NA,0
Calophyllum_rugosum,0,0,0,NA,0
Calophyllum_rupicola,1,1,0,Points-PointsKO-Adjacents,9
Calophyllum_sakarium,0,0,0,NA,0
Calophyllum_savannarum,2,2,0,Points-PointsKO-Adjacents,16
Calophyllum_sclerophyllum,2,1,1,Points-PointsKO-Adjacents,18
Calophyllum_scriblitifolium,0,0,0,NA,0
Calophyllum_sil,443,383,60,Alphahull-PointsKO-Adjacents,2580
Calophyllum_soulattri,333,266,67,Alphahull-PointsKO-Adjacents,1750
Calophyllum_stipitatum,0,0,0,NA,0
Calophyllum_streimannii,4,4,0,Points-PointsKO-Adjacents,20
Calophyllum_suberosum,4,0,4,Points-PointsKO-Adjacents,15
Calophyllum_subhorizontale,NA,NA,NA,NA,NA
Calophyllum_subsessile,0,0,0,NA,0
Calophyllum_sundaicum,0,0,0,NA,0
Calophyllum_symingtonianum,0,0,0,NA,0
Calophyllum_tacamahaca,4,4,0,Points-PointsKO-Adjacents,29
Calophyllum_tetrapterum,10,1,9,Points-PointsKO-Adjacents,86
Calophyllum_teysmannii,6,0,6,Points-PointsKO-Adjacents,54
Calophyllum_thorelii,1,0,1,Points-PointsKO-Adjacents,9
Calophyllum_thuriferum,0,0,0,NA,0
Calophyllum_thwaitesii,0,0,0,NA,0
Calophyllum_tomentosum,1,0,1,Points-PointsKO-Adjacents,9
Calophyllum_trachycaule,4,4,0,Points-PointsKO-Adjacents,21
Calophyllum_trapezifolium,1,1,0,Points-PointsKO-Adjacents,9
Calophyllum_undulatum,1,1,0,Points-PointsKO-Adjacents,8
Calophyllum_utile,1,1,0,Points-PointsKO-Adjacents,9
Calophyllum_vanoverberghii,NA,NA,NA,NA,NA
Calophyllum_venulosum,6,1,5,Points-PointsKO-Adjacents,54
Calophyllum_vergens,NA,NA,NA,NA,NA
Calophyllum_vernicosum,7,0,7,Points-PointsKO-Adjacents,35
Calophyllum_verticillatum,14,0,14,Points-PointsKO-Adjacents,68
Calophyllum_vexans,24,10,14,Points-PointsKO-Adjacents,164
Calophyllum_vitiense,2,2,0,Points-PointsKO-Adjacents,3
Calophyllum_waliense,2,2,0,Points-PointsKO-Adjacents,9
Calophyllum_walkeri,2,1,1,Points-PointsKO-Adjacents,18
Calophyllum_whitfordii,0,0,0,NA,0
Calophyllum_woodii,2,2,0,Points-PointsKO-Adjacents,18
Calothamnus_rupestris,74,54,20,Alphahull-PointsKO-Adjacents,252
Calotropis_procera,18,14,4,Points-PointsKO-Adjacents,61
Calpocalyx_atlanticus,1,1,0,Points-PointsKO-Adjacents,9
Calpocalyx_aubrevillei,22,12,10,Points-PointsKO-Adjacents,163
Calpocalyx_brevibracteatus,102,84,18,Alphahull-PointsKO-Adjacents,2387
Calpocalyx_brevifolius,6,1,5,Points-PointsKO-Adjacents,52
Calpocalyx_cauliflorus,5,5,0,Points-PointsKO-Adjacents,39
Calpocalyx_dinklagei,149,136,13,Alphahull-PointsKO-Adjacents,2951
Calpocalyx_heitzii,57,47,10,Alphahull-PointsKO-Adjacents,642
Calpocalyx_klainei,32,26,6,Alphahull-PointsKO-Adjacents,284
Calpocalyx_winkleri,6,1,5,Points-PointsKO-Adjacents,48
Calpurnia_aurea,165,108,57,Alphahull-PointsKO-Adjacents,5472
Calpurnia_capensis,1,1,0,Points-PointsKO-Adjacents,9
Calpurnia_glabrata,23,4,19,Points-PointsKO-Adjacents,198
Calpurnia_villosa,34,17,17,Points-PointsKO-Adjacents,285
Calycogonium_heterophyllum,5,5,0,Points-PointsKO-Adjacents,43
Calycogonium_lomense,0,0,0,NA,0
Calycogonium_reticulatum,0,0,0,NA,0
Calycogonium_squamulosum,12,7,5,Points-PointsKO-Adjacents,38
Calycolpus_aequatorialis,3,3,0,Points-PointsKO-Adjacents,27
Calycolpus_andersonii,3,3,0,Points-PointsKO-Adjacents,23
Calycolpus_calophyllus,162,122,40,Alphahull-PointsKO-Adjacents,7391
Calycolpus_cochleatus,9,0,9,Points-PointsKO-Adjacents,39
Calycolpus_goetheanus,197,131,66,Alphahull-PointsKO-Adjacents,11657
Calycolpus_legrandii,95,66,29,Alphahull-PointsKO-Adjacents,250
Calycolpus_moritzianus,163,134,29,Alphahull-PointsKO-Adjacents,2995
Calycolpus_revolutus,38,33,5,Alphahull-PointsKO-Adjacents,478
Calycolpus_roraimensis,21,8,13,Points-PointsKO-Adjacents,168
Calycolpus_sessiliflorus,8,0,8,Points-PointsKO-Adjacents,57
Calycolpus_surinamensis,17,9,8,Points-PointsKO-Adjacents,125
Calycolpus_warscewiczianus,8,1,7,Points-PointsKO-Adjacents,65
Calycolpus_warszewiczianus,43,25,18,Alphahull-PointsKO-Adjacents,207
Calycopeplus_casuarinoides,113,86,27,Alphahull-PointsKO-Adjacents,1242
Calycopeplus_marginatus,7,5,2,Points-PointsKO-Adjacents,47
Calycopeplus_oligandrus,16,9,7,Points-PointsKO-Adjacents,87
Calycophyllum_candidissimum,531,435,96,Alphahull-PointsKO-Adjacents,9324
Calycophyllum_megistocaulum,263,221,42,Alphahull-PointsKO-Adjacents,14294
Calycophyllum_merumense,4,4,0,Points-PointsKO-Adjacents,34
Calycophyllum_multiflorum,265,222,43,Alphahull-PointsKO-Adjacents,10696
Calycophyllum_obovatum,38,15,23,Points-PointsKO-Adjacents,302
Calycophyllum_papillosum,1,1,0,Points-PointsKO-Adjacents,9
Calycophyllum_spectabile,5,5,0,Points-PointsKO-Adjacents,45
Calycophyllum_spruceanum,361,288,73,Alphahull-PointsKO-Adjacents,34578
Calycophyllum_tefense,3,3,0,Points-PointsKO-Adjacents,27
Calycophyllum_venezuelense,6,0,6,Points-PointsKO-Adjacents,54
Calycorectes_acutatus,204,172,32,Alphahull-PointsKO-Adjacents,3923
Calycorectes_batavorum,2,2,0,Points-PointsKO-Adjacents,12
Calycorectes_belemii,NA,NA,NA,NA,NA
Calycorectes_bergii,26,15,11,Points-PointsKO-Adjacents,179
Calycorectes_beruttii,1,1,0,Points-PointsKO-Adjacents,9
Calycorectes_costatus,1,1,0,Points-PointsKO-Adjacents,9
Calycorectes_cucullatus,NA,NA,NA,NA,NA
Calycorectes_dardanoi,NA,NA,NA,NA,NA
Calycorectes_dominicanus,NA,NA,NA,NA,NA
Calycorectes_enormis,5,5,0,Points-PointsKO-Adjacents,43
Calycorectes_ferrugineus,NA,NA,NA,NA,NA
Calycorectes_fluminensis,NA,NA,NA,NA,NA
Calycorectes_grandifolius,34,26,8,Alphahull-PointsKO-Adjacents,676
Calycorectes_heringerianus,1,1,0,Points-PointsKO-Adjacents,9
Calycorectes_langsdorffii,7,1,6,Points-PointsKO-Adjacents,51
Calycorectes_martianus,6,1,5,Points-PointsKO-Adjacents,39
Calycorectes_maximus,0,0,0,NA,0
Calycorectes_mexicanus,22,8,14,Points-PointsKO-Adjacents,138
Calycorectes_orlandoi,NA,NA,NA,NA,NA
Calycorectes_paraguayensis,0,0,0,NA,0
Calycorectes_paranaensis,0,0,0,NA,0
Calycorectes_pirataquinensis,NA,NA,NA,NA,NA
Calycorectes_pohlianus,2,1,1,Points-PointsKO-Adjacents,18
Calycorectes_rodriguesii,0,0,0,NA,0
Calycorectes_rogersianus,0,0,0,NA,0
Calycorectes_schottianus,7,0,7,Points-PointsKO-Adjacents,54
Calycorectes_teixeireanus,1,1,0,Points-PointsKO-Adjacents,9
Calycorectes_wurdackii,4,4,0,Points-PointsKO-Adjacents,30
Calycosia_callithrix,0,0,0,NA,0
Calycosia_kajewskii,0,0,0,NA,0
Calycosia_lageniformis,1,1,0,Points-PointsKO-Adjacents,9
Calycosia_macrocyatha,0,0,0,NA,0
Calycosia_mamosei,0,0,0,NA,0
Calycosia_petiolata,1,1,0,Points-PointsKO-Adjacents,9
Calycosia_trichocalyx,NA,NA,NA,NA,NA
Calycosiphonia_macrochlamys,39,21,18,Alphahull-PointsKO-Adjacents,1372
Calycosiphonia_spathicalyx,93,27,66,Alphahull-PointsKO-Adjacents,1289
Calymmanthium_fertile,0,0,0,NA,0
Calymmanthium_substerile,0,0,0,NA,0
Calyptranthes_acutissima,1,1,0,Points-PointsKO-Adjacents,9
Calyptranthes_affinis,1,0,1,Points-PointsKO-Adjacents,7
Calyptranthes_amarulenta,6,1,5,Points-PointsKO-Adjacents,30
Calyptranthes_amoena,28,15,13,Points-PointsKO-Adjacents,232
Calyptranthes_amshoffae,26,15,11,Points-PointsKO-Adjacents,136
Calyptranthes_anacletoi,1,1,0,Points-PointsKO-Adjacents,9
Calyptranthes_anceps,2,2,0,Points-PointsKO-Adjacents,18
Calyptranthes_angustifolia,13,7,6,Points-PointsKO-Adjacents,72
Calyptranthes_arborea,2,2,0,Points-PointsKO-Adjacents,17
Calyptranthes_arenicola,0,0,0,NA,0
Calyptranthes_aromatica,35,1,34,Points-PointsKO-Adjacents,188
Calyptranthes_banilejoana,2,2,0,Points-PointsKO-Adjacents,18
Calyptranthes_barkeri,5,5,0,Points-PointsKO-Adjacents,37
Calyptranthes_bartlettii,24,16,8,Points-PointsKO-Adjacents,68
Calyptranthes_bimarginata,5,5,0,Points-PointsKO-Adjacents,39
Calyptranthes_bipennis,239,174,65,Alphahull-PointsKO-Adjacents,19273
Calyptranthes_blanchetiana,6,0,6,Points-PointsKO-Adjacents,40
Calyptranthes_bracteata,4,1,3,Points-PointsKO-Adjacents,15
Calyptranthes_bracteosa,0,0,0,NA,0
Calyptranthes_brasiliensis,373,286,87,Alphahull-PointsKO-Adjacents,8040
Calyptranthes_brevispicata,48,28,20,Alphahull-PointsKO-Adjacents,2923
Calyptranthes_buchenavioides,2,2,0,Points-PointsKO-Adjacents,18
Calyptranthes_bullata,1,1,0,Points-PointsKO-Adjacents,9
Calyptranthes_calderonii,16,12,4,Points-PointsKO-Adjacents,98
Calyptranthes_calyptrata,1,1,0,Points-PointsKO-Adjacents,8
Calyptranthes_canaliculata,3,3,0,Points-PointsKO-Adjacents,25
Calyptranthes_capitata,1,1,0,Points-PointsKO-Adjacents,9
Calyptranthes_caudata,7,0,7,Points-PointsKO-Adjacents,45
Calyptranthes_chiapensis,53,29,24,Alphahull-PointsKO-Adjacents,209
Calyptranthes_chrysophylloides,6,1,5,Points-PointsKO-Adjacents,45
Calyptranthes_chytraculia,193,133,60,Alphahull-PointsKO-Adjacents,3419
Calyptranthes_clusiifolia,333,273,60,Alphahull-PointsKO-Adjacents,9637
Calyptranthes_collina,2,2,0,Points-PointsKO-Adjacents,18
Calyptranthes_concinna,823,744,79,Alphahull-PointsKO-Adjacents,14135
Calyptranthes_conduplicata,2,2,0,Points-PointsKO-Adjacents,18
Calyptranthes_contrerasii,5,5,0,Points-PointsKO-Adjacents,30
Calyptranthes_crebra,68,28,40,Alphahull-PointsKO-Adjacents,1458
Calyptranthes_cristalensis,3,3,0,Points-PointsKO-Adjacents,23
Calyptranthes_cuneifolia,9,5,4,Points-PointsKO-Adjacents,58
Calyptranthes_cuspidata,135,77,58,Alphahull-PointsKO-Adjacents,15858
Calyptranthes_dardanoi,86,1,85,Points-PointsKO-Adjacents,408
Calyptranthes_decandra,3,3,0,Points-PointsKO-Adjacents,26
Calyptranthes_densiflora,59,40,19,Alphahull-PointsKO-Adjacents,1230
Calyptranthes_densifolia,3,3,0,Points-PointsKO-Adjacents,25
Calyptranthes_depressa,1,1,0,Points-PointsKO-Adjacents,9
Calyptranthes_dichotoma,2,2,0,Points-PointsKO-Adjacents,18
Calyptranthes_discolor,1,1,0,Points-PointsKO-Adjacents,9
Calyptranthes_dryadica,6,1,5,Points-PointsKO-Adjacents,52
Calyptranthes_elegans,3,2,1,Points-PointsKO-Adjacents,23
Calyptranthes_elliptica,9,3,6,Points-PointsKO-Adjacents,58
Calyptranthes_estoraquensis,3,3,0,Points-PointsKO-Adjacents,12
Calyptranthes_estremenae,4,2,2,Points-PointsKO-Adjacents,14
Calyptranthes_fasciculata,202,137,65,Alphahull-PointsKO-Adjacents,16078
Calyptranthes_flavoviridis,0,0,0,NA,0
Calyptranthes_forsteri,117,67,50,Alphahull-PointsKO-Adjacents,10963
Calyptranthes_fusiformis,15,2,13,Points-PointsKO-Adjacents,103
Calyptranthes_garciae,5,5,0,Points-PointsKO-Adjacents,27
Calyptranthes_glabrescens,2,2,0,Points-PointsKO-Adjacents,15
Calyptranthes_glandulosa,9,1,8,Points-PointsKO-Adjacents,75
Calyptranthes_glazioviana,13,2,11,Points-PointsKO-Adjacents,106
Calyptranthes_grammica,76,55,21,Alphahull-PointsKO-Adjacents,1761
Calyptranthes_grandiflora,18,4,14,Points-PointsKO-Adjacents,157
Calyptranthes_grandifolia,435,377,58,Alphahull-PointsKO-Adjacents,9499
Calyptranthes_grandis,2,2,0,Points-PointsKO-Adjacents,18
Calyptranthes_hatschbachii,10,6,4,Points-PointsKO-Adjacents,75
Calyptranthes_heineriana,74,36,38,Alphahull-PointsKO-Adjacents,728
Calyptranthes_heteroclada,3,3,0,Points-PointsKO-Adjacents,27
Calyptranthes_hondurensis,62,54,8,Alphahull-PointsKO-Adjacents,918
Calyptranthes_hotteana,2,2,0,Points-PointsKO-Adjacents,18
Calyptranthes_hylobates,62,39,23,Alphahull-PointsKO-Adjacents,846
Calyptranthes_involucrata,4,4,0,Points-PointsKO-Adjacents,32
Calyptranthes_ishoaquinicca,5,5,0,Points-PointsKO-Adjacents,30
Calyptranthes_izabalana,5,5,0,Points-PointsKO-Adjacents,45
Calyptranthes_jefensis,3,3,0,Points-PointsKO-Adjacents,15
Calyptranthes_johnstonii,3,3,0,Points-PointsKO-Adjacents,15
Calyptranthes_karlingii,32,17,15,Points-PointsKO-Adjacents,229
Calyptranthes_karwinskyana,28,18,10,Points-PointsKO-Adjacents,89
Calyptranthes_kiaerskovii,0,0,0,NA,0
Calyptranthes_killipii,9,3,6,Points-PointsKO-Adjacents,48
Calyptranthes_krugii,22,18,4,Points-PointsKO-Adjacents,43
Calyptranthes_krugioides,22,7,15,Points-PointsKO-Adjacents,180
Calyptranthes_lanceolata,105,76,29,Alphahull-PointsKO-Adjacents,601
Calyptranthes_langsdorffii,14,4,10,Points-PointsKO-Adjacents,101
Calyptranthes_lepida,4,4,0,Points-PointsKO-Adjacents,36
Calyptranthes_leptoclada,5,5,0,Points-PointsKO-Adjacents,37
Calyptranthes_lilloi,NA,NA,NA,NA,NA
Calyptranthes_limoncillo,3,3,0,Points-PointsKO-Adjacents,27
Calyptranthes_lindeniana,48,34,14,Alphahull-PointsKO-Adjacents,647
Calyptranthes_litoralis,0,0,0,NA,0
Calyptranthes_longicalyptrata,4,4,0,Points-PointsKO-Adjacents,20
Calyptranthes_longifolia,85,51,34,Alphahull-PointsKO-Adjacents,1573
Calyptranthes_loranthifolia,8,0,8,Points-PointsKO-Adjacents,56
Calyptranthes_lozanoi,6,1,5,Points-PointsKO-Adjacents,36
Calyptranthes_lucida,632,474,158,Alphahull-PointsKO-Adjacents,50727
Calyptranthes_luetzelburgii,2,2,0,Points-PointsKO-Adjacents,18
Calyptranthes_luquillensis,5,2,3,Points-PointsKO-Adjacents,20
Calyptranthes_macrantha,7,4,3,Points-PointsKO-Adjacents,51
Calyptranthes_macrocarpa,13,3,10,Points-PointsKO-Adjacents,68
Calyptranthes_macrophylla,219,146,73,Alphahull-PointsKO-Adjacents,22678
Calyptranthes_manuensis,6,3,3,Points-PointsKO-Adjacents,41
Calyptranthes_marmeladensis,4,4,0,Points-PointsKO-Adjacents,34
Calyptranthes_martiusiana,6,0,6,Points-PointsKO-Adjacents,54
Calyptranthes_maxima,74,48,26,Alphahull-PointsKO-Adjacents,2690
Calyptranthes_mayana,14,0,14,Points-PointsKO-Adjacents,92
Calyptranthes_mayarensis,1,1,0,Points-PointsKO-Adjacents,9
Calyptranthes_megistophylla,15,5,10,Points-PointsKO-Adjacents,95
Calyptranthes_melanoclada,2,1,1,Points-PointsKO-Adjacents,18
Calyptranthes_meridensis,5,5,0,Points-PointsKO-Adjacents,36
Calyptranthes_microphylla,8,4,4,Points-PointsKO-Adjacents,18
Calyptranthes_millspaughii,45,26,19,Alphahull-PointsKO-Adjacents,484
Calyptranthes_monteverdensis,20,14,6,Points-PointsKO-Adjacents,64
Calyptranthes_mornicola,3,3,0,Points-PointsKO-Adjacents,22
Calyptranthes_multiflora,249,185,64,Alphahull-PointsKO-Adjacents,18962
Calyptranthes_myrcioides,1,1,0,Points-PointsKO-Adjacents,9
Calyptranthes_nigrescens,52,33,19,Alphahull-PointsKO-Adjacents,1369
Calyptranthes_nigricans,5,4,1,Points-PointsKO-Adjacents,45
Calyptranthes_nodosa,2,2,0,Points-PointsKO-Adjacents,18
Calyptranthes_nummularia,3,3,0,Points-PointsKO-Adjacents,27
Calyptranthes_obovata,54,38,16,Alphahull-PointsKO-Adjacents,616
Calyptranthes_obtusa,0,0,0,NA,0
Calyptranthes_obversa,8,2,6,Points-PointsKO-Adjacents,66
Calyptranthes_oreophila,NA,NA,NA,NA,NA
Calyptranthes_ovalifolia,22,8,14,Points-PointsKO-Adjacents,126
Calyptranthes_ovata,2,2,0,Points-PointsKO-Adjacents,18
Calyptranthes_ovoidea,3,3,0,Points-PointsKO-Adjacents,27
Calyptranthes_pachyadenia,2,2,0,Points-PointsKO-Adjacents,17
Calyptranthes_pallens,331,243,88,Alphahull-PointsKO-Adjacents,6132
Calyptranthes_palustris,1,1,0,Points-PointsKO-Adjacents,8
Calyptranthes_paniculata,39,21,18,Alphahull-PointsKO-Adjacents,1161
Calyptranthes_pauciflora,7,1,6,Points-PointsKO-Adjacents,51
Calyptranthes_peduncularis,7,4,3,Points-PointsKO-Adjacents,32
Calyptranthes_pendula,22,6,16,Points-PointsKO-Adjacents,162
Calyptranthes_perlaevigata,9,1,8,Points-PointsKO-Adjacents,65
Calyptranthes_petenensis,4,4,0,Points-PointsKO-Adjacents,36
Calyptranthes_pileata,55,42,13,Alphahull-PointsKO-Adjacents,443
Calyptranthes_pitoniana,3,3,0,Points-PointsKO-Adjacents,24
Calyptranthes_pittieri,47,37,10,Alphahull-PointsKO-Adjacents,99
Calyptranthes_platyphylla,1,1,0,Points-PointsKO-Adjacents,9
Calyptranthes_plicata,87,65,22,Alphahull-PointsKO-Adjacents,3379
Calyptranthes_pozasiana,1,1,0,Points-PointsKO-Adjacents,8
Calyptranthes_proctorii,2,2,0,Points-PointsKO-Adjacents,18
Calyptranthes_protracta,3,3,0,Points-PointsKO-Adjacents,26
Calyptranthes_pseudobrunneica,4,4,0,Points-PointsKO-Adjacents,27
Calyptranthes_pseudomoaensis,1,1,0,Points-PointsKO-Adjacents,9
Calyptranthes_pteropoda,30,19,11,Points-PointsKO-Adjacents,201
Calyptranthes_pulchella,230,148,82,Alphahull-PointsKO-Adjacents,6826
Calyptranthes_pullei,52,23,29,Alphahull-PointsKO-Adjacents,1334
Calyptranthes_quinoensis,0,0,0,NA,0
Calyptranthes_restingae,15,3,12,Points-PointsKO-Adjacents,87
Calyptranthes_rigida,8,2,6,Points-PointsKO-Adjacents,62
Calyptranthes_rostrata,2,2,0,Points-PointsKO-Adjacents,17
Calyptranthes_rubella,50,0,50,Points-PointsKO-Adjacents,277
Calyptranthes_rufescens,0,0,0,NA,0
Calyptranthes_rufotomentosa,4,4,0,Points-PointsKO-Adjacents,26
Calyptranthes_ruiziana,67,27,40,Alphahull-PointsKO-Adjacents,1726
Calyptranthes_rupicola,1,1,0,Points-PointsKO-Adjacents,9
Calyptranthes_salamensis,8,5,3,Points-PointsKO-Adjacents,27
Calyptranthes_salicifolia,3,3,0,Points-PointsKO-Adjacents,24
Calyptranthes_samuelssonii,2,2,0,Points-PointsKO-Adjacents,18
Calyptranthes_schiedeana,135,103,32,Alphahull-PointsKO-Adjacents,1328
Calyptranthes_scoparia,2,2,0,Points-PointsKO-Adjacents,18
Calyptranthes_sessilis,5,5,0,Points-PointsKO-Adjacents,45
Calyptranthes_simulata,50,30,20,Alphahull-PointsKO-Adjacents,370
Calyptranthes_sintenisii,26,9,17,Points-PointsKO-Adjacents,145
Calyptranthes_smithii,8,2,6,Points-PointsKO-Adjacents,48
Calyptranthes_sordida,3,3,0,Points-PointsKO-Adjacents,27
Calyptranthes_speciosa,256,191,65,Alphahull-PointsKO-Adjacents,10090
Calyptranthes_spicata,3,3,0,Points-PointsKO-Adjacents,27
Calyptranthes_spruceana,46,30,16,Alphahull-PointsKO-Adjacents,1362
Calyptranthes_strigipes,123,100,23,Alphahull-PointsKO-Adjacents,1095
Calyptranthes_subcapitata,4,4,0,Points-PointsKO-Adjacents,30
Calyptranthes_tenuipes,16,5,11,Points-PointsKO-Adjacents,97
Calyptranthes_terniflora,2,2,0,Points-PointsKO-Adjacents,18
Calyptranthes_tessmannii,31,15,16,Points-PointsKO-Adjacents,251
Calyptranthes_tetraptera,6,1,5,Points-PointsKO-Adjacents,50
Calyptranthes_thomasiana,0,0,0,NA,0
Calyptranthes_toaensis,2,2,0,Points-PointsKO-Adjacents,18
Calyptranthes_tonii,9,0,9,Points-PointsKO-Adjacents,81
Calyptranthes_tricona,66,50,16,Alphahull-PointsKO-Adjacents,2542
Calyptranthes_tridymantha,7,0,7,Points-PointsKO-Adjacents,59
Calyptranthes_tumidonodia,15,7,8,Points-PointsKO-Adjacents,77
Calyptranthes_umbelliformis,5,5,0,Points-PointsKO-Adjacents,36
Calyptranthes_ursina,3,2,1,Points-PointsKO-Adjacents,24
Calyptranthes_vexata,8,3,5,Points-PointsKO-Adjacents,39
Calyptranthes_widgreniana,187,151,36,Alphahull-PointsKO-Adjacents,6334
Calyptranthes_wilsonii,1,1,0,Points-PointsKO-Adjacents,9
Calyptranthes_woodburyi,8,4,4,Points-PointsKO-Adjacents,32
Calyptranthes_yaquensis,0,0,0,NA,0
Calyptranthes_yaraensis,2,2,0,Points-PointsKO-Adjacents,17
Calyptranthes_zanquinensis,2,2,0,Points-PointsKO-Adjacents,18
Calyptranthes_zuzygium,64,28,36,Alphahull-PointsKO-Adjacents,604
Calyptrocalyx_albertisianus,25,10,15,Points-PointsKO-Adjacents,163
Calyptrocalyx_amoenus,NA,NA,NA,NA,NA
Calyptrocalyx_doxanthus,0,0,0,NA,0
Calyptrocalyx_elegans,5,5,0,Points-PointsKO-Adjacents,44
Calyptrocalyx_forbesii,8,2,6,Points-PointsKO-Adjacents,39
Calyptrocalyx_lauterbachianus,9,4,5,Points-PointsKO-Adjacents,77
Calyptrocalyx_lepidotus,2,2,0,Points-PointsKO-Adjacents,18
Calyptrocalyx_merrillianus,2,2,0,Points-PointsKO-Adjacents,18
Calyptrocalyx_pachystachys,3,3,0,Points-PointsKO-Adjacents,18
Calyptrocalyx_polyphyllus,1,1,0,Points-PointsKO-Adjacents,9
Calyptrocalyx_spicatus,2,2,0,Points-PointsKO-Adjacents,18
Calyptrogenia_biflora,3,3,0,Points-PointsKO-Adjacents,27
Calyptrogenia_cuspidata,3,3,0,Points-PointsKO-Adjacents,21
Calyptrogenia_ekmanii,1,1,0,Points-PointsKO-Adjacents,9
Calyptrogenia_jeremiensis,2,1,1,Points-PointsKO-Adjacents,18
Calyptrogyne_costatifrons,85,73,12,Alphahull-PointsKO-Adjacents,142
Calyptronoma_occidentalis,12,6,6,Points-PointsKO-Adjacents,91
Calyptronoma_plumeriana,22,4,18,Points-PointsKO-Adjacents,181
Calyptronoma_rivalis,17,8,9,Points-PointsKO-Adjacents,131
Calytrix_achaeta,667,635,32,Alphahull-PointsKO-Adjacents,4415
Calytrix_exstipulata,2179,0,2179,Points-PointsKO-Adjacents,5268
Camellia_amplexifolia,4,4,0,Points-PointsKO-Adjacents,30
Camellia_anlungensis,4,3,1,Points-PointsKO-Adjacents,36
Camellia_assimiloides,2,2,0,Points-PointsKO-Adjacents,18
Camellia_aurea,NA,NA,NA,NA,NA
Camellia_azalea,NA,NA,NA,NA,NA
Camellia_brevistyla,242,191,51,Alphahull-PointsKO-Adjacents,3259
Camellia_candida,2,2,0,Points-PointsKO-Adjacents,18
Camellia_caudata,113,66,47,Alphahull-PointsKO-Adjacents,5240
Camellia_chekiangoleosa,12,6,6,Points-PointsKO-Adjacents,108
Camellia_chrysanthoides,1,1,0,Points-PointsKO-Adjacents,9
Camellia_confusa,4,4,0,Points-PointsKO-Adjacents,36
Camellia_connata,2,2,0,Points-PointsKO-Adjacents,18
Camellia_corallina,0,0,0,NA,0
Camellia_cordifolia,37,21,16,Alphahull-PointsKO-Adjacents,1356
Camellia_costata,NA,NA,NA,NA,NA
Camellia_costei,22,3,19,Points-PointsKO-Adjacents,188
Camellia_crapnelliana,12,1,11,Points-PointsKO-Adjacents,108
Camellia_crassicolumna,7,1,6,Points-PointsKO-Adjacents,51
Camellia_crassiphylla,NA,NA,NA,NA,NA
Camellia_cuspidata,86,64,22,Alphahull-PointsKO-Adjacents,7094
Camellia_drupifera,16,2,14,Points-PointsKO-Adjacents,140
Camellia_edithae,9,3,6,Points-PointsKO-Adjacents,81
Camellia_elongata,3,2,1,Points-PointsKO-Adjacents,27
Camellia_euphlebia,3,3,0,Points-PointsKO-Adjacents,21
Camellia_euryoides,72,48,24,Alphahull-PointsKO-Adjacents,1872
Camellia_fangchengensis,NA,NA,NA,NA,NA
Camellia_fascicularis,NA,NA,NA,NA,NA
Camellia_flava,6,3,3,Points-PointsKO-Adjacents,24
Camellia_fluviatilis,9,1,8,Points-PointsKO-Adjacents,81
Camellia_formosensis,9,4,5,Points-PointsKO-Adjacents,52
Camellia_forrestii,19,9,10,Points-PointsKO-Adjacents,148
Camellia_fraterna,50,27,23,Alphahull-PointsKO-Adjacents,2695
Camellia_furfuracea,30,12,18,Points-PointsKO-Adjacents,234
Camellia_gaudichaudii,0,0,0,NA,0
Camellia_glabricostata,NA,NA,NA,NA,NA
Camellia_grandibracteata,NA,NA,NA,NA,NA
Camellia_granthamiana,1,1,0,Points-PointsKO-Adjacents,9
Camellia_grijsii,26,7,19,Points-PointsKO-Adjacents,225
Camellia_gymnogyna,3,3,0,Points-PointsKO-Adjacents,27
Camellia_hekouensis,NA,NA,NA,NA,NA
Camellia_hongkongensis,6,1,5,Points-PointsKO-Adjacents,54
Camellia_ilicifolia,0,0,0,NA,0
Camellia_impressinervis,1,1,0,Points-PointsKO-Adjacents,9
Camellia_indochinensis,5,0,5,Points-PointsKO-Adjacents,45
Camellia_japonica,358,184,174,Alphahull-PointsKO-Adjacents,2727
Camellia_kissii,46,11,35,Points-PointsKO-Adjacents,410
Camellia_kwangsiensis,6,1,5,Points-PointsKO-Adjacents,45
Camellia_lanceolata,35,5,30,Points-PointsKO-Adjacents,270
Camellia_laotica,0,0,0,NA,0
Camellia_leptophylla,NA,NA,NA,NA,NA
Camellia_longicalyx,1,1,0,Points-PointsKO-Adjacents,9
Camellia_longissima,1,1,0,Points-PointsKO-Adjacents,9
Camellia_lutchuensis,46,34,12,Alphahull-PointsKO-Adjacents,176
Camellia_luteoflora,1,1,0,Points-PointsKO-Adjacents,9
Camellia_mairei,17,1,16,Points-PointsKO-Adjacents,153
Camellia_megasepala,NA,NA,NA,NA,NA
Camellia_mollis,0,0,0,NA,0
Camellia_montana,0,0,0,NA,0
Camellia_nematodea,2,2,0,Points-PointsKO-Adjacents,9
Camellia_nervosa,0,0,0,NA,0
Camellia_nitidissima,8,0,8,Points-PointsKO-Adjacents,63
Camellia_oleifera,211,168,43,Alphahull-PointsKO-Adjacents,19818
Camellia_pachyandra,5,5,0,Points-PointsKO-Adjacents,45
Camellia_paucipunctata,2,1,1,Points-PointsKO-Adjacents,18
Camellia_petelotii,1,1,0,Points-PointsKO-Adjacents,9
Camellia_piquetiana,0,0,0,NA,0
Camellia_pitardii,50,32,18,Alphahull-PointsKO-Adjacents,3924
Camellia_pleurocarpa,1,1,0,Points-PointsKO-Adjacents,9
Camellia_polyodonta,19,9,10,Points-PointsKO-Adjacents,171
Camellia_ptilophylla,NA,NA,NA,NA,NA
Camellia_pubicosta,1,1,0,Points-PointsKO-Adjacents,9
Camellia_pubifurfuracea,1,1,0,Points-PointsKO-Adjacents,9
Camellia_pubipetala,2,2,0,Points-PointsKO-Adjacents,18
Camellia_pyxidiacea,NA,NA,NA,NA,NA
Camellia_reticulata,51,39,12,Alphahull-PointsKO-Adjacents,2240
Camellia_rhytidocarpa,1,1,0,Points-PointsKO-Adjacents,9
Camellia_salicifolia,68,49,19,Alphahull-PointsKO-Adjacents,1535
Camellia_sasanqua,37,14,23,Points-PointsKO-Adjacents,206
Camellia_sealyana,NA,NA,NA,NA,NA
Camellia_semiserrata,8,5,3,Points-PointsKO-Adjacents,72
Camellia_siangensis,0,0,0,NA,0
Camellia_sinensis,0,0,0,NA,0
Camellia_stuartiana,1,1,0,Points-PointsKO-Adjacents,9
Camellia_subintegra,3,3,0,Points-PointsKO-Adjacents,27
Camellia_synaptica,9,3,6,Points-PointsKO-Adjacents,81
Camellia_szechuanensis,4,4,0,Points-PointsKO-Adjacents,35
Camellia_szemaoensis,3,3,0,Points-PointsKO-Adjacents,27
Camellia_tachangensis,3,3,0,Points-PointsKO-Adjacents,27
Camellia_taliensis,11,5,6,Points-PointsKO-Adjacents,97
Camellia_tsaii,19,10,9,Points-PointsKO-Adjacents,133
Camellia_tsingpienensis,10,4,6,Points-PointsKO-Adjacents,90
Camellia_tuberculata,4,4,0,Points-PointsKO-Adjacents,36
Camellia_uraku,3,1,2,Points-PointsKO-Adjacents,24
Camellia_wardii,2,2,0,Points-PointsKO-Adjacents,12
Camellia_xanthochroma,1,1,0,Points-PointsKO-Adjacents,9
Camellia_yunnanensis,24,13,11,Points-PointsKO-Adjacents,211
Cameraria_angustifolia,1,1,0,Points-PointsKO-Adjacents,5
Cameraria_latifolia,220,0,220,Points-PointsKO-Adjacents,839
Cameraria_linearifolia,3,3,0,Points-PointsKO-Adjacents,19
Cameraria_microphylla,NA,NA,NA,NA,NA
Cameraria_orientensis,1,1,0,Points-PointsKO-Adjacents,9
Cameraria_retusa,6,0,6,Points-PointsKO-Adjacents,54
Campnosperma_auriculatum,17,0,17,Points-PointsKO-Adjacents,151
Campnosperma_brevipetiolatum,51,14,37,Points-PointsKO-Adjacents,308
Campnosperma_coriaceum,8,4,4,Points-PointsKO-Adjacents,50
Campnosperma_gummifera,29,9,20,Points-PointsKO-Adjacents,228
Campnosperma_lepidotum,21,9,12,Points-PointsKO-Adjacents,122
Campnosperma_micranteia,40,25,15,Alphahull-PointsKO-Adjacents,668
Campnosperma_micranteium,43,27,16,Alphahull-PointsKO-Adjacents,677
Campnosperma_montanum,43,12,31,Points-PointsKO-Adjacents,249
Campnosperma_panamense,50,22,28,Alphahull-PointsKO-Adjacents,1175
Campnosperma_parvifolium,16,9,7,Points-PointsKO-Adjacents,55
Campnosperma_schatzii,48,28,20,Alphahull-PointsKO-Adjacents,485
Campnosperma_seychellarum,2,2,0,Points-PointsKO-Adjacents,9
Campnosperma_squamatum,6,0,6,Points-PointsKO-Adjacents,53
Campnosperma_zacharyi,1,1,0,Points-PointsKO-Adjacents,9
Campnosperma_zeylanica,1,1,0,Points-PointsKO-Adjacents,9
Campomanesia_anemonea,9,3,6,Points-PointsKO-Adjacents,53
Campomanesia_aromatica,399,302,97,Alphahull-PointsKO-Adjacents,11905
Campomanesia_aurea,74,49,25,Alphahull-PointsKO-Adjacents,3641
Campomanesia_blanchetiana,3,2,1,Points-PointsKO-Adjacents,26
Campomanesia_cucullata,1,1,0,Points-PointsKO-Adjacents,9
Campomanesia_dichotoma,376,291,85,Alphahull-PointsKO-Adjacents,4106
Campomanesia_espiritosantensis,15,7,8,Points-PointsKO-Adjacents,110
Campomanesia_eugenioides,563,463,100,Alphahull-PointsKO-Adjacents,36394
Campomanesia_grandiflora,72,23,49,Alphahull-PointsKO-Adjacents,3783
Campomanesia_guaviroba,800,704,96,Alphahull-PointsKO-Adjacents,12555
Campomanesia_guazumifolia,939,861,78,Alphahull-PointsKO-Adjacents,20276
Campomanesia_hirsuta,6,0,6,Points-PointsKO-Adjacents,45
Campomanesia_ilhoensis,102,66,36,Alphahull-PointsKO-Adjacents,2248
Campomanesia_laurifolia,99,80,19,Alphahull-PointsKO-Adjacents,2630
Campomanesia_lineatifolia,155,85,70,Alphahull-PointsKO-Adjacents,13550
Campomanesia_lundiana,4,4,0,Points-PointsKO-Adjacents,36
Campomanesia_macrobracteolata,10,7,3,Points-PointsKO-Adjacents,66
Campomanesia_neriiflora,89,0,89,Points-PointsKO-Adjacents,510
Campomanesia_phaea,114,0,114,Points-PointsKO-Adjacents,638
Campomanesia_prosthecesepala,7,0,7,Points-PointsKO-Adjacents,60
Campomanesia_pubescens,500,412,88,Alphahull-PointsKO-Adjacents,18213
Campomanesia_reitziana,96,0,96,Points-PointsKO-Adjacents,476
Campomanesia_rufa,49,34,15,Alphahull-PointsKO-Adjacents,784
Campomanesia_schlechtendaliana,52,25,27,Alphahull-PointsKO-Adjacents,815
Campomanesia_sessiliflora,407,358,49,Alphahull-PointsKO-Adjacents,18781
Campomanesia_simulans,17,8,9,Points-PointsKO-Adjacents,127
Campomanesia_speciosa,39,17,22,Points-PointsKO-Adjacents,280
Campomanesia_terminalis,3,3,0,Points-PointsKO-Adjacents,27
Campomanesia_velutina,388,344,44,Alphahull-PointsKO-Adjacents,18718
Campomanesia_xanthocarpa,1214,1109,105,Alphahull-PointsKO-Adjacents,26158
Campsiandra_angustifolia,355,306,49,Alphahull-PointsKO-Adjacents,32488
Campsiandra_aymardii,5,5,0,Points-PointsKO-Adjacents,38
Campsiandra_casiquiarensis,2,2,0,Points-PointsKO-Adjacents,18
Campsiandra_chigo-montero,99,56,43,Alphahull-PointsKO-Adjacents,3847
Campsiandra_comosa,102,70,32,Alphahull-PointsKO-Adjacents,2151
Campsiandra_curaara,3,3,0,Points-PointsKO-Adjacents,27
Campsiandra_emonensis,8,1,7,Points-PointsKO-Adjacents,65
Campsiandra_ferruginea,3,3,0,Points-PointsKO-Adjacents,26
Campsiandra_gomez-alvareziana,13,7,6,Points-PointsKO-Adjacents,97
Campsiandra_guayanensis,12,4,8,Points-PointsKO-Adjacents,96
Campsiandra_implexicaulis,103,61,42,Alphahull-PointsKO-Adjacents,2298
Campsiandra_laurifolia,172,120,52,Alphahull-PointsKO-Adjacents,16630
Campsiandra_macrocarpa,21,8,13,Points-PointsKO-Adjacents,155
Campsiandra_nutans,35,0,35,Points-PointsKO-Adjacents,300
Campsiandra_pasibensis,5,5,0,Points-PointsKO-Adjacents,38
Campsiandra_steyermarkiana,4,4,0,Points-PointsKO-Adjacents,36
Campsiandra_taphornii,28,18,10,Points-PointsKO-Adjacents,247
Campsiandra_velutina,2,2,0,Points-PointsKO-Adjacents,17
Campsiandra_wurdackiana,14,7,7,Points-PointsKO-Adjacents,117
Camptolepis_crassifolia,1,1,0,Points-PointsKO-Adjacents,6
Camptolepis_grandiflora,5,5,0,Points-PointsKO-Adjacents,18
Camptolepis_hygrophila,4,4,0,Points-PointsKO-Adjacents,36
Camptolepis_ramiflora,7,1,6,Points-PointsKO-Adjacents,37
Camptostemon_philippinense,6,0,6,Points-PointsKO-Adjacents,51
Camptostemon_schultzii,168,126,42,Alphahull-PointsKO-Adjacents,1364
Camptostylus_kivuensis,4,4,0,Points-PointsKO-Adjacents,34
Camptostylus_mannii,109,90,19,Alphahull-PointsKO-Adjacents,3235
Camptostylus_ovalis,22,15,7,Points-PointsKO-Adjacents,87
Camptotheca_acuminata,111,68,43,Alphahull-PointsKO-Adjacents,13660
Camptotheca_lowreyana,NA,NA,NA,NA,NA
Campylospermum_amplectens,44,28,16,Alphahull-PointsKO-Adjacents,653
Campylospermum_anceps,70,55,15,Alphahull-PointsKO-Adjacents,808
Campylospermum_congestum,47,31,16,Alphahull-PointsKO-Adjacents,892
Campylospermum_deltoideum,36,21,15,Alphahull-PointsKO-Adjacents,244
Campylospermum_densiflorum,210,143,67,Alphahull-PointsKO-Adjacents,25472
Campylospermum_dependens,47,30,17,Alphahull-PointsKO-Adjacents,527
Campylospermum_dusenii,7,7,0,Points-PointsKO-Adjacents,31
Campylospermum_elongatum,378,333,45,Alphahull-PointsKO-Adjacents,16448
Campylospermum_flavum,454,365,89,Alphahull-PointsKO-Adjacents,17879
Campylospermum_laevigatum,81,54,27,Alphahull-PointsKO-Adjacents,659
Campylospermum_letouzeyi,7,4,3,Points-PointsKO-Adjacents,57
Campylospermum_mannii,25,19,6,Points-PointsKO-Adjacents,174
Campylospermum_obtusifolium,101,68,33,Alphahull-PointsKO-Adjacents,1204
Campylospermum_reticulatum,453,374,79,Alphahull-PointsKO-Adjacents,24445
Campylospermum_schoenleinianum,125,95,30,Alphahull-PointsKO-Adjacents,2732
Campylospermum_serratum,138,69,69,Alphahull-PointsKO-Adjacents,3019
Campylospermum_squamosum,183,160,23,Alphahull-PointsKO-Adjacents,5249
Campylospermum_vogelii,236,148,88,Alphahull-PointsKO-Adjacents,8809
Canacomyrica_monticola,29,22,7,Alphahull-PointsKO-Adjacents,47
Cananga_brandisiana,0,0,0,NA,0
Cananga_latifolia,4,1,3,Points-PointsKO-Adjacents,32
Cananga_odorata,196,109,87,Alphahull-PointsKO-Adjacents,2898
Canarium_acutifolium,124,79,45,Alphahull-PointsKO-Adjacents,2917
Canarium_album,33,16,17,Points-PointsKO-Adjacents,285
Canarium_apertum,4,1,3,Points-PointsKO-Adjacents,36
Canarium_asperum,94,33,61,Alphahull-PointsKO-Adjacents,1307
Canarium_australasicum,183,152,31,Alphahull-PointsKO-Adjacents,475
Canarium_australianum,1671,1575,96,Alphahull-PointsKO-Adjacents,9180
Canarium_balansae,3,3,0,Points-PointsKO-Adjacents,18
Canarium_balsamiferum,15,2,13,Points-PointsKO-Adjacents,121
Canarium_batjanense,1,1,0,Points-PointsKO-Adjacents,9
Canarium_bengalense,1,1,0,Points-PointsKO-Adjacents,9
Canarium_caudatum,11,0,11,Points-PointsKO-Adjacents,98
Canarium_cestracion,5,5,0,Points-PointsKO-Adjacents,29
Canarium_chinare,5,5,0,Points-PointsKO-Adjacents,33
Canarium_cinereum,NA,NA,NA,NA,NA
Canarium_copaliferum,0,0,0,NA,0
Canarium_decumanum,9,0,9,Points-PointsKO-Adjacents,54
Canarium_denticulatum,26,12,14,Points-PointsKO-Adjacents,216
Canarium_dichotomum,13,3,10,Points-PointsKO-Adjacents,110
Canarium_divergens,1,1,0,Points-PointsKO-Adjacents,9
Canarium_engleri,1,1,0,Points-PointsKO-Adjacents,9
Canarium_euphyllum,0,0,0,NA,0
Canarium_euryphyllum,9,0,9,Points-PointsKO-Adjacents,61
Canarium_fuscocalycinum,1,1,0,Points-PointsKO-Adjacents,9
Canarium_gracile,1,1,0,Points-PointsKO-Adjacents,5
Canarium_grandifolium,0,0,0,NA,0
Canarium_harveyi,13,3,10,Points-PointsKO-Adjacents,61
Canarium_hirsutum,57,14,43,Points-PointsKO-Adjacents,435
Canarium_indicum,49,0,49,Points-PointsKO-Adjacents,286
Canarium_intermedium,1,1,0,Points-PointsKO-Adjacents,9
Canarium_kaniense,10,1,9,Points-PointsKO-Adjacents,42
Canarium_karoense,0,0,0,NA,0
Canarium_kerrii,0,0,0,NA,0
Canarium_kinabaluense,3,3,0,Points-PointsKO-Adjacents,27
Canarium_kipella,0,0,0,NA,0
Canarium_kostermansii,2,2,0,Points-PointsKO-Adjacents,18
Canarium_lamii,1,1,0,Points-PointsKO-Adjacents,9
Canarium_latistipulatum,6,2,4,Points-PointsKO-Adjacents,54
Canarium_liguliferum,0,0,0,NA,0
Canarium_littorale,47,31,16,Alphahull-PointsKO-Adjacents,3043
Canarium_luzonicum,0,0,0,NA,0
Canarium_lyi,NA,NA,NA,NA,NA
Canarium_macadamii,9,6,3,Points-PointsKO-Adjacents,21
Canarium_madagascariense,299,261,38,Alphahull-PointsKO-Adjacents,4892
Canarium_maluense,59,30,29,Alphahull-PointsKO-Adjacents,2352
Canarium_megacarpum,1,1,0,Points-PointsKO-Adjacents,9
Canarium_megalanthum,5,0,5,Points-PointsKO-Adjacents,45
Canarium_merrillii,14,1,13,Points-PointsKO-Adjacents,116
Canarium_muelleri,52,37,15,Alphahull-PointsKO-Adjacents,199
Canarium_odontophyllum,10,0,10,Points-PointsKO-Adjacents,81
Canarium_oleiferum,3,3,0,Points-PointsKO-Adjacents,25
Canarium_oleosum,17,1,16,Points-PointsKO-Adjacents,124
Canarium_ovatum,3,3,0,Points-PointsKO-Adjacents,21
Canarium_paniculatum,0,0,0,NA,0
Canarium_parvum,4,4,0,Points-PointsKO-Adjacents,27
Canarium_patentinervium,16,9,7,Points-PointsKO-Adjacents,119
Canarium_perlisanum,0,0,0,NA,0
Canarium_pilososylvestre,0,0,0,NA,0
Canarium_pilosum,21,6,15,Points-PointsKO-Adjacents,170
Canarium_pimela,14,2,12,Points-PointsKO-Adjacents,126
Canarium_polyphyllum,1,1,0,Points-PointsKO-Adjacents,9
Canarium_pseudodecumanum,1,1,0,Points-PointsKO-Adjacents,9
Canarium_pseudopatentinervium,2,2,0,Points-PointsKO-Adjacents,18
Canarium_pseudopimela,0,0,0,NA,0
Canarium_pseudosumatranum,0,0,0,NA,0
Canarium_reniforme,0,0,0,NA,0
Canarium_resiniferum,0,0,0,NA,0
Canarium_rigidum,6,0,6,Points-PointsKO-Adjacents,36
Canarium_rotundifolium,0,0,0,NA,0
Canarium_sarawakanum,3,3,0,Points-PointsKO-Adjacents,9
Canarium_schweinfurtii,225,168,57,Alphahull-PointsKO-Adjacents,7634
Canarium_sikkimense,3,3,0,Points-PointsKO-Adjacents,27
Canarium_solomonense,0,0,0,NA,0
Canarium_strictum,3,0,3,Points-PointsKO-Adjacents,27
Canarium_subulatum,11,1,10,Points-PointsKO-Adjacents,95
Canarium_sumatranum,0,0,0,NA,0
Canarium_sylvestre,13,3,10,Points-PointsKO-Adjacents,93
Canarium_thorelianum,0,0,0,NA,0
Canarium_trifoliolatum,2,2,0,Points-PointsKO-Adjacents,17
Canarium_trigonum,1,1,0,Points-PointsKO-Adjacents,9
Canarium_vanikoroense,0,0,0,NA,0
Canarium_venosum,0,0,0,NA,0
Canarium_vitiense,123,77,46,Alphahull-PointsKO-Adjacents,2933
Canarium_vittatistipulatum,0,0,0,NA,0
Canarium_vrieseanum,13,1,12,Points-PointsKO-Adjacents,87
Canarium_vulgare,27,7,20,Points-PointsKO-Adjacents,173
Canarium_whitei,2,2,0,Points-PointsKO-Adjacents,14
Canarium_zeylanicum,3,2,1,Points-PointsKO-Adjacents,27
Canella_winterana,122,78,44,Alphahull-PointsKO-Adjacents,2632
Canotia_holacantha,443,429,14,Alphahull-PointsKO-Adjacents,1917
Canthium_carinatum,0,0,0,NA,0
Canthium_ciliatum,103,80,23,Alphahull-PointsKO-Adjacents,2935
Canthium_coffeoides,5,5,0,Points-PointsKO-Adjacents,45
Canthium_confertum,30,14,16,Points-PointsKO-Adjacents,174
Canthium_congestiflorum,2,2,0,Points-PointsKO-Adjacents,18
Canthium_coromandelicum,5,0,5,Points-PointsKO-Adjacents,33
Canthium_depressinerve,1,1,0,Points-PointsKO-Adjacents,9
Canthium_glaucum,25,4,21,Points-PointsKO-Adjacents,205
Canthium_hainanense,4,4,0,Points-PointsKO-Adjacents,36
Canthium_inerme,122,0,122,Points-PointsKO-Adjacents,996
Canthium_kuntzeanum,20,7,13,Points-PointsKO-Adjacents,170
Canthium_neilgherrense,1,1,0,Points-PointsKO-Adjacents,9
Canthium_oligocarpum,150,105,45,Alphahull-PointsKO-Adjacents,3482
Canthium_rheedei,0,0,0,NA,0
Canthium_simile,7,2,5,Points-PointsKO-Adjacents,63
Canthium_spinosum,21,7,14,Points-PointsKO-Adjacents,178
Canthium_strychnoides,0,0,0,NA,0
Canthium_travancoricum,0,0,0,NA,0
Canthium_umbelligerum,2,2,0,Points-PointsKO-Adjacents,18
Cantinoa_duplicatodentata,14,0,14,Points-PointsKO-Adjacents,122
Cantleya_corniculata,0,0,0,NA,0
Cantua_bicolor,3,3,0,Points-PointsKO-Adjacents,27
Cantua_buxifolia,41,14,27,Points-PointsKO-Adjacents,306
Cantua_flexuosa,20,7,13,Points-PointsKO-Adjacents,127
Cantua_longifolia,6,0,6,Points-PointsKO-Adjacents,50
Cantua_pyrifolia,34,16,18,Points-PointsKO-Adjacents,229
Caphexandra_heydeana,40,0,40,Points-PointsKO-Adjacents,244
Capirona_decorticans,457,378,79,Alphahull-PointsKO-Adjacents,48190
Capitanopsis_angustifolia,21,15,6,Points-PointsKO-Adjacents,113
Capitanopsis_cloiselii,25,15,10,Points-PointsKO-Adjacents,117
Capparicordis_tweedieana,3,3,0,Points-PointsKO-Adjacents,27
Capparicordis_yunckeri,3,3,0,Points-PointsKO-Adjacents,18
Capparidastrum_bonifazianum,22,12,10,Points-PointsKO-Adjacents,187
Capparidastrum_brasilianum,50,0,50,Points-PointsKO-Adjacents,329
Capparidastrum_coimbranum,140,113,27,Alphahull-PointsKO-Adjacents,2971
Capparidastrum_cuatrecasanum,5,0,5,Points-PointsKO-Adjacents,45
Capparidastrum_discolor,123,112,11,Alphahull-PointsKO-Adjacents,593
Capparidastrum_elegans,16,0,16,Points-PointsKO-Adjacents,140
Capparidastrum_frondosum,817,601,216,Alphahull-PointsKO-Adjacents,29598
Capparidastrum_grandiflorum,8,5,3,Points-PointsKO-Adjacents,53
Capparidastrum_macrophyllum,98,57,41,Alphahull-PointsKO-Adjacents,7339
Capparidastrum_megalospermum,5,5,0,Points-PointsKO-Adjacents,45
Capparidastrum_mollicellum,109,72,37,Alphahull-PointsKO-Adjacents,1393
Capparidastrum_osmanthum,190,129,61,Alphahull-PointsKO-Adjacents,13493
Capparidastrum_pachaca,107,67,40,Alphahull-PointsKO-Adjacents,1190
Capparidastrum_petiolare,52,30,22,Alphahull-PointsKO-Adjacents,1793
Capparidastrum_quinum,17,0,17,Points-PointsKO-Adjacents,140
Capparidastrum_quiriguense,54,37,17,Alphahull-PointsKO-Adjacents,911
Capparidastrum_sola,153,107,46,Alphahull-PointsKO-Adjacents,8827
Capparidastrum_sprucei,5,5,0,Points-PointsKO-Adjacents,42
Capparidastrum_tuxtlense,1,1,0,Points-PointsKO-Adjacents,9
Capparis_antonensis,19,9,10,Points-PointsKO-Adjacents,78
Capparis_arborea,946,875,71,Alphahull-PointsKO-Adjacents,3815
Capparis_brevispina,0,0,0,NA,0
Capparis_burmanica,0,0,0,NA,0
Capparis_calciphila,7,3,4,Points-PointsKO-Adjacents,57
Capparis_canescens,252,217,35,Alphahull-PointsKO-Adjacents,5773
Capparis_cartilaginea,33,7,26,Points-PointsKO-Adjacents,201
Capparis_decidua,30,4,26,Points-PointsKO-Adjacents,252
Capparis_detonsa,87,0,87,Points-PointsKO-Adjacents,575
Capparis_divaricata,1,1,0,Points-PointsKO-Adjacents,9
Capparis_domingensis,8,1,7,Points-PointsKO-Adjacents,64
Capparis_erycibe,2,2,0,Points-PointsKO-Adjacents,18
Capparis_filipes,44,30,14,Alphahull-PointsKO-Adjacents,409
Capparis_flavicans,4,4,0,Points-PointsKO-Adjacents,27
Capparis_fruticosa,0,0,0,NA,0
Capparis_grandipetala,14,6,8,Points-PointsKO-Adjacents,94
Capparis_grandis,2,0,2,Points-PointsKO-Adjacents,18
Capparis_grisebachii,8,2,6,Points-PointsKO-Adjacents,65
Capparis_jacobsii,131,105,26,Alphahull-PointsKO-Adjacents,2055
Capparis_loranthifolia,234,196,38,Alphahull-PointsKO-Adjacents,13832
Capparis_lucida,151,104,47,Alphahull-PointsKO-Adjacents,1080
Capparis_maroniensis,12,1,11,Points-PointsKO-Adjacents,75
Capparis_mekongensis,NA,NA,NA,NA,NA
Capparis_micracantha,28,0,28,Points-PointsKO-Adjacents,220
Capparis_mirifica,4,4,0,Points-PointsKO-Adjacents,15
Capparis_mitchellii,1468,1404,64,Alphahull-PointsKO-Adjacents,23061
Capparis_muco,6,0,6,Points-PointsKO-Adjacents,36
Capparis_multiflora,2,2,0,Points-PointsKO-Adjacents,18
Capparis_nectarea,34,21,13,Alphahull-PointsKO-Adjacents,400
Capparis_olacifolia,3,3,0,Points-PointsKO-Adjacents,18
Capparis_pachyphylla,0,0,0,NA,0
Capparis_panamensis,9,6,3,Points-PointsKO-Adjacents,38
Capparis_peltata,NA,NA,NA,NA,NA
Capparis_pittieri,161,137,24,Alphahull-PointsKO-Adjacents,1056
Capparis_pseudocerasifera,1,1,0,Points-PointsKO-Adjacents,9
Capparis_pubiflora,25,3,22,Points-PointsKO-Adjacents,198
Capparis_quiniflora,200,170,30,Alphahull-PointsKO-Adjacents,1354
Capparis_rotundifolia,0,0,0,NA,0
Capparis_rufidula,0,0,0,NA,0
Capparis_salicifolia,58,40,18,Alphahull-PointsKO-Adjacents,1984
Capparis_shanesiana,29,13,16,Points-PointsKO-Adjacents,214
Capparis_siamensis,1,1,0,Points-PointsKO-Adjacents,9
Capparis_sikkimensis,0,0,0,NA,0
Capparis_steyermarkii,3,3,0,Points-PointsKO-Adjacents,18
Capparis_sunbisiniana,1,1,0,Points-PointsKO-Adjacents,9
Capparis_tenera,3,3,0,Points-PointsKO-Adjacents,27
Capparis_thorelii,1,1,0,Points-PointsKO-Adjacents,8
Capparis_tonkinensis,0,0,0,NA,0
Capparis_umbonata,819,759,60,Alphahull-PointsKO-Adjacents,19989
Capparis_urophylla,21,6,15,Points-PointsKO-Adjacents,185
Capparis_viminea,28,11,17,Points-PointsKO-Adjacents,211
Capraria_biflora,1052,780,272,Alphahull-PointsKO-Adjacents,18769
Capsicum_annuum,4809,3288,1521,Alphahull-PointsKO-Adjacents,127142
Capsicum_caballeroi,21,17,4,Points-PointsKO-Adjacents,87
Capsicum_lanceolatum,64,46,18,Alphahull-PointsKO-Adjacents,908
Capsicum_rhomboideum,418,332,86,Alphahull-PointsKO-Adjacents,9894
Capurodendron_androyense,40,0,40,Points-PointsKO-Adjacents,221
Capurodendron_ankaranense,20,11,9,Points-PointsKO-Adjacents,98
Capurodendron_antongiliense,1,1,0,Points-PointsKO-Adjacents,9
Capurodendron_apollonioides,4,4,0,Points-PointsKO-Adjacents,27
Capurodendron_bakeri,8,3,5,Points-PointsKO-Adjacents,47
Capurodendron_costatum,3,3,0,Points-PointsKO-Adjacents,27
Capurodendron_delphinense,7,0,7,Points-PointsKO-Adjacents,17
Capurodendron_gracilifolium,21,11,10,Points-PointsKO-Adjacents,132
Capurodendron_greveanum,42,26,16,Alphahull-PointsKO-Adjacents,176
Capurodendron_ludiifolium,11,2,9,Points-PointsKO-Adjacents,54
Capurodendron_madagascariense,5,2,3,Points-PointsKO-Adjacents,30
Capurodendron_mandrarense,42,28,14,Alphahull-PointsKO-Adjacents,933
Capurodendron_nodosum,28,18,10,Points-PointsKO-Adjacents,115
Capurodendron_perrieri,26,6,20,Points-PointsKO-Adjacents,176
Capurodendron_pervillei,25,14,11,Points-PointsKO-Adjacents,153
Capurodendron_pseudoterminalia,3,3,0,Points-PointsKO-Adjacents,24
Capurodendron_rubrocostatum,22,13,9,Points-PointsKO-Adjacents,150
Capurodendron_rufescens,6,0,6,Points-PointsKO-Adjacents,44
Capurodendron_sakalavum,15,10,5,Points-PointsKO-Adjacents,101
Capurodendron_suarezense,10,6,4,Points-PointsKO-Adjacents,24
Capurodendron_tampinense,26,13,13,Points-PointsKO-Adjacents,149
Capurodendron_terminalioides,7,1,6,Points-PointsKO-Adjacents,57
Capuronia_benoistii,57,35,22,Alphahull-PointsKO-Adjacents,944
Capuronianthus_mahafalensis,9,4,5,Points-PointsKO-Adjacents,66
Capuronianthus_vohemarensis,4,4,0,Points-PointsKO-Adjacents,18
Caragana_alpina,NA,NA,NA,NA,NA
Caragana_arborescens,174,140,34,Alphahull-PointsKO-Adjacents,810
Caragana_decorticans,0,0,0,NA,0
Caragana_gobica,NA,NA,NA,NA,NA
Caragana_korshinskii,11,2,9,Points-PointsKO-Adjacents,99
Caragana_opulens,14,1,13,Points-PointsKO-Adjacents,122
Caragana_pekinensis,4,2,2,Points-PointsKO-Adjacents,36
Caragana_purdomii,2,2,0,Points-PointsKO-Adjacents,18
Caragana_tragacanthoides,1,1,0,Points-PointsKO-Adjacents,9
Caraipa_ampla,14,4,10,Points-PointsKO-Adjacents,107
Caraipa_costata,48,30,18,Alphahull-PointsKO-Adjacents,2799
Caraipa_densifolia,782,683,99,Alphahull-PointsKO-Adjacents,65706
Caraipa_duckeana,24,3,21,Points-PointsKO-Adjacents,215
Caraipa_grandifolia,271,213,58,Alphahull-PointsKO-Adjacents,18805
Caraipa_heterocarpa,54,28,26,Alphahull-PointsKO-Adjacents,807
Caraipa_jaramilloi,30,17,13,Points-PointsKO-Adjacents,216
Caraipa_llanorum,236,1,235,Points-PointsKO-Adjacents,1590
Caraipa_longipedicellata,53,27,26,Alphahull-PointsKO-Adjacents,1271
Caraipa_minor,16,0,16,Points-PointsKO-Adjacents,131
Caraipa_multinervia,4,3,1,Points-PointsKO-Adjacents,36
Caraipa_myrcioides,32,11,21,Points-PointsKO-Adjacents,207
Caraipa_odorata,18,1,17,Points-PointsKO-Adjacents,125
Caraipa_parvielliptica,22,8,14,Points-PointsKO-Adjacents,179
Caraipa_parvifolia,9,3,6,Points-PointsKO-Adjacents,75
Caraipa_psilocarpa,12,3,9,Points-PointsKO-Adjacents,102
Caraipa_punctulata,277,203,74,Alphahull-PointsKO-Adjacents,27370
Caraipa_racemosa,48,22,26,Alphahull-PointsKO-Adjacents,2260
Caraipa_richardiana,123,68,55,Alphahull-PointsKO-Adjacents,5869
Caraipa_rodriguesii,9,0,9,Points-PointsKO-Adjacents,62
Caraipa_savannarum,194,150,44,Alphahull-PointsKO-Adjacents,11771
Caraipa_surinamensis,NA,NA,NA,NA,NA
Caraipa_tereticaulis,71,0,71,Points-PointsKO-Adjacents,486
Caraipa_utilis,16,10,6,Points-PointsKO-Adjacents,96
Caraipa_valioi,9,1,8,Points-PointsKO-Adjacents,78
Carallia_borneensis,9,1,8,Points-PointsKO-Adjacents,72
Carallia_brachiata,1640,1431,209,Alphahull-PointsKO-Adjacents,22902
Carallia_calophylloidea,0,0,0,NA,0
Carallia_coriifolia,2,0,2,Points-PointsKO-Adjacents,18
Carallia_eugenioidea,5,1,4,Points-PointsKO-Adjacents,45
Carallia_garciniifolia,13,3,10,Points-PointsKO-Adjacents,117
Carallia_hulstijnii,0,0,0,NA,0
Carallia_longipes,2,2,0,Points-PointsKO-Adjacents,18
Carallia_orophila,0,0,0,NA,0
Carallia_papuana,0,0,0,NA,0
Carallia_paucinervia,NA,NA,NA,NA,NA
Carallia_pectinifolia,28,15,13,Points-PointsKO-Adjacents,249
Carallia_suffruticosa,0,0,0,NA,0
Carapa_akuri,7,2,5,Points-PointsKO-Adjacents,54
Carapa_alticola,5,5,0,Points-PointsKO-Adjacents,42
Carapa_angustifolia,6,1,5,Points-PointsKO-Adjacents,45
Carapa_batesii,6,1,5,Points-PointsKO-Adjacents,43
Carapa_dinklagei,21,11,10,Points-PointsKO-Adjacents,124
Carapa_grandiflora,29,18,11,Points-PointsKO-Adjacents,142
Carapa_guianensis,820,674,146,Alphahull-PointsKO-Adjacents,49235
Carapa_hygrophila,7,2,5,Points-PointsKO-Adjacents,63
Carapa_longipetala,3,3,0,Points-PointsKO-Adjacents,27
Carapa_macrantha,29,12,17,Points-PointsKO-Adjacents,198
Carapa_megistocarpa,18,13,5,Points-PointsKO-Adjacents,129
Carapa_microcarpa,18,9,9,Points-PointsKO-Adjacents,120
Carapa_nicaraguensis,47,28,19,Alphahull-PointsKO-Adjacents,620
Carapa_parviflora,62,45,17,Alphahull-PointsKO-Adjacents,1581
Carapa_procera,146,0,146,Points-PointsKO-Adjacents,951
Carapa_surinamensis,14,0,14,Points-PointsKO-Adjacents,108
Carapa_vasquezii,26,12,14,Points-PointsKO-Adjacents,151
Carapa_velutina,21,12,9,Points-PointsKO-Adjacents,141
Carapichea_adinantha,87,48,39,Alphahull-PointsKO-Adjacents,2479
Carapichea_dolichophylla,96,51,45,Alphahull-PointsKO-Adjacents,8336
Carapichea_guianensis,57,37,20,Alphahull-PointsKO-Adjacents,1006
Carapichea_klugii,49,33,16,Alphahull-PointsKO-Adjacents,468
Carapichea_ligularis,48,26,22,Alphahull-PointsKO-Adjacents,964
Carapichea_maturacensis,13,9,4,Points-PointsKO-Adjacents,70
Carapichea_pacimonica,73,33,40,Alphahull-PointsKO-Adjacents,1485
Carapichea_tillettii,11,7,4,Points-PointsKO-Adjacents,34
Carapichea_verrucosa,9,1,8,Points-PointsKO-Adjacents,81
Cardenasiodendron_brachypterum,31,23,8,Alphahull-PointsKO-Adjacents,214
Cardiopetalum_calophyllum,469,403,66,Alphahull-PointsKO-Adjacents,26944
Cardiopetalum_plicatum,2,2,0,Points-PointsKO-Adjacents,18
Cardiopetalum_surinamense,27,19,8,Points-PointsKO-Adjacents,188
Cardwellia_sublimis,165,151,14,Alphahull-PointsKO-Adjacents,359
Careya_arborea,22,4,18,Points-PointsKO-Adjacents,170
Careya_herbacea,0,0,0,NA,0
Carica_aprica,6,0,6,Points-PointsKO-Adjacents,54
Carica_chilensis,16,7,9,Points-PointsKO-Adjacents,86
Carica_crassipetala,11,2,9,Points-PointsKO-Adjacents,62
Carica_papaya,918,0,918,Points-PointsKO-Adjacents,4330
Cariniana_domestica,260,202,58,Alphahull-PointsKO-Adjacents,20972
Cariniana_estrellensis,1057,938,119,Alphahull-PointsKO-Adjacents,29748
Cariniana_legalis,318,250,68,Alphahull-PointsKO-Adjacents,7111
Cariniana_micrantha,105,75,30,Alphahull-PointsKO-Adjacents,8038
Cariniana_parvifolia,7,0,7,Points-PointsKO-Adjacents,54
Cariniana_penduliflora,2,2,0,Points-PointsKO-Adjacents,18
Cariniana_pyriformis,74,57,17,Alphahull-PointsKO-Adjacents,2587
Cariniana_rubra,207,164,43,Alphahull-PointsKO-Adjacents,13220
Carissa_bispinosa,256,0,256,Points-PointsKO-Adjacents,2029
Carissa_boiviniana,98,73,25,Alphahull-PointsKO-Adjacents,4005
Carissa_carandas,2,2,0,Points-PointsKO-Adjacents,18
Carissa_haematocarpa,77,53,24,Alphahull-PointsKO-Adjacents,1392
Carissa_macrocarpa,43,7,36,Points-PointsKO-Adjacents,287
Carissa_spinarum,26,5,21,Points-PointsKO-Adjacents,211
Carmichaelia_arborea,456,424,32,Alphahull-PointsKO-Adjacents,1742
Carmichaelia_astonii,13,9,4,Points-PointsKO-Adjacents,61
Carmichaelia_australis,1642,1565,77,Alphahull-PointsKO-Adjacents,4276
Carmichaelia_kirkii,48,38,10,Alphahull-PointsKO-Adjacents,753
Carmichaelia_muritai,5,5,0,Points-PointsKO-Adjacents,29
Carmichaelia_stevensonii,16,8,8,Points-PointsKO-Adjacents,104
Carmichaelia_williamsii,26,7,19,Points-PointsKO-Adjacents,183
Carnarvonia_araliifolia,185,170,15,Alphahull-PointsKO-Adjacents,225
Carnegiea_gigantea,2115,1978,137,Alphahull-PointsKO-Adjacents,3134
Carpentaria_acuminata,503,470,33,Alphahull-PointsKO-Adjacents,1875
Carphalea_angulata,19,9,10,Points-PointsKO-Adjacents,109
Carphalea_cloiselii,18,10,8,Points-PointsKO-Adjacents,103
Carphalea_kirondron,56,38,18,Alphahull-PointsKO-Adjacents,2806
Carphalea_madagascariensis,18,11,7,Points-PointsKO-Adjacents,91
Carphalea_pervilleana,41,22,19,Alphahull-PointsKO-Adjacents,1031
Carpinus_betulus,41549,33929,7620,Alphahull-PointsKO-Adjacents,61495
Carpinus_caroliniana,12688,11691,997,Alphahull-PointsKO-Adjacents,44793
Carpinus_chuniana,8,0,8,Points-PointsKO-Adjacents,72
Carpinus_cordata,504,392,112,Alphahull-PointsKO-Adjacents,6404
Carpinus_dayongiana,NA,NA,NA,NA,NA
Carpinus_faginea,2,1,1,Points-PointsKO-Adjacents,18
Carpinus_fangiana,21,8,13,Points-PointsKO-Adjacents,179
Carpinus_fargesiana,24,10,14,Points-PointsKO-Adjacents,215
Carpinus_firmifolia,1,1,0,Points-PointsKO-Adjacents,9
Carpinus_hebestroma,8,3,5,Points-PointsKO-Adjacents,20
Carpinus_henryana,12,0,12,Points-PointsKO-Adjacents,108
Carpinus_japonica,660,524,136,Alphahull-PointsKO-Adjacents,2162
Carpinus_kawakamii,133,123,10,Alphahull-PointsKO-Adjacents,244
Carpinus_kweichowensis,11,1,10,Points-PointsKO-Adjacents,95
Carpinus_laxiflora,610,450,160,Alphahull-PointsKO-Adjacents,4061
Carpinus_lipoensis,NA,NA,NA,NA,NA
Carpinus_londoniana,39,12,27,Points-PointsKO-Adjacents,345
Carpinus_luochengensis,NA,NA,NA,NA,NA
Carpinus_mengshanensis,NA,NA,NA,NA,NA
Carpinus_microphylla,1,1,0,Points-PointsKO-Adjacents,9
Carpinus_mollicoma,3,3,0,Points-PointsKO-Adjacents,27
Carpinus_monbeigiana,23,8,15,Points-PointsKO-Adjacents,138
Carpinus_omeiensis,4,4,0,Points-PointsKO-Adjacents,36
Carpinus_orientalis,244,208,36,Alphahull-PointsKO-Adjacents,3737
Carpinus_paohsingensis,4,4,0,Points-PointsKO-Adjacents,36
Carpinus_polyneura,23,2,21,Points-PointsKO-Adjacents,192
Carpinus_pubescens,37,17,20,Points-PointsKO-Adjacents,325
Carpinus_purpurinervis,1,1,0,Points-PointsKO-Adjacents,9
Carpinus_putoensis,2,0,2,Points-PointsKO-Adjacents,18
Carpinus_rankanensis,33,26,7,Alphahull-PointsKO-Adjacents,113
Carpinus_rupestris,2,2,0,Points-PointsKO-Adjacents,18
Carpinus_shensiensis,3,3,0,Points-PointsKO-Adjacents,25
Carpinus_shimenensis,NA,NA,NA,NA,NA
Carpinus_tientaiensis,1,1,0,Points-PointsKO-Adjacents,9
Carpinus_tropicalis,166,115,51,Alphahull-PointsKO-Adjacents,5528
Carpinus_tsaiana,3,3,0,Points-PointsKO-Adjacents,27
Carpinus_tschonoskii,547,339,208,Alphahull-PointsKO-Adjacents,3450
Carpinus_viminea,102,49,53,Alphahull-PointsKO-Adjacents,8182
Carpodetus_amplus,0,0,0,NA,0
Carpodetus_arboreus,55,34,21,Alphahull-PointsKO-Adjacents,501
Carpodetus_archboldianus,2,2,0,Points-PointsKO-Adjacents,12
Carpodetus_denticulatus,NA,NA,NA,NA,NA
Carpodetus_flexuosus,0,0,0,NA,0
Carpodetus_fuscus,1,1,0,Points-PointsKO-Adjacents,9
Carpodetus_grandiflorus,3,3,0,Points-PointsKO-Adjacents,27
Carpodetus_major,48,30,18,Alphahull-PointsKO-Adjacents,154
Carpodetus_montanus,4,4,0,Points-PointsKO-Adjacents,15
Carpodetus_pullei,0,0,0,NA,0
Carpodetus_serratus,8545,8454,91,Alphahull-PointsKO-Adjacents,4541
Carpodiptera_africana,13,0,13,Points-PointsKO-Adjacents,108
Carpodiptera_cubensis,79,48,31,Alphahull-PointsKO-Adjacents,405
Carpodiptera_hexaptera,3,3,0,Points-PointsKO-Adjacents,25
Carpodiptera_mirabilis,3,3,0,Points-PointsKO-Adjacents,21
Carpodiptera_simonis,0,0,0,NA,0
Carpolobia_alba,295,230,65,Alphahull-PointsKO-Adjacents,7994
Carpolobia_gabonica,7,5,2,Points-PointsKO-Adjacents,51
Carpolobia_goetzei,59,19,40,Points-PointsKO-Adjacents,391
Carpolobia_gossweileri,27,16,11,Points-PointsKO-Adjacents,142
Carpolobia_lutea,303,257,46,Alphahull-PointsKO-Adjacents,4462
Carpotroche_amazonica,25,8,17,Points-PointsKO-Adjacents,201
Carpotroche_brasiliensis,370,0,370,Points-PointsKO-Adjacents,1983
Carpotroche_crispidentata,79,57,22,Alphahull-PointsKO-Adjacents,1006
Carpotroche_grandiflora,66,41,25,Alphahull-PointsKO-Adjacents,5054
Carpotroche_integrifolia,11,0,11,Points-PointsKO-Adjacents,75
Carpotroche_longifolia,510,441,69,Alphahull-PointsKO-Adjacents,30551
Carpotroche_pacifica,35,15,20,Points-PointsKO-Adjacents,248
Carpotroche_platyptera,309,270,39,Alphahull-PointsKO-Adjacents,2381
Carpotroche_ramosii,7,1,6,Points-PointsKO-Adjacents,51
Carpotroche_surinamensis,87,64,23,Alphahull-PointsKO-Adjacents,2461
Carpoxylon_macrospermum,0,0,0,NA,0
Carrierea_calycina,20,3,17,Points-PointsKO-Adjacents,179
Carrierea_dunniana,4,4,0,Points-PointsKO-Adjacents,36
Carrierea_rehderiana,4,4,0,Points-PointsKO-Adjacents,36
Carrierea_vieillardii,0,0,0,NA,0
Carvalhoa_campanulata,18,9,9,Points-PointsKO-Adjacents,89
Carvalhoa_macrophylla,0,0,0,NA,0
Carya_alba,16146,15396,750,Alphahull-PointsKO-Adjacents,35159
Carya_aquatica,1521,1375,146,Alphahull-PointsKO-Adjacents,15059
Carya_cathayensis,1,0,1,Points-PointsKO-Adjacents,9
Carya_cordiformis,7556,6762,794,Alphahull-PointsKO-Adjacents,42407
Carya_floridana,56,31,25,Alphahull-PointsKO-Adjacents,562
Carya_glabra,15070,14287,783,Alphahull-PointsKO-Adjacents,35939
Carya_hunanensis,2,2,0,Points-PointsKO-Adjacents,18
Carya_illinoinensis,2425,1974,451,Alphahull-PointsKO-Adjacents,38158
Carya_kweichowensis,1,1,0,Points-PointsKO-Adjacents,9
Carya_laciniosa,979,782,197,Alphahull-PointsKO-Adjacents,22879
Carya_myristiciformis,181,126,55,Alphahull-PointsKO-Adjacents,4560
Carya_ovata,10027,9092,935,Alphahull-PointsKO-Adjacents,40729
Carya_pallida,718,638,80,Alphahull-PointsKO-Adjacents,11858
Carya_palmeri,52,34,18,Alphahull-PointsKO-Adjacents,870
Carya_poilanei,0,0,0,NA,0
Carya_sinensis,10,1,9,Points-PointsKO-Adjacents,90
Carya_texana,6607,6424,183,Alphahull-PointsKO-Adjacents,13542
Carya_tonkinensis,6,0,6,Points-PointsKO-Adjacents,54
Caryocar_amygdaliferum,52,43,9,Alphahull-PointsKO-Adjacents,954
Caryocar_amygdaliforme,21,0,21,Points-PointsKO-Adjacents,185
Caryocar_brasiliense,670,605,65,Alphahull-PointsKO-Adjacents,29517
Caryocar_coriaceum,98,69,29,Alphahull-PointsKO-Adjacents,6359
Caryocar_costaricense,54,49,5,Alphahull-PointsKO-Adjacents,133
Caryocar_cuneatum,99,74,25,Alphahull-PointsKO-Adjacents,4437
Caryocar_dentatum,42,21,21,Alphahull-PointsKO-Adjacents,1296
Caryocar_edule,84,66,18,Alphahull-PointsKO-Adjacents,2006
Caryocar_glabrum,722,653,69,Alphahull-PointsKO-Adjacents,62675
Caryocar_gracile,78,54,24,Alphahull-PointsKO-Adjacents,3277
Caryocar_harlingii,18,7,11,Points-PointsKO-Adjacents,147
Caryocar_microcarpum,520,451,69,Alphahull-PointsKO-Adjacents,45492
Caryocar_montanum,19,8,11,Points-PointsKO-Adjacents,142
Caryocar_nuciferum,52,33,19,Alphahull-PointsKO-Adjacents,1983
Caryocar_pallidum,90,49,41,Alphahull-PointsKO-Adjacents,11724
Caryocar_villosum,238,181,57,Alphahull-PointsKO-Adjacents,29535
Caryodaphnopsis_baviensis,1,1,0,Points-PointsKO-Adjacents,9
Caryodaphnopsis_bilocellata,3,3,0,Points-PointsKO-Adjacents,27
Caryodaphnopsis_burgeri,36,27,9,Alphahull-PointsKO-Adjacents,245
Caryodaphnopsis_cogolloi,7,1,6,Points-PointsKO-Adjacents,32
Caryodaphnopsis_fieldii,1,1,0,Points-PointsKO-Adjacents,9
Caryodaphnopsis_fosteri,57,36,21,Alphahull-PointsKO-Adjacents,846
Caryodaphnopsis_henryi,3,2,1,Points-PointsKO-Adjacents,26
Caryodaphnopsis_inaequalis,5,4,1,Points-PointsKO-Adjacents,45
Caryodaphnopsis_laotica,0,0,0,NA,0
Caryodaphnopsis_latifolia,5,5,0,Points-PointsKO-Adjacents,45
Caryodaphnopsis_metallica,4,4,0,Points-PointsKO-Adjacents,27
Caryodaphnopsis_poilanei,0,0,0,NA,0
Caryodaphnopsis_theobromifolia,38,30,8,Alphahull-PointsKO-Adjacents,375
Caryodaphnopsis_tonkinensis,9,3,6,Points-PointsKO-Adjacents,71
Caryodendron_amazonicum,20,0,20,Points-PointsKO-Adjacents,150
Caryodendron_angustifolium,3,2,1,Points-PointsKO-Adjacents,24
Caryodendron_janeirense,36,17,19,Points-PointsKO-Adjacents,262
Caryodendron_orinocense,161,120,41,Alphahull-PointsKO-Adjacents,4614
Caryota_albertii,19,12,7,Points-PointsKO-Adjacents,74
Caryota_angustifolia,1,1,0,Points-PointsKO-Adjacents,9
Caryota_cumingii,1,1,0,Points-PointsKO-Adjacents,9
Caryota_kiriwongensis,1,1,0,Points-PointsKO-Adjacents,9
Caryota_maxima,22,4,18,Points-PointsKO-Adjacents,189
Caryota_mitis,49,7,42,Points-PointsKO-Adjacents,368
Caryota_no,10,2,8,Points-PointsKO-Adjacents,61
Caryota_obtusa,7,0,7,Points-PointsKO-Adjacents,57
Caryota_ophiopellis,1,1,0,Points-PointsKO-Adjacents,7
Caryota_rumphiana,35,10,25,Points-PointsKO-Adjacents,246
Caryota_sympetala,23,5,18,Points-PointsKO-Adjacents,172
Caryota_urens,14,0,14,Points-PointsKO-Adjacents,126
Caryota_zebrina,1,1,0,Points-PointsKO-Adjacents,9
Casasia_clusiifolia,22,10,12,Points-PointsKO-Adjacents,127
Casasia_haitiensis,8,3,5,Points-PointsKO-Adjacents,41
Casasia_longipes,1,1,0,Points-PointsKO-Adjacents,9
Casasia_samuelssonii,5,3,2,Points-PointsKO-Adjacents,39
Cascabela_gaumeri,424,369,55,Alphahull-PointsKO-Adjacents,2538
Cascabela_ovata,742,619,123,Alphahull-PointsKO-Adjacents,6388
Cascabela_pinifolia,31,18,13,Points-PointsKO-Adjacents,155
Cascabela_thevetia,376,205,171,Alphahull-PointsKO-Adjacents,14348
Cascabela_thevetioides,246,204,42,Alphahull-PointsKO-Adjacents,3805
Cascaronia_astragalina,26,0,26,Points-PointsKO-Adjacents,213
Casearia_aculeata,879,622,257,Alphahull-PointsKO-Adjacents,45744
Casearia_acuminata,28,0,28,Points-PointsKO-Adjacents,174
Casearia_albicans,0,0,0,NA,0
Casearia_andamanica,0,0,0,NA,0
Casearia_angustifolia,0,0,0,NA,0
Casearia_anisophylla,0,0,0,NA,0
Casearia_arborea,1450,1200,250,Alphahull-PointsKO-Adjacents,112502
Casearia_archboldiana,2,2,0,Points-PointsKO-Adjacents,18
Casearia_arguta,451,341,110,Alphahull-PointsKO-Adjacents,8070
Casearia_atlantica,12,9,3,Points-PointsKO-Adjacents,50
Casearia_auriculata,0,0,0,NA,0
Casearia_bahiensis,30,17,13,Points-PointsKO-Adjacents,172
Casearia_barteri,204,143,61,Alphahull-PointsKO-Adjacents,7025
Casearia_bartlettii,19,15,4,Points-PointsKO-Adjacents,106
Casearia_battiscombei,21,8,13,Points-PointsKO-Adjacents,151
Casearia_brassii,1,1,0,Points-PointsKO-Adjacents,9
Casearia_cajambrensis,17,4,13,Points-PointsKO-Adjacents,96
Casearia_calva,0,0,0,NA,0
Casearia_capitellata,9,3,6,Points-PointsKO-Adjacents,54
Casearia_catharinensis,9,4,5,Points-PointsKO-Adjacents,70
Casearia_cauliflora,0,0,0,NA,0
Casearia_clarkei,1,1,0,Points-PointsKO-Adjacents,9
Casearia_clutiifolia,51,24,27,Alphahull-PointsKO-Adjacents,902
Casearia_combaymensis,92,65,27,Alphahull-PointsKO-Adjacents,3569
Casearia_commersoniana,536,434,102,Alphahull-PointsKO-Adjacents,30460
Casearia_comocladifolia,7,0,7,Points-PointsKO-Adjacents,47
Casearia_congensis,12,1,11,Points-PointsKO-Adjacents,69
Casearia_coriacea,0,0,0,NA,0
Casearia_coriifolia,4,4,0,Points-PointsKO-Adjacents,24
Casearia_coronata,121,97,24,Alphahull-PointsKO-Adjacents,808
Casearia_corymbosa,1728,1543,185,Alphahull-PointsKO-Adjacents,19654
Casearia_crassinervis,7,5,2,Points-PointsKO-Adjacents,35
Casearia_cuspidata,1,1,0,Points-PointsKO-Adjacents,9
Casearia_dallachyi,134,116,18,Alphahull-PointsKO-Adjacents,410
Casearia_decandra,1090,868,222,Alphahull-PointsKO-Adjacents,51314
Casearia_deplanchei,8,2,6,Points-PointsKO-Adjacents,52
Casearia_dinklagei,0,0,0,NA,0
Casearia_duckeana,15,2,13,Points-PointsKO-Adjacents,105
Casearia_eichleriana,143,113,30,Alphahull-PointsKO-Adjacents,2151
Casearia_elegans,11,2,9,Points-PointsKO-Adjacents,79
Casearia_elliptifolia,1,1,0,Points-PointsKO-Adjacents,9
Casearia_emarginata,66,48,18,Alphahull-PointsKO-Adjacents,995
Casearia_engleri,16,10,6,Points-PointsKO-Adjacents,58
Casearia_erythrocarpa,10,0,10,Points-PointsKO-Adjacents,37
Casearia_fasciculata,134,102,32,Alphahull-PointsKO-Adjacents,5385
Casearia_flavovirens,1,1,0,Points-PointsKO-Adjacents,9
Casearia_flexicaulis,3,3,0,Points-PointsKO-Adjacents,14
Casearia_flexula,3,3,0,Points-PointsKO-Adjacents,21
Casearia_flexuosa,5,5,0,Points-PointsKO-Adjacents,45
Casearia_fuliginosa,5,5,0,Points-PointsKO-Adjacents,39
Calcearia_callifera,NA,NA,NA,NA,NA
Casearia_gigantifolia,0,0,0,NA,0
Casearia_glabra,16,9,7,Points-PointsKO-Adjacents,65
Casearia_globifera,0,0,0,NA,0
Casearia_glomerata,37,11,26,Points-PointsKO-Adjacents,327
Casearia_gossypiosperma,574,490,84,Alphahull-PointsKO-Adjacents,27376
Casearia_grandiflora,585,450,135,Alphahull-PointsKO-Adjacents,53166
Casearia_graveolens,22,0,22,Points-PointsKO-Adjacents,188
Casearia_grayi,21,16,5,Points-PointsKO-Adjacents,36
Casearia_grewiifolia,85,24,61,Alphahull-PointsKO-Adjacents,501
Casearia_guevarana,1,1,0,Points-PointsKO-Adjacents,7
Casearia_guianensis,221,114,107,Alphahull-PointsKO-Adjacents,3767
Casearia_guineensis,NA,NA,NA,NA,NA
Casearia_halmaherensis,4,4,0,Points-PointsKO-Adjacents,27
Casearia_hirsuta,60,17,43,Points-PointsKO-Adjacents,393
Casearia_hirtella,3,3,0,Points-PointsKO-Adjacents,13
Casearia_hosei,12,5,7,Points-PointsKO-Adjacents,101
Casearia_ilicifolia,4,3,1,Points-PointsKO-Adjacents,30
Casearia_impressinervia,0,0,0,NA,0
Casearia_inaequalis,3,0,3,Points-PointsKO-Adjacents,27
Casearia_javitensis,918,773,145,Alphahull-PointsKO-Adjacents,81872
Casearia_kaalaensis,3,3,0,Points-PointsKO-Adjacents,8
Casearia_kostermansii,0,0,0,NA,0
Casearia_kurzii,5,0,5,Points-PointsKO-Adjacents,45
Casearia_lasiophylla,264,207,57,Alphahull-PointsKO-Adjacents,6533
Casearia_ledermannii,0,0,0,NA,0
Casearia_lobbiana,3,3,0,Points-PointsKO-Adjacents,27
Casearia_loheri,0,0,0,NA,0
Casearia_longifolia,1,1,0,Points-PointsKO-Adjacents,9
Casearia_lopeziana,2,2,0,Points-PointsKO-Adjacents,18
Casearia_luetzelburgii,36,15,21,Points-PointsKO-Adjacents,264
Casearia_macrocarpa,0,0,0,NA,0
Casearia_manausensis,14,0,14,Points-PointsKO-Adjacents,95
Casearia_mannii,1,1,0,Points-PointsKO-Adjacents,7
Casearia_mariquitensis,261,173,88,Alphahull-PointsKO-Adjacents,19451
Casearia_mauritiana,0,0,0,NA,0
Casearia_maynacarpa,25,10,15,Points-PointsKO-Adjacents,153
Casearia_megacarpa,17,9,8,Points-PointsKO-Adjacents,96
Casearia_melliodora,11,2,9,Points-PointsKO-Adjacents,90
Casearia_mexiae,8,5,3,Points-PointsKO-Adjacents,36
Casearia_michelsonii,4,4,0,Points-PointsKO-Adjacents,36
Casearia_mindanaensis,0,0,0,NA,0
Casearia_mollis,39,18,21,Points-PointsKO-Adjacents,333
Casearia_monticola,2,2,0,Points-PointsKO-Adjacents,18
Casearia_neblinae,2,2,0,Points-PointsKO-Adjacents,18
Casearia_negrensis,86,34,52,Alphahull-PointsKO-Adjacents,3095
Casearia_nigrescens,219,185,34,Alphahull-PointsKO-Adjacents,2032
Casearia_nigricans,14,7,7,Points-PointsKO-Adjacents,112
Casearia_nigricolor,8,1,7,Points-PointsKO-Adjacents,71
Casearia_nitida,4,4,0,Points-PointsKO-Adjacents,34
Casearia_novoguineensis,0,0,0,NA,0
Casearia_obliqua,311,252,59,Alphahull-PointsKO-Adjacents,8096
Casearia_oblongifolia,28,9,19,Points-PointsKO-Adjacents,227
Casearia_obovalis,99,63,36,Alphahull-PointsKO-Adjacents,6700
Casearia_olivacea,3,3,0,Points-PointsKO-Adjacents,27
Casearia_oreogenes,0,0,0,NA,0
Casearia_ovata,1,1,0,Points-PointsKO-Adjacents,9
Casearia_pachyphylla,19,10,9,Points-PointsKO-Adjacents,125
Casearia_pallida,1,1,0,Points-PointsKO-Adjacents,9
Casearia_paranaensis,8,2,6,Points-PointsKO-Adjacents,64
Casearia_parhamii,0,0,0,NA,0
Casearia_pauciflora,49,32,17,Alphahull-PointsKO-Adjacents,656
Casearia_phanerophlebia,0,0,0,NA,0
Casearia_philippinensis,0,0,0,NA,0
Casearia_pitumba,403,324,79,Alphahull-PointsKO-Adjacents,42892
Casearia_praecox,65,39,26,Alphahull-PointsKO-Adjacents,1513
Casearia_prismatocarpa,84,45,39,Alphahull-PointsKO-Adjacents,2134
Casearia_procera,0,0,0,NA,0
Casearia_prunifolia,100,87,13,Alphahull-PointsKO-Adjacents,4579
Casearia_pseudoglomerata,0,0,0,NA,0
Casearia_puberula,3,3,0,Points-PointsKO-Adjacents,22
Casearia_pubipes,0,0,0,NA,0
Casearia_quinduensis,10,6,4,Points-PointsKO-Adjacents,51
Casearia_resinifera,48,16,32,Points-PointsKO-Adjacents,369
Casearia_richii,0,0,0,NA,0
Casearia_ripicola,8,1,7,Points-PointsKO-Adjacents,66
Casearia_rubescens,1,0,1,Points-PointsKO-Adjacents,9
Casearia_rugulosa,38,21,17,Alphahull-PointsKO-Adjacents,728
Casearia_runssorica,16,5,11,Points-PointsKO-Adjacents,105
Casearia_rupestris,255,217,38,Alphahull-PointsKO-Adjacents,16075
Casearia_rusbyana,27,10,17,Points-PointsKO-Adjacents,207
Casearia_sanchezii,4,4,0,Points-PointsKO-Adjacents,12
Casearia_selloana,75,45,30,Alphahull-PointsKO-Adjacents,4473
Casearia_spinescens,61,37,24,Alphahull-PointsKO-Adjacents,1430
Casearia_spruceana,50,16,34,Points-PointsKO-Adjacents,359
Casearia_standleyana,29,24,5,Alphahull-PointsKO-Adjacents,86
Casearia_stapfiana,0,0,0,NA,0
Casearia_stenophylla,0,0,0,NA,0
Casearia_stipitata,26,6,20,Points-PointsKO-Adjacents,212
Casearia_sylvestris,4072,3611,461,Alphahull-PointsKO-Adjacents,159851
Casearia_tacanensis,66,45,21,Alphahull-PointsKO-Adjacents,780
Casearia_tachirensis,8,0,8,Points-PointsKO-Adjacents,72
Casearia_tardieuae,3,3,0,Points-PointsKO-Adjacents,27
Casearia_thwaitesii,5,5,0,Points-PointsKO-Adjacents,45
Casearia_tinifolia,0,0,0,NA,0
Casearia_tomentosa,7,0,7,Points-PointsKO-Adjacents,63
Casearia_tremula,180,127,53,Alphahull-PointsKO-Adjacents,1119
Casearia_trivalvis,1,1,0,Points-PointsKO-Adjacents,9
Casearia_tuberculata,5,0,5,Points-PointsKO-Adjacents,35
Casearia_uleana,32,0,32,Points-PointsKO-Adjacents,269
Casearia_ulmifolia,199,122,77,Alphahull-PointsKO-Adjacents,8433
Casearia_urophylla,0,0,0,NA,0
Casearia_vareca,4,4,0,Points-PointsKO-Adjacents,27
Casearia_velutina,48,25,23,Alphahull-PointsKO-Adjacents,1772
Casearia_velutinosa,2,2,0,Points-PointsKO-Adjacents,18
Casearia_williamsiana,3,3,0,Points-PointsKO-Adjacents,26
Casearia_wynadensis,0,0,0,NA,0
Casearia_zahlbruckneri,13,5,8,Points-PointsKO-Adjacents,69
Casearia_zizyphoides,56,24,32,Alphahull-PointsKO-Adjacents,910
Casimirella_beckii,5,5,0,Points-PointsKO-Adjacents,45
Casimiroa_edulis,359,285,74,Alphahull-PointsKO-Adjacents,7234
Casimiroa_emarginata,3,3,0,Points-PointsKO-Adjacents,27
Casimiroa_greggii,99,84,15,Alphahull-PointsKO-Adjacents,707
Casimiroa_pringlei,73,62,11,Alphahull-PointsKO-Adjacents,685
Casimiroa_sapota,90,38,52,Alphahull-PointsKO-Adjacents,2448
Casimiroa_tetrameria,113,81,32,Alphahull-PointsKO-Adjacents,1337
Cassia_abbreviata,112,68,44,Alphahull-PointsKO-Adjacents,14520
Cassia_afrofistula,65,28,37,Alphahull-PointsKO-Adjacents,676
Cassia_aldabrensis,0,0,0,NA,0
Cassia_angolensis,6,0,6,Points-PointsKO-Adjacents,54
Cassia_arereh,8,0,8,Points-PointsKO-Adjacents,63
Cassia_artensis,2,2,0,Points-PointsKO-Adjacents,16
Cassia_aubrevillei,2,2,0,Points-PointsKO-Adjacents,18
Cassia_brewsteri,269,232,37,Alphahull-PointsKO-Adjacents,3469
Cassia_burttii,8,2,6,Points-PointsKO-Adjacents,48
Cassia_circinnata,213,190,23,Alphahull-PointsKO-Adjacents,7723
Cassia_cowanii,32,16,16,Points-PointsKO-Adjacents,191
Cassia_eremophila,10,1,9,Points-PointsKO-Adjacents,84
Cassia_fastuosa,222,175,47,Alphahull-PointsKO-Adjacents,21898
Cassia_ferruginea,651,554,97,Alphahull-PointsKO-Adjacents,29611
Cassia_fikifiki,15,10,5,Points-PointsKO-Adjacents,92
Cassia_fistula,60,10,50,Points-PointsKO-Adjacents,486
Cassia_grandis,664,441,223,Alphahull-PointsKO-Adjacents,27486
Cassia_hintonii,28,12,16,Points-PointsKO-Adjacents,147
Cassia_hippophallus,31,17,14,Points-PointsKO-Adjacents,166
Cassia_javanica,27,11,16,Points-PointsKO-Adjacents,174
Cassia_leiandra,212,156,56,Alphahull-PointsKO-Adjacents,13841
Cassia_leptophylla,135,92,43,Alphahull-PointsKO-Adjacents,3675
Cassia_mannii,30,5,25,Points-PointsKO-Adjacents,217
Cassia_marksiana,86,75,11,Alphahull-PointsKO-Adjacents,96
Cassia_midas,7,2,5,Points-PointsKO-Adjacents,61
Cassia_moschata,315,229,86,Alphahull-PointsKO-Adjacents,15898
Cassia_nemophila,27,2,25,Points-PointsKO-Adjacents,207
Cassia_psilocarpa,NA,NA,NA,NA,NA
Cassia_queenslandica,29,0,29,Points-PointsKO-Adjacents,98
Cassia_roxburghii,1,0,1,Points-PointsKO-Adjacents,9
Cassia_rubriflora,23,14,9,Points-PointsKO-Adjacents,119
Cassia_sieberiana,414,377,37,Alphahull-PointsKO-Adjacents,16005
Cassia_spruceana,102,53,49,Alphahull-PointsKO-Adjacents,1961
Cassia_swartzioides,23,10,13,Points-PointsKO-Adjacents,189
Cassia_thyrsoidea,2,2,0,Points-PointsKO-Adjacents,18
Cassia_tomentella,115,91,24,Alphahull-PointsKO-Adjacents,1600
Cassine_albens,0,0,0,NA,0
Cassine_australis,286,0,286,Points-PointsKO-Adjacents,1062
Cassine_balae,NA,NA,NA,NA,NA
Cassine_brachycremastra,6,0,6,Points-PointsKO-Adjacents,47
Cassine_buchananii,43,11,32,Points-PointsKO-Adjacents,314
Cassine_congylos,2,2,0,Points-PointsKO-Adjacents,15
Cassine_cunninghamii,19,5,14,Points-PointsKO-Adjacents,92
Cassine_curtipendula,41,29,12,Alphahull-PointsKO-Adjacents,234
Cassine_ehrenbergii,6,1,5,Points-PointsKO-Adjacents,46
Cassine_fruticosa,NA,NA,NA,NA,NA
Cassine_glauca,5,0,5,Points-PointsKO-Adjacents,42
Cassine_humbertii,3,3,0,Points-PointsKO-Adjacents,18
Cassine_kamerunensis,5,4,1,Points-PointsKO-Adjacents,34
Cassine_kedarnathii,NA,NA,NA,NA,NA
Cassine_koordersii,0,0,0,NA,0
Cassine_lanceolata,2,2,0,Points-PointsKO-Adjacents,16
Cassine_laneana,0,0,0,NA,0
Cassine_matabelica,12,2,10,Points-PointsKO-Adjacents,99
Cassine_melanocarpa,235,179,56,Alphahull-PointsKO-Adjacents,2461
Cassine_nipensis,NA,NA,NA,NA,NA
Cassine_obiensis,0,0,0,NA,0
Cassine_orientalis,3,2,1,Points-PointsKO-Adjacents,23
Cassine_paniculata,0,0,0,NA,0
Cassine_parvifolia,14,3,11,Points-PointsKO-Adjacents,126
Cassine_peragua,111,80,31,Alphahull-PointsKO-Adjacents,1668
Cassine_pininsularis,6,1,5,Points-PointsKO-Adjacents,28
Cassine_schinoides,49,33,16,Alphahull-PointsKO-Adjacents,595
Cassine_schlechteriana,0,0,0,NA,0
Cassine_transvaalensis,78,55,23,Alphahull-PointsKO-Adjacents,2616
Cassine_viburnifolia,4,4,0,Points-PointsKO-Adjacents,28
Cassine_vitiensis,0,0,0,NA,0
Cassine_xylocarpa,76,32,44,Alphahull-PointsKO-Adjacents,4110
Cassinopsis_chapelieri,6,0,6,Points-PointsKO-Adjacents,52
Cassinopsis_ciliata,12,1,11,Points-PointsKO-Adjacents,89
Cassinopsis_ilicifolia,96,91,5,Alphahull-PointsKO-Adjacents,4652
Cassinopsis_madagascariensis,111,87,24,Alphahull-PointsKO-Adjacents,1578
Cassinopsis_tinifolia,29,13,16,Points-PointsKO-Adjacents,239
Cassinopsis_tomentosa,8,2,6,Points-PointsKO-Adjacents,42
Cassipourea_acuminata,3,3,0,Points-PointsKO-Adjacents,21
Cassipourea_adamauensis,0,0,0,NA,0
Cassipourea_afzelii,26,13,13,Points-PointsKO-Adjacents,166
Cassipourea_annobonensis,0,0,0,NA,0
Cassipourea_barteri,57,22,35,Alphahull-PointsKO-Adjacents,266
Cassipourea_brittoniana,0,0,0,NA,0
Cassipourea_calimensis,7,3,4,Points-PointsKO-Adjacents,42
Cassipourea_carringtoniana,6,0,6,Points-PointsKO-Adjacents,25
Cassipourea_celastroides,18,10,8,Points-PointsKO-Adjacents,133
Cassipourea_delphinensis,1,1,0,Points-PointsKO-Adjacents,9
Cassipourea_eketensis,0,0,0,NA,0
Cassipourea_ellipticifolia,2,2,0,Points-PointsKO-Adjacents,18
Cassipourea_euryoides,30,0,30,Points-PointsKO-Adjacents,147
Cassipourea_evrardii,3,3,0,Points-PointsKO-Adjacents,18
Cassipourea_fanshawei,0,0,0,NA,0
Cassipourea_firestoneana,1,1,0,Points-PointsKO-Adjacents,9
Cassipourea_flanaganii,12,3,9,Points-PointsKO-Adjacents,106
Cassipourea_floribunda,5,5,0,Points-PointsKO-Adjacents,42
Cassipourea_gossweileri,1,1,0,Points-PointsKO-Adjacents,9
Cassipourea_guianensis,1126,955,171,Alphahull-PointsKO-Adjacents,52922
Cassipourea_gummiflua,101,33,68,Alphahull-PointsKO-Adjacents,674
Cassipourea_hiotou,9,4,5,Points-PointsKO-Adjacents,64
Cassipourea_huillensis,0,0,0,NA,0
Cassipourea_insignis,NA,NA,NA,NA,NA
Cassipourea_killipii,14,8,6,Points-PointsKO-Adjacents,104
Cassipourea_korupensis,0,0,0,NA,0
Cassipourea_lanceolata,26,10,16,Points-PointsKO-Adjacents,168
Cassipourea_lasiocalyx,19,12,7,Points-PointsKO-Adjacents,101
Cassipourea_leptoclada,4,4,0,Points-PointsKO-Adjacents,32
Cassipourea_leptoneura,9,0,9,Points-PointsKO-Adjacents,46
Cassipourea_lescotiana,3,2,1,Points-PointsKO-Adjacents,27
Cassipourea_le-testui,4,4,0,Points-PointsKO-Adjacents,36
Cassipourea_louisii,6,0,6,Points-PointsKO-Adjacents,53
Cassipourea_madagascariensis,8,2,6,Points-PointsKO-Adjacents,42
Cassipourea_malosana,72,25,47,Alphahull-PointsKO-Adjacents,2486
Cassipourea_microcarpa,NA,NA,NA,NA,NA
Cassipourea_mollis,6,0,6,Points-PointsKO-Adjacents,52
Cassipourea_myriocarpa,3,3,0,Points-PointsKO-Adjacents,18
Cassipourea_ndambiana,4,4,0,Points-PointsKO-Adjacents,35
Cassipourea_ndando,21,13,8,Points-PointsKO-Adjacents,117
Cassipourea_nialatou,22,14,8,Points-PointsKO-Adjacents,152
Cassipourea_nodosa,0,0,0,NA,0
Cassipourea_obovata,1,1,0,Points-PointsKO-Adjacents,9
Cassipourea_obtusa,8,1,7,Points-PointsKO-Adjacents,40
Cassipourea_ovata,1,1,0,Points-PointsKO-Adjacents,7
Cassipourea_paludosa,4,4,0,Points-PointsKO-Adjacents,30
Cassipourea_peruviana,92,68,24,Alphahull-PointsKO-Adjacents,3124
Cassipourea_plumosa,3,3,0,Points-PointsKO-Adjacents,12
Cassipourea_pumila,2,2,0,Points-PointsKO-Adjacents,18
Cassipourea_rogersii,1,1,0,Points-PointsKO-Adjacents,9
Cassipourea_rotundifolia,1,1,0,Points-PointsKO-Adjacents,9
Cassipourea_ruwensorensis,61,41,20,Alphahull-PointsKO-Adjacents,1482
Cassipourea_salvago-raggei,0,0,0,NA,0
Cassipourea_schizocalyx,33,19,14,Points-PointsKO-Adjacents,203
Cassipourea_sessiliflora,0,0,0,NA,0
Cassipourea_spruceana,11,1,10,Points-PointsKO-Adjacents,84
Cassipourea_subcordata,1,1,0,Points-PointsKO-Adjacents,9
Cassipourea_subsessilis,1,1,0,Points-PointsKO-Adjacents,9
Cassipourea_swaziensis,4,4,0,Points-PointsKO-Adjacents,36
Cassipourea_vilhenae,0,0,0,NA,0
Cassipourea_zenkeri,8,4,4,Points-PointsKO-Adjacents,56
Castanea_crenata,591,360,231,Alphahull-PointsKO-Adjacents,4482
Castanea_dentata,2178,1903,275,Alphahull-PointsKO-Adjacents,28328
Castanea_henryi,152,104,48,Alphahull-PointsKO-Adjacents,13811
Castanea_mollissima,262,196,66,Alphahull-PointsKO-Adjacents,22782
Castanea_ozarkensis,54,41,13,Alphahull-PointsKO-Adjacents,819
Castanea_pumila,1117,931,186,Alphahull-PointsKO-Adjacents,17960
Castanea_sativa,123,78,45,Alphahull-PointsKO-Adjacents,2083
Castanea_seguinii,123,82,41,Alphahull-PointsKO-Adjacents,8126
Castanopsis_acuminatissima,351,259,92,Alphahull-PointsKO-Adjacents,10277
Castanopsis_amabilis,8,0,8,Points-PointsKO-Adjacents,72
Castanopsis_annamensis,2,2,0,Points-PointsKO-Adjacents,18
Castanopsis_argentea,4,1,3,Points-PointsKO-Adjacents,36
Castanopsis_argyrophylla,44,13,31,Points-PointsKO-Adjacents,365
Castanopsis_arietina,NA,NA,NA,NA,NA
Castanopsis_armata,13,0,13,Points-PointsKO-Adjacents,101
Castanopsis_birmanica,NA,NA,NA,NA,NA
Castanopsis_boisii,5,4,1,Points-PointsKO-Adjacents,45
Castanopsis_borneensis,0,0,0,NA,0
Castanopsis_brevispinula,8,2,6,Points-PointsKO-Adjacents,64
Castanopsis_buruana,22,8,14,Points-PointsKO-Adjacents,171
Castanopsis_calathiformis,39,0,39,Points-PointsKO-Adjacents,313
Castanopsis_cambodiana,4,4,0,Points-PointsKO-Adjacents,30
Castanopsis_carlesii,479,410,69,Alphahull-PointsKO-Adjacents,11806
Castanopsis_castanicarpa,1,1,0,Points-PointsKO-Adjacents,9
Castanopsis_catappifolia,0,0,0,NA,0
Castanopsis_ceratacantha,53,28,25,Alphahull-PointsKO-Adjacents,3664
Castanopsis_cerebrina,5,1,4,Points-PointsKO-Adjacents,26
Castanopsis_chapaensis,NA,NA,NA,NA,NA
Castanopsis_chevalieri,9,4,5,Points-PointsKO-Adjacents,46
Castanopsis_chinensis,46,25,21,Alphahull-PointsKO-Adjacents,2197
Castanopsis_choboensis,5,5,0,Points-PointsKO-Adjacents,45
Castanopsis_chunii,16,8,8,Points-PointsKO-Adjacents,144
Castanopsis_clarkei,2,2,0,Points-PointsKO-Adjacents,18
Castanopsis_clemensii,3,3,0,Points-PointsKO-Adjacents,18
Castanopsis_concinna,12,2,10,Points-PointsKO-Adjacents,104
Castanopsis_costata,14,3,11,Points-PointsKO-Adjacents,93
Castanopsis_crassifolia,6,2,4,Points-PointsKO-Adjacents,36
Castanopsis_cryptoneuron,0,0,0,NA,0
Castanopsis_curtisii,9,3,6,Points-PointsKO-Adjacents,67
Castanopsis_cuspidata,176,79,97,Alphahull-PointsKO-Adjacents,1910
Castanopsis_damingshanensis,1,1,0,Points-PointsKO-Adjacents,9
Castanopsis_delavayi,89,70,19,Alphahull-PointsKO-Adjacents,3293
Castanopsis_densinervia,2,2,0,Points-PointsKO-Adjacents,18
Castanopsis_densispinosa,1,1,0,Points-PointsKO-Adjacents,9
Castanopsis_diversifolia,20,9,11,Points-PointsKO-Adjacents,135
Castanopsis_dongchoensis,9,0,9,Points-PointsKO-Adjacents,64
Castanopsis_echinocarpa,43,29,14,Alphahull-PointsKO-Adjacents,794
Castanopsis_echinophora,0,0,0,NA,0
Castanopsis_endertii,1,1,0,Points-PointsKO-Adjacents,9
Castanopsis_evansii,6,0,6,Points-PointsKO-Adjacents,48
Castanopsis_eyrei,199,161,38,Alphahull-PointsKO-Adjacents,9615
Castanopsis_faberi,53,0,53,Points-PointsKO-Adjacents,215
Castanopsis_fargesii,209,171,38,Alphahull-PointsKO-Adjacents,12346
Castanopsis_ferox,61,25,36,Alphahull-PointsKO-Adjacents,2763
Castanopsis_fissa,155,0,155,Points-PointsKO-Adjacents,1172
Castanopsis_fleuryi,17,9,8,Points-PointsKO-Adjacents,138
Castanopsis_fordii,61,40,21,Alphahull-PointsKO-Adjacents,2070
Castanopsis_formosana,97,78,19,Alphahull-PointsKO-Adjacents,213
Castanopsis_foxworthyi,13,1,12,Points-PointsKO-Adjacents,78
Castanopsis_fulva,6,0,6,Points-PointsKO-Adjacents,54
Castanopsis_gamblei,0,0,0,NA,0
Castanopsis_glabra,0,0,0,NA,0
Castanopsis_glabrifolia,NA,NA,NA,NA,NA
Castanopsis_globigemmata,1,1,0,Points-PointsKO-Adjacents,9
Castanopsis_griffithii,NA,NA,NA,NA,NA
Castanopsis_guinieri,2,2,0,Points-PointsKO-Adjacents,18
Castanopsis_hainanensis,7,0,7,Points-PointsKO-Adjacents,52
Castanopsis_harmandii,0,0,0,NA,0
Castanopsis_hsiensiui,NA,NA,NA,NA,NA
Castanopsis_hupehensis,55,29,26,Alphahull-PointsKO-Adjacents,5884
Castanopsis_hypophoenicea,11,4,7,Points-PointsKO-Adjacents,86
Castanopsis_indica,132,93,39,Alphahull-PointsKO-Adjacents,3751
Castanopsis_inermis,18,4,14,Points-PointsKO-Adjacents,142
Castanopsis_javanica,22,0,22,Points-PointsKO-Adjacents,148
Castanopsis_jianfenglingensis,NA,NA,NA,NA,NA
Castanopsis_jinpingensis,NA,NA,NA,NA,NA
Castanopsis_johorensis,0,0,0,NA,0
Castanopsis_jucunda,49,32,17,Alphahull-PointsKO-Adjacents,2213
Castanopsis_kawakamii,80,61,19,Alphahull-PointsKO-Adjacents,1405
Castanopsis_kweichowensis,4,4,0,Points-PointsKO-Adjacents,36
Castanopsis_lamontii,61,39,22,Alphahull-PointsKO-Adjacents,2522
Castanopsis_lanceifolia,8,2,6,Points-PointsKO-Adjacents,54
Castanopsis_lecomtei,5,5,0,Points-PointsKO-Adjacents,41
Castanopsis_ledongensis,1,1,0,Points-PointsKO-Adjacents,9
Castanopsis_longipes,3,3,0,Points-PointsKO-Adjacents,12
Castanopsis_longipetiolata,4,4,0,Points-PointsKO-Adjacents,18
Castanopsis_longispina,NA,NA,NA,NA,NA
Castanopsis_lucida,9,0,9,Points-PointsKO-Adjacents,36
Castanopsis_malaccensis,1,1,0,Points-PointsKO-Adjacents,9
Castanopsis_malipoensis,NA,NA,NA,NA,NA
Castanopsis_megacarpa,11,3,8,Points-PointsKO-Adjacents,92
Castanopsis_mekongensis,6,0,6,Points-PointsKO-Adjacents,50
Castanopsis_microphylla,5,5,0,Points-PointsKO-Adjacents,36
Castanopsis_motleyana,13,6,7,Points-PointsKO-Adjacents,95
Castanopsis_namdinhensis,5,5,0,Points-PointsKO-Adjacents,45
Castanopsis_neocavaleriei,8,3,5,Points-PointsKO-Adjacents,72
Castanopsis_nephelioides,5,1,4,Points-PointsKO-Adjacents,39
Castanopsis_nhatrangensis,3,2,1,Points-PointsKO-Adjacents,27
Castanopsis_nigrescens,8,1,7,Points-PointsKO-Adjacents,72
Castanopsis_ninhhoensis,2,2,0,Points-PointsKO-Adjacents,12
Castanopsis_oblonga,NA,NA,NA,NA,NA
Castanopsis_oligoneura,0,0,0,NA,0
Castanopsis_orthacantha,59,45,14,Alphahull-PointsKO-Adjacents,1877
Castanopsis_ouonbiensis,1,1,0,Points-PointsKO-Adjacents,9
Castanopsis_oviformis,3,3,0,Points-PointsKO-Adjacents,25
Castanopsis_paucispina,1,1,0,Points-PointsKO-Adjacents,9
Castanopsis_pedunculata,1,1,0,Points-PointsKO-Adjacents,9
Castanopsis_philipensis,2,2,0,Points-PointsKO-Adjacents,18
Castanopsis_phuthoensis,NA,NA,NA,NA,NA
Castanopsis_pierrei,24,16,8,Points-PointsKO-Adjacents,139
Castanopsis_piriformis,62,43,19,Alphahull-PointsKO-Adjacents,2143
Castanopsis_platyacantha,33,17,16,Points-PointsKO-Adjacents,265
Castanopsis_poilanei,1,1,0,Points-PointsKO-Adjacents,9
Castanopsis_pseudohystrix,0,0,0,NA,0
Castanopsis_psilophylla,2,2,0,Points-PointsKO-Adjacents,12
Castanopsis_purpurea,2,2,0,Points-PointsKO-Adjacents,18
Castanopsis_purpurella,2,1,1,Points-PointsKO-Adjacents,18
Castanopsis_remotidenticulata,2,2,0,Points-PointsKO-Adjacents,18
Castanopsis_rhamnifolia,6,1,5,Points-PointsKO-Adjacents,47
Castanopsis_ridleyi,0,0,0,NA,0
Castanopsis_rockii,9,1,8,Points-PointsKO-Adjacents,73
Castanopsis_rufotomentosa,1,1,0,Points-PointsKO-Adjacents,9
Castanopsis_schefferiana,8,5,3,Points-PointsKO-Adjacents,57
Castanopsis_sclerophylla,107,73,34,Alphahull-PointsKO-Adjacents,5144
Castanopsis_scortechinii,1,1,0,Points-PointsKO-Adjacents,9
Castanopsis_selangorensis,NA,NA,NA,NA,NA
Castanopsis_semifabri,1,1,0,Points-PointsKO-Adjacents,9
Castanopsis_siamensis,NA,NA,NA,NA,NA
Castanopsis_sieboldii,312,146,166,Alphahull-PointsKO-Adjacents,2965
Castanopsis_subuliformis,NA,NA,NA,NA,NA
Castanopsis_symmetricupulata,NA,NA,NA,NA,NA
Castanopsis_tcheponensis,6,1,5,Points-PointsKO-Adjacents,45
Castanopsis_tessellata,7,0,7,Points-PointsKO-Adjacents,63
Castanopsis_thaiensis,NA,NA,NA,NA,NA
Castanopsis_tibetana,94,73,21,Alphahull-PointsKO-Adjacents,7753
Castanopsis_tonkinensis,28,16,12,Points-PointsKO-Adjacents,218
Castanopsis_torulosa,NA,NA,NA,NA,NA
Castanopsis_touranensis,NA,NA,NA,NA,NA
Castanopsis_tranninhensis,1,1,0,Points-PointsKO-Adjacents,9
Castanopsis_tribuloides,60,19,41,Points-PointsKO-Adjacents,435
Castanopsis_trinervis,0,0,0,NA,0
Castanopsis_tungurrut,7,0,7,Points-PointsKO-Adjacents,58
Castanopsis_undulatifolia,NA,NA,NA,NA,NA
Castanopsis_wallichii,4,3,1,Points-PointsKO-Adjacents,14
Castanopsis_wattii,8,2,6,Points-PointsKO-Adjacents,68
Castanopsis_wenchangensis,NA,NA,NA,NA,NA
Castanopsis_wilsonii,4,4,0,Points-PointsKO-Adjacents,21
Castanopsis_xichouensis,NA,NA,NA,NA,NA
Castanospermum_australe,245,193,52,Alphahull-PointsKO-Adjacents,1064
Castanospora_alphandi,213,186,27,Alphahull-PointsKO-Adjacents,464
Castela_calcicola,4,4,0,Points-PointsKO-Adjacents,31
Castela_coccinea,176,147,29,Alphahull-PointsKO-Adjacents,9601
Castela_depressa,0,0,0,NA,0
Castela_emoryi,98,86,12,Alphahull-PointsKO-Adjacents,1102
Castela_tortuosa,244,197,47,Alphahull-PointsKO-Adjacents,3765
Castela_tweediei,84,58,26,Alphahull-PointsKO-Adjacents,6739
Castellanosia_caineana,8,0,8,Points-PointsKO-Adjacents,70
Castilla_elastica,199,156,43,Alphahull-PointsKO-Adjacents,6286
Castilla_tunu,110,78,32,Alphahull-PointsKO-Adjacents,1064
Castilla_ulei,127,84,43,Alphahull-PointsKO-Adjacents,7496
Casuarina_collina,19,11,8,Points-PointsKO-Adjacents,107
Casuarina_cristata,1504,1471,33,Alphahull-PointsKO-Adjacents,12206
Casuarina_cunninghamiana,2456,2208,248,Alphahull-PointsKO-Adjacents,17442
Casuarina_equisetifolia,1173,659,514,Alphahull-PointsKO-Adjacents,18381
Casuarina_glauca,767,627,140,Alphahull-PointsKO-Adjacents,2271
Casuarina_grandis,4,4,0,Points-PointsKO-Adjacents,27
Casuarina_junghuhniana,4,4,0,Points-PointsKO-Adjacents,35
Casuarina_obesa,358,303,55,Alphahull-PointsKO-Adjacents,9384
Casuarina_oligodon,50,27,23,Alphahull-PointsKO-Adjacents,358
Casuarina_orophila,NA,NA,NA,NA,NA
Casuarina_pauper,1976,1930,46,Alphahull-PointsKO-Adjacents,19042
Casuarina_potamophila,0,0,0,NA,0
Casuarina_tenella,0,0,0,NA,0
Casuarina_teres,NA,NA,NA,NA,NA
Catalepidia_heyana,70,63,7,Alphahull-PointsKO-Adjacents,77
Catalpa_bignonioides,624,407,217,Alphahull-PointsKO-Adjacents,30092
Catalpa_brevipes,8,3,5,Points-PointsKO-Adjacents,54
Catalpa_bungei,28,2,26,Points-PointsKO-Adjacents,250
Catalpa_duclouxii,46,16,30,Points-PointsKO-Adjacents,384
Catalpa_fargesii,60,24,36,Alphahull-PointsKO-Adjacents,2052
Catalpa_longissima,47,32,15,Alphahull-PointsKO-Adjacents,416
Catalpa_macrocarpa,24,7,17,Points-PointsKO-Adjacents,149
Catalpa_ovata,71,33,38,Alphahull-PointsKO-Adjacents,11839
Catalpa_purpurea,6,0,6,Points-PointsKO-Adjacents,47
Catalpa_speciosa,850,564,286,Alphahull-PointsKO-Adjacents,33531
Catalpa_tibetica,1,1,0,Points-PointsKO-Adjacents,9
Catha_edulis,102,54,48,Alphahull-PointsKO-Adjacents,1055
Catha_transvaalensis,16,10,6,Points-PointsKO-Adjacents,118
Cathaya_argyrophylla,11,3,8,Points-PointsKO-Adjacents,72
Cathedra_acuminata,387,303,84,Alphahull-PointsKO-Adjacents,53335
Cathedra_bahiensis,44,16,28,Points-PointsKO-Adjacents,247
Cathedra_grandiflora,5,5,0,Points-PointsKO-Adjacents,43
Cathedra_paraensis,12,2,10,Points-PointsKO-Adjacents,108
Cathedra_rubricaulis,74,35,39,Alphahull-PointsKO-Adjacents,671
Cathormion_umbellatum,515,469,46,Alphahull-PointsKO-Adjacents,5861
Catophractes_alexandri,122,92,30,Alphahull-PointsKO-Adjacents,8043
Catostemma_albuquerquei,12,6,6,Points-PointsKO-Adjacents,79
Catostemma_altsonii,8,3,5,Points-PointsKO-Adjacents,72
Catostemma_cavalcantei,9,0,9,Points-PointsKO-Adjacents,78
Catostemma_commune,93,76,17,Alphahull-PointsKO-Adjacents,3941
Catostemma_digitata,22,15,7,Points-PointsKO-Adjacents,169
Catostemma_durifolius,4,4,0,Points-PointsKO-Adjacents,27
Catostemma_ebracteolatum,15,7,8,Points-PointsKO-Adjacents,121
Catostemma_fragrans,67,47,20,Alphahull-PointsKO-Adjacents,1548
Catostemma_grazielae,1,1,0,Points-PointsKO-Adjacents,9
Catostemma_hirsutulum,7,0,7,Points-PointsKO-Adjacents,54
Catostemma_lemense,4,4,0,Points-PointsKO-Adjacents,32
Catostemma_marahuacense,2,2,0,Points-PointsKO-Adjacents,16
Catostemma_milanezii,5,5,0,Points-PointsKO-Adjacents,39
Catostemma_sancarlosianum,9,4,5,Points-PointsKO-Adjacents,51
Catostemma_sclerophyllum,26,10,16,Points-PointsKO-Adjacents,208
Catunaregam_longispina,1,1,0,Points-PointsKO-Adjacents,9
Catunaregam_nilotica,28,9,19,Points-PointsKO-Adjacents,215
Catunaregam_nutans,1,1,0,Points-PointsKO-Adjacents,9
Catunaregam_obovata,25,14,11,Points-PointsKO-Adjacents,196
Catunaregam_oocarpa,2,2,0,Points-PointsKO-Adjacents,18
Catunaregam_spinosa,8,3,5,Points-PointsKO-Adjacents,50
Catunaregam_taylorii,79,35,44,Alphahull-PointsKO-Adjacents,2434
Caucanthus_auriculatus,45,22,23,Alphahull-PointsKO-Adjacents,523
Cavacoa_aurea,31,9,22,Points-PointsKO-Adjacents,219
Cavacoa_baldwinii,10,5,5,Points-PointsKO-Adjacents,51
Cavacoa_quintasii,10,3,7,Points-PointsKO-Adjacents,51
Cavanillesia_arborea,41,19,22,Points-PointsKO-Adjacents,300
Cavanillesia_chicamochae,5,1,4,Points-PointsKO-Adjacents,37
Cavanillesia_hylogeiton,96,65,31,Alphahull-PointsKO-Adjacents,10881
Cavanillesia_platanifolia,118,77,41,Alphahull-PointsKO-Adjacents,2604
Cavanillesia_umbellata,30,11,19,Points-PointsKO-Adjacents,223
Cavendishia_bracteata,2108,1972,136,Alphahull-PointsKO-Adjacents,13403
Cavendishia_guatapeensis,80,71,9,Alphahull-PointsKO-Adjacents,423
Cavendishia_pubescens,322,258,64,Alphahull-PointsKO-Adjacents,2687
Cavendishia_trujilloensis,2,2,0,Points-PointsKO-Adjacents,18
Ceanothus_arboreus,105,85,20,Alphahull-PointsKO-Adjacents,128
Ceanothus_caeruleus,345,291,54,Alphahull-PointsKO-Adjacents,7071
Ceanothus_impressus,70,48,22,Alphahull-PointsKO-Adjacents,158
Ceanothus_oliganthus,637,563,74,Alphahull-PointsKO-Adjacents,2450
Ceanothus_parvifolius,125,107,18,Alphahull-PointsKO-Adjacents,448
Ceanothus_spinosus,360,281,79,Alphahull-PointsKO-Adjacents,774
Ceanothus_thyrsiflorus,616,507,109,Alphahull-PointsKO-Adjacents,2833
Ceanothus_velutinus,1634,1557,77,Alphahull-PointsKO-Adjacents,23919
Cecropia_albicans,7,0,7,Points-PointsKO-Adjacents,61
Cecropia_andina,44,21,23,Alphahull-PointsKO-Adjacents,505
Cecropia_angustifolia,54,39,15,Alphahull-PointsKO-Adjacents,160
Cecropia_annulata,5,5,0,Points-PointsKO-Adjacents,39
Cecropia_bullata,25,14,11,Points-PointsKO-Adjacents,122
Cecropia_chlorostachya,2,2,0,Points-PointsKO-Adjacents,18
Cecropia_concolor,262,200,62,Alphahull-PointsKO-Adjacents,22506
Cecropia_david-smithii,NA,NA,NA,NA,NA
Cecropia_dealbata,0,0,0,NA,0
Cecropia_dentata,2,2,0,Points-PointsKO-Adjacents,18
Cecropia_distachya,278,190,88,Alphahull-PointsKO-Adjacents,34480
Cecropia_elongata,10,1,9,Points-PointsKO-Adjacents,81
Cecropia_engleriana,189,139,50,Alphahull-PointsKO-Adjacents,16526
Cecropia_ficifolia,358,308,50,Alphahull-PointsKO-Adjacents,33195
Cecropia_gabrielis,39,23,16,Alphahull-PointsKO-Adjacents,204
Cecropia_garciae,27,13,14,Points-PointsKO-Adjacents,182
Cecropia_glaziovii,636,551,85,Alphahull-PointsKO-Adjacents,9134
Cecropia_goudotiana,7,4,3,Points-PointsKO-Adjacents,45
Cecropia_granvilleana,5,5,0,Points-PointsKO-Adjacents,27
Cecropia_herthae,40,0,40,Points-PointsKO-Adjacents,294
Cecropia_heterochroma,34,21,13,Alphahull-PointsKO-Adjacents,166
Cecropia_hispidissima,84,60,24,Alphahull-PointsKO-Adjacents,1442
Cecropia_hololeuca,342,299,43,Alphahull-PointsKO-Adjacents,5158
Cecropia_idroboi,9,3,6,Points-PointsKO-Adjacents,60
Cecropia_insignis,177,142,35,Alphahull-PointsKO-Adjacents,3875
Cecropia_kavanayensis,47,34,13,Alphahull-PointsKO-Adjacents,1824
Cecropia_latiloba,460,391,69,Alphahull-PointsKO-Adjacents,61419
Cecropia_litoralis,38,29,9,Alphahull-PointsKO-Adjacents,1201
Cecropia_longipes,18,7,11,Points-PointsKO-Adjacents,124
Cecropia_marginalis,64,46,18,Alphahull-PointsKO-Adjacents,943
Cecropia_maxima,10,5,5,Points-PointsKO-Adjacents,79
Cecropia_megastachya,11,7,4,Points-PointsKO-Adjacents,68
Cecropia_membranacea,388,323,65,Alphahull-PointsKO-Adjacents,26801
Cecropia_metensis,95,69,26,Alphahull-PointsKO-Adjacents,6559
Cecropia_montana,43,24,19,Alphahull-PointsKO-Adjacents,703
Cecropia_multisecta,5,2,3,Points-PointsKO-Adjacents,39
Cecropia_mutisiana,39,27,12,Alphahull-PointsKO-Adjacents,618
Cecropia_obtusa,159,120,39,Alphahull-PointsKO-Adjacents,11847
Cecropia_obtusifolia,640,551,89,Alphahull-PointsKO-Adjacents,11048
Cecropia_pachystachya,2053,1851,202,Alphahull-PointsKO-Adjacents,56796
Cecropia_palmata,306,208,98,Alphahull-PointsKO-Adjacents,22962
Cecropia_pastasana,9,1,8,Points-PointsKO-Adjacents,65
Cecropia_peltata,1202,1049,153,Alphahull-PointsKO-Adjacents,30325
Cecropia_pittieri,5,5,0,Points-PointsKO-Adjacents,2
Cecropia_plicata,18,7,11,Points-PointsKO-Adjacents,129
Cecropia_polystachya,182,146,36,Alphahull-PointsKO-Adjacents,10965
Cecropia_purpurascens,50,27,23,Alphahull-PointsKO-Adjacents,280
Cecropia_putumayonis,78,54,24,Alphahull-PointsKO-Adjacents,1623
Cecropia_radlkoferana,7,2,5,Points-PointsKO-Adjacents,53
Cecropia_reticulata,85,64,21,Alphahull-PointsKO-Adjacents,1825
Cecropia_sararensis,46,31,15,Alphahull-PointsKO-Adjacents,446
Cecropia_saxatilis,148,111,37,Alphahull-PointsKO-Adjacents,7144
Cecropia_schreberiana,106,64,42,Alphahull-PointsKO-Adjacents,907
Cecropia_sciadophylla,710,635,75,Alphahull-PointsKO-Adjacents,62882
Cecropia_silvae,10,0,10,Points-PointsKO-Adjacents,90
Cecropia_strigosa,70,47,23,Alphahull-PointsKO-Adjacents,2130
Cecropia_subintegra,6,0,6,Points-PointsKO-Adjacents,54
Cecropia_tacuna,57,38,19,Alphahull-PointsKO-Adjacents,721
Cecropia_telealba,19,13,6,Points-PointsKO-Adjacents,121
Cecropia_telenitida,144,109,35,Alphahull-PointsKO-Adjacents,3154
Cecropia_ulei,24,2,22,Points-PointsKO-Adjacents,194
Cecropia_utcubambana,40,22,18,Alphahull-PointsKO-Adjacents,615
Cecropia_velutinella,3,3,0,Points-PointsKO-Adjacents,25
Cecropia_virgusa,24,11,13,Points-PointsKO-Adjacents,171
Cedrela_angustifolia,150,95,55,Alphahull-PointsKO-Adjacents,2910
Cedrela_balansae,57,25,32,Alphahull-PointsKO-Adjacents,577
Cedrela_discolor,56,31,25,Alphahull-PointsKO-Adjacents,592
Cedrela_dugesii,79,56,23,Alphahull-PointsKO-Adjacents,1529
Cedrela_fissilis,1010,855,155,Alphahull-PointsKO-Adjacents,49665
Cedrela_kuelapensis,9,0,9,Points-PointsKO-Adjacents,69
Cedrela_longipetiolulata,9,0,9,Points-PointsKO-Adjacents,77
Cedrela_molinensis,3,3,0,Points-PointsKO-Adjacents,21
Cedrela_monroensis,5,4,1,Points-PointsKO-Adjacents,42
Cedrela_montana,245,189,56,Alphahull-PointsKO-Adjacents,3856
Cedrela_nebulosa,44,23,21,Alphahull-PointsKO-Adjacents,571
Cedrela_oaxacensis,59,38,21,Alphahull-PointsKO-Adjacents,968
Cedrela_odorata,1708,1386,322,Alphahull-PointsKO-Adjacents,65169
Cedrela_saltensis,56,26,30,Alphahull-PointsKO-Adjacents,478
Cedrela_salvadorensis,171,124,47,Alphahull-PointsKO-Adjacents,1890
Cedrela_tonduzii,106,0,106,Points-PointsKO-Adjacents,546
Cedrela_weberbaueri,9,2,7,Points-PointsKO-Adjacents,71
Cedrelinga_cateniformis,403,319,84,Alphahull-PointsKO-Adjacents,34558
Cedrelopsis_ambanjensis,3,3,0,Points-PointsKO-Adjacents,25
Cedrelopsis_gracilis,3,3,0,Points-PointsKO-Adjacents,26
Cedrelopsis_grevei,140,115,25,Alphahull-PointsKO-Adjacents,2786
Cedrelopsis_longibracteata,5,5,0,Points-PointsKO-Adjacents,32
Cedrelopsis_microfoliolata,31,16,15,Points-PointsKO-Adjacents,221
Cedrelopsis_procera,2,2,0,Points-PointsKO-Adjacents,9
Cedrelopsis_trivalvis,26,13,13,Points-PointsKO-Adjacents,165
Cedrus_atlantica,69,47,22,Alphahull-PointsKO-Adjacents,417
Cedrus_deodara,41,14,27,Points-PointsKO-Adjacents,318
Cedrus_libani,44,21,23,Alphahull-PointsKO-Adjacents,386
Ceiba_acuminata,130,102,28,Alphahull-PointsKO-Adjacents,4354
Ceiba_aesculifolia,857,751,106,Alphahull-PointsKO-Adjacents,12193
Ceiba_boliviana,121,91,30,Alphahull-PointsKO-Adjacents,1770
Ceiba_chodatii,101,74,27,Alphahull-PointsKO-Adjacents,6349
Ceiba_crispiflora,18,0,18,Points-PointsKO-Adjacents,146
Ceiba_erianthos,185,148,37,Alphahull-PointsKO-Adjacents,4752
Ceiba_glaziovii,289,259,30,Alphahull-PointsKO-Adjacents,6120
Ceiba_insignis,92,70,22,Alphahull-PointsKO-Adjacents,2524
Ceiba_jasminodora,39,27,12,Alphahull-PointsKO-Adjacents,605
Ceiba_lupuna,61,27,34,Alphahull-PointsKO-Adjacents,1744
Ceiba_pentandra,1144,859,285,Alphahull-PointsKO-Adjacents,71204
Ceiba_pubiflora,346,297,49,Alphahull-PointsKO-Adjacents,18072
Ceiba_rubriflora,17,10,7,Points-PointsKO-Adjacents,104
Ceiba_salmonea,9,2,7,Points-PointsKO-Adjacents,81
Ceiba_samauma,374,291,83,Alphahull-PointsKO-Adjacents,36370
Ceiba_schottii,121,96,25,Alphahull-PointsKO-Adjacents,1222
Ceiba_soluta,4,4,0,Points-PointsKO-Adjacents,36
Ceiba_speciosa,573,467,106,Alphahull-PointsKO-Adjacents,35908
Ceiba_trischistandra,80,64,16,Alphahull-PointsKO-Adjacents,476
Ceiba_ventricosa,88,61,27,Alphahull-PointsKO-Adjacents,3335
Celianella_montana,12,5,7,Points-PointsKO-Adjacents,74
Celosia_floribunda,80,62,18,Alphahull-PointsKO-Adjacents,415
Celosia_monosperma,78,55,23,Alphahull-PointsKO-Adjacents,249
Celtis_adolfi-friderici,73,44,29,Alphahull-PointsKO-Adjacents,1644
Celtis_affinis,0,0,0,NA,0
Celtis_africana,432,288,144,Alphahull-PointsKO-Adjacents,27228
Celtis_australis,3335,2613,722,Alphahull-PointsKO-Adjacents,21556
Celtis_balansae,1,1,0,Points-PointsKO-Adjacents,9
Celtis_bequaertii,8,4,4,Points-PointsKO-Adjacents,24
Celtis_berteroana,12,2,10,Points-PointsKO-Adjacents,97
Celtis_bifida,21,1,20,Points-PointsKO-Adjacents,163
Celtis_biondii,185,118,67,Alphahull-PointsKO-Adjacents,18283
Celtis_boninensis,12,0,12,Points-PointsKO-Adjacents,51
Celtis_brasiliensis,1003,882,121,Alphahull-PointsKO-Adjacents,46531
Celtis_bungeana,63,13,50,Points-PointsKO-Adjacents,564
Celtis_caudata,453,400,53,Alphahull-PointsKO-Adjacents,6749
Celtis_cerasifera,4,4,0,Points-PointsKO-Adjacents,18
Celtis_chekiangensis,6,1,5,Points-PointsKO-Adjacents,54
Celtis_chichape,234,190,44,Alphahull-PointsKO-Adjacents,15545
Celtis_choseniana,87,59,28,Alphahull-PointsKO-Adjacents,696
Celtis_conferta,15,7,8,Points-PointsKO-Adjacents,74
Celtis_dubia,8,4,4,Points-PointsKO-Adjacents,24
Celtis_edulis,84,57,27,Alphahull-PointsKO-Adjacents,1004
Celtis_gomphophylla,135,50,85,Alphahull-PointsKO-Adjacents,3967
Celtis_harperi,3,3,0,Points-PointsKO-Adjacents,8
Celtis_hildebrandii,16,7,9,Points-PointsKO-Adjacents,56
Celtis_hypoleuca,7,1,6,Points-PointsKO-Adjacents,51
Celtis_iguanaea,4315,3869,446,Alphahull-PointsKO-Adjacents,145541
Celtis_ituriensis,3,3,0,Points-PointsKO-Adjacents,18
Celtis_jamaicensis,0,0,0,NA,0
Celtis_jessoensis,190,143,47,Alphahull-PointsKO-Adjacents,1501
Celtis_julianae,23,5,18,Points-PointsKO-Adjacents,207
Celtis_koraiensis,14,0,14,Points-PointsKO-Adjacents,124
Celtis_laevigata,6048,5448,600,Alphahull-PointsKO-Adjacents,70296
Celtis_latifolia,50,21,29,Alphahull-PointsKO-Adjacents,787
Celtis_lindheimeri,7,1,6,Points-PointsKO-Adjacents,63
Celtis_loxensis,27,16,11,Points-PointsKO-Adjacents,225
Celtis_luzonica,1,1,0,Points-PointsKO-Adjacents,9
Celtis_madagascariensis,20,7,13,Points-PointsKO-Adjacents,120
Celtis_mildbraedii,247,179,68,Alphahull-PointsKO-Adjacents,5590
Celtis_occidentalis,7831,6716,1115,Alphahull-PointsKO-Adjacents,58815
Celtis_orthocanthos,NA,NA,NA,NA,NA
Celtis_pacifica,9,0,9,Points-PointsKO-Adjacents,32
Celtis_pallida,908,774,134,Alphahull-PointsKO-Adjacents,22456
Celtis_paniculata,357,0,357,Points-PointsKO-Adjacents,1473
Celtis_petenensis,0,0,0,NA,0
Celtis_philippensis,1330,1124,206,Alphahull-PointsKO-Adjacents,16999
Celtis_planchoniana,13,7,6,Points-PointsKO-Adjacents,78
Celtis_prantlii,308,193,115,Alphahull-PointsKO-Adjacents,6823
Celtis_rigescens,22,8,14,Points-PointsKO-Adjacents,157
Celtis_rubrovenia,3,3,0,Points-PointsKO-Adjacents,27
Celtis_salomonensis,NA,NA,NA,NA,NA
Celtis_schippii,451,389,62,Alphahull-PointsKO-Adjacents,17470
Celtis_sinensis,398,214,184,Alphahull-PointsKO-Adjacents,1639
Celtis_solenostigma,NA,NA,NA,NA,NA
Celtis_tala,21,3,18,Points-PointsKO-Adjacents,169
Celtis_tenuifolia,667,516,151,Alphahull-PointsKO-Adjacents,23370
Celtis_tessmannii,140,111,29,Alphahull-PointsKO-Adjacents,5001
Celtis_tetrandra,303,224,79,Alphahull-PointsKO-Adjacents,10297
Celtis_tikalana,2,2,0,Points-PointsKO-Adjacents,18
Celtis_timorensis,42,16,26,Points-PointsKO-Adjacents,369
Celtis_toka,194,131,63,Alphahull-PointsKO-Adjacents,8021
Celtis_tournefortii,9,1,8,Points-PointsKO-Adjacents,47
Celtis_trinervia,81,40,41,Alphahull-PointsKO-Adjacents,1432
Celtis_tupalangi,NA,NA,NA,NA,NA
Celtis_vandervoetiana,14,1,13,Points-PointsKO-Adjacents,126
Celtis_vitiensis,1,1,0,Points-PointsKO-Adjacents,9
Celtis_zenkeri,422,344,78,Alphahull-PointsKO-Adjacents,10443
Cenocentrum_tonkinense,2,2,0,Points-PointsKO-Adjacents,18
Cenostigma_macrophyllum,696,655,41,Alphahull-PointsKO-Adjacents,24368
Cenostigma_tocantinum,108,78,30,Alphahull-PointsKO-Adjacents,7309
Centaurodendron_dracaenoides,3,3,0,Points-PointsKO-Adjacents,5
Centaurodendron_palmiforme,3,3,0,Points-PointsKO-Adjacents,5
Centrolobium_microchaete,146,95,51,Alphahull-PointsKO-Adjacents,4598
Centrolobium_ochroxylum,44,31,13,Alphahull-PointsKO-Adjacents,474
Centrolobium_paraense,109,72,37,Alphahull-PointsKO-Adjacents,4549
Centrolobium_robustum,56,24,32,Alphahull-PointsKO-Adjacents,1504
Centrolobium_sclerophyllum,155,122,33,Alphahull-PointsKO-Adjacents,5422
Centrolobium_tomentosum,350,289,61,Alphahull-PointsKO-Adjacents,16388
Centrolobium_yavizanum,20,12,8,Points-PointsKO-Adjacents,151
Centronia_brachycera,45,33,12,Alphahull-PointsKO-Adjacents,1235
Centronia_crassiramis,6,1,5,Points-PointsKO-Adjacents,39
Centronia_laurifolia,27,15,12,Points-PointsKO-Adjacents,192
Centronia_mutisii,16,9,7,Points-PointsKO-Adjacents,74
Centronia_neblinae,8,0,8,Points-PointsKO-Adjacents,47
Centronia_peruviana,16,8,8,Points-PointsKO-Adjacents,100
Centronia_reticulata,4,4,0,Points-PointsKO-Adjacents,23
Centroplacus_glaucinus,178,155,23,Alphahull-PointsKO-Adjacents,3501
Centropogon_knoxii,1,1,0,Points-PointsKO-Adjacents,9
Cephalanthus_angustifolius,4,4,0,Points-PointsKO-Adjacents,27
Cephalanthus_glabratus,115,83,32,Alphahull-PointsKO-Adjacents,7477
Cephalanthus_natalensis,79,57,22,Alphahull-PointsKO-Adjacents,886
Cephalanthus_salicifolius,205,148,57,Alphahull-PointsKO-Adjacents,9126
Cephalanthus_tetrandra,48,22,26,Alphahull-PointsKO-Adjacents,2410
Cephalocereus_apicicephalium,31,21,10,Alphahull-PointsKO-Adjacents,111
Cephalocereus_columna-trajani,24,19,5,Points-PointsKO-Adjacents,57
Cephalocereus_senilis,40,0,40,Points-PointsKO-Adjacents,80
Cephalocereus_totolapensis,31,21,10,Alphahull-PointsKO-Adjacents,111
Cephalocrotonopsis_socotranus,3,3,0,Points-PointsKO-Adjacents,11
Cephalohibiscus_peekelii,12,2,10,Points-PointsKO-Adjacents,83
Cephalomappa_beccariana,5,1,4,Points-PointsKO-Adjacents,37
Cephalomappa_lepidotula,3,1,2,Points-PointsKO-Adjacents,27
Cephalomappa_malloticarpa,17,2,15,Points-PointsKO-Adjacents,153
Cephalomappa_paludicola,1,1,0,Points-PointsKO-Adjacents,9
Cephalomappa_penangensis,1,1,0,Points-PointsKO-Adjacents,8
Cephalosphaera_usambarensis,20,8,12,Points-PointsKO-Adjacents,83
Cephalotaxus_fortunei,223,187,36,Alphahull-PointsKO-Adjacents,19264
Cephalotaxus_hainanensis,3,3,0,Points-PointsKO-Adjacents,27
Cephalotaxus_harringtonii,370,288,82,Alphahull-PointsKO-Adjacents,2615
Cephalotaxus_lanceolata,4,4,0,Points-PointsKO-Adjacents,18
Cephalotaxus_latifolia,16,3,13,Points-PointsKO-Adjacents,132
Cephalotaxus_mannii,40,9,31,Points-PointsKO-Adjacents,319
Cephalotaxus_oliveri,15,4,11,Points-PointsKO-Adjacents,122
Cephalotaxus_sinensis,220,162,58,Alphahull-PointsKO-Adjacents,13420
Cephalotomandra_fragrans,8,1,7,Points-PointsKO-Adjacents,54
Cephalotomandra_panamensis,0,0,0,NA,0
Ceraria_kuneneana,0,0,0,NA,0
Ceraria_namaquensis,43,34,9,Alphahull-PointsKO-Adjacents,260
Cerasus_dolichadenia,2,2,0,Points-PointsKO-Adjacents,18
Cerasus_jamasakura,401,250,151,Alphahull-PointsKO-Adjacents,2531
Cerasus_yaoiana,NA,NA,NA,NA,NA
Cerasus_yedoensis,7,0,7,Points-PointsKO-Adjacents,51
Ceratonia_oreothauma,5,5,0,Points-PointsKO-Adjacents,30
Ceratonia_siliqua,5522,4222,1300,Alphahull-PointsKO-Adjacents,9837
Ceratopetalum_apetalum,1641,0,1641,Points-PointsKO-Adjacents,1244
Ceratopetalum_corymbosum,16,9,7,Points-PointsKO-Adjacents,16
Ceratopetalum_gummiferum,1401,1068,333,Alphahull-PointsKO-Adjacents,1048
Ceratopetalum_hylandii,19,13,6,Points-PointsKO-Adjacents,30
Ceratopetalum_iugumense,15,12,3,Points-PointsKO-Adjacents,27
Ceratopetalum_macrophyllum,16,13,3,Points-PointsKO-Adjacents,22
Ceratopetalum_succirubrum,116,0,116,Points-PointsKO-Adjacents,308
Ceratopetalum_virchowii,57,49,8,Alphahull-PointsKO-Adjacents,33
Cerbera_dumicola,46,33,13,Alphahull-PointsKO-Adjacents,1271
Cerbera_floribunda,179,115,64,Alphahull-PointsKO-Adjacents,4694
Cerbera_inflata,70,53,17,Alphahull-PointsKO-Adjacents,164
Cerbera_laeta,0,0,0,NA,0
Cerbera_manghas,422,240,182,Alphahull-PointsKO-Adjacents,7396
Cerbera_odollam,40,0,40,Points-PointsKO-Adjacents,242
Cerberiopsis_candelabra,1,1,0,Points-PointsKO-Adjacents,8
Cerberiopsis_neriifolia,8,1,7,Points-PointsKO-Adjacents,45
Cerberiopsis_obtusifolia,2,2,0,Points-PointsKO-Adjacents,18
Cercidiphyllum_japonicum,212,146,66,Alphahull-PointsKO-Adjacents,2401
Cercidiphyllum_magnificum,52,41,11,Alphahull-PointsKO-Adjacents,302
Cercidium_andicola,29,17,12,Points-PointsKO-Adjacents,205
Cercidium_floridum,718,651,67,Alphahull-PointsKO-Adjacents,4232
Cercidium_microphyllum,561,531,30,Alphahull-PointsKO-Adjacents,3864
Cercidium_praecox,352,263,89,Alphahull-PointsKO-Adjacents,5427
Cercidium_texanum,56,40,16,Alphahull-PointsKO-Adjacents,1387
Cercis_canadensis,8200,7223,977,Alphahull-PointsKO-Adjacents,43167
Cercis_chinensis,57,29,28,Alphahull-PointsKO-Adjacents,7714
Cercis_chingii,4,4,0,Points-PointsKO-Adjacents,36
Cercis_chuniana,9,2,7,Points-PointsKO-Adjacents,81
Cercis_glabra,18,5,13,Points-PointsKO-Adjacents,162
Cercis_griffithii,5,5,0,Points-PointsKO-Adjacents,45
Cercis_racemosa,8,0,8,Points-PointsKO-Adjacents,70
Cercis_siliquastrum,847,572,275,Alphahull-PointsKO-Adjacents,9431
Cercocarpus_ledifolius,3038,2991,47,Alphahull-PointsKO-Adjacents,23157
Cercocarpus_macrophyllus,257,229,28,Alphahull-PointsKO-Adjacents,5369
Cercocarpus_montanus,3856,3599,257,Alphahull-PointsKO-Adjacents,32307
Cercocarpus_traskiae,20,12,8,Points-PointsKO-Adjacents,48
Cereus_albicaulis,35,23,12,Alphahull-PointsKO-Adjacents,1305
Cereus_cochabambensis,9,5,4,Points-PointsKO-Adjacents,77
Cereus_comarapanus,8,5,3,Points-PointsKO-Adjacents,69
Cereus_estevesii,1,1,0,Points-PointsKO-Adjacents,9
Cereus_fernambucensis,94,50,44,Alphahull-PointsKO-Adjacents,1187
Cereus_forbesii,6,0,6,Points-PointsKO-Adjacents,54
Cereus_fricii,0,0,0,NA,0
Cereus_grandicostatus,0,0,0,NA,0
Cereus_hankeanus,10,0,10,Points-PointsKO-Adjacents,86
Cereus_hertrichianus,NA,NA,NA,NA,NA
Cereus_hexagonus,42,0,42,Points-PointsKO-Adjacents,326
Cereus_hildmannianus,64,0,64,Points-PointsKO-Adjacents,534
Cereus_huilunchu,9,4,5,Points-PointsKO-Adjacents,77
Cereus_insularis,1,1,0,Points-PointsKO-Adjacents,3
Cereus_jamacaru,323,281,42,Alphahull-PointsKO-Adjacents,11379
Cereus_lamprospermus,1,1,0,Points-PointsKO-Adjacents,9
Cereus_mortensenii,0,0,0,NA,0
Cereus_nashii,0,0,0,NA,0
Cereus_portoricensis,8,3,5,Points-PointsKO-Adjacents,5
Cereus_repandus,7,0,7,Points-PointsKO-Adjacents,53
Cereus_stenogonus,65,46,19,Alphahull-PointsKO-Adjacents,2397
Cereus_tacuaralensis,33,21,12,Alphahull-PointsKO-Adjacents,772
Cereus_trigonodendron,0,0,0,NA,0
Cereus_vargasianus,0,0,0,NA,0
Ceriops_australis,461,328,133,Alphahull-PointsKO-Adjacents,6472
Ceriops_decandra,4,3,1,Points-PointsKO-Adjacents,36
Ceriops_pseudodecandra,103,61,42,Alphahull-PointsKO-Adjacents,612
Ceriops_tagal,673,459,214,Alphahull-PointsKO-Adjacents,8151
Ceriops_zippeliana,33,0,33,Points-PointsKO-Adjacents,228
Ceriscoides_campanulata,2,2,0,Points-PointsKO-Adjacents,12
Ceriscoides_curranii,0,0,0,NA,0
Ceriscoides_howii,2,2,0,Points-PointsKO-Adjacents,18
Ceriscoides_kerrii,0,0,0,NA,0
Ceriscoides_mamillata,0,0,0,NA,0
Ceriscoides_perakensis,1,1,0,Points-PointsKO-Adjacents,9
Ceriscoides_sessiliflora,0,0,0,NA,0
Ceriscoides_turgida,4,0,4,Points-PointsKO-Adjacents,36
Cerothamnus_pumilus,95,34,61,Alphahull-PointsKO-Adjacents,2483
Ceroxylon_alpinum,14,5,9,Points-PointsKO-Adjacents,75
Ceroxylon_amazonicum,9,1,8,Points-PointsKO-Adjacents,57
Ceroxylon_ceriferum,15,5,10,Points-PointsKO-Adjacents,96
Ceroxylon_echinulatum,14,7,7,Points-PointsKO-Adjacents,83
Ceroxylon_parvifrons,116,66,50,Alphahull-PointsKO-Adjacents,1216
Ceroxylon_parvum,3,3,0,Points-PointsKO-Adjacents,18
Ceroxylon_peruvianum,1,1,0,Points-PointsKO-Adjacents,9
Ceroxylon_pityrophyllum,39,0,39,Points-PointsKO-Adjacents,298
Ceroxylon_quindiuense,131,104,27,Alphahull-PointsKO-Adjacents,1348
Ceroxylon_sasaimae,4,1,3,Points-PointsKO-Adjacents,30
Ceroxylon_ventricosum,15,3,12,Points-PointsKO-Adjacents,113
Ceroxylon_vogelianum,155,124,31,Alphahull-PointsKO-Adjacents,2442
Cervantesia_bicolor,7,0,7,Points-PointsKO-Adjacents,62
Cervantesia_tomentosa,69,37,32,Alphahull-PointsKO-Adjacents,583
Cespedesia_spathulata,618,493,125,Alphahull-PointsKO-Adjacents,29930
Cestrum_acuminatissimum,53,0,53,Points-PointsKO-Adjacents,393
Cestrum_affine,85,62,23,Alphahull-PointsKO-Adjacents,1853
Cestrum_alternifolium,228,149,79,Alphahull-PointsKO-Adjacents,10974
Cestrum_anagyris,231,195,36,Alphahull-PointsKO-Adjacents,3749
Cestrum_aurantiacum,517,449,68,Alphahull-PointsKO-Adjacents,5101
Cestrum_axillare,861,712,149,Alphahull-PointsKO-Adjacents,38223
Cestrum_bigibbosum,54,36,18,Alphahull-PointsKO-Adjacents,640
Cestrum_bracteatum,650,575,75,Alphahull-PointsKO-Adjacents,11045
Cestrum_brunneopurpureum,0,0,0,NA,0
Cestrum_cahosianum,0,0,0,NA,0
Cestrum_capsulare,33,0,33,Points-PointsKO-Adjacents,248
Cestrum_chimborazinum,0,0,0,NA,0
Cestrum_coelophlebium,37,31,6,Alphahull-PointsKO-Adjacents,183
Cestrum_colombianum,0,0,0,NA,0
Cestrum_conglomeratum,84,59,25,Alphahull-PointsKO-Adjacents,556
Cestrum_corcovadense,36,0,36,Points-PointsKO-Adjacents,211
Cestrum_coriaceum,8,2,6,Points-PointsKO-Adjacents,59
Cestrum_cuneifolium,27,22,5,Alphahull-PointsKO-Adjacents,350
Cestrum_cuspidatum,74,0,74,Points-PointsKO-Adjacents,543
Cestrum_daphnoides,10,3,7,Points-PointsKO-Adjacents,57
Cestrum_darcyanum,18,8,10,Points-PointsKO-Adjacents,118
Cestrum_dependens,9,3,6,Points-PointsKO-Adjacents,64
Cestrum_dielsii,8,2,6,Points-PointsKO-Adjacents,63
Cestrum_diurnum,44,17,27,Points-PointsKO-Adjacents,209
Cestrum_diversifolium,15,0,15,Points-PointsKO-Adjacents,116
Cestrum_ecuadorense,0,0,0,NA,0
Cestrum_ehrenbergii,83,70,13,Alphahull-PointsKO-Adjacents,1914
Cestrum_euanthes,86,51,35,Alphahull-PointsKO-Adjacents,4837
Cestrum_flavinervium,3,2,1,Points-PointsKO-Adjacents,27
Cestrum_fulvescens,42,27,15,Alphahull-PointsKO-Adjacents,600
Cestrum_glabrescens,5,5,0,Points-PointsKO-Adjacents,39
Cestrum_glanduliferum,155,89,66,Alphahull-PointsKO-Adjacents,2861
Cestrum_glaucophyllum,2,2,0,Points-PointsKO-Adjacents,18
Cestrum_glomeratum,7,1,6,Points-PointsKO-Adjacents,63
Cestrum_guatemalense,15,8,7,Points-PointsKO-Adjacents,83
Cestrum_hirtellum,6,1,5,Points-PointsKO-Adjacents,53
Cestrum_hirtum,5,4,1,Points-PointsKO-Adjacents,34
Cestrum_humboldtii,200,150,50,Alphahull-PointsKO-Adjacents,3044
Cestrum_imbricatum,2,2,0,Points-PointsKO-Adjacents,18
Cestrum_intermedium,481,433,48,Alphahull-PointsKO-Adjacents,8872
Cestrum_killipii,1,1,0,Points-PointsKO-Adjacents,9
Cestrum_kunthii,5,5,0,Points-PointsKO-Adjacents,35
Cestrum_laevifolium,13,7,6,Points-PointsKO-Adjacents,84
Cestrum_laevigatum,546,441,105,Alphahull-PointsKO-Adjacents,28552
Cestrum_lanceolatum,5,5,0,Points-PointsKO-Adjacents,45
Cestrum_latifolium,411,298,113,Alphahull-PointsKO-Adjacents,26689
Cestrum_laurifolium,52,23,29,Alphahull-PointsKO-Adjacents,240
Cestrum_lewisii,5,1,4,Points-PointsKO-Adjacents,36
Cestrum_lindenii,67,41,26,Alphahull-PointsKO-Adjacents,1058
Cestrum_longiflorum,22,17,5,Points-PointsKO-Adjacents,75
Cestrum_luteovirescens,55,39,16,Alphahull-PointsKO-Adjacents,465
Cestrum_macrophyllum,71,47,24,Alphahull-PointsKO-Adjacents,170
Cestrum_magnifolium,17,0,17,Points-PointsKO-Adjacents,82
Cestrum_mariquitense,602,436,166,Alphahull-PointsKO-Adjacents,27936
Cestrum_megalophyllum,372,287,85,Alphahull-PointsKO-Adjacents,8458
Cestrum_microcalyx,594,518,76,Alphahull-PointsKO-Adjacents,14470
Cestrum_mononeurum,6,1,5,Points-PointsKO-Adjacents,45
Cestrum_montanum,32,9,23,Points-PointsKO-Adjacents,245
Cestrum_mortonianum,2,2,0,Points-PointsKO-Adjacents,18
Cestrum_nocturnum,1153,907,246,Alphahull-PointsKO-Adjacents,14894
Cestrum_oblongifolium,165,146,19,Alphahull-PointsKO-Adjacents,2524
Cestrum_ochraceum,90,71,19,Alphahull-PointsKO-Adjacents,873
Cestrum_ovatolanceolatum,1,1,0,Points-PointsKO-Adjacents,9
Cestrum_pacayense,6,1,5,Points-PointsKO-Adjacents,50
Cestrum_parqui,1077,1,1076,Points-PointsKO-Adjacents,3964
Cestrum_petiolare,60,34,26,Alphahull-PointsKO-Adjacents,834
Cestrum_pittieri,19,8,11,Points-PointsKO-Adjacents,66
Cestrum_poasanum,72,58,14,Alphahull-PointsKO-Adjacents,135
Cestrum_potaliifolium,2,2,0,Points-PointsKO-Adjacents,18
Cestrum_pulverulentum,1,1,0,Points-PointsKO-Adjacents,9
Cestrum_racemosum,674,555,119,Alphahull-PointsKO-Adjacents,15906
Cestrum_reticulatum,1,1,0,Points-PointsKO-Adjacents,9
Cestrum_rugulosum,47,36,11,Alphahull-PointsKO-Adjacents,122
Cestrum_ruizteranianum,1,1,0,Points-PointsKO-Adjacents,9
Cestrum_salicifolium,9,1,8,Points-PointsKO-Adjacents,65
Cestrum_salzmannii,105,0,105,Points-PointsKO-Adjacents,529
Cestrum_scandens,77,30,47,Alphahull-PointsKO-Adjacents,1927
Cestrum_strigilatum,1126,945,181,Alphahull-PointsKO-Adjacents,53070
Cestrum_subpulverulentum,8,1,7,Points-PointsKO-Adjacents,66
Cestrum_taylorii,1,1,0,Points-PointsKO-Adjacents,9
Cestrum_tillettii,2,2,0,Points-PointsKO-Adjacents,9
Cestrum_tipocochense,3,3,0,Points-PointsKO-Adjacents,27
Cestrum_toledii,16,7,9,Points-PointsKO-Adjacents,117
Cestrum_tomentosum,738,573,165,Alphahull-PointsKO-Adjacents,9844
Cestrum_undulatum,7,1,6,Points-PointsKO-Adjacents,47
Cestrum_vestioides,2,2,0,Points-PointsKO-Adjacents,18
Cestrum_vestitum,37,29,8,Alphahull-PointsKO-Adjacents,192
Cestrum_viminale,9,1,8,Points-PointsKO-Adjacents,72
Ceuthocarpus_involucratus,8,5,3,Points-PointsKO-Adjacents,38
Ceuthostoma_palawanense,0,0,0,NA,0
Ceuthostoma_terminale,3,3,0,Points-PointsKO-Adjacents,22
Chadsia_flammea,119,97,22,Alphahull-PointsKO-Adjacents,2557
Chadsia_magnifica,0,0,0,NA,0
Chadsia_salicina,42,29,13,Alphahull-PointsKO-Adjacents,169
Chaenomeles_cathayensis,29,7,22,Points-PointsKO-Adjacents,261
Chaenomeles_japonica,187,84,103,Alphahull-PointsKO-Adjacents,508
Chaenomeles_sinensis,13,2,11,Points-PointsKO-Adjacents,114
Chaenomeles_thibetica,2,2,0,Points-PointsKO-Adjacents,18
Chaetachme_aristata,216,122,94,Alphahull-PointsKO-Adjacents,4570
Chaetocarpus_acutifolius,5,5,0,Points-PointsKO-Adjacents,27
Chaetocarpus_africanus,60,41,19,Alphahull-PointsKO-Adjacents,584
Chaetocarpus_castanocarpus,51,0,51,Points-PointsKO-Adjacents,394
Chaetocarpus_cordifolius,6,0,6,Points-PointsKO-Adjacents,50
Chaetocarpus_coriaceus,1,1,0,Points-PointsKO-Adjacents,9
Chaetocarpus_echinocarpus,387,315,72,Alphahull-PointsKO-Adjacents,29798
Chaetocarpus_ferrugineus,0,0,0,NA,0
Chaetocarpus_gabonensis,9,3,6,Points-PointsKO-Adjacents,52
Chaetocarpus_globosus,48,28,20,Alphahull-PointsKO-Adjacents,461
Chaetocarpus_myrsinites,284,200,84,Alphahull-PointsKO-Adjacents,4699
Chaetocarpus_pearcei,9,2,7,Points-PointsKO-Adjacents,73
Chaetocarpus_pubescens,1,1,0,Points-PointsKO-Adjacents,9
Chaetocarpus_rabaraba,11,8,3,Points-PointsKO-Adjacents,17
Chaetocarpus_schomburgkianus,257,205,52,Alphahull-PointsKO-Adjacents,25620
Chalepophyllum_guyanense,42,35,7,Alphahull-PointsKO-Adjacents,196
Chamaecrista_adiantifolia,157,110,47,Alphahull-PointsKO-Adjacents,8666
Chamaecrista_amabilis,14,8,6,Points-PointsKO-Adjacents,69
Chamaecrista_amorimii,7,4,3,Points-PointsKO-Adjacents,47
Chamaecrista_apoucouita,130,41,89,Alphahull-PointsKO-Adjacents,2050
Chamaecrista_aspidiifolia,11,2,9,Points-PointsKO-Adjacents,96
Chamaecrista_aspleniifolia,32,19,13,Points-PointsKO-Adjacents,229
Chamaecrista_auris-zerdae,3,3,0,Points-PointsKO-Adjacents,27
Chamaecrista_aurivilla,17,8,9,Points-PointsKO-Adjacents,107
Chamaecrista_bahiae,195,123,72,Alphahull-PointsKO-Adjacents,3287
Chamaecrista_boyanii,1,1,0,Points-PointsKO-Adjacents,9
Chamaecrista_brachystachya,358,311,47,Alphahull-PointsKO-Adjacents,5424
Chamaecrista_bracteolata,12,7,5,Points-PointsKO-Adjacents,73
Chamaecrista_bucherae,2,2,0,Points-PointsKO-Adjacents,18
Chamaecrista_celiae,9,0,9,Points-PointsKO-Adjacents,65
Chamaecrista_chaetostegia,15,4,11,Points-PointsKO-Adjacents,100
Chamaecrista_compitalis,12,4,8,Points-PointsKO-Adjacents,67
Chamaecrista_confertiformis,61,49,12,Alphahull-PointsKO-Adjacents,169
Chamaecrista_cytisoides,463,414,49,Alphahull-PointsKO-Adjacents,6906
Chamaecrista_decora,129,97,32,Alphahull-PointsKO-Adjacents,3131
Chamaecrista_dentata,34,25,9,Alphahull-PointsKO-Adjacents,127
Chamaecrista_desvauxii,1765,0,1765,Points-PointsKO-Adjacents,8420
Chamaecrista_duartei,68,47,21,Alphahull-PointsKO-Adjacents,843
Chamaecrista_dumalis,28,12,16,Points-PointsKO-Adjacents,229
Chamaecrista_eitenorum,127,85,42,Alphahull-PointsKO-Adjacents,8160
Chamaecrista_ensiformis,625,499,126,Alphahull-PointsKO-Adjacents,21996
Chamaecrista_flexuosa,1052,781,271,Alphahull-PointsKO-Adjacents,83845
Chamaecrista_fodinarum,6,1,5,Points-PointsKO-Adjacents,30
Chamaecrista_fulgida,4,4,0,Points-PointsKO-Adjacents,18
Chamaecrista_glandulosa,400,254,146,Alphahull-PointsKO-Adjacents,5790
Chamaecrista_glaziovii,8,1,7,Points-PointsKO-Adjacents,53
Chamaecrista_glischrodes,7,1,6,Points-PointsKO-Adjacents,45
Chamaecrista_greggii,211,184,27,Alphahull-PointsKO-Adjacents,2520
Chamaecrista_hatschbachii,3,3,0,Points-PointsKO-Adjacents,26
Chamaecrista_hedysaroides,55,0,55,Points-PointsKO-Adjacents,182
Chamaecrista_hymenaeifolia,27,12,15,Points-PointsKO-Adjacents,195
Chamaecrista_katangensis,12,5,7,Points-PointsKO-Adjacents,75
Chamaecrista_lentiscifolia,2,2,0,Points-PointsKO-Adjacents,18
Chamaecrista_machaeriifolia,63,42,21,Alphahull-PointsKO-Adjacents,600
Chamaecrista_mindanaensis,NA,NA,NA,NA,NA
Chamaecrista_multiseta,115,69,46,Alphahull-PointsKO-Adjacents,8680
Chamaecrista_negrensis,131,93,38,Alphahull-PointsKO-Adjacents,8651
Chamaecrista_nuda,2,2,0,Points-PointsKO-Adjacents,12
Chamaecrista_onusta,15,6,9,Points-PointsKO-Adjacents,71
Chamaecrista_orbiculata,314,280,34,Alphahull-PointsKO-Adjacents,8499
Chamaecrista_orenocensis,31,15,16,Points-PointsKO-Adjacents,194
Chamaecrista_paniculata,25,8,17,Points-PointsKO-Adjacents,153
Chamaecrista_phyllostachya,13,5,8,Points-PointsKO-Adjacents,92
Chamaecrista_pilicarpa,5,5,0,Points-PointsKO-Adjacents,33
Chamaecrista_polystachya,17,8,9,Points-PointsKO-Adjacents,126
Chamaecrista_pteropoda,2,2,0,Points-PointsKO-Adjacents,18
Chamaecrista_scleroxylon,32,13,19,Points-PointsKO-Adjacents,266
Chamaecrista_sincorana,35,28,7,Alphahull-PointsKO-Adjacents,87
Chamaecrista_spinulosa,7,0,7,Points-PointsKO-Adjacents,46
Chamaecrista_subpeltata,6,2,4,Points-PointsKO-Adjacents,54
Chamaecrista_ulmea,7,2,5,Points-PointsKO-Adjacents,42
Chamaecrista_xinguensis,48,23,25,Alphahull-PointsKO-Adjacents,3571
Chamaecrista_zygophylloides,287,260,27,Alphahull-PointsKO-Adjacents,9049
Chamaecyparis_formosensis,125,119,6,Alphahull-PointsKO-Adjacents,168
Chamaecyparis_lawsoniana,399,330,69,Alphahull-PointsKO-Adjacents,1938
Chamaecyparis_obtusa,486,306,180,Alphahull-PointsKO-Adjacents,2947
Chamaecyparis_pisifera,207,73,134,Alphahull-PointsKO-Adjacents,1309
Chamaecyparis_thyoides,782,1,781,Points-PointsKO-Adjacents,2548
Chamaedorea_alternans,18,12,6,Points-PointsKO-Adjacents,85
Chamaedorea_angustisecta,159,135,24,Alphahull-PointsKO-Adjacents,4769
Chamaedorea_arenbergiana,49,0,49,Points-PointsKO-Adjacents,364
Chamaedorea_carchensis,8,3,5,Points-PointsKO-Adjacents,68
Chamaedorea_christinae,4,4,0,Points-PointsKO-Adjacents,35
Chamaedorea_deckeriana,117,99,18,Alphahull-PointsKO-Adjacents,671
Chamaedorea_elatior,166,135,31,Alphahull-PointsKO-Adjacents,1092
Chamaedorea_falcifera,2,2,0,Points-PointsKO-Adjacents,18
Chamaedorea_foveata,3,3,0,Points-PointsKO-Adjacents,27
Chamaedorea_fractiflexa,2,2,0,Points-PointsKO-Adjacents,18
Chamaedorea_fragrans,20,9,11,Points-PointsKO-Adjacents,149
Chamaedorea_glaucifolia,35,21,14,Alphahull-PointsKO-Adjacents,123
Chamaedorea_keelerorum,4,4,0,Points-PointsKO-Adjacents,36
Chamaedorea_klotzschiana,16,0,16,Points-PointsKO-Adjacents,63
Chamaedorea_linearis,440,378,62,Alphahull-PointsKO-Adjacents,7851
Chamaedorea_neurochlamys,103,83,20,Alphahull-PointsKO-Adjacents,1682
Chamaedorea_oblongata,321,267,54,Alphahull-PointsKO-Adjacents,3309
Chamaedorea_pinnatifrons,2103,1970,133,Alphahull-PointsKO-Adjacents,37129
Chamaedorea_plumosa,2,0,2,Points-PointsKO-Adjacents,12
Chamaedorea_pochutlensis,66,43,23,Alphahull-PointsKO-Adjacents,416
Chamaedorea_sartorii,37,18,19,Points-PointsKO-Adjacents,211
Chamaedorea_seifrizii,209,191,18,Alphahull-PointsKO-Adjacents,2165
Chamaedorea_tepejilote,484,418,66,Alphahull-PointsKO-Adjacents,6596
Chamaedorea_woodsoniana,93,52,41,Alphahull-PointsKO-Adjacents,846
Chamaefistula_toroana,0,0,0,NA,0
Chamaemeles_coriacea,1,1,0,Points-PointsKO-Adjacents,6
Chamaerops_humilis,5755,4629,1126,Alphahull-PointsKO-Adjacents,6217
Chambeyronia_lepidota,7,3,4,Points-PointsKO-Adjacents,12
Chambeyronia_macrocarpa,25,15,10,Points-PointsKO-Adjacents,94
Chamguava_gentlei,42,28,14,Alphahull-PointsKO-Adjacents,298
Chamguava_musarum,3,3,0,Points-PointsKO-Adjacents,27
Chamguava_schippii,28,13,15,Points-PointsKO-Adjacents,175
Champereia_manillana,181,135,46,Alphahull-PointsKO-Adjacents,500
Changiostyrax_dolichocarpus,1,1,0,Points-PointsKO-Adjacents,9
Chapelieria_madagascariensis,44,26,18,Alphahull-PointsKO-Adjacents,1963
Chapmannia_gracilis,9,5,4,Points-PointsKO-Adjacents,23
Charpentiera_australis,2,2,0,Points-PointsKO-Adjacents,3
Charpentiera_densiflora,3,3,0,Points-PointsKO-Adjacents,9
Charpentiera_elliptica,7,0,7,Points-PointsKO-Adjacents,21
Charpentiera_obovata,13,5,8,Points-PointsKO-Adjacents,76
Charpentiera_ovata,8,3,5,Points-PointsKO-Adjacents,39
Charpentiera_tomentosa,8,1,7,Points-PointsKO-Adjacents,47
Chascotheca_neopeltandra,17,2,15,Points-PointsKO-Adjacents,130
Chassalia_albiflora,38,29,9,Alphahull-PointsKO-Adjacents,133
Chassalia_androrangensis,7,3,4,Points-PointsKO-Adjacents,56
Chassalia_bojeri,107,88,19,Alphahull-PointsKO-Adjacents,1275
Chassalia_boryana,1,1,0,Points-PointsKO-Adjacents,9
Chassalia_catatii,26,12,14,Points-PointsKO-Adjacents,150
Chassalia_chartacea,9,0,9,Points-PointsKO-Adjacents,69
Chassalia_comorensis,5,5,0,Points-PointsKO-Adjacents,24
Chassalia_corallioides,0,0,0,NA,0
Chassalia_coriacea,1,1,0,Points-PointsKO-Adjacents,9
Chassalia_coursii,3,3,0,Points-PointsKO-Adjacents,27
Chassalia_curviflora,64,0,64,Points-PointsKO-Adjacents,535
Chassalia_discolor,81,67,14,Alphahull-PointsKO-Adjacents,504
Chassalia_eurybotrya,5,0,5,Points-PointsKO-Adjacents,30
Chassalia_gaertneroides,2,2,0,Points-PointsKO-Adjacents,16
Chassalia_grandifolia,1,1,0,Points-PointsKO-Adjacents,9
Chassalia_grandistipula,8,3,5,Points-PointsKO-Adjacents,42
Chassalia_kenyensis,21,10,11,Points-PointsKO-Adjacents,105
Chassalia_lukwangulensis,3,3,0,Points-PointsKO-Adjacents,14
Chassalia_lushaiensis,0,0,0,NA,0
Chassalia_magnifolia,20,13,7,Points-PointsKO-Adjacents,110
Chassalia_moramangensis,16,6,10,Points-PointsKO-Adjacents,78
Chassalia_parvifolia,70,53,17,Alphahull-PointsKO-Adjacents,898
Chassalia_stenantha,21,13,8,Points-PointsKO-Adjacents,133
Chassalia_subochreata,63,32,31,Alphahull-PointsKO-Adjacents,478
Chassalia_ternifolia,50,31,19,Alphahull-PointsKO-Adjacents,210
Chassalia_tsaratanensis,6,1,5,Points-PointsKO-Adjacents,38
Chassalia_umbraticola,134,111,23,Alphahull-PointsKO-Adjacents,2214
Chaunochiton_angustifolium,154,127,27,Alphahull-PointsKO-Adjacents,12685
Chaunochiton_kappleri,227,154,73,Alphahull-PointsKO-Adjacents,23275
Chaunochiton_loranthoides,61,42,19,Alphahull-PointsKO-Adjacents,4485
Chazaliella_abrupta,124,85,39,Alphahull-PointsKO-Adjacents,1840
Chazaliella_coffeosperma,59,38,21,Alphahull-PointsKO-Adjacents,1397
Chazaliella_oddonii,50,32,18,Alphahull-PointsKO-Adjacents,2130
Cheiloclinium_anomalum,47,8,39,Points-PointsKO-Adjacents,415
Cheiloclinium_cognatum,1858,1714,144,Alphahull-PointsKO-Adjacents,116289
Cheiloclinium_obtusum,13,3,10,Points-PointsKO-Adjacents,99
Cheilosa_montana,2,2,0,Points-PointsKO-Adjacents,18
Cheirodendron_bastardianum,8,1,7,Points-PointsKO-Adjacents,22
Cheirodendron_dominii,2,2,0,Points-PointsKO-Adjacents,14
Cheirodendron_fauriei,9,4,5,Points-PointsKO-Adjacents,28
Cheirodendron_forbesii,4,4,0,Points-PointsKO-Adjacents,19
Cheirodendron_platyphyllum,10,5,5,Points-PointsKO-Adjacents,22
Cheirodendron_trigynum,48,35,13,Alphahull-PointsKO-Adjacents,170
Chelyocarpus_chuco,32,23,9,Alphahull-PointsKO-Adjacents,717
Chelyocarpus_dianeurus,27,19,8,Points-PointsKO-Adjacents,89
Chelyocarpus_ulei,96,66,30,Alphahull-PointsKO-Adjacents,5460
Chengiopanax_fargesii,4,4,0,Points-PointsKO-Adjacents,36
Chengiopanax_sciadophylloides,278,210,68,Alphahull-PointsKO-Adjacents,2978
Chenopodium_nesodendron,1,1,0,Points-PointsKO-Adjacents,4
Chenopodium_oahuense,26,0,26,Points-PointsKO-Adjacents,129
Chiangiodendron_mexicanum,13,6,7,Points-PointsKO-Adjacents,74
Chidlowia_sanguinea,88,66,22,Alphahull-PointsKO-Adjacents,1180
Chieniodendron_hainanense,7,2,5,Points-PointsKO-Adjacents,54
Chilopsis_linearis,999,893,106,Alphahull-PointsKO-Adjacents,19503
Chimarrhis_barbata,42,13,29,Points-PointsKO-Adjacents,324
Chimarrhis_brevipes,9,3,6,Points-PointsKO-Adjacents,72
Chimarrhis_cubensis,5,5,0,Points-PointsKO-Adjacents,43
Chimarrhis_cymosa,42,15,27,Points-PointsKO-Adjacents,232
Chimarrhis_duckeana,21,7,14,Points-PointsKO-Adjacents,152
Chimarrhis_ekmanii,1,1,0,Points-PointsKO-Adjacents,9
Chimarrhis_gentryana,39,23,16,Alphahull-PointsKO-Adjacents,2685
Chimarrhis_glabriflora,169,132,37,Alphahull-PointsKO-Adjacents,11212
Chimarrhis_hookeri,127,98,29,Alphahull-PointsKO-Adjacents,4212
Chimarrhis_jamaicensis,3,3,0,Points-PointsKO-Adjacents,21
Chimarrhis_latifolia,48,35,13,Alphahull-PointsKO-Adjacents,165
Chimarrhis_microcarpa,58,35,23,Alphahull-PointsKO-Adjacents,3675
Chimarrhis_parviflora,115,92,23,Alphahull-PointsKO-Adjacents,1065
Chimarrhis_speciosa,6,1,5,Points-PointsKO-Adjacents,48
Chimarrhis_turbinata,152,0,152,Points-PointsKO-Adjacents,1098
Chimonanthus_grammatus,1,1,0,Points-PointsKO-Adjacents,9
Chimonanthus_nitens,22,4,18,Points-PointsKO-Adjacents,198
Chimonanthus_praecox,38,4,34,Points-PointsKO-Adjacents,326
Chiococca_alba,3108,0,3108,Points-PointsKO-Adjacents,12780
Chiococca_belizensis,179,132,47,Alphahull-PointsKO-Adjacents,3510
Chiococca_naiguatensis,2,2,0,Points-PointsKO-Adjacents,18
Chiococca_nitida,269,158,111,Alphahull-PointsKO-Adjacents,8150
Chiococca_pachyphylla,312,249,63,Alphahull-PointsKO-Adjacents,6375
Chiococca_petrina,17,9,8,Points-PointsKO-Adjacents,132
Chiococca_phaenostemon,156,116,40,Alphahull-PointsKO-Adjacents,1313
Chiococca_rubriflora,7,2,5,Points-PointsKO-Adjacents,61
Chiococca_semipilosa,87,66,21,Alphahull-PointsKO-Adjacents,1245
Chiococca_sessilifolia,28,18,10,Points-PointsKO-Adjacents,69
Chionanthus_acunae,NA,NA,NA,NA,NA
Chionanthus_adamsii,1,1,0,Points-PointsKO-Adjacents,9
Chionanthus_albidiflorus,0,0,0,NA,0
Chionanthus_amblirrhinus,2,2,0,Points-PointsKO-Adjacents,18
Chionanthus_avilensis,3,3,0,Points-PointsKO-Adjacents,18
Chionanthus_axillaris,133,111,22,Alphahull-PointsKO-Adjacents,392
Chionanthus_axilliflorus,5,1,4,Points-PointsKO-Adjacents,38
Chionanthus_bakeri,2,2,0,Points-PointsKO-Adjacents,18
Chionanthus_balgooyana,NA,NA,NA,NA,NA
Chionanthus_beccarii,NA,NA,NA,NA,NA
Chionanthus_boutonii,1,1,0,Points-PointsKO-Adjacents,9
Chionanthus_brachystachys,68,57,11,Alphahull-PointsKO-Adjacents,169
Chionanthus_brachythyrsus,2,2,0,Points-PointsKO-Adjacents,18
Chionanthus_brassii,17,7,10,Points-PointsKO-Adjacents,111
Chionanthus_bumelioides,9,0,9,Points-PointsKO-Adjacents,67
Chionanthus_calcicola,0,0,0,NA,0
Chionanthus_callophylloides,NA,NA,NA,NA,NA
Chionanthus_callophyllus,4,4,0,Points-PointsKO-Adjacents,36
Chionanthus_caudifolius,0,0,0,NA,0
Chionanthus_caymanensis,NA,NA,NA,NA,NA
Chionanthus_celebicus,7,3,4,Points-PointsKO-Adjacents,59
Chionanthus_clementis,NA,NA,NA,NA,NA
Chionanthus_colonchensis,1,1,0,Points-PointsKO-Adjacents,9
Chionanthus_compactus,104,47,57,Alphahull-PointsKO-Adjacents,491
Chionanthus_cordulatus,7,0,7,Points-PointsKO-Adjacents,62
Chionanthus_coriaceus,4,4,0,Points-PointsKO-Adjacents,35
Chionanthus_crassifolius,102,82,20,Alphahull-PointsKO-Adjacents,6113
Chionanthus_crispus,3,3,0,Points-PointsKO-Adjacents,26
Chionanthus_curvicarpus,20,0,20,Points-PointsKO-Adjacents,165
Chionanthus_cuspidatus,6,0,6,Points-PointsKO-Adjacents,49
Chionanthus_decipiens,0,0,0,NA,0
Chionanthus_densiflorus,0,0,0,NA,0
Chionanthus_dictyophyllus,1,1,0,Points-PointsKO-Adjacents,7
Chionanthus_diversifolius,NA,NA,NA,NA,NA
Chionanthus_domingensis,154,98,56,Alphahull-PointsKO-Adjacents,1675
Chionanthus_dussii,0,0,0,NA,0
Chionanthus_ellipticus,2,2,0,Points-PointsKO-Adjacents,18
Chionanthus_enerve,1,1,0,Points-PointsKO-Adjacents,9
Chionanthus_eriorachis,0,0,0,NA,0
Chionanthus_evenius,1,1,0,Points-PointsKO-Adjacents,9
Chionanthus_ferrugineus,28,15,13,Points-PointsKO-Adjacents,241
Chionanthus_filiformis,262,202,60,Alphahull-PointsKO-Adjacents,2819
Chionanthus_fluminensis,0,0,0,NA,0
Chionanthus_gigantifolius,NA,NA,NA,NA,NA
Chionanthus_gigas,2,2,0,Points-PointsKO-Adjacents,18
Chionanthus_globosus,0,0,0,NA,0
Chionanthus_glomeratus,NA,NA,NA,NA,NA
Chionanthus_grandifolius,1,1,0,Points-PointsKO-Adjacents,9
Chionanthus_greenii,5,5,0,Points-PointsKO-Adjacents,39
Chionanthus_guangxiensis,1,1,0,Points-PointsKO-Adjacents,9
Chionanthus_guianensis,0,0,0,NA,0
Chionanthus_hahlii,4,4,0,Points-PointsKO-Adjacents,25
Chionanthus_hainanensis,4,4,0,Points-PointsKO-Adjacents,27
Chionanthus_havilandii,NA,NA,NA,NA,NA
Chionanthus_henryae,NA,NA,NA,NA,NA
Chionanthus_henryanus,1,1,0,Points-PointsKO-Adjacents,9
Chionanthus_holdridgii,7,3,4,Points-PointsKO-Adjacents,22
Chionanthus_implicatus,57,21,36,Alphahull-PointsKO-Adjacents,2161
Chionanthus_jamaicensis,2,1,1,Points-PointsKO-Adjacents,18
Chionanthus_kajewskii,0,0,0,NA,0
Chionanthus_kinabaluensis,0,0,0,NA,0
Chionanthus_lancifolius,0,0,0,NA,0
Chionanthus_leopoldii,0,0,0,NA,0
Chionanthus_ligustrinus,43,25,18,Alphahull-PointsKO-Adjacents,670
Chionanthus_littoreus,NA,NA,NA,NA,NA
Chionanthus_longiflorus,2,2,0,Points-PointsKO-Adjacents,18
Chionanthus_longipetalus,2,2,0,Points-PointsKO-Adjacents,18
Chionanthus_lucens,2,2,0,Points-PointsKO-Adjacents,18
Chionanthus_luzonicus,0,0,0,NA,0
Chionanthus_macrocarpus,5,0,5,Points-PointsKO-Adjacents,45
Chionanthus_macrothyrsus,2,2,0,Points-PointsKO-Adjacents,18
Chionanthus_mala-elengi,10,0,10,Points-PointsKO-Adjacents,90
Chionanthus_maxwellii,0,0,0,NA,0
Chionanthus_micranthus,41,22,19,Alphahull-PointsKO-Adjacents,314
Chionanthus_microbotrys,3,3,0,Points-PointsKO-Adjacents,27
Chionanthus_microstigma,8,0,8,Points-PointsKO-Adjacents,57
Chionanthus_minutiflorus,NA,NA,NA,NA,NA
Chionanthus_montanus,1,1,0,Points-PointsKO-Adjacents,9
Chionanthus_nitens,0,0,0,NA,0
Chionanthus_nitidus,0,0,0,NA,0
Chionanthus_oblanceolatus,117,94,23,Alphahull-PointsKO-Adjacents,660
Chionanthus_oblongifolius,NA,NA,NA,NA,NA
Chionanthus_oliganthus,0,0,0,NA,0
Chionanthus_pachyphyllus,5,5,0,Points-PointsKO-Adjacents,45
Chionanthus_palustris,1,1,0,Points-PointsKO-Adjacents,9
Chionanthus_panamensis,123,97,26,Alphahull-PointsKO-Adjacents,1350
Chionanthus_parkinsonii,0,0,0,NA,0
Chionanthus_pedunculatus,22,13,9,Points-PointsKO-Adjacents,87
Chionanthus_plurifloroides,NA,NA,NA,NA,NA
Chionanthus_pluriflorus,35,21,14,Alphahull-PointsKO-Adjacents,400
Chionanthus_polycephalus,0,0,0,NA,0
Chionanthus_polygamus,32,9,23,Points-PointsKO-Adjacents,252
Chionanthus_porcatus,9,3,6,Points-PointsKO-Adjacents,68
Chionanthus_proctorii,0,0,0,NA,0
Chionanthus_pubescens,22,11,11,Points-PointsKO-Adjacents,153
Chionanthus_pubicalyx,10,3,7,Points-PointsKO-Adjacents,80
Chionanthus_purpureus,1,1,0,Points-PointsKO-Adjacents,9
Chionanthus_pygmaeus,10,5,5,Points-PointsKO-Adjacents,61
Chionanthus_quadristamineus,14,0,14,Points-PointsKO-Adjacents,5
Chionanthus_ramiflorus,513,345,168,Alphahull-PointsKO-Adjacents,8402
Chionanthus_remotinervius,1,1,0,Points-PointsKO-Adjacents,9
Chionanthus_retusus,93,29,64,Alphahull-PointsKO-Adjacents,3377
Chionanthus_riparius,6,0,6,Points-PointsKO-Adjacents,35
Chionanthus_rostratus,0,0,0,NA,0
Chionanthus_rugosus,2,2,0,Points-PointsKO-Adjacents,18
Chionanthus_rupicolus,32,11,21,Points-PointsKO-Adjacents,191
Chionanthus_sabahensis,NA,NA,NA,NA,NA
Chionanthus_salicifolius,3,3,0,Points-PointsKO-Adjacents,21
Chionanthus_sessiliflorus,35,21,14,Alphahull-PointsKO-Adjacents,1037
Chionanthus_sleumeri,41,31,10,Alphahull-PointsKO-Adjacents,78
Chionanthus_spicatus,12,1,11,Points-PointsKO-Adjacents,108
Chionanthus_spiciferus,1,1,0,Points-PointsKO-Adjacents,9
Chionanthus_stenurus,1,1,0,Points-PointsKO-Adjacents,9
Chionanthus_subsessilis,11,2,9,Points-PointsKO-Adjacents,88
Chionanthus_sumatranus,0,0,0,NA,0
Chionanthus_sutepensis,0,0,0,NA,0
Chionanthus_tenuis,1,1,0,Points-PointsKO-Adjacents,9
Chionanthus_thorelii,10,1,9,Points-PointsKO-Adjacents,75
Chionanthus_timorensis,0,0,0,NA,0
Chionanthus_trichotomus,209,159,50,Alphahull-PointsKO-Adjacents,16984
Chionanthus_velutinus,0,0,0,NA,0
Chionanthus_verruculatus,NA,NA,NA,NA,NA
Chionanthus_verticillatus,9,2,7,Points-PointsKO-Adjacents,48
Chionanthus_virginicus,1012,806,206,Alphahull-PointsKO-Adjacents,20038
Chionanthus_vitiensis,3,3,0,Points-PointsKO-Adjacents,17
Chionanthus_wurdackii,4,4,0,Points-PointsKO-Adjacents,36
Chionanthus_zeylanicus,5,1,4,Points-PointsKO-Adjacents,44
Chionanthus_zollingerianus,NA,NA,NA,NA,NA
Chione_venosa,56,21,35,Alphahull-PointsKO-Adjacents,631
Chionothrix_somalensis,2,2,0,Points-PointsKO-Adjacents,18
Chiranthodendron_pentadactylon,191,163,28,Alphahull-PointsKO-Adjacents,1824
Chisocheton_aenigmaticus,0,0,0,NA,0
Chisocheton_amabilis,0,0,0,NA,0
Chisocheton_cauliflorus,0,0,0,NA,0
Chisocheton_ceramicus,51,21,30,Alphahull-PointsKO-Adjacents,1169
Chisocheton_cumingianus,42,16,26,Points-PointsKO-Adjacents,264
Chisocheton_curranii,0,0,0,NA,0
Chisocheton_diversifolius,2,2,0,Points-PointsKO-Adjacents,18
Chisocheton_dysoxylifolius,0,0,0,NA,0
Chisocheton_erythrocarpus,4,4,0,Points-PointsKO-Adjacents,36
Chisocheton_gliroides,1,1,0,Points-PointsKO-Adjacents,6
Chisocheton_granatum,2,2,0,Points-PointsKO-Adjacents,18
Chisocheton_grandiflorus,0,0,0,NA,0
Chisocheton_koordersii,2,2,0,Points-PointsKO-Adjacents,16
Chisocheton_lansiifolius,0,0,0,NA,0
Chisocheton_laosensis,1,1,0,Points-PointsKO-Adjacents,6
Chisocheton_lasiocarpus,3,3,0,Points-PointsKO-Adjacents,27
Chisocheton_lasiogynus,6,0,6,Points-PointsKO-Adjacents,54
Chisocheton_longistipitatus,56,37,19,Alphahull-PointsKO-Adjacents,215
Chisocheton_macranthus,2,2,0,Points-PointsKO-Adjacents,16
Chisocheton_macrophyllus,4,1,3,Points-PointsKO-Adjacents,36
Chisocheton_maxilla-pisticis,NA,NA,NA,NA,NA
Chisocheton_medusae,1,1,0,Points-PointsKO-Adjacents,9
Chisocheton_mendozai,0,0,0,NA,0
Chisocheton_montanus,3,3,0,Points-PointsKO-Adjacents,21
Chisocheton_novobritannicus,5,5,0,Points-PointsKO-Adjacents,36
Chisocheton_patens,23,3,20,Points-PointsKO-Adjacents,169
Chisocheton_pauciflorus,2,2,0,Points-PointsKO-Adjacents,18
Chisocheton_pellegrinianus,0,0,0,NA,0
Chisocheton_penduliflorus,2,1,1,Points-PointsKO-Adjacents,18
Chisocheton_pentandrus,28,0,28,Points-PointsKO-Adjacents,240
Chisocheton_perakensis,0,0,0,NA,0
Chisocheton_pilosus,0,0,0,NA,0
Chisocheton_pohlianus,1,1,0,Points-PointsKO-Adjacents,9
Chisocheton_polyandrus,2,2,0,Points-PointsKO-Adjacents,18
Chisocheton_rex,4,4,0,Points-PointsKO-Adjacents,28
Chisocheton_ruber,2,2,0,Points-PointsKO-Adjacents,14
Chisocheton_sapindinus,13,6,7,Points-PointsKO-Adjacents,56
Chisocheton_sarasinorum,NA,NA,NA,NA,NA
Chisocheton_sarawakanus,10,0,10,Points-PointsKO-Adjacents,90
Chisocheton_sayeri,33,14,19,Points-PointsKO-Adjacents,224
Chisocheton_schoddei,1,1,0,Points-PointsKO-Adjacents,9
Chisocheton_setosus,1,1,0,Points-PointsKO-Adjacents,9
Chisocheton_stellatus,0,0,0,NA,0
Chisocheton_tenuis,7,0,7,Points-PointsKO-Adjacents,57
Chisocheton_tomentosus,2,2,0,Points-PointsKO-Adjacents,18
Chisocheton_velutinus,NA,NA,NA,NA,NA
Chisocheton_vindictae,0,0,0,NA,0
Chisocheton_warburgii,1,1,0,Points-PointsKO-Adjacents,9
Chlorocardium_rodiei,39,28,11,Alphahull-PointsKO-Adjacents,246
Chlorocardium_venenosum,61,41,20,Alphahull-PointsKO-Adjacents,2163
Chlorocarpa_pentaschista,0,0,0,NA,0
Chloroleucon_acacioides,232,168,64,Alphahull-PointsKO-Adjacents,27458
Chloroleucon_chacoense,61,47,14,Alphahull-PointsKO-Adjacents,1320
Chloroleucon_dumosum,312,277,35,Alphahull-PointsKO-Adjacents,12053
Chloroleucon_eurycyclum,2,2,0,Points-PointsKO-Adjacents,18
Chloroleucon_extortum,42,22,20,Alphahull-PointsKO-Adjacents,506
Chloroleucon_foliolosum,556,1,555,Points-PointsKO-Adjacents,3757
Chloroleucon_guantanamense,1,1,0,Points-PointsKO-Adjacents,9
Chloroleucon_mangense,753,564,189,Alphahull-PointsKO-Adjacents,17727
Chloroleucon_tenuiflorum,264,187,77,Alphahull-PointsKO-Adjacents,15457
Chloroleucon_tortum,43,17,26,Points-PointsKO-Adjacents,237
Chloroxylon_faho,11,0,11,Points-PointsKO-Adjacents,65
Chloroxylon_falcatum,5,5,0,Points-PointsKO-Adjacents,34
Chloroxylon_swietenia,9,0,9,Points-PointsKO-Adjacents,81
Choerospondias_axillaris,124,70,54,Alphahull-PointsKO-Adjacents,10858
Chomelia_albicaulis,11,3,8,Points-PointsKO-Adjacents,96
Chomelia_apodantha,30,1,29,Points-PointsKO-Adjacents,181
Chomelia_barbata,24,6,18,Points-PointsKO-Adjacents,143
Chomelia_bella,34,19,15,Points-PointsKO-Adjacents,180
Chomelia_brachypoda,47,33,14,Alphahull-PointsKO-Adjacents,540
Chomelia_brasiliana,190,145,45,Alphahull-PointsKO-Adjacents,4755
Chomelia_breedlovei,3,3,0,Points-PointsKO-Adjacents,21
Chomelia_caurensis,10,5,5,Points-PointsKO-Adjacents,85
Chomelia_crassifolia,2,2,0,Points-PointsKO-Adjacents,18
Chomelia_delascioi,2,2,0,Points-PointsKO-Adjacents,18
Chomelia_ecuadorensis,9,5,4,Points-PointsKO-Adjacents,69
Chomelia_estrellana,20,8,12,Points-PointsKO-Adjacents,138
Chomelia_gracilis,0,0,0,NA,0
Chomelia_grandicarpa,4,3,1,Points-PointsKO-Adjacents,24
Chomelia_grandifolia,3,3,0,Points-PointsKO-Adjacents,27
Chomelia_hirsuta,7,1,6,Points-PointsKO-Adjacents,57
Chomelia_intercedens,21,0,21,Points-PointsKO-Adjacents,156
Chomelia_juruensis,2,2,0,Points-PointsKO-Adjacents,18
Chomelia_kirkbridei,7,2,5,Points-PointsKO-Adjacents,46
Chomelia_longiflora,1,1,0,Points-PointsKO-Adjacents,9
Chomelia_longituba,NA,NA,NA,NA,NA
Chomelia_malaneoides,163,93,70,Alphahull-PointsKO-Adjacents,18076
Chomelia_microloba,67,45,22,Alphahull-PointsKO-Adjacents,814
Chomelia_minutiflora,1,1,0,Points-PointsKO-Adjacents,9
Chomelia_monantha,2,2,0,Points-PointsKO-Adjacents,18
Chomelia_myrtifolia,NA,NA,NA,NA,NA
Chomelia_obtusa,959,836,123,Alphahull-PointsKO-Adjacents,47832
Chomelia_occidentalis,3,2,1,Points-PointsKO-Adjacents,27
Chomelia_oligantha,3,3,0,Points-PointsKO-Adjacents,27
Chomelia_paniculata,51,0,51,Points-PointsKO-Adjacents,369
Chomelia_parviflora,76,50,26,Alphahull-PointsKO-Adjacents,5108
Chomelia_parvifolia,62,40,22,Alphahull-PointsKO-Adjacents,642
Chomelia_pedunculosa,64,29,35,Alphahull-PointsKO-Adjacents,507
Chomelia_pohliana,456,0,456,Points-PointsKO-Adjacents,3120
Chomelia_polyantha,54,17,37,Points-PointsKO-Adjacents,448
Chomelia_pringlei,27,18,9,Points-PointsKO-Adjacents,104
Chomelia_pubescens,79,51,28,Alphahull-PointsKO-Adjacents,2141
Chomelia_ramiae,0,0,0,NA,0
Chomelia_randioides,2,2,0,Points-PointsKO-Adjacents,18
Chomelia_rauwolfioides,17,9,8,Points-PointsKO-Adjacents,123
Chomelia_recordii,92,70,22,Alphahull-PointsKO-Adjacents,955
Chomelia_ribesioides,270,220,50,Alphahull-PointsKO-Adjacents,16343
Chomelia_rubra,7,1,6,Points-PointsKO-Adjacents,44
Chomelia_rudis,4,4,0,Points-PointsKO-Adjacents,36
Chomelia_sericea,3,2,1,Points-PointsKO-Adjacents,27
Chomelia_sessilis,10,1,9,Points-PointsKO-Adjacents,86
Chomelia_spinosa,400,296,104,Alphahull-PointsKO-Adjacents,9588
Chomelia_stergiosii,1,1,0,Points-PointsKO-Adjacents,9
Chomelia_tenuiflora,403,0,403,Points-PointsKO-Adjacents,2655
Chomelia_transiens,2,2,0,Points-PointsKO-Adjacents,18
Chomelia_tristis,5,4,1,Points-PointsKO-Adjacents,45
Chomelia_ulei,5,5,0,Points-PointsKO-Adjacents,45
Chomelia_venezuelensis,21,10,11,Points-PointsKO-Adjacents,167
Chomelia_venulosa,38,25,13,Alphahull-PointsKO-Adjacents,375
Chomelia_vulpina,1,1,0,Points-PointsKO-Adjacents,9
Chondrodendron_tomentosum,51,23,28,Alphahull-PointsKO-Adjacents,560
Chondrostylis_bancana,3,3,0,Points-PointsKO-Adjacents,24
Chondrostylis_kunstleri,2,1,1,Points-PointsKO-Adjacents,18
Chonemorpha_verrucosa,8,1,7,Points-PointsKO-Adjacents,72
Chonocentrum_cyathophorum,5,5,0,Points-PointsKO-Adjacents,45
Chonopetalum_stenodictyum,NA,NA,NA,NA,NA
Choriceras_majus,13,11,2,Points-PointsKO-Adjacents,21
Choriceras_tricorne,388,348,40,Alphahull-PointsKO-Adjacents,1238
Chorilaena_quercifolia,142,129,13,Alphahull-PointsKO-Adjacents,317
Chorisandrachne_diplosperma,8,3,5,Points-PointsKO-Adjacents,38
Chorisepalum_psychotrioides,15,7,8,Points-PointsKO-Adjacents,83
Chorisepalum_rotundifolium,5,5,0,Points-PointsKO-Adjacents,36
Chouxia_bijugata,3,3,0,Points-PointsKO-Adjacents,21
Chouxia_borealis,14,10,4,Points-PointsKO-Adjacents,86
Chouxia_macrophylla,4,4,0,Points-PointsKO-Adjacents,13
Chouxia_mollis,6,3,3,Points-PointsKO-Adjacents,24
Chouxia_saboureaui,3,3,0,Points-PointsKO-Adjacents,23
Chouxia_sorindeioides,22,15,7,Points-PointsKO-Adjacents,122
Christiana_africana,221,109,112,Alphahull-PointsKO-Adjacents,5734
Christiana_eburnea,6,1,5,Points-PointsKO-Adjacents,45
Christiana_macrodon,32,23,9,Alphahull-PointsKO-Adjacents,564
Christiana_mennegae,4,4,0,Points-PointsKO-Adjacents,34
Christiana_vescoana,1,1,0,Points-PointsKO-Adjacents,4
Chromolaena_odorata,3985,3227,758,Alphahull-PointsKO-Adjacents,103580
Chromolucuma_apiculata,6,0,6,Points-PointsKO-Adjacents,48
Chromolucuma_baehniana,3,3,0,Points-PointsKO-Adjacents,27
Chromolucuma_cespedesiiformis,8,3,5,Points-PointsKO-Adjacents,52
Chromolucuma_congestifolia,47,32,15,Alphahull-PointsKO-Adjacents,209
Chromolucuma_rubriflora,59,0,59,Points-PointsKO-Adjacents,451
Chronopappus_bifrons,31,21,10,Alphahull-PointsKO-Adjacents,116
Chrysanthemoides_monilifera,2297,1887,410,Alphahull-PointsKO-Adjacents,17912
Chrysobalanus_cuspidatus,7,1,6,Points-PointsKO-Adjacents,24
Chrysobalanus_icaco,1454,986,468,Alphahull-PointsKO-Adjacents,35327
Chrysochlamys_allenii,112,95,17,Alphahull-PointsKO-Adjacents,320
Chrysochlamys_alterninervia,2,2,0,Points-PointsKO-Adjacents,18
Chrysochlamys_bracteolata,65,41,24,Alphahull-PointsKO-Adjacents,2207
Chrysochlamys_caribaea,3,3,0,Points-PointsKO-Adjacents,12
Chrysochlamys_colombiana,280,255,25,Alphahull-PointsKO-Adjacents,3464
Chrysochlamys_cuneata,23,15,8,Points-PointsKO-Adjacents,171
Chrysochlamys_dependens,197,172,25,Alphahull-PointsKO-Adjacents,5645
Chrysochlamys_eclipes,148,132,16,Alphahull-PointsKO-Adjacents,837
Chrysochlamys_floribunda,33,15,18,Points-PointsKO-Adjacents,260
Chrysochlamys_glauca,330,310,20,Alphahull-PointsKO-Adjacents,716
Chrysochlamys_goudotii,8,3,5,Points-PointsKO-Adjacents,65
Chrysochlamys_grandifolia,94,82,12,Alphahull-PointsKO-Adjacents,562
Chrysochlamys_laxa,4,4,0,Points-PointsKO-Adjacents,36
Chrysochlamys_macrophylla,84,47,37,Alphahull-PointsKO-Adjacents,1215
Chrysochlamys_membranacea,146,100,46,Alphahull-PointsKO-Adjacents,14305
Chrysochlamys_membrillensis,7,1,6,Points-PointsKO-Adjacents,51
Chrysochlamys_micrantha,2,2,0,Points-PointsKO-Adjacents,18
Chrysochlamys_myrcioides,3,3,0,Points-PointsKO-Adjacents,27
Chrysochlamys_nicaraguensis,154,136,18,Alphahull-PointsKO-Adjacents,903
Chrysochlamys_pavonii,6,1,5,Points-PointsKO-Adjacents,54
Chrysochlamys_psychotriifolia,105,87,18,Alphahull-PointsKO-Adjacents,387
Chrysochlamys_saldanhae,86,68,18,Alphahull-PointsKO-Adjacents,1194
Chrysochlamys_silvicola,87,68,19,Alphahull-PointsKO-Adjacents,359
Chrysochlamys_skutchii,46,33,13,Alphahull-PointsKO-Adjacents,145
Chrysochlamys_tenuifolia,44,27,17,Alphahull-PointsKO-Adjacents,160
Chrysochlamys_tenuis,87,69,18,Alphahull-PointsKO-Adjacents,595
Chrysochlamys_ulei,83,52,31,Alphahull-PointsKO-Adjacents,4994
Chrysochlamys_weberbaueri,323,252,71,Alphahull-PointsKO-Adjacents,20208
Chrysolepis_chrysophylla,878,819,59,Alphahull-PointsKO-Adjacents,5011
Chrysophyllum_acreanum,22,3,19,Points-PointsKO-Adjacents,193
Chrysophyllum_africanum,169,109,60,Alphahull-PointsKO-Adjacents,4977
Chrysophyllum_akusae,NA,NA,NA,NA,NA
Chrysophyllum_albidum,205,163,42,Alphahull-PointsKO-Adjacents,1254
Chrysophyllum_albipilum,6,0,6,Points-PointsKO-Adjacents,50
Chrysophyllum_amazonicum,181,124,57,Alphahull-PointsKO-Adjacents,14229
Chrysophyllum_ambrense,6,4,2,Points-PointsKO-Adjacents,27
Chrysophyllum_analalavense,16,8,8,Points-PointsKO-Adjacents,124
Chrysophyllum_arenarium,83,49,34,Alphahull-PointsKO-Adjacents,4131
Chrysophyllum_argenteum,1178,991,187,Alphahull-PointsKO-Adjacents,55999
Chrysophyllum_asraoi,NA,NA,NA,NA,NA
Chrysophyllum_aulacocarpum,NA,NA,NA,NA,NA
Chrysophyllum_azaguieanum,12,10,2,Points-PointsKO-Adjacents,76
Chrysophyllum_bangweolense,26,5,21,Points-PointsKO-Adjacents,223
Chrysophyllum_beguei,40,17,23,Points-PointsKO-Adjacents,300
Chrysophyllum_boivinianum,137,109,28,Alphahull-PointsKO-Adjacents,2305
Chrysophyllum_bombycinum,47,0,47,Points-PointsKO-Adjacents,326
Chrysophyllum_boukokoense,44,21,23,Alphahull-PointsKO-Adjacents,1835
Chrysophyllum_brenesii,133,115,18,Alphahull-PointsKO-Adjacents,490
Chrysophyllum_cainito,53,38,15,Alphahull-PointsKO-Adjacents,538
Chrysophyllum_calophyllum,1,1,0,Points-PointsKO-Adjacents,6
Chrysophyllum_capuronii,2,2,0,Points-PointsKO-Adjacents,8
Chrysophyllum_colombianum,86,52,34,Alphahull-PointsKO-Adjacents,5063
Chrysophyllum_contumacense,2,2,0,Points-PointsKO-Adjacents,18
Chrysophyllum_cuneifolium,120,74,46,Alphahull-PointsKO-Adjacents,5262
Chrysophyllum_delphinense,15,4,11,Points-PointsKO-Adjacents,73
Chrysophyllum_durifructum,0,0,0,NA,0
Chrysophyllum_euryphyllum,0,0,0,NA,0
Chrysophyllum_eximium,37,7,30,Points-PointsKO-Adjacents,286
Chrysophyllum_fenerivense,17,7,10,Points-PointsKO-Adjacents,113
Chrysophyllum_flexuosum,271,223,48,Alphahull-PointsKO-Adjacents,2745
Chrysophyllum_giganteum,34,23,11,Alphahull-PointsKO-Adjacents,1433
Chrysophyllum_gonocarpum,1504,1361,143,Alphahull-PointsKO-Adjacents,58966
Chrysophyllum_gorungosanum,64,26,38,Alphahull-PointsKO-Adjacents,799
Chrysophyllum_guerelianum,3,3,0,Points-PointsKO-Adjacents,26
Chrysophyllum_hirsutum,73,57,16,Alphahull-PointsKO-Adjacents,415
Chrysophyllum_imperiale,16,5,11,Points-PointsKO-Adjacents,128
Chrysophyllum_inornatum,256,0,256,Points-PointsKO-Adjacents,1117
Chrysophyllum_januariense,45,22,23,Alphahull-PointsKO-Adjacents,496
Chrysophyllum_lacourtianum,73,49,24,Alphahull-PointsKO-Adjacents,2951
Chrysophyllum_lanatum,3,3,0,Points-PointsKO-Adjacents,27
Chrysophyllum_longifolium,0,0,0,NA,0
Chrysophyllum_lucentifolium,422,265,157,Alphahull-PointsKO-Adjacents,24506
Chrysophyllum_lungi,3,3,0,Points-PointsKO-Adjacents,24
Chrysophyllum_manabiense,4,4,0,Points-PointsKO-Adjacents,33
Chrysophyllum_manaosense,131,89,42,Alphahull-PointsKO-Adjacents,10378
Chrysophyllum_marginatum,1669,1512,157,Alphahull-PointsKO-Adjacents,57100
Chrysophyllum_masoalense,10,7,3,Points-PointsKO-Adjacents,54
Chrysophyllum_mexicanum,275,236,39,Alphahull-PointsKO-Adjacents,7717
Chrysophyllum_muerense,24,13,11,Points-PointsKO-Adjacents,125
Chrysophyllum_novoguineense,0,0,0,NA,0
Chrysophyllum_ogowense,22,11,11,Points-PointsKO-Adjacents,132
Chrysophyllum_oliviforme,171,0,171,Points-PointsKO-Adjacents,1004
Chrysophyllum_ovale,36,14,22,Points-PointsKO-Adjacents,281
Chrysophyllum_papuanicum,0,0,0,NA,0
Chrysophyllum_paranaense,19,13,6,Points-PointsKO-Adjacents,117
Chrysophyllum_parvulum,9,3,6,Points-PointsKO-Adjacents,78
Chrysophyllum_pauciflorum,35,23,12,Alphahull-PointsKO-Adjacents,124
Chrysophyllum_perpulchrum,84,49,35,Alphahull-PointsKO-Adjacents,1242
Chrysophyllum_perrieri,57,36,21,Alphahull-PointsKO-Adjacents,734
Chrysophyllum_pomiferum,130,67,63,Alphahull-PointsKO-Adjacents,15962
Chrysophyllum_prieurii,266,174,92,Alphahull-PointsKO-Adjacents,19281
Chrysophyllum_prunifolium,0,0,0,NA,0
Chrysophyllum_pruniforme,85,39,46,Alphahull-PointsKO-Adjacents,2440
Chrysophyllum_reitzianum,NA,NA,NA,NA,NA
Chrysophyllum_revolutum,9,4,5,Points-PointsKO-Adjacents,74
Chrysophyllum_roxburghii,95,29,66,Alphahull-PointsKO-Adjacents,535
Chrysophyllum_rufum,211,155,56,Alphahull-PointsKO-Adjacents,4360
Chrysophyllum_sanguinolentum,600,553,47,Alphahull-PointsKO-Adjacents,42629
Chrysophyllum_sapini,NA,NA,NA,NA,NA
Chrysophyllum_scalare,5,0,5,Points-PointsKO-Adjacents,45
Chrysophyllum_sparsiflorum,144,72,72,Alphahull-PointsKO-Adjacents,15961
Chrysophyllum_splendens,240,192,48,Alphahull-PointsKO-Adjacents,2681
Chrysophyllum_subnudum,110,80,30,Alphahull-PointsKO-Adjacents,4037
Chrysophyllum_subspinosum,4,4,0,Points-PointsKO-Adjacents,36
Chrysophyllum_superbum,2,2,0,Points-PointsKO-Adjacents,18
Chrysophyllum_taiense,8,4,4,Points-PointsKO-Adjacents,59
Chrysophyllum_tessmannii,NA,NA,NA,NA,NA
Chrysophyllum_ucuquirana-branca,30,11,19,Points-PointsKO-Adjacents,216
Chrysophyllum_venezuelanense,456,357,99,Alphahull-PointsKO-Adjacents,20732
Chrysophyllum_viride,205,165,40,Alphahull-PointsKO-Adjacents,2254
Chrysophyllum_viridifolium,15,4,11,Points-PointsKO-Adjacents,119
Chrysophyllum_wilsonii,9,5,4,Points-PointsKO-Adjacents,51
Chrysophyllum_zimmermannii,NA,NA,NA,NA,NA
Chukrasia_tabularis,33,10,23,Points-PointsKO-Adjacents,294
Chunia_bucklandioides,3,3,0,Points-PointsKO-Adjacents,27
Chuniophoenix_hainanensis,4,3,1,Points-PointsKO-Adjacents,35
Chydenanthus_excelsus,10,0,10,Points-PointsKO-Adjacents,51
Chytranthus_angustifolius,76,52,24,Alphahull-PointsKO-Adjacents,2020
Chytranthus_atroviolaceus,14,2,12,Points-PointsKO-Adjacents,123
Chytranthus_brunneotomentosus,12,7,5,Points-PointsKO-Adjacents,50
Chytranthus_calophyllus,1,0,1,Points-PointsKO-Adjacents,9
Chytranthus_carneus,73,40,33,Alphahull-PointsKO-Adjacents,3371
Chytranthus_cauliflorus,54,31,23,Alphahull-PointsKO-Adjacents,355
Chytranthus_dasystachys,1,0,1,Points-PointsKO-Adjacents,9
Chytranthus_edulis,21,13,8,Points-PointsKO-Adjacents,97
Chytranthus_ellipticus,1,1,0,Points-PointsKO-Adjacents,9
Chytranthus_flavoviridis,1,0,1,Points-PointsKO-Adjacents,9
Chytranthus_gilletii,36,23,13,Alphahull-PointsKO-Adjacents,1192
Chytranthus_imenoensis,2,2,0,Points-PointsKO-Adjacents,18
Chytranthus_klaineanus,15,6,9,Points-PointsKO-Adjacents,128
Chytranthus_ledermannii,1,0,1,Points-PointsKO-Adjacents,9
Chytranthus_longibracteatus,2,2,0,Points-PointsKO-Adjacents,9
Chytranthus_macrobotrys,106,68,38,Alphahull-PointsKO-Adjacents,3802
Chytranthus_macrophyllus,12,5,7,Points-PointsKO-Adjacents,96
Chytranthus_mannii,2,2,0,Points-PointsKO-Adjacents,8
Chytranthus_micranthus,4,3,1,Points-PointsKO-Adjacents,18
Chytranthus_mortehanii,12,3,9,Points-PointsKO-Adjacents,99
Chytranthus_obliquinervis,28,14,14,Points-PointsKO-Adjacents,146
Chytranthus_setosus,25,12,13,Points-PointsKO-Adjacents,192
Chytranthus_sexlocularis,22,14,8,Points-PointsKO-Adjacents,126
Chytranthus_stenophyllus,9,1,8,Points-PointsKO-Adjacents,72
Chytranthus_strigosus,1,0,1,Points-PointsKO-Adjacents,9
Chytranthus_subvilliger,NA,NA,NA,NA,NA
Chytranthus_xanthophyllus,1,0,1,Points-PointsKO-Adjacents,9
Ciliosemina_pedunculata,158,125,33,Alphahull-PointsKO-Adjacents,7192
Ciliosemina_purdieana,20,14,6,Points-PointsKO-Adjacents,144
Cinchona_antioquiae,12,7,5,Points-PointsKO-Adjacents,92
Cinchona_asperifolia,8,6,2,Points-PointsKO-Adjacents,35
Cinchona_barbacoensis,63,1,62,Points-PointsKO-Adjacents,324
Cinchona_calisaya,138,108,30,Alphahull-PointsKO-Adjacents,1192
Cinchona_glandulifera,8,0,8,Points-PointsKO-Adjacents,72
Cinchona_hirsuta,18,11,7,Points-PointsKO-Adjacents,83
Cinchona_krauseana,9,1,8,Points-PointsKO-Adjacents,69
Cinchona_lancifolia,56,35,21,Alphahull-PointsKO-Adjacents,958
Cinchona_lucumifolia,5,5,0,Points-PointsKO-Adjacents,41
Cinchona_macrocalyx,65,35,30,Alphahull-PointsKO-Adjacents,836
Cinchona_micrantha,28,10,18,Points-PointsKO-Adjacents,227
Cinchona_mutisii,11,6,5,Points-PointsKO-Adjacents,33
Cinchona_nitida,8,0,8,Points-PointsKO-Adjacents,64
Cinchona_officinalis,68,53,15,Alphahull-PointsKO-Adjacents,654
Cinchona_parabolica,26,15,11,Points-PointsKO-Adjacents,161
Cinchona_pitayensis,34,21,13,Alphahull-PointsKO-Adjacents,253
Cinchona_pubescens,669,570,99,Alphahull-PointsKO-Adjacents,8142
Cinchona_pyrifolia,19,6,13,Points-PointsKO-Adjacents,136
Cinchona_rugosa,8,4,4,Points-PointsKO-Adjacents,69
Cinchona_scrobiculata,10,0,10,Points-PointsKO-Adjacents,76
Cinchona_villosa,22,5,17,Points-PointsKO-Adjacents,169
Cinchonopsis_amazonica,90,39,51,Alphahull-PointsKO-Adjacents,3921
Cinnadenia_malayana,0,0,0,NA,0
Cinnadenia_paniculata,5,0,5,Points-PointsKO-Adjacents,45
Cinnamodendron_angustifolium,1,1,0,Points-PointsKO-Adjacents,9
Cinnamodendron_axillare,27,11,16,Points-PointsKO-Adjacents,157
Cinnamodendron_corticosum,2,2,0,Points-PointsKO-Adjacents,16
Cinnamodendron_cubense,0,0,0,NA,0
Cinnamodendron_dinisii,373,325,48,Alphahull-PointsKO-Adjacents,3982
Cinnamodendron_ekmanii,8,4,4,Points-PointsKO-Adjacents,43
Cinnamodendron_occhionianum,5,5,0,Points-PointsKO-Adjacents,43
Cinnamodendron_sampaioanum,4,4,0,Points-PointsKO-Adjacents,32
Cinnamodendron_tenuifolium,3,3,0,Points-PointsKO-Adjacents,27
Cinnamodendron_venezuelense,2,2,0,Points-PointsKO-Adjacents,18
Cinnamomum_alainii,9,4,5,Points-PointsKO-Adjacents,32
Cinnamomum_alatum,NA,NA,NA,NA,NA
Cinnamomum_alibertii,NA,NA,NA,NA,NA
Cinnamomum_altissimum,1,1,0,Points-PointsKO-Adjacents,9
Cinnamomum_amoenum,251,230,21,Alphahull-PointsKO-Adjacents,3692
Cinnamomum_amplexicaule,7,0,7,Points-PointsKO-Adjacents,54
Cinnamomum_amplifolium,1,1,0,Points-PointsKO-Adjacents,9
Cinnamomum_anacardium,1,1,0,Points-PointsKO-Adjacents,6
Cinnamomum_andersonii,NA,NA,NA,NA,NA
Cinnamomum_angustifolium,NA,NA,NA,NA,NA
Cinnamomum_angustitepalum,2,2,0,Points-PointsKO-Adjacents,15
Cinnamomum_appelianum,45,26,19,Alphahull-PointsKO-Adjacents,3630
Cinnamomum_archboldianum,5,5,0,Points-PointsKO-Adjacents,45
Cinnamomum_areolatum,45,25,20,Alphahull-PointsKO-Adjacents,407
Cinnamomum_arfakense,0,0,0,NA,0
Cinnamomum_argenteum,14,0,14,Points-PointsKO-Adjacents,105
Cinnamomum_arsenei,82,66,16,Alphahull-PointsKO-Adjacents,1348
Cinnamomum_assamicum,NA,NA,NA,NA,NA
Cinnamomum_aureofulvum,1,0,1,Points-PointsKO-Adjacents,9
Cinnamomum_austrosinense,0,0,0,NA,0
Cinnamomum_austroyunnanense,NA,NA,NA,NA,NA
Cinnamomum_bahianum,NA,NA,NA,NA,NA
Cinnamomum_baileyanum,59,37,22,Alphahull-PointsKO-Adjacents,290
Cinnamomum_balansae,4,4,0,Points-PointsKO-Adjacents,27
Cinnamomum_bamoense,NA,NA,NA,NA,NA
Cinnamomum_barbatoaxillatum,44,21,23,Alphahull-PointsKO-Adjacents,1922
Cinnamomum_beccarii,NA,NA,NA,NA,NA
Cinnamomum_bejolghota,71,31,40,Alphahull-PointsKO-Adjacents,1417
Cinnamomum_bhamoensis,NA,NA,NA,NA,NA
Cinnamomum_bhaskarii,NA,NA,NA,NA,NA
Cinnamomum_birmanicum,0,0,0,NA,0
Cinnamomum_bishnupadae,NA,NA,NA,NA,NA
Cinnamomum_blandfordii,NA,NA,NA,NA,NA
Cinnamomum_blumei,NA,NA,NA,NA,NA
Cinnamomum_bodinieri,43,22,21,Alphahull-PointsKO-Adjacents,2296
Cinnamomum_bonii,1,1,0,Points-PointsKO-Adjacents,9
Cinnamomum_brachythyrsum,NA,NA,NA,NA,NA
Cinnamomum_bractifoliaceum,NA,NA,NA,NA,NA
Cinnamomum_breedlovei,14,8,6,Points-PointsKO-Adjacents,66
Cinnamomum_brenesii,54,42,12,Alphahull-PointsKO-Adjacents,151
Cinnamomum_burmanni,1,0,1,Points-PointsKO-Adjacents,8
Cinnamomum_calcareum,20,8,12,Points-PointsKO-Adjacents,180
Cinnamomum_calciphilum,0,0,0,NA,0
Cinnamomum_calleryi,NA,NA,NA,NA,NA
Cinnamomum_cambodianum,2,2,0,Points-PointsKO-Adjacents,18
Cinnamomum_camphora,2524,365,2159,Alphahull-PointsKO-Adjacents,16917
Cinnamomum_cappara-coronde,3,3,0,Points-PointsKO-Adjacents,17
Cinnamomum_caratingae,3,3,0,Points-PointsKO-Adjacents,27
Cinnamomum_carrierei,NA,NA,NA,NA,NA
Cinnamomum_caryophyllus,7,2,5,Points-PointsKO-Adjacents,30
Cinnamomum_cassia,34,16,18,Points-PointsKO-Adjacents,297
Cinnamomum_caudiferum,2,2,0,Points-PointsKO-Adjacents,18
Cinnamomum_cebuense,0,0,0,NA,0
Cinnamomum_celebicum,5,5,0,Points-PointsKO-Adjacents,45
Cinnamomum_champokianum,NA,NA,NA,NA,NA
Cinnamomum_chantinii,NA,NA,NA,NA,NA
Cinnamomum_chartophyllum,1,1,0,Points-PointsKO-Adjacents,9
Cinnamomum_chavarrianum,28,17,11,Points-PointsKO-Adjacents,155
Cinnamomum_chekiangense,14,5,9,Points-PointsKO-Adjacents,124
Cinnamomum_chemungianum,NA,NA,NA,NA,NA
Cinnamomum_chengkouense,7,1,6,Points-PointsKO-Adjacents,63
Cinnamomum_chiapense,20,0,20,Points-PointsKO-Adjacents,95
Cinnamomum_citriodorum,3,3,0,Points-PointsKO-Adjacents,18
Cinnamomum_clemensii,16,9,7,Points-PointsKO-Adjacents,107
Cinnamomum_concinnum,3,3,0,Points-PointsKO-Adjacents,18
Cinnamomum_contractum,4,4,0,Points-PointsKO-Adjacents,36
Cinnamomum_cordatum,0,0,0,NA,0
Cinnamomum_corneri,0,0,0,NA,0
Cinnamomum_costaricanum,86,70,16,Alphahull-PointsKO-Adjacents,388
Cinnamomum_crassinervium,0,0,0,NA,0
Cinnamomum_crenulicupulum,NA,NA,NA,NA,NA
Cinnamomum_culilaban,3,3,0,Points-PointsKO-Adjacents,12
Cinnamomum_culitlawan,1,0,1,Points-PointsKO-Adjacents,8
Cinnamomum_cupulatum,0,0,0,NA,0
Cinnamomum_curvifolium,27,9,18,Points-PointsKO-Adjacents,198
Cinnamomum_cuspidatum,4,4,0,Points-PointsKO-Adjacents,36
Cinnamomum_daphnoides,7,1,6,Points-PointsKO-Adjacents,61
Cinnamomum_decaisnei,NA,NA,NA,NA,NA
Cinnamomum_decourtilzii,NA,NA,NA,NA,NA
Cinnamomum_degeneri,1,1,0,Points-PointsKO-Adjacents,9
Cinnamomum_deschampsii,1,1,0,Points-PointsKO-Adjacents,9
Cinnamomum_doederleinii,12,4,8,Points-PointsKO-Adjacents,30
Cinnamomum_dominii,36,14,22,Points-PointsKO-Adjacents,315
Cinnamomum_duartianum,10,2,8,Points-PointsKO-Adjacents,79
Cinnamomum_dubium,11,5,6,Points-PointsKO-Adjacents,67
Cinnamomum_ebaloi,0,0,0,NA,0
Cinnamomum_effusum,133,97,36,Alphahull-PointsKO-Adjacents,1245
Cinnamomum_ehrenbergii,81,66,15,Alphahull-PointsKO-Adjacents,1456
Cinnamomum_ellipticifolium,0,0,0,NA,0
Cinnamomum_englerianum,0,0,0,NA,0
Cinnamomum_erectifolium,4,4,0,Points-PointsKO-Adjacents,27
Cinnamomum_erythropus,28,13,15,Points-PointsKO-Adjacents,149
Cinnamomum_esquirolii,22,7,15,Points-PointsKO-Adjacents,189
Cinnamomum_estrellense,7,0,7,Points-PointsKO-Adjacents,54
Cinnamomum_eugenoliferum,11,0,11,Points-PointsKO-Adjacents,66
Cinnamomum_falcatum,0,0,0,NA,0
Cinnamomum_fargesii,7,0,7,Points-PointsKO-Adjacents,63
Cinnamomum_filipedicellatum,1,1,0,Points-PointsKO-Adjacents,9
Cinnamomum_filipes,2,2,0,Points-PointsKO-Adjacents,18
Cinnamomum_fitianum,0,0,0,NA,0
Cinnamomum_floccosum,2,2,0,Points-PointsKO-Adjacents,18
Cinnamomum_formicarium,6,2,4,Points-PointsKO-Adjacents,49
Cinnamomum_foveolatum,3,3,0,Points-PointsKO-Adjacents,27
Cinnamomum_frodinii,5,5,0,Points-PointsKO-Adjacents,26
Cinnamomum_fruticosum,NA,NA,NA,NA,NA
Cinnamomum_gaudichaudii,NA,NA,NA,NA,NA
Cinnamomum_glanduliferum,54,22,32,Alphahull-PointsKO-Adjacents,1700
Cinnamomum_glaucescens,1,0,1,Points-PointsKO-Adjacents,9
Cinnamomum_glauciphyllum,1,1,0,Points-PointsKO-Adjacents,9
Cinnamomum_glaziovii,42,22,20,Alphahull-PointsKO-Adjacents,530
Cinnamomum_glossophyllum,2,2,0,Points-PointsKO-Adjacents,18
Cinnamomum_goaense,2,2,0,Points-PointsKO-Adjacents,18
Cinnamomum_gracillimum,0,0,0,NA,0
Cinnamomum_grandiflorum,9,2,7,Points-PointsKO-Adjacents,79
Cinnamomum_grandifolium,0,0,0,NA,0
Cinnamomum_grisebachii,36,16,20,Points-PointsKO-Adjacents,238
Cinnamomum_guyanense,NA,NA,NA,NA,NA
Cinnamomum_hammelianum,55,39,16,Alphahull-PointsKO-Adjacents,248
Cinnamomum_hartmannii,59,38,21,Alphahull-PointsKO-Adjacents,359
Cinnamomum_hatschbachii,99,85,14,Alphahull-PointsKO-Adjacents,1354
Cinnamomum_haussknechtii,58,29,29,Alphahull-PointsKO-Adjacents,2219
Cinnamomum_helferi,1,1,0,Points-PointsKO-Adjacents,9
Cinnamomum_heterantherum,2,2,0,Points-PointsKO-Adjacents,18
Cinnamomum_heyneanum,2,2,0,Points-PointsKO-Adjacents,18
Cinnamomum_hkinlumense,0,0,0,NA,0
Cinnamomum_hookeri,NA,NA,NA,NA,NA
Cinnamomum_hupehanum,42,19,23,Points-PointsKO-Adjacents,358
Cinnamomum_ilicioides,4,4,0,Points-PointsKO-Adjacents,36
Cinnamomum_impressicostatum,NA,NA,NA,NA,NA
Cinnamomum_impressinervium,1,0,1,Points-PointsKO-Adjacents,9
Cinnamomum_impressum,2,1,1,Points-PointsKO-Adjacents,15
Cinnamomum_iners,44,0,44,Points-PointsKO-Adjacents,344
Cinnamomum_insularimontanum,248,231,17,Alphahull-PointsKO-Adjacents,371
Cinnamomum_japonicum,6,2,4,Points-PointsKO-Adjacents,43
Cinnamomum_javanicum,14,0,14,Points-PointsKO-Adjacents,118
Cinnamomum_jensenianum,21,4,17,Points-PointsKO-Adjacents,189
Cinnamomum_johnstonii,0,0,0,NA,0
Cinnamomum_kami,8,2,6,Points-PointsKO-Adjacents,47
Cinnamomum_keralaense,0,0,0,NA,0
Cinnamomum_kerangas,1,1,0,Points-PointsKO-Adjacents,9
Cinnamomum_kerrii,1,1,0,Points-PointsKO-Adjacents,9
Cinnamomum_kinabaluense,1,1,0,Points-PointsKO-Adjacents,9
Cinnamomum_kingdon-wardii,0,0,0,NA,0
Cinnamomum_kotoense,7,2,5,Points-PointsKO-Adjacents,42
Cinnamomum_kruseanum,0,0,0,NA,0
Cinnamomum_kunstleri,1,1,0,Points-PointsKO-Adjacents,9
Cinnamomum_kwangtungense,4,4,0,Points-PointsKO-Adjacents,36
Cinnamomum_lanaoense,0,0,0,NA,0
Cinnamomum_lanigerum,3,3,0,Points-PointsKO-Adjacents,21
Cinnamomum_lanuginosum,NA,NA,NA,NA,NA
Cinnamomum_laubatii,143,121,22,Alphahull-PointsKO-Adjacents,332
Cinnamomum_lawang,0,0,0,NA,0
Cinnamomum_ledermannii,6,0,6,Points-PointsKO-Adjacents,50
Cinnamomum_leptophyllum,2,0,2,Points-PointsKO-Adjacents,9
Cinnamomum_liangii,9,0,9,Points-PointsKO-Adjacents,81
Cinnamomum_ligneum,NA,NA,NA,NA,NA
Cinnamomum_lineatum,0,0,0,NA,0
Cinnamomum_lioui,33,17,16,Points-PointsKO-Adjacents,295
Cinnamomum_litseifolium,0,0,0,NA,0
Cinnamomum_loheri,0,0,0,NA,0
Cinnamomum_lohitensis,NA,NA,NA,NA,NA
Cinnamomum_longipaniculatum,NA,NA,NA,NA,NA
Cinnamomum_longipedicellatum,1,1,0,Points-PointsKO-Adjacents,9
Cinnamomum_longipes,2,1,1,Points-PointsKO-Adjacents,18
Cinnamomum_longipetiolatum,2,2,0,Points-PointsKO-Adjacents,18
Cinnamomum_loureiroi,5,5,0,Points-PointsKO-Adjacents,36
Cinnamomum_lucens,1,1,0,Points-PointsKO-Adjacents,9
Cinnamomum_macrocarpum,2,2,0,Points-PointsKO-Adjacents,18
Cinnamomum_macrophyllum,8,1,7,Points-PointsKO-Adjacents,39
Cinnamomum_mairei,14,0,14,Points-PointsKO-Adjacents,105
Cinnamomum_malabatrum,0,0,0,NA,0
Cinnamomum_martiniquense,NA,NA,NA,NA,NA
Cinnamomum_mathewsii,2,2,0,Points-PointsKO-Adjacents,18
Cinnamomum_mayanum,0,0,0,NA,0
Cinnamomum_melliodorum,3,3,0,Points-PointsKO-Adjacents,21
Cinnamomum_mendozae,0,0,0,NA,0
Cinnamomum_mercadoi,11,1,10,Points-PointsKO-Adjacents,81
Cinnamomum_merrillianum,10,2,8,Points-PointsKO-Adjacents,87
Cinnamomum_mezii,1,1,0,Points-PointsKO-Adjacents,9
Cinnamomum_miaoshanense,21,3,18,Points-PointsKO-Adjacents,185
Cinnamomum_micranthum,106,82,24,Alphahull-PointsKO-Adjacents,746
Cinnamomum_microphyllum,1,1,0,Points-PointsKO-Adjacents,9
Cinnamomum_migao,8,2,6,Points-PointsKO-Adjacents,72
Cinnamomum_molle,4,3,1,Points-PointsKO-Adjacents,36
Cinnamomum_mollicellum,37,29,8,Alphahull-PointsKO-Adjacents,101
Cinnamomum_mollifolium,1,1,0,Points-PointsKO-Adjacents,9
Cinnamomum_mollissimum,5,1,4,Points-PointsKO-Adjacents,44
Cinnamomum_montanum,87,21,66,Alphahull-PointsKO-Adjacents,794
Cinnamomum_myrianthum,1,1,0,Points-PointsKO-Adjacents,9
Cinnamomum_nalingway,0,0,0,NA,0
Cinnamomum_nanophyllum,0,0,0,NA,0
Cinnamomum_napoense,48,28,20,Alphahull-PointsKO-Adjacents,455
Cinnamomum_neesii,NA,NA,NA,NA,NA
Cinnamomum_neurophyllum,38,26,12,Alphahull-PointsKO-Adjacents,240
Cinnamomum_nicolsonianum,NA,NA,NA,NA,NA
Cinnamomum_novae-britanniae,0,0,0,NA,0
Cinnamomum_oblongum,0,0,0,NA,0
Cinnamomum_obscurum,NA,NA,NA,NA,NA
Cinnamomum_oleifolium,1,1,0,Points-PointsKO-Adjacents,9
Cinnamomum_oliveri,593,533,60,Alphahull-PointsKO-Adjacents,1523
Cinnamomum_orbiculatum,0,0,0,NA,0
Cinnamomum_osmophloeum,176,157,19,Alphahull-PointsKO-Adjacents,352
Cinnamomum_ovalauense,1,1,0,Points-PointsKO-Adjacents,8
Cinnamomum_ovalifolium,1,1,0,Points-PointsKO-Adjacents,9
Cinnamomum_pachypes,NA,NA,NA,NA,NA
Cinnamomum_pachyphyllum,9,0,9,Points-PointsKO-Adjacents,72
Cinnamomum_pachypodum,238,206,32,Alphahull-PointsKO-Adjacents,4592
Cinnamomum_padiforme,58,36,22,Alphahull-PointsKO-Adjacents,390
Cinnamomum_paiei,1,1,0,Points-PointsKO-Adjacents,9
Cinnamomum_palaciosii,5,5,0,Points-PointsKO-Adjacents,39
Cinnamomum_palghatensis,NA,NA,NA,NA,NA
Cinnamomum_pallidum,0,0,0,NA,0
Cinnamomum_panayense,0,0,0,NA,0
Cinnamomum_paraneuron,0,0,0,NA,0
Cinnamomum_parthenoxylon,49,6,43,Points-PointsKO-Adjacents,348
Cinnamomum_patens,NA,NA,NA,NA,NA
Cinnamomum_pauciflorum,0,0,0,NA,0
Cinnamomum_pedatinervium,0,0,0,NA,0
Cinnamomum_pendulum,2,2,0,Points-PointsKO-Adjacents,18
Cinnamomum_percoriaceum,0,0,0,NA,0
Cinnamomum_perglabrum,0,0,0,NA,0
Cinnamomum_perrottetii,3,3,0,Points-PointsKO-Adjacents,17
Cinnamomum_petiolatum,0,0,0,NA,0
Cinnamomum_petrophilum,18,5,13,Points-PointsKO-Adjacents,162
Cinnamomum_philippinense,80,65,15,Alphahull-PointsKO-Adjacents,246
Cinnamomum_pilosum,1,1,0,Points-PointsKO-Adjacents,8
Cinnamomum_pingbienense,5,5,0,Points-PointsKO-Adjacents,45
Cinnamomum_piniodorum,2,2,0,Points-PointsKO-Adjacents,18
Cinnamomum_pittosporoides,4,4,0,Points-PointsKO-Adjacents,36
Cinnamomum_platyphyllum,7,1,6,Points-PointsKO-Adjacents,63
Cinnamomum_podagricum,16,5,11,Points-PointsKO-Adjacents,82
Cinnamomum_polderi,2,2,0,Points-PointsKO-Adjacents,18
Cinnamomum_politum,2,2,0,Points-PointsKO-Adjacents,18
Cinnamomum_polyadelphum,28,15,13,Points-PointsKO-Adjacents,188
Cinnamomum_porphyrium,51,31,20,Alphahull-PointsKO-Adjacents,421
Cinnamomum_porphyrospermum,0,0,0,NA,0
Cinnamomum_propinquum,30,24,6,Alphahull-PointsKO-Adjacents,27
Cinnamomum_pseudopedunculatum,0,0,0,NA,0
Cinnamomum_psychotrioides,73,54,19,Alphahull-PointsKO-Adjacents,312
Cinnamomum_puberulum,0,0,0,NA,0
Cinnamomum_pubescens,1,1,0,Points-PointsKO-Adjacents,9
Cinnamomum_purpureaum,NA,NA,NA,NA,NA
Cinnamomum_racemosum,2,2,0,Points-PointsKO-Adjacents,15
Cinnamomum_reticulatum,76,65,11,Alphahull-PointsKO-Adjacents,60
Cinnamomum_reticulifolium,1,1,0,Points-PointsKO-Adjacents,9
Cinnamomum_rhynchophyllum,5,0,5,Points-PointsKO-Adjacents,39
Cinnamomum_riedelianum,28,12,16,Points-PointsKO-Adjacents,194
Cinnamomum_rigidissimum,27,13,14,Points-PointsKO-Adjacents,98
Cinnamomum_rigidum,0,0,0,NA,0
Cinnamomum_riparium,0,0,0,NA,0
Cinnamomum_rivulorum,1,1,0,Points-PointsKO-Adjacents,9
Cinnamomum_rosiflorum,NA,NA,NA,NA,NA
Cinnamomum_rosselianum,2,2,0,Points-PointsKO-Adjacents,8
Cinnamomum_rufotomentosum,NA,NA,NA,NA,NA
Cinnamomum_rumphii,NA,NA,NA,NA,NA
Cinnamomum_rupestre,0,0,0,NA,0
Cinnamomum_safrol,0,0,0,NA,0
Cinnamomum_salicifolium,56,49,7,Alphahull-PointsKO-Adjacents,85
Cinnamomum_sancti-caroli,0,0,0,NA,0
Cinnamomum_sandkuhlii,2,2,0,Points-PointsKO-Adjacents,16
Cinnamomum_sanjappae,NA,NA,NA,NA,NA
Cinnamomum_saxatile,17,7,10,Points-PointsKO-Adjacents,153
Cinnamomum_scortechinii,3,3,0,Points-PointsKO-Adjacents,27
Cinnamomum_sellowianum,201,161,40,Alphahull-PointsKO-Adjacents,2497
Cinnamomum_semecarpifolium,5,5,0,Points-PointsKO-Adjacents,45
Cinnamomum_septentrionale,6,0,6,Points-PointsKO-Adjacents,54
Cinnamomum_sericans,0,0,0,NA,0
Cinnamomum_sessilifolium,2,2,0,Points-PointsKO-Adjacents,9
Cinnamomum_siamense,NA,NA,NA,NA,NA
Cinnamomum_sieboldii,13,4,9,Points-PointsKO-Adjacents,85
Cinnamomum_simondii,17,6,11,Points-PointsKO-Adjacents,111
Cinnamomum_sinharajaense,1,1,0,Points-PointsKO-Adjacents,9
Cinnamomum_sintoc,15,0,15,Points-PointsKO-Adjacents,114
Cinnamomum_smithianum,22,16,6,Points-PointsKO-Adjacents,117
Cinnamomum_soegengii,0,0,0,NA,0
Cinnamomum_solomonense,8,1,7,Points-PointsKO-Adjacents,58
Cinnamomum_splendens,0,0,0,NA,0
Cinnamomum_spurium,NA,NA,NA,NA,NA
Cinnamomum_stenophyllum,55,33,22,Alphahull-PointsKO-Adjacents,1257
Cinnamomum_stereophyllum,1,1,0,Points-PointsKO-Adjacents,9
Cinnamomum_suaveolens,NA,NA,NA,NA,NA
Cinnamomum_subaveniopsis,3,3,0,Points-PointsKO-Adjacents,27
Cinnamomum_subavenium,245,197,48,Alphahull-PointsKO-Adjacents,5200
Cinnamomum_subcuneatum,4,4,0,Points-PointsKO-Adjacents,36
Cinnamomum_sublanuginosum,1,1,0,Points-PointsKO-Adjacents,9
Cinnamomum_subsericeum,1,1,0,Points-PointsKO-Adjacents,9
Cinnamomum_subsessile,5,5,0,Points-PointsKO-Adjacents,37
Cinnamomum_subtetrapterum,1,1,0,Points-PointsKO-Adjacents,9
Cinnamomum_subtriplinervium,4,3,1,Points-PointsKO-Adjacents,36
Cinnamomum_sulavesianum,4,4,0,Points-PointsKO-Adjacents,29
Cinnamomum_sulphuratum,4,0,4,Points-PointsKO-Adjacents,36
Cinnamomum_sumatranum,NA,NA,NA,NA,NA
Cinnamomum_suvrae,NA,NA,NA,NA,NA
Cinnamomum_tahijanum,2,2,0,Points-PointsKO-Adjacents,18
Cinnamomum_talawaense,0,0,0,NA,0
Cinnamomum_tamala,26,0,26,Points-PointsKO-Adjacents,186
Cinnamomum_tampicense,75,69,6,Alphahull-PointsKO-Adjacents,554
Cinnamomum_taquetii,87,22,65,Alphahull-PointsKO-Adjacents,482
Cinnamomum_tavoyanum,0,0,0,NA,0
Cinnamomum_tenuifolium,341,189,152,Alphahull-PointsKO-Adjacents,2626
Cinnamomum_tenuipile,3,3,0,Points-PointsKO-Adjacents,27
Cinnamomum_tetragonum,10,1,9,Points-PointsKO-Adjacents,69
Cinnamomum_thorelii,NA,NA,NA,NA,NA
Cinnamomum_tomentulosum,50,31,19,Alphahull-PointsKO-Adjacents,763
Cinnamomum_tonduzii,50,36,14,Alphahull-PointsKO-Adjacents,137
Cinnamomum_tonkinense,32,17,15,Points-PointsKO-Adjacents,216
Cinnamomum_travancoricum,0,0,0,NA,0
Cinnamomum_trichophyllum,2,2,0,Points-PointsKO-Adjacents,17
Cinnamomum_trinervatum,40,21,19,Alphahull-PointsKO-Adjacents,2372
Cinnamomum_trinerve,4,4,0,Points-PointsKO-Adjacents,30
Cinnamomum_trintaense,0,0,0,NA,0
Cinnamomum_triplinerve,21,2,19,Points-PointsKO-Adjacents,160
Cinnamomum_tsangii,10,1,9,Points-PointsKO-Adjacents,87
Cinnamomum_tsoi,5,0,5,Points-PointsKO-Adjacents,45
Cinnamomum_utile,0,0,0,NA,0
Cinnamomum_vacciniifolium,1,1,0,Points-PointsKO-Adjacents,9
Cinnamomum_validinerve,8,1,7,Points-PointsKO-Adjacents,72
Cinnamomum_verum,40,7,33,Points-PointsKO-Adjacents,165
Cinnamomum_villosulum,40,21,19,Alphahull-PointsKO-Adjacents,2372
Cinnamomum_vimineum,1,1,0,Points-PointsKO-Adjacents,8
Cinnamomum_virens,346,329,17,Alphahull-PointsKO-Adjacents,660
Cinnamomum_vitiense,0,0,0,NA,0
Cinnamomum_walaiwarense,0,0,0,NA,0
Cinnamomum_wightii,4,2,2,Points-PointsKO-Adjacents,32
Cinnamomum_wilsonii,51,24,27,Alphahull-PointsKO-Adjacents,5285
Cinnamomum_woulfei,0,0,0,NA,0
Cinnamomum_yabunikkei,32,7,25,Points-PointsKO-Adjacents,245
Cinnamomum_zapatae,18,9,9,Points-PointsKO-Adjacents,102
Cinnamosma_fragrans,67,46,21,Alphahull-PointsKO-Adjacents,1470
Cinnamosma_macrocarpa,8,3,5,Points-PointsKO-Adjacents,54
Cinnamosma_madagascariensis,29,17,12,Points-PointsKO-Adjacents,197
Cipadessa_baccifera,126,1,125,Points-PointsKO-Adjacents,1015
Cissampelos_andromorpha,385,239,146,Alphahull-PointsKO-Adjacents,22221
Cissampelos_sympodialis,51,28,23,Alphahull-PointsKO-Adjacents,2049
Citharexylum_affine,206,153,53,Alphahull-PointsKO-Adjacents,4190
Citharexylum_argutedentatum,4,4,0,Points-PointsKO-Adjacents,25
Citharexylum_berlandieri,87,55,32,Alphahull-PointsKO-Adjacents,1714
Citharexylum_bourgeauanum,7,2,5,Points-PointsKO-Adjacents,42
Citharexylum_caudatum,431,326,105,Alphahull-PointsKO-Adjacents,5514
Citharexylum_chartaceum,10,2,8,Points-PointsKO-Adjacents,80
Citharexylum_cooperi,67,48,19,Alphahull-PointsKO-Adjacents,393
Citharexylum_costaricense,72,56,16,Alphahull-PointsKO-Adjacents,537
Citharexylum_crassifolium,17,5,12,Points-PointsKO-Adjacents,142
Citharexylum_decorum,8,0,8,Points-PointsKO-Adjacents,64
Citharexylum_donnell-smithii,205,149,56,Alphahull-PointsKO-Adjacents,1384
Citharexylum_dryanderae,7,1,6,Points-PointsKO-Adjacents,60
Citharexylum_ellipticum,60,27,33,Alphahull-PointsKO-Adjacents,192
Citharexylum_flexuosum,9,0,9,Points-PointsKO-Adjacents,81
Citharexylum_gentryi,14,9,5,Points-PointsKO-Adjacents,99
Citharexylum_glabrum,33,0,33,Points-PointsKO-Adjacents,181
Citharexylum_glaziovii,11,1,10,Points-PointsKO-Adjacents,89
Citharexylum_grandiflorum,9,0,9,Points-PointsKO-Adjacents,81
Citharexylum_guatemalense,9,0,9,Points-PointsKO-Adjacents,66
Citharexylum_herrerae,6,0,6,Points-PointsKO-Adjacents,48
Citharexylum_hexangulare,196,157,39,Alphahull-PointsKO-Adjacents,4266
Citharexylum_hidalgense,142,123,19,Alphahull-PointsKO-Adjacents,540
Citharexylum_hintonii,9,4,5,Points-PointsKO-Adjacents,52
Citharexylum_hirtellum,50,27,23,Alphahull-PointsKO-Adjacents,548
Citharexylum_ilicifolium,42,0,42,Points-PointsKO-Adjacents,271
Citharexylum_joergensenii,17,0,17,Points-PointsKO-Adjacents,93
Citharexylum_karstenii,29,14,15,Points-PointsKO-Adjacents,240
Citharexylum_krukovii,9,1,8,Points-PointsKO-Adjacents,64
Citharexylum_kunthianum,103,81,22,Alphahull-PointsKO-Adjacents,1667
Citharexylum_laetum,37,6,31,Points-PointsKO-Adjacents,311
Citharexylum_laurifolium,23,11,12,Points-PointsKO-Adjacents,153
Citharexylum_ligustrifolium,8,5,3,Points-PointsKO-Adjacents,44
Citharexylum_lojense,6,0,6,Points-PointsKO-Adjacents,45
Citharexylum_macradenium,69,50,19,Alphahull-PointsKO-Adjacents,177
Citharexylum_macrochlamys,27,8,19,Points-PointsKO-Adjacents,217
Citharexylum_macrophyllum,124,51,73,Alphahull-PointsKO-Adjacents,5406
Citharexylum_matheanum,NA,NA,NA,NA,NA
Citharexylum_mexicanum,24,12,12,Points-PointsKO-Adjacents,125
Citharexylum_mirifolium,8,0,8,Points-PointsKO-Adjacents,71
Citharexylum_mocinoi,206,149,57,Alphahull-PointsKO-Adjacents,1235
Citharexylum_montanum,25,13,12,Points-PointsKO-Adjacents,167
Citharexylum_montevidense,167,133,34,Alphahull-PointsKO-Adjacents,7024
Citharexylum_myrianthum,462,342,120,Alphahull-PointsKO-Adjacents,14307
Citharexylum_obtusifolium,5,5,0,Points-PointsKO-Adjacents,42
Citharexylum_pernambucense,28,18,10,Points-PointsKO-Adjacents,143
Citharexylum_poeppigii,168,100,68,Alphahull-PointsKO-Adjacents,7755
Citharexylum_quercifolium,20,3,17,Points-PointsKO-Adjacents,170
Citharexylum_reticulatum,30,7,23,Points-PointsKO-Adjacents,215
Citharexylum_rigidum,1,0,1,Points-PointsKO-Adjacents,9
Citharexylum_rimbachii,5,5,0,Points-PointsKO-Adjacents,43
Citharexylum_schottii,63,39,24,Alphahull-PointsKO-Adjacents,1341
Citharexylum_solanaceum,183,149,34,Alphahull-PointsKO-Adjacents,3582
Citharexylum_spinosum,261,152,109,Alphahull-PointsKO-Adjacents,5050
Citharexylum_steyermarkii,8,0,8,Points-PointsKO-Adjacents,60
Citharexylum_suberosum,1,1,0,Points-PointsKO-Adjacents,9
Citharexylum_subflavescens,94,50,44,Alphahull-PointsKO-Adjacents,1039
Citharexylum_subthyrsoideum,13,5,8,Points-PointsKO-Adjacents,60
Citharexylum_subtruncatum,3,3,0,Points-PointsKO-Adjacents,27
Citharexylum_sulcatum,39,30,9,Alphahull-PointsKO-Adjacents,203
Citharexylum_teclense,4,3,1,Points-PointsKO-Adjacents,33
Citharexylum_ternatum,2,1,1,Points-PointsKO-Adjacents,18
Citharexylum_ulei,13,1,12,Points-PointsKO-Adjacents,107
Citharexylum_vallense,3,3,0,Points-PointsKO-Adjacents,27
Citharexylum_venezuelense,13,5,8,Points-PointsKO-Adjacents,114
Citronella_apogon,67,52,15,Alphahull-PointsKO-Adjacents,537
Citronella_costaricensis,96,61,35,Alphahull-PointsKO-Adjacents,1082
Citronella_engleriana,61,44,17,Alphahull-PointsKO-Adjacents,512
Citronella_gongonha,357,304,53,Alphahull-PointsKO-Adjacents,20102
Citronella_incarum,280,238,42,Alphahull-PointsKO-Adjacents,6097
Citronella_latifolia,0,0,0,NA,0
Citronella_macrocarpa,8,1,7,Points-PointsKO-Adjacents,63
Citronella_melliodora,159,118,41,Alphahull-PointsKO-Adjacents,3786
Citronella_moorei,659,0,659,Points-PointsKO-Adjacents,1201
Citronella_mucronata,68,41,27,Alphahull-PointsKO-Adjacents,623
Citronella_paniculata,823,735,88,Alphahull-PointsKO-Adjacents,18724
Citronella_philippinensis,0,0,0,NA,0
Citronella_samoensis,2,2,0,Points-PointsKO-Adjacents,15
Citronella_sarmentosa,43,30,13,Alphahull-PointsKO-Adjacents,219
Citronella_silvatica,8,2,6,Points-PointsKO-Adjacents,66
Citronella_smythii,142,123,19,Alphahull-PointsKO-Adjacents,346
Citronella_suaveolens,43,22,21,Alphahull-PointsKO-Adjacents,294
Citronella_vitiensis,5,5,0,Points-PointsKO-Adjacents,30
Citropsis_angolensis,1,1,0,Points-PointsKO-Adjacents,9
Citropsis_articulata,74,29,45,Alphahull-PointsKO-Adjacents,1957
Citropsis_daweana,7,2,5,Points-PointsKO-Adjacents,63
Citropsis_gabunensis,3,3,0,Points-PointsKO-Adjacents,25
Citropsis_gilletiana,1,1,0,Points-PointsKO-Adjacents,9
Citropsis_latialata,8,1,7,Points-PointsKO-Adjacents,60
Citropsis_le-testui,1,1,0,Points-PointsKO-Adjacents,9
Citropsis_noldeae,1,1,0,Points-PointsKO-Adjacents,9
Citrus_assamensis,0,0,0,NA,0
Citrus_aurantiaca,4,0,4,Points-PointsKO-Adjacents,29
Citrus_australasica,139,0,139,Points-PointsKO-Adjacents,249
Citrus_australis,72,56,16,Alphahull-PointsKO-Adjacents,263
Citrus_cavaleriei,22,4,18,Points-PointsKO-Adjacents,198
Citrus_garrawayi,62,45,17,Alphahull-PointsKO-Adjacents,326
Citrus_glauca,397,355,42,Alphahull-PointsKO-Adjacents,11335
Citrus_gracilis,50,38,12,Alphahull-PointsKO-Adjacents,756
Citrus_halimii,6,2,4,Points-PointsKO-Adjacents,39
Citrus_hystrix,66,17,49,Points-PointsKO-Adjacents,502
Citrus_indica,0,0,0,NA,0
Citrus_inodora,22,14,8,Points-PointsKO-Adjacents,76
Citrus_japonica,47,17,30,Points-PointsKO-Adjacents,422
Citrus_latipes,0,0,0,NA,0
Citrus_lucida,8,1,7,Points-PointsKO-Adjacents,61
Citrus_maxima,157,66,91,Alphahull-PointsKO-Adjacents,5579
Citrus_medica,3,2,1,Points-PointsKO-Adjacents,27
Citrus_swinglei,3,3,0,Points-PointsKO-Adjacents,27
Citrus_trifoliata,64,31,33,Alphahull-PointsKO-Adjacents,5003
Citrus_warburgina,NA,NA,NA,NA,NA
Citrus_wintersii,12,9,3,Points-PointsKO-Adjacents,27
Cladogynos_orientalis,27,4,23,Points-PointsKO-Adjacents,230
Cladostemon_kirkii,41,18,23,Points-PointsKO-Adjacents,299
Cladrastis_chingii,1,1,0,Points-PointsKO-Adjacents,9
Cladrastis_delavayi,4,4,0,Points-PointsKO-Adjacents,36
Cladrastis_kentukea,200,121,79,Alphahull-PointsKO-Adjacents,7216
Cladrastis_parvifolia,1,1,0,Points-PointsKO-Adjacents,9
Cladrastis_platycarpa,108,70,38,Alphahull-PointsKO-Adjacents,1362
Cladrastis_scandens,NA,NA,NA,NA,NA
Cladrastis_wilsonii,15,4,11,Points-PointsKO-Adjacents,135
Claoxylon_angustifolium,58,43,15,Alphahull-PointsKO-Adjacents,110
Claoxylon_arboreum,2,2,0,Points-PointsKO-Adjacents,18
Claoxylon_australe,1678,0,1678,Points-PointsKO-Adjacents,1939
Claoxylon_brachyandrum,4,4,0,Points-PointsKO-Adjacents,30
Claoxylon_capillipes,31,1,30,Points-PointsKO-Adjacents,72
Claoxylon_carinatum,0,0,0,NA,0
Claoxylon_carolinianum,7,5,2,Points-PointsKO-Adjacents,11
Claoxylon_carrii,3,3,0,Points-PointsKO-Adjacents,18
Claoxylon_centenarium,0,0,0,NA,0
Claoxylon_collenettei,2,2,0,Points-PointsKO-Adjacents,4
Claoxylon_coriaceolanatum,27,21,6,Alphahull-PointsKO-Adjacents,141
Claoxylon_cuneatum,4,4,0,Points-PointsKO-Adjacents,35
Claoxylon_decaryanum,1,1,0,Points-PointsKO-Adjacents,9
Claoxylon_echinospermum,7,3,4,Points-PointsKO-Adjacents,39
Claoxylon_fallax,1,1,0,Points-PointsKO-Adjacents,7
Claoxylon_gillisonii,10,6,4,Points-PointsKO-Adjacents,50
Claoxylon_glandulosum,0,0,0,NA,0
Claoxylon_goodenoviense,0,0,0,NA,0
Claoxylon_hillii,187,141,46,Alphahull-PointsKO-Adjacents,1542
Claoxylon_indicum,147,61,86,Alphahull-PointsKO-Adjacents,2746
Claoxylon_insulanum,35,25,10,Alphahull-PointsKO-Adjacents,250
Claoxylon_khasianum,1,1,0,Points-PointsKO-Adjacents,9
Claoxylon_kinabaluense,4,4,0,Points-PointsKO-Adjacents,24
Claoxylon_ledermannii,39,15,24,Points-PointsKO-Adjacents,235
Claoxylon_linostachys,0,0,0,NA,0
Claoxylon_longifolium,80,0,80,Points-PointsKO-Adjacents,644
Claoxylon_longipetiolatum,0,0,0,NA,0
Claoxylon_longiracemosum,0,0,0,NA,0
Claoxylon_lutescens,45,32,13,Alphahull-PointsKO-Adjacents,398
Claoxylon_marianum,0,0,0,NA,0
Claoxylon_microcarpum,13,1,12,Points-PointsKO-Adjacents,79
Claoxylon_muscisilvae,9,3,6,Points-PointsKO-Adjacents,58
Claoxylon_neoebudicum,5,5,0,Points-PointsKO-Adjacents,31
Claoxylon_nervosum,0,0,0,NA,0
Claoxylon_nubicola,41,36,5,Alphahull-PointsKO-Adjacents,211
Claoxylon_oliganthum,2,2,0,Points-PointsKO-Adjacents,18
Claoxylon_ooumuense,3,3,0,Points-PointsKO-Adjacents,11
Claoxylon_papuae,167,138,29,Alphahull-PointsKO-Adjacents,3724
Claoxylon_paucinerve,9,3,6,Points-PointsKO-Adjacents,59
Claoxylon_physocarpum,4,4,0,Points-PointsKO-Adjacents,27
Claoxylon_platyphyllum,0,0,0,NA,0
Claoxylon_porphyrostemon,2,2,0,Points-PointsKO-Adjacents,18
Claoxylon_praetermissum,2,2,0,Points-PointsKO-Adjacents,18
Claoxylon_pseudoinsulanum,0,0,0,NA,0
Claoxylon_psilogyne,6,0,6,Points-PointsKO-Adjacents,41
Claoxylon_purpureum,4,4,0,Points-PointsKO-Adjacents,33
Claoxylon_putii,1,1,0,Points-PointsKO-Adjacents,9
Claoxylon_rostratum,0,0,0,NA,0
Claoxylon_salicinum,3,3,0,Points-PointsKO-Adjacents,21
Claoxylon_salomonense,8,0,8,Points-PointsKO-Adjacents,51
Claoxylon_samoense,2,2,0,Points-PointsKO-Adjacents,18
Claoxylon_sandwicense,14,6,8,Points-PointsKO-Adjacents,72
Claoxylon_scabratum,17,5,12,Points-PointsKO-Adjacents,107
Claoxylon_setosum,0,0,0,NA,0
Claoxylon_stapfianum,6,1,5,Points-PointsKO-Adjacents,33
Claoxylon_taitense,15,11,4,Points-PointsKO-Adjacents,33
Claoxylon_tenerifolium,218,169,49,Alphahull-PointsKO-Adjacents,2158
Claoxylon_tenuiflorum,1,1,0,Points-PointsKO-Adjacents,9
Claoxylon_tetracoccum,0,0,0,NA,0
Claoxylon_vitiense,0,0,0,NA,0
Claoxylon_wallichianum,0,0,0,NA,0
Claoxylopsis_andapensis,2,2,0,Points-PointsKO-Adjacents,12
Clappertonia_ficifolia,190,111,79,Alphahull-PointsKO-Adjacents,6882
Clarisia_biflora,813,708,105,Alphahull-PointsKO-Adjacents,27334
Clarisia_ilicifolia,574,460,114,Alphahull-PointsKO-Adjacents,41149
Clarisia_racemosa,851,717,134,Alphahull-PointsKO-Adjacents,74188
Clathrotropis_brachypetala,113,87,26,Alphahull-PointsKO-Adjacents,4580
Clathrotropis_brunnea,54,43,11,Alphahull-PointsKO-Adjacents,314
Clathrotropis_glaucophylla,73,56,17,Alphahull-PointsKO-Adjacents,3648
Clathrotropis_macrocarpa,281,248,33,Alphahull-PointsKO-Adjacents,13946
Clathrotropis_nitida,142,111,31,Alphahull-PointsKO-Adjacents,6151
Clathrotropis_paradoxa,15,9,6,Points-PointsKO-Adjacents,58
Clausena_anisata,511,371,140,Alphahull-PointsKO-Adjacents,14962
Clausena_austroindica,0,0,0,NA,0
Clausena_brevistyla,122,73,49,Alphahull-PointsKO-Adjacents,676
Clausena_engleri,0,0,0,NA,0
Clausena_excavata,155,91,64,Alphahull-PointsKO-Adjacents,5754
Clausena_hainanensis,NA,NA,NA,NA,NA
Clausena_harmandiana,7,0,7,Points-PointsKO-Adjacents,63
Clausena_heptaphylla,1,1,0,Points-PointsKO-Adjacents,9
Clausena_indica,4,0,4,Points-PointsKO-Adjacents,27
Clausena_lansium,29,12,17,Points-PointsKO-Adjacents,252
Clausena_lenis,19,8,11,Points-PointsKO-Adjacents,171
Clausena_sanki,2,2,0,Points-PointsKO-Adjacents,18
Clausena_smyrelliana,3,3,0,Points-PointsKO-Adjacents,20
Clausena_wallichii,4,4,0,Points-PointsKO-Adjacents,30
Clavija_biborrana,67,43,24,Alphahull-PointsKO-Adjacents,249
Clavija_cauliflora,9,3,6,Points-PointsKO-Adjacents,62
Clavija_costaricana,171,142,29,Alphahull-PointsKO-Adjacents,1148
Clavija_domingensis,3,3,0,Points-PointsKO-Adjacents,27
Clavija_eggersiana,43,32,11,Alphahull-PointsKO-Adjacents,625
Clavija_elliptica,25,13,12,Points-PointsKO-Adjacents,190
Clavija_fusca,25,13,12,Points-PointsKO-Adjacents,152
Clavija_grandis,7,0,7,Points-PointsKO-Adjacents,57
Clavija_hookeri,13,4,9,Points-PointsKO-Adjacents,100
Clavija_imatacae,11,4,7,Points-PointsKO-Adjacents,87
Clavija_jelskii,5,5,0,Points-PointsKO-Adjacents,36
Clavija_kalbreyeri,0,0,0,NA,0
Clavija_killipii,2,2,0,Points-PointsKO-Adjacents,18
Clavija_lancifolia,185,128,57,Alphahull-PointsKO-Adjacents,19279
Clavija_lehmannii,6,1,5,Points-PointsKO-Adjacents,48
Clavija_macrocarpa,25,16,9,Points-PointsKO-Adjacents,138
Clavija_membranacea,62,47,15,Alphahull-PointsKO-Adjacents,1141
Clavija_mezii,106,90,16,Alphahull-PointsKO-Adjacents,1107
Clavija_neglecta,0,0,0,NA,0
Clavija_nutans,378,311,67,Alphahull-PointsKO-Adjacents,14227
Clavija_ornata,115,85,30,Alphahull-PointsKO-Adjacents,5182
Clavija_parvula,6,1,5,Points-PointsKO-Adjacents,41
Clavija_plumbea,1,1,0,Points-PointsKO-Adjacents,9
Clavija_poeppigii,53,31,22,Alphahull-PointsKO-Adjacents,934
Clavija_procera,21,14,7,Points-PointsKO-Adjacents,145
Clavija_pubens,7,2,5,Points-PointsKO-Adjacents,39
Clavija_repanda,5,5,0,Points-PointsKO-Adjacents,45
Clavija_sanctae-martae,8,1,7,Points-PointsKO-Adjacents,62
Clavija_subandina,3,3,0,Points-PointsKO-Adjacents,21
Clavija_tarapotana,83,55,28,Alphahull-PointsKO-Adjacents,2769
Clavija_weberbaueri,365,323,42,Alphahull-PointsKO-Adjacents,16437
Cleidiocarpon_cavaleriei,2,2,0,Points-PointsKO-Adjacents,18
Cleidiocarpon_laurinum,0,0,0,NA,0
Cleidion_amazonicum,94,50,44,Alphahull-PointsKO-Adjacents,11243
Cleidion_bracteosum,7,3,4,Points-PointsKO-Adjacents,63
Cleidion_brevipetiolatum,59,32,27,Alphahull-PointsKO-Adjacents,3394
Cleidion_capuronii,5,5,0,Points-PointsKO-Adjacents,42
Cleidion_castaneifolium,138,92,46,Alphahull-PointsKO-Adjacents,1999
Cleidion_claoxyloides,26,16,10,Points-PointsKO-Adjacents,121
Cleidion_gabonicum,34,23,11,Alphahull-PointsKO-Adjacents,523
Cleidion_javanicum,178,0,178,Points-PointsKO-Adjacents,1023
Cleidion_lasiophyllum,40,30,10,Alphahull-PointsKO-Adjacents,65
Cleidion_lemurum,1,1,0,Points-PointsKO-Adjacents,9
Cleidion_leptostachyum,1,1,0,Points-PointsKO-Adjacents,9
Cleidion_lochmios,2,2,0,Points-PointsKO-Adjacents,17
Cleidion_luziae,0,0,0,NA,0
Cleidion_macarangoides,13,9,4,Points-PointsKO-Adjacents,58
Cleidion_macrophyllum,19,11,8,Points-PointsKO-Adjacents,69
Cleidion_marginatum,3,3,0,Points-PointsKO-Adjacents,18
Cleidion_megistophyllum,0,0,0,NA,0
Cleidion_microcarpum,4,0,4,Points-PointsKO-Adjacents,30
Cleidion_minahassae,NA,NA,NA,NA,NA
Cleidion_moniliflorum,2,2,0,Points-PointsKO-Adjacents,14
Cleidion_nitidum,2,2,0,Points-PointsKO-Adjacents,14
Cleidion_papuanum,16,2,14,Points-PointsKO-Adjacents,91
Cleidion_ramosii,6,1,5,Points-PointsKO-Adjacents,47
Cleidion_sessile,2,2,0,Points-PointsKO-Adjacents,6
Cleidion_spathulatum,42,29,13,Alphahull-PointsKO-Adjacents,99
Cleidion_taynguyenense,NA,NA,NA,NA,NA
Cleidion_tricoccum,15,3,12,Points-PointsKO-Adjacents,115
Cleidion_veillonii,6,1,5,Points-PointsKO-Adjacents,28
Cleidion_vieillardii,173,157,16,Alphahull-PointsKO-Adjacents,339
Cleistanthus_angustifolius,1,1,0,Points-PointsKO-Adjacents,9
Cleistanthus_apodus,163,133,30,Alphahull-PointsKO-Adjacents,913
Cleistanthus_bakonensis,4,4,0,Points-PointsKO-Adjacents,36
Cleistanthus_baramicus,3,3,0,Points-PointsKO-Adjacents,16
Cleistanthus_beccarianus,0,0,0,NA,0
Cleistanthus_bipindensis,12,5,7,Points-PointsKO-Adjacents,77
Cleistanthus_bracteosus,1,1,0,Points-PointsKO-Adjacents,9
Cleistanthus_brideliifolius,6,0,6,Points-PointsKO-Adjacents,53
Cleistanthus_capuronii,14,4,10,Points-PointsKO-Adjacents,75
Cleistanthus_carolinianus,2,2,0,Points-PointsKO-Adjacents,12
Cleistanthus_caudatus,114,82,32,Alphahull-PointsKO-Adjacents,5439
Cleistanthus_celebicus,1,1,0,Points-PointsKO-Adjacents,9
Cleistanthus_chlorocarpus,0,0,0,NA,0
Cleistanthus_collinus,0,0,0,NA,0
Cleistanthus_contractus,0,0,0,NA,0
Cleistanthus_coriaceus,1,1,0,Points-PointsKO-Adjacents,9
Cleistanthus_cunninghamii,595,547,48,Alphahull-PointsKO-Adjacents,1641
Cleistanthus_dallachyanus,44,28,16,Alphahull-PointsKO-Adjacents,237
Cleistanthus_decurrens,6,1,5,Points-PointsKO-Adjacents,43
Cleistanthus_denudatus,3,3,0,Points-PointsKO-Adjacents,26
Cleistanthus_duvipermaniorum,3,3,0,Points-PointsKO-Adjacents,21
Cleistanthus_ellipticus,1,1,0,Points-PointsKO-Adjacents,9
Cleistanthus_elongatus,0,0,0,NA,0
Cleistanthus_erycibifolius,4,4,0,Points-PointsKO-Adjacents,27
Cleistanthus_everettii,2,2,0,Points-PointsKO-Adjacents,18
Cleistanthus_evrardii,1,1,0,Points-PointsKO-Adjacents,9
Cleistanthus_ferrugineus,4,4,0,Points-PointsKO-Adjacents,30
Cleistanthus_flavescens,NA,NA,NA,NA,NA
Cleistanthus_floricola,0,0,0,NA,0
Cleistanthus_gabonensis,44,35,9,Alphahull-PointsKO-Adjacents,959
Cleistanthus_glaber,3,3,0,Points-PointsKO-Adjacents,27
Cleistanthus_glabratus,0,0,0,NA,0
Cleistanthus_glandulosus,0,0,0,NA,0
Cleistanthus_gracilis,3,2,1,Points-PointsKO-Adjacents,22
Cleistanthus_helferi,9,3,6,Points-PointsKO-Adjacents,68
Cleistanthus_hirsutipetalus,0,0,0,NA,0
Cleistanthus_hirsutulus,8,0,8,Points-PointsKO-Adjacents,69
Cleistanthus_hylandii,58,47,11,Alphahull-PointsKO-Adjacents,198
Cleistanthus_inglorius,2,2,0,Points-PointsKO-Adjacents,14
Cleistanthus_insignis,17,2,15,Points-PointsKO-Adjacents,72
Cleistanthus_insularis,NA,NA,NA,NA,NA
Cleistanthus_inundatus,16,10,6,Points-PointsKO-Adjacents,127
Cleistanthus_isabellinus,2,2,0,Points-PointsKO-Adjacents,8
Cleistanthus_itsoghensis,31,22,9,Alphahull-PointsKO-Adjacents,748
Cleistanthus_jacobsianus,1,1,0,Points-PointsKO-Adjacents,9
Cleistanthus_kingii,0,0,0,NA,0
Cleistanthus_kwangensis,2,2,0,Points-PointsKO-Adjacents,16
Cleistanthus_langkawiensis,0,0,0,NA,0
Cleistanthus_lanuginosus,0,0,0,NA,0
Cleistanthus_letouzeyi,33,21,12,Alphahull-PointsKO-Adjacents,1637
Cleistanthus_libericus,14,2,12,Points-PointsKO-Adjacents,98
Cleistanthus_longinervis,NA,NA,NA,NA,NA
Cleistanthus_macrophyllus,3,3,0,Points-PointsKO-Adjacents,27
Cleistanthus_maingayi,5,5,0,Points-PointsKO-Adjacents,30
Cleistanthus_major,NA,NA,NA,NA,NA
Cleistanthus_malabaricus,1,1,0,Points-PointsKO-Adjacents,9
Cleistanthus_malaccensis,0,0,0,NA,0
Cleistanthus_meeboldii,NA,NA,NA,NA,NA
Cleistanthus_megacarpus,5,5,0,Points-PointsKO-Adjacents,44
Cleistanthus_membranaceus,1,1,0,Points-PointsKO-Adjacents,9
Cleistanthus_micranthus,0,0,0,NA,0
Cleistanthus_monoicus,7,3,4,Points-PointsKO-Adjacents,63
Cleistanthus_morii,0,0,0,NA,0
Cleistanthus_namatanaiensis,NA,NA,NA,NA,NA
Cleistanthus_ngounyensis,30,21,9,Alphahull-PointsKO-Adjacents,198
Cleistanthus_nitidus,0,0,0,NA,0
Cleistanthus_normanbyanus,3,3,0,Points-PointsKO-Adjacents,10
Cleistanthus_oblongatus,0,0,0,NA,0
Cleistanthus_oblongifolius,67,35,32,Alphahull-PointsKO-Adjacents,252
Cleistanthus_occidentalis,9,1,8,Points-PointsKO-Adjacents,72
Cleistanthus_pallidus,3,3,0,Points-PointsKO-Adjacents,27
Cleistanthus_papuanus,4,4,0,Points-PointsKO-Adjacents,30
Cleistanthus_parvifolius,0,0,0,NA,0
Cleistanthus_patulus,2,2,0,Points-PointsKO-Adjacents,18
Cleistanthus_paxii,0,0,0,NA,0
Cleistanthus_pedicellatus,12,0,12,Points-PointsKO-Adjacents,95
Cleistanthus_perrieri,23,0,23,Points-PointsKO-Adjacents,137
Cleistanthus_petelotii,0,0,0,NA,0
Cleistanthus_pierlotii,5,5,0,Points-PointsKO-Adjacents,45
Cleistanthus_pilosus,NA,NA,NA,NA,NA
Cleistanthus_podocarpus,0,0,0,NA,0
Cleistanthus_podopyxis,1,1,0,Points-PointsKO-Adjacents,9
Cleistanthus_polyneurus,NA,NA,NA,NA,NA
Cleistanthus_polyphyllus,1,1,0,Points-PointsKO-Adjacents,9
Cleistanthus_polystachyus,99,46,53,Alphahull-PointsKO-Adjacents,2639
Cleistanthus_praetermissus,0,0,0,NA,0
Cleistanthus_pseudopodocarpus,3,0,3,Points-PointsKO-Adjacents,27
Cleistanthus_pubens,5,5,0,Points-PointsKO-Adjacents,37
Cleistanthus_pyrrhocarpus,2,2,0,Points-PointsKO-Adjacents,18
Cleistanthus_ripicola,11,0,11,Points-PointsKO-Adjacents,72
Cleistanthus_robinsonii,2,2,0,Points-PointsKO-Adjacents,8
Cleistanthus_robustus,2,2,0,Points-PointsKO-Adjacents,18
Cleistanthus_rotundatus,0,0,0,NA,0
Cleistanthus_rufescens,5,5,0,Points-PointsKO-Adjacents,27
Cleistanthus_rufus,0,0,0,NA,0
Cleistanthus_salicifolius,0,0,0,NA,0
Cleistanthus_schlechteri,44,13,31,Points-PointsKO-Adjacents,353
Cleistanthus_semiopacus,60,42,18,Alphahull-PointsKO-Adjacents,173
Cleistanthus_stenonia,13,6,7,Points-PointsKO-Adjacents,67
Cleistanthus_stenophyllus,0,0,0,NA,0
Cleistanthus_stipitatus,57,44,13,Alphahull-PointsKO-Adjacents,232
Cleistanthus_striatus,0,0,0,NA,0
Cleistanthus_suarezensis,12,6,6,Points-PointsKO-Adjacents,67
Cleistanthus_sumatranus,42,13,29,Points-PointsKO-Adjacents,302
Cleistanthus_tomentosus,5,1,4,Points-PointsKO-Adjacents,45
Cleistanthus_tonkinensis,7,2,5,Points-PointsKO-Adjacents,57
Cleistanthus_travancorensis,0,0,0,NA,0
Cleistanthus_venosus,2,2,0,Points-PointsKO-Adjacents,18
Cleistanthus_vestitus,6,0,6,Points-PointsKO-Adjacents,41
Cleistanthus_winkleri,2,2,0,Points-PointsKO-Adjacents,11
Cleistanthus_xanthopus,2,2,0,Points-PointsKO-Adjacents,17
Cleistanthus_zenkeri,8,1,7,Points-PointsKO-Adjacents,68
Cleistocactus_sepium,47,31,16,Alphahull-PointsKO-Adjacents,111
Cleistochlamys_kirkii,37,10,27,Points-PointsKO-Adjacents,276
Cleistopholis_glauca,89,52,37,Alphahull-PointsKO-Adjacents,3576
Cleistopholis_patens,261,187,74,Alphahull-PointsKO-Adjacents,6985
Cleistopholis_staudtii,36,22,14,Alphahull-PointsKO-Adjacents,465
Cleome_glandulosa,17,4,13,Points-PointsKO-Adjacents,125
Cleome_lechleri,63,36,27,Alphahull-PointsKO-Adjacents,267
Clermontia_arborescens,9,5,4,Points-PointsKO-Adjacents,32
Clermontia_calophylla,0,0,0,NA,0
Clermontia_clermontioides,6,2,4,Points-PointsKO-Adjacents,40
Clermontia_drepanomorpha,0,0,0,NA,0
Clermontia_fauriei,6,2,4,Points-PointsKO-Adjacents,32
Clermontia_grandiflora,6,1,5,Points-PointsKO-Adjacents,43
Clermontia_hawaiiensis,9,4,5,Points-PointsKO-Adjacents,32
Clermontia_kakeana,8,4,4,Points-PointsKO-Adjacents,47
Clermontia_kohalae,3,3,0,Points-PointsKO-Adjacents,20
Clermontia_lindseyana,9,4,5,Points-PointsKO-Adjacents,43
Clermontia_micrantha,5,5,0,Points-PointsKO-Adjacents,28
Clermontia_montis-loa,9,5,4,Points-PointsKO-Adjacents,31
Clermontia_oblongifolia,6,1,5,Points-PointsKO-Adjacents,37
Clermontia_pallida,3,3,0,Points-PointsKO-Adjacents,9
Clermontia_parviflora,24,17,7,Points-PointsKO-Adjacents,74
Clermontia_peleana,2,2,0,Points-PointsKO-Adjacents,18
Clermontia_persicifolia,4,3,1,Points-PointsKO-Adjacents,27
Clermontia_pyrularia,2,2,0,Points-PointsKO-Adjacents,18
Clermontia_samuelii,6,4,2,Points-PointsKO-Adjacents,10
Clermontia_tuberculata,1,1,0,Points-PointsKO-Adjacents,9
Clermontia_waimeae,0,0,0,NA,0
Clerodendrum_adenophysum,60,37,23,Alphahull-PointsKO-Adjacents,3115
Clerodendrum_africanum,1,1,0,Points-PointsKO-Adjacents,9
Clerodendrum_anafense,1,1,0,Points-PointsKO-Adjacents,9
Clerodendrum_aucubifolium,13,3,10,Points-PointsKO-Adjacents,105
Clerodendrum_bosseri,3,3,0,Points-PointsKO-Adjacents,26
Clerodendrum_brachystemon,2,2,0,Points-PointsKO-Adjacents,18
Clerodendrum_bracteatum,8,3,5,Points-PointsKO-Adjacents,30
Clerodendrum_bungei,100,59,41,Alphahull-PointsKO-Adjacents,12616
Clerodendrum_calcicola,5,5,0,Points-PointsKO-Adjacents,25
Clerodendrum_capitatum,355,277,78,Alphahull-PointsKO-Adjacents,8654
Clerodendrum_cauliflorum,6,1,5,Points-PointsKO-Adjacents,42
Clerodendrum_cephalanthum,109,75,34,Alphahull-PointsKO-Adjacents,1523
Clerodendrum_chinense,33,16,17,Points-PointsKO-Adjacents,271
Clerodendrum_comans,0,0,0,NA,0
Clerodendrum_costatum,529,466,63,Alphahull-PointsKO-Adjacents,3473
Clerodendrum_cyrtophyllum,326,251,75,Alphahull-PointsKO-Adjacents,11533
Clerodendrum_decaryi,2,2,0,Points-PointsKO-Adjacents,18
Clerodendrum_denticulatum,1,1,0,Points-PointsKO-Adjacents,9
Clerodendrum_disparifolium,107,0,107,Points-PointsKO-Adjacents,757
Clerodendrum_ekmanii,5,5,0,Points-PointsKO-Adjacents,35
Clerodendrum_emirnense,12,4,8,Points-PointsKO-Adjacents,95
Clerodendrum_eucalycinum,4,4,0,Points-PointsKO-Adjacents,36
Clerodendrum_floribundum,2127,1991,136,Alphahull-PointsKO-Adjacents,41579
Clerodendrum_formicarum,72,27,45,Alphahull-PointsKO-Adjacents,1618
Clerodendrum_galeatum,3,3,0,Points-PointsKO-Adjacents,12
Clerodendrum_glandulosum,6,0,6,Points-PointsKO-Adjacents,45
Clerodendrum_grevei,2,2,0,Points-PointsKO-Adjacents,18
Clerodendrum_griffithianum,6,1,5,Points-PointsKO-Adjacents,54
Clerodendrum_hildebrandtii,41,23,18,Alphahull-PointsKO-Adjacents,452
Clerodendrum_hircinum,10,2,8,Points-PointsKO-Adjacents,73
Clerodendrum_hiulcum,6,0,6,Points-PointsKO-Adjacents,44
Clerodendrum_indicum,10,0,10,Points-PointsKO-Adjacents,87
Clerodendrum_involucratum,36,19,17,Points-PointsKO-Adjacents,268
Clerodendrum_japonicum,55,24,31,Alphahull-PointsKO-Adjacents,1018
Clerodendrum_johnstonii,50,28,22,Alphahull-PointsKO-Adjacents,1404
Clerodendrum_kaichianum,1,1,0,Points-PointsKO-Adjacents,9
Clerodendrum_kauderni,4,4,0,Points-PointsKO-Adjacents,32
Clerodendrum_kinabaluense,19,15,4,Points-PointsKO-Adjacents,39
Clerodendrum_kwangtungense,18,6,12,Points-PointsKO-Adjacents,162
Clerodendrum_laciniatum,0,0,0,NA,0
Clerodendrum_laevifolium,29,14,15,Points-PointsKO-Adjacents,233
Clerodendrum_laxiflorum,3,3,0,Points-PointsKO-Adjacents,27
Clerodendrum_leucophloeum,6,3,3,Points-PointsKO-Adjacents,27
Clerodendrum_macrostegium,22,8,14,Points-PointsKO-Adjacents,138
Clerodendrum_madagascariense,3,2,1,Points-PointsKO-Adjacents,27
Clerodendrum_magnoliifolium,11,5,6,Points-PointsKO-Adjacents,91
Clerodendrum_mandarinorum,69,45,24,Alphahull-PointsKO-Adjacents,6498
Clerodendrum_margaritense,3,3,0,Points-PointsKO-Adjacents,27
Clerodendrum_petunioides,13,4,9,Points-PointsKO-Adjacents,89
Clerodendrum_phlomidis,0,0,0,NA,0
Clerodendrum_poggei,19,3,16,Points-PointsKO-Adjacents,153
Clerodendrum_polyanthum,0,0,0,NA,0
Clerodendrum_pauciflorum,0,0,0,NA,0
Clerodendrum_roseiflorum,8,3,5,Points-PointsKO-Adjacents,27
Clerodendrum_rotundifolium,32,14,18,Points-PointsKO-Adjacents,261
Clerodendrum_rubellum,17,4,13,Points-PointsKO-Adjacents,105
Clerodendrum_smitinandii,1,1,0,Points-PointsKO-Adjacents,9
Clerodendrum_tanganyikense,9,1,8,Points-PointsKO-Adjacents,60
Clerodendrum_tessmannii,29,13,16,Points-PointsKO-Adjacents,217
Clerodendrum_tomentellum,0,0,0,NA,0
Clerodendrum_tomentosum,2540,2244,296,Alphahull-PointsKO-Adjacents,15177
Clerodendrum_tracyanum,214,148,66,Alphahull-PointsKO-Adjacents,4076
Clerodendrum_trichanthum,5,5,0,Points-PointsKO-Adjacents,43
Clerodendrum_trichotomum,479,302,177,Alphahull-PointsKO-Adjacents,1376
Clerodendrum_tuberculatum,0,0,0,NA,0
Clerodendrum_villosum,69,25,44,Alphahull-PointsKO-Adjacents,851
Clethra_acuminata,313,283,30,Alphahull-PointsKO-Adjacents,1762
Clethra_alcoceri,70,53,17,Alphahull-PointsKO-Adjacents,296
Clethra_alexandri,3,2,1,Points-PointsKO-Adjacents,18
Clethra_alnifolia,1062,838,224,Alphahull-PointsKO-Adjacents,7947
Clethra_arborea,17,11,6,Points-PointsKO-Adjacents,34
Clethra_arfakana,1,1,0,Points-PointsKO-Adjacents,9
Clethra_barbinervis,479,360,119,Alphahull-PointsKO-Adjacents,2834
Clethra_bodinieri,16,6,10,Points-PointsKO-Adjacents,144
Clethra_canescens,13,5,8,Points-PointsKO-Adjacents,95
Clethra_cardenasii,23,12,11,Points-PointsKO-Adjacents,86
Clethra_castaneifolia,42,24,18,Alphahull-PointsKO-Adjacents,575
Clethra_chiapensis,6,1,5,Points-PointsKO-Adjacents,42
Clethra_coloradensis,8,3,5,Points-PointsKO-Adjacents,43
Clethra_conzattiana,13,10,3,Points-PointsKO-Adjacents,49
Clethra_crispa,14,5,9,Points-PointsKO-Adjacents,91
Clethra_cuneata,72,47,25,Alphahull-PointsKO-Adjacents,512
Clethra_delavayi,115,82,33,Alphahull-PointsKO-Adjacents,9215
Clethra_elongata,46,33,13,Alphahull-PointsKO-Adjacents,358
Clethra_fabri,15,6,9,Points-PointsKO-Adjacents,135
Clethra_fagifolia,383,332,51,Alphahull-PointsKO-Adjacents,4115
Clethra_fargesii,33,19,14,Points-PointsKO-Adjacents,297
Clethra_ferruginea,55,25,30,Alphahull-PointsKO-Adjacents,324
Clethra_fimbriata,249,208,41,Alphahull-PointsKO-Adjacents,1818
Clethra_formosa,29,21,8,Alphahull-PointsKO-Adjacents,73
Clethra_fragrans,3,3,0,Points-PointsKO-Adjacents,27
Clethra_galeottiana,34,28,6,Alphahull-PointsKO-Adjacents,193
Clethra_gelida,38,27,11,Alphahull-PointsKO-Adjacents,79
Clethra_guyanensis,31,22,9,Alphahull-PointsKO-Adjacents,364
Clethra_hartwegii,101,82,19,Alphahull-PointsKO-Adjacents,1898
Clethra_hendersonii,2,2,0,Points-PointsKO-Adjacents,12
Clethra_hondurensis,95,66,29,Alphahull-PointsKO-Adjacents,1876
Clethra_javanica,1,1,0,Points-PointsKO-Adjacents,9
Clethra_kebarensis,1,1,0,Points-PointsKO-Adjacents,9
Clethra_licanioides,7,0,7,Points-PointsKO-Adjacents,63
Clethra_longispicata,13,6,7,Points-PointsKO-Adjacents,74
Clethra_luzmariae,4,4,0,Points-PointsKO-Adjacents,18
Clethra_macrophylla,192,155,37,Alphahull-PointsKO-Adjacents,1419
Clethra_mexicana,1089,966,123,Alphahull-PointsKO-Adjacents,12498
Clethra_oaxacana,2,2,0,Points-PointsKO-Adjacents,18
Clethra_obovata,64,44,20,Alphahull-PointsKO-Adjacents,1099
Clethra_occidentalis,12,5,7,Points-PointsKO-Adjacents,57
Clethra_oleoides,30,0,30,Points-PointsKO-Adjacents,106
Clethra_ovalifolia,148,117,31,Alphahull-PointsKO-Adjacents,2034
Clethra_pachecoana,32,16,16,Points-PointsKO-Adjacents,199
Clethra_pachyphylla,11,8,3,Points-PointsKO-Adjacents,46
Clethra_papuana,0,0,0,NA,0
Clethra_parallelinervia,9,4,5,Points-PointsKO-Adjacents,60
Clethra_pedicellaris,54,29,25,Alphahull-PointsKO-Adjacents,423
Clethra_peruviana,16,6,10,Points-PointsKO-Adjacents,130
Clethra_petelotii,3,3,0,Points-PointsKO-Adjacents,18
Clethra_poilanei,1,1,0,Points-PointsKO-Adjacents,9
Clethra_pringlei,158,143,15,Alphahull-PointsKO-Adjacents,2827
Clethra_pulgarensis,1,1,0,Points-PointsKO-Adjacents,9
Clethra_purpusii,7,1,6,Points-PointsKO-Adjacents,43
Clethra_pyrogena,32,23,9,Alphahull-PointsKO-Adjacents,104
Clethra_repanda,56,34,22,Alphahull-PointsKO-Adjacents,1354
Clethra_retivenia,2,2,0,Points-PointsKO-Adjacents,18
Clethra_revoluta,254,201,53,Alphahull-PointsKO-Adjacents,3555
Clethra_rosei,86,49,37,Alphahull-PointsKO-Adjacents,950
Clethra_rugosa,26,8,18,Points-PointsKO-Adjacents,177
Clethra_scabra,1216,1117,99,Alphahull-PointsKO-Adjacents,13145
Clethra_skutchii,4,4,0,Points-PointsKO-Adjacents,36
Clethra_sleumeriana,NA,NA,NA,NA,NA
Clethra_suaveolens,153,134,19,Alphahull-PointsKO-Adjacents,1651
Clethra_sumatrana,2,2,0,Points-PointsKO-Adjacents,18
Clethra_sumbawaensis,1,1,0,Points-PointsKO-Adjacents,9
Clethra_talamancana,9,5,4,Points-PointsKO-Adjacents,39
Clethra_tomentella,1,1,0,Points-PointsKO-Adjacents,9
Clethra_tutensis,3,3,0,Points-PointsKO-Adjacents,23
Clethra_tuxtlensis,4,4,0,Points-PointsKO-Adjacents,27
Clethra_uleana,79,70,9,Alphahull-PointsKO-Adjacents,914
Clethra_vicentina,93,72,21,Alphahull-PointsKO-Adjacents,761
Cleyera_albopunctata,37,18,19,Points-PointsKO-Adjacents,233
Cleyera_bolleana,3,3,0,Points-PointsKO-Adjacents,27
Cleyera_cernua,6,0,6,Points-PointsKO-Adjacents,48
Cleyera_ekmanii,2,2,0,Points-PointsKO-Adjacents,16
Cleyera_incornuta,12,3,9,Points-PointsKO-Adjacents,108
Cleyera_integrifolia,254,217,37,Alphahull-PointsKO-Adjacents,3225
Cleyera_japonica,450,1,449,Points-PointsKO-Adjacents,1049
Cleyera_nimanimae,2,2,0,Points-PointsKO-Adjacents,16
Cleyera_obovata,4,4,0,Points-PointsKO-Adjacents,36
Cleyera_obscurinervia,1,1,0,Points-PointsKO-Adjacents,9
Cleyera_orbicularis,1,1,0,Points-PointsKO-Adjacents,7
Cleyera_pachyphylla,0,0,0,NA,0
Cleyera_ternstroemioides,3,3,0,Points-PointsKO-Adjacents,25
Cleyera_theoides,512,462,50,Alphahull-PointsKO-Adjacents,4198
Cleyera_vaccinioides,3,3,0,Points-PointsKO-Adjacents,23
Cleyera_velutina,10,0,10,Points-PointsKO-Adjacents,60
Cleyera_yangchunensis,NA,NA,NA,NA,NA
Clianthus_puniceus,42,25,17,Alphahull-PointsKO-Adjacents,883
Clibadium_arboreum,454,400,54,Alphahull-PointsKO-Adjacents,4928
Clibadium_erosum,17,10,7,Points-PointsKO-Adjacents,55
Clibadium_grandifolium,101,70,31,Alphahull-PointsKO-Adjacents,866
Clibadium_manabiense,7,2,5,Points-PointsKO-Adjacents,63
Clibadium_pastazense,1,1,0,Points-PointsKO-Adjacents,9
Clibadium_surinamense,502,389,113,Alphahull-PointsKO-Adjacents,18772
Clibadium_sylvestre,273,0,273,Points-PointsKO-Adjacents,1649
Clidemia_allardii,110,83,27,Alphahull-PointsKO-Adjacents,6561
Clidemia_angustilamina,43,34,9,Alphahull-PointsKO-Adjacents,297
Clidemia_asplundii,2,2,0,Points-PointsKO-Adjacents,15
Clidemia_capitellata,1181,941,240,Alphahull-PointsKO-Adjacents,86561
Clidemia_caudata,15,9,6,Points-PointsKO-Adjacents,65
Clidemia_costaricensis,82,65,17,Alphahull-PointsKO-Adjacents,369
Clidemia_cuatrecasasii,20,13,7,Points-PointsKO-Adjacents,82
Clidemia_cymosa,36,28,8,Alphahull-PointsKO-Adjacents,69
Clidemia_dentata,900,748,152,Alphahull-PointsKO-Adjacents,29116
Clidemia_dimorphica,159,0,159,Points-PointsKO-Adjacents,931
Clidemia_discolor,221,172,49,Alphahull-PointsKO-Adjacents,3569
Clidemia_domingensis,7,3,4,Points-PointsKO-Adjacents,46
Clidemia_ecuadorensis,8,4,4,Points-PointsKO-Adjacents,54
Clidemia_eggersii,19,1,18,Points-PointsKO-Adjacents,94
Clidemia_epiphytica,370,290,80,Alphahull-PointsKO-Adjacents,10561
Clidemia_hammelii,107,83,24,Alphahull-PointsKO-Adjacents,804
Clidemia_hirta,1968,1586,382,Alphahull-PointsKO-Adjacents,110123
Clidemia_inobsepta,51,30,21,Alphahull-PointsKO-Adjacents,763
Clidemia_longipedunculata,9,6,3,Points-PointsKO-Adjacents,36
Clidemia_octona,674,525,149,Alphahull-PointsKO-Adjacents,23552
Clidemia_ostrina,91,68,23,Alphahull-PointsKO-Adjacents,1379
Clidemia_pittieri,20,11,9,Points-PointsKO-Adjacents,80
Clidemia_plumosa,25,7,18,Points-PointsKO-Adjacents,153
Clidemia_rubra,289,175,114,Alphahull-PointsKO-Adjacents,23685
Clidemia_septuplinervia,471,391,80,Alphahull-PointsKO-Adjacents,17175
Clidemia_sessiliflora,87,46,41,Alphahull-PointsKO-Adjacents,720
Clidemia_setosa,257,218,39,Alphahull-PointsKO-Adjacents,2968
Clidemia_subpeltata,5,5,0,Points-PointsKO-Adjacents,42
Clidemia_tuerckheimii,3,2,1,Points-PointsKO-Adjacents,27
Clidemia_umbellata,52,37,15,Alphahull-PointsKO-Adjacents,577
Cliffortia_arborea,15,12,3,Points-PointsKO-Adjacents,98
Cliffortia_nitidula,2,2,0,Points-PointsKO-Adjacents,16
Cliftonia_monophylla,181,141,40,Alphahull-PointsKO-Adjacents,1868
Clinosperma_bracteale,20,12,8,Points-PointsKO-Adjacents,88
Clinosperma_lanuginosa,8,3,5,Points-PointsKO-Adjacents,19
Clinosperma_macrocarpa,2,2,0,Points-PointsKO-Adjacents,7
Clinosperma_vaginata,17,11,6,Points-PointsKO-Adjacents,56
Clinostigma_carolinense,0,0,0,NA,0
Clinostigma_collegarum,3,3,0,Points-PointsKO-Adjacents,9
Clinostigma_exorrhizum,0,0,0,NA,0
Clinostigma_gronophyllum,1,1,0,Points-PointsKO-Adjacents,9
Clinostigma_haerestigma,0,0,0,NA,0
Clinostigma_harlandii,3,3,0,Points-PointsKO-Adjacents,25
Clinostigma_onchorhynchum,3,3,0,Points-PointsKO-Adjacents,13
Clinostigma_ponapense,6,1,5,Points-PointsKO-Adjacents,10
Clinostigma_samoense,4,4,0,Points-PointsKO-Adjacents,22
Clinostigma_savoryanum,0,0,0,NA,0
Clinostigma_warburgii,0,0,0,NA,0
Clitoria_amazonum,242,174,68,Alphahull-PointsKO-Adjacents,25478
Clitoria_andrei,1,1,0,Points-PointsKO-Adjacents,9
Clitoria_arborea,182,110,72,Alphahull-PointsKO-Adjacents,17290
Clitoria_arborescens,51,25,26,Alphahull-PointsKO-Adjacents,1135
Clitoria_brachycalyx,16,8,8,Points-PointsKO-Adjacents,133
Clitoria_brachystegia,10,1,9,Points-PointsKO-Adjacents,64
Clitoria_dendrina,28,14,14,Points-PointsKO-Adjacents,210
Clitoria_fairchildiana,197,100,97,Alphahull-PointsKO-Adjacents,24949
Clitoria_glaberrima,44,13,31,Points-PointsKO-Adjacents,300
Clitoria_juninensis,11,2,9,Points-PointsKO-Adjacents,90
Clitoria_moyobambensis,1,1,0,Points-PointsKO-Adjacents,9
Clitoria_nervosa,9,0,9,Points-PointsKO-Adjacents,77
Clitoria_woytkowskii,2,2,0,Points-PointsKO-Adjacents,18
Cloezia_artensis,82,66,16,Alphahull-PointsKO-Adjacents,223
Cloezia_floribunda,36,25,11,Alphahull-PointsKO-Adjacents,104
Clonostylis_forbesii,1,1,0,Points-PointsKO-Adjacents,9
Clusia_abbottii,45,26,19,Alphahull-PointsKO-Adjacents,178
Clusia_aemygdioi,18,12,6,Points-PointsKO-Adjacents,118
Clusia_alainii,1,1,0,Points-PointsKO-Adjacents,9
Clusia_alata,225,199,26,Alphahull-PointsKO-Adjacents,3138
Clusia_amabilis,18,8,10,Points-PointsKO-Adjacents,126
Clusia_amazonica,534,424,110,Alphahull-PointsKO-Adjacents,43000
Clusia_angustifolia,1,1,0,Points-PointsKO-Adjacents,9
Clusia_annularis,10,5,5,Points-PointsKO-Adjacents,62
Clusia_araracuarae,5,5,0,Points-PointsKO-Adjacents,32
Clusia_aripoensis,2,2,0,Points-PointsKO-Adjacents,12
Clusia_articulata,59,42,17,Alphahull-PointsKO-Adjacents,544
Clusia_asymmetrica,6,0,6,Points-PointsKO-Adjacents,29
Clusia_aymardii,3,3,0,Points-PointsKO-Adjacents,15
Clusia_belizensis,24,13,11,Points-PointsKO-Adjacents,162
Clusia_bernardoi,2,2,0,Points-PointsKO-Adjacents,18
Clusia_botryoidea,2,2,0,Points-PointsKO-Adjacents,18
Clusia_brachycarpa,62,42,20,Alphahull-PointsKO-Adjacents,1034
Clusia_brachystyla,61,45,16,Alphahull-PointsKO-Adjacents,1562
Clusia_bracteosa,9,4,5,Points-PointsKO-Adjacents,75
Clusia_brongniartiana,NA,NA,NA,NA,NA
Clusia_burchellii,27,1,26,Points-PointsKO-Adjacents,177
Clusia_burle-marxii,93,0,93,Points-PointsKO-Adjacents,208
Clusia_caicedoi,3,3,0,Points-PointsKO-Adjacents,27
Clusia_cajamarcensis,2,2,0,Points-PointsKO-Adjacents,18
Clusia_cajambrensis,5,0,5,Points-PointsKO-Adjacents,38
Clusia_calimae,0,0,0,NA,0
Clusia_candelabrum,206,150,56,Alphahull-PointsKO-Adjacents,24518
Clusia_carachensis,NA,NA,NA,NA,NA
Clusia_cardonae,31,21,10,Alphahull-PointsKO-Adjacents,253
Clusia_carinata,7,1,6,Points-PointsKO-Adjacents,51
Clusia_cassinioides,2,2,0,Points-PointsKO-Adjacents,18
Clusia_caudata,66,50,16,Alphahull-PointsKO-Adjacents,482
Clusia_celiae,6,0,6,Points-PointsKO-Adjacents,51
Clusia_centricupula,4,4,0,Points-PointsKO-Adjacents,35
Clusia_cerroana,144,106,38,Alphahull-PointsKO-Adjacents,5944
Clusia_chiribiquetensis,79,50,29,Alphahull-PointsKO-Adjacents,2572
Clusia_chusqueae,3,3,0,Points-PointsKO-Adjacents,21
Clusia_clarendonensis,NA,NA,NA,NA,NA
Clusia_clusioides,77,52,25,Alphahull-PointsKO-Adjacents,418
Clusia_cochlanthera,1,1,0,Points-PointsKO-Adjacents,9
Clusia_cochliformis,9,1,8,Points-PointsKO-Adjacents,68
Clusia_cochlitheca,13,7,6,Points-PointsKO-Adjacents,76
Clusia_coclensis,40,30,10,Alphahull-PointsKO-Adjacents,275
Clusia_colombiana,28,16,12,Points-PointsKO-Adjacents,189
Clusia_columnaris,680,0,680,Points-PointsKO-Adjacents,4104
Clusia_comans,0,0,0,NA,0
Clusia_congestiflora,28,11,17,Points-PointsKO-Adjacents,199
Clusia_coremandra,1,1,0,Points-PointsKO-Adjacents,9
Clusia_crassifolia,51,0,51,Points-PointsKO-Adjacents,281
Clusia_crassipetiolata,2,2,0,Points-PointsKO-Adjacents,18
Clusia_crenata,101,79,22,Alphahull-PointsKO-Adjacents,1480
Clusia_criuva,851,751,100,Alphahull-PointsKO-Adjacents,15851
Clusia_croatii,56,49,7,Alphahull-PointsKO-Adjacents,323
Clusia_cruciata,73,54,19,Alphahull-PointsKO-Adjacents,2305
Clusia_cundinamarcensis,13,9,4,Points-PointsKO-Adjacents,71
Clusia_cuneata,46,27,19,Alphahull-PointsKO-Adjacents,416
Clusia_cuneifolia,67,50,17,Alphahull-PointsKO-Adjacents,837
Clusia_cupulata,25,18,7,Points-PointsKO-Adjacents,95
Clusia_cylindrica,112,91,21,Alphahull-PointsKO-Adjacents,876
Clusia_dardanoi,55,33,22,Alphahull-PointsKO-Adjacents,1101
Clusia_decussata,73,47,26,Alphahull-PointsKO-Adjacents,763
Clusia_densinervia,4,4,0,Points-PointsKO-Adjacents,35
Clusia_diamantina,8,3,5,Points-PointsKO-Adjacents,53
Clusia_dichrophylla,1,0,1,Points-PointsKO-Adjacents,7
Clusia_diguensis,8,1,7,Points-PointsKO-Adjacents,69
Clusia_discolor,44,31,13,Alphahull-PointsKO-Adjacents,1997
Clusia_divaricata,45,36,9,Alphahull-PointsKO-Adjacents,178
Clusia_dixonii,70,52,18,Alphahull-PointsKO-Adjacents,653
Clusia_domingensis,1,0,1,Points-PointsKO-Adjacents,9
Clusia_drouetiana,12,0,12,Points-PointsKO-Adjacents,84
Clusia_duartei,5,5,0,Points-PointsKO-Adjacents,33
Clusia_ducu,125,82,43,Alphahull-PointsKO-Adjacents,2237
Clusia_ducuoides,130,99,31,Alphahull-PointsKO-Adjacents,1354
Clusia_duidae,19,9,10,Points-PointsKO-Adjacents,123
Clusia_dukei,22,18,4,Points-PointsKO-Adjacents,52
Clusia_elliptica,111,86,25,Alphahull-PointsKO-Adjacents,1413
Clusia_ellipticifolia,58,40,18,Alphahull-PointsKO-Adjacents,959
Clusia_elongata,17,11,6,Points-PointsKO-Adjacents,48
Clusia_epiphytica,3,3,0,Points-PointsKO-Adjacents,27
Clusia_erubescens,0,0,0,NA,0
Clusia_eugenioides,27,15,12,Points-PointsKO-Adjacents,189
Clusia_fabiolae,15,7,8,Points-PointsKO-Adjacents,75
Clusia_firmifolia,6,1,5,Points-PointsKO-Adjacents,38
Clusia_fistulosa,3,3,0,Points-PointsKO-Adjacents,27
Clusia_flava,129,97,32,Alphahull-PointsKO-Adjacents,4755
Clusia_flavida,436,357,79,Alphahull-PointsKO-Adjacents,30650
Clusia_flaviflora,0,0,0,NA,0
Clusia_fluminensis,89,52,37,Alphahull-PointsKO-Adjacents,1143
Clusia_fockeana,69,58,11,Alphahull-PointsKO-Adjacents,1491
Clusia_formosa,19,9,10,Points-PointsKO-Adjacents,131
Clusia_fragrans,47,25,22,Alphahull-PointsKO-Adjacents,674
Clusia_fructiangusta,62,28,34,Alphahull-PointsKO-Adjacents,708
Clusia_garcibarrigae,47,37,10,Alphahull-PointsKO-Adjacents,1521
Clusia_gardneri,50,40,10,Alphahull-PointsKO-Adjacents,595
Clusia_gaudichaudii,21,7,14,Points-PointsKO-Adjacents,132
Clusia_gentlei,1,0,1,Points-PointsKO-Adjacents,9
Clusia_globosa,3,3,0,Points-PointsKO-Adjacents,27
Clusia_glomerata,11,5,6,Points-PointsKO-Adjacents,90
Clusia_grammadenioides,15,8,7,Points-PointsKO-Adjacents,59
Clusia_grandiflora,182,157,25,Alphahull-PointsKO-Adjacents,6918
Clusia_gratula,25,10,15,Points-PointsKO-Adjacents,141
Clusia_guatemalensis,242,210,32,Alphahull-PointsKO-Adjacents,3752
Clusia_guaviarensis,9,0,9,Points-PointsKO-Adjacents,72
Clusia_guayanae,3,3,0,Points-PointsKO-Adjacents,27
Clusia_guedesiana,1,1,0,Points-PointsKO-Adjacents,9
Clusia_gundlachii,48,39,9,Alphahull-PointsKO-Adjacents,75
Clusia_hachensis,17,9,8,Points-PointsKO-Adjacents,150
Clusia_hammeliana,362,0,362,Points-PointsKO-Adjacents,2098
Clusia_haughtii,108,64,44,Alphahull-PointsKO-Adjacents,2428
Clusia_havetioides,7,2,5,Points-PointsKO-Adjacents,33
Clusia_hexacarpa,18,8,10,Points-PointsKO-Adjacents,100
Clusia_hilariana,132,0,132,Points-PointsKO-Adjacents,647
Clusia_hoffmannseggiana,87,0,87,Points-PointsKO-Adjacents,626
Clusia_huberi,49,37,12,Alphahull-PointsKO-Adjacents,1045
Clusia_hydrogera,100,85,15,Alphahull-PointsKO-Adjacents,1799
Clusia_hylaeae,5,5,0,Points-PointsKO-Adjacents,45
Clusia_imbricata,13,7,6,Points-PointsKO-Adjacents,72
Clusia_immersa,9,1,8,Points-PointsKO-Adjacents,53
Clusia_inesiana,33,23,10,Alphahull-PointsKO-Adjacents,906
Clusia_insignis,229,167,62,Alphahull-PointsKO-Adjacents,22404
Clusia_intertexta,1,1,0,Points-PointsKO-Adjacents,9
Clusia_kanukuana,3,0,3,Points-PointsKO-Adjacents,27
Clusia_lanceolata,143,108,35,Alphahull-PointsKO-Adjacents,948
Clusia_latifolia,3,3,0,Points-PointsKO-Adjacents,27
Clusia_latipes,18,12,6,Points-PointsKO-Adjacents,128
Clusia_laurifolia,69,54,15,Alphahull-PointsKO-Adjacents,1206
Clusia_laxiflora,23,12,11,Points-PointsKO-Adjacents,179
Clusia_lechleri,82,64,18,Alphahull-PointsKO-Adjacents,690
Clusia_lehmannii,2,2,0,Points-PointsKO-Adjacents,18
Clusia_leprantha,144,92,52,Alphahull-PointsKO-Adjacents,11243
Clusia_leptanthera,33,21,12,Alphahull-PointsKO-Adjacents,327
Clusia_liesneri,31,23,8,Alphahull-PointsKO-Adjacents,109
Clusia_lineata,165,128,37,Alphahull-PointsKO-Adjacents,5139
Clusia_longipetiolata,12,7,5,Points-PointsKO-Adjacents,64
Clusia_longistyla,50,32,18,Alphahull-PointsKO-Adjacents,544
Clusia_lopezii,41,27,14,Alphahull-PointsKO-Adjacents,425
Clusia_loranthacea,212,185,27,Alphahull-PointsKO-Adjacents,9117
Clusia_loretensis,52,27,25,Alphahull-PointsKO-Adjacents,2171
Clusia_lunanthera,8,5,3,Points-PointsKO-Adjacents,27
Clusia_lundellii,163,138,25,Alphahull-PointsKO-Adjacents,2636
Clusia_lusoria,28,13,15,Points-PointsKO-Adjacents,206
Clusia_macropoda,40,15,25,Points-PointsKO-Adjacents,324
Clusia_magnifolia,40,24,16,Alphahull-PointsKO-Adjacents,2218
Clusia_maguireana,16,10,6,Points-PointsKO-Adjacents,91
Clusia_major,6,0,6,Points-PointsKO-Adjacents,26
Clusia_mamillata,54,39,15,Alphahull-PointsKO-Adjacents,706
Clusia_mangle,1,0,1,Points-PointsKO-Adjacents,9
Clusia_martiana,65,27,38,Alphahull-PointsKO-Adjacents,1234
Clusia_massoniana,74,48,26,Alphahull-PointsKO-Adjacents,594
Clusia_mayana,4,4,0,Points-PointsKO-Adjacents,33
Clusia_melchiorii,122,96,26,Alphahull-PointsKO-Adjacents,1461
Clusia_microphylla,7,2,5,Points-PointsKO-Adjacents,57
Clusia_microstemon,300,246,54,Alphahull-PointsKO-Adjacents,24259
Clusia_minor,616,489,127,Alphahull-PointsKO-Adjacents,23710
Clusia_minutiflora,2,2,0,Points-PointsKO-Adjacents,16
Clusia_mirandensis,3,3,0,Points-PointsKO-Adjacents,21
Clusia_mituana,41,24,17,Alphahull-PointsKO-Adjacents,1840
Clusia_moaensis,2,2,0,Points-PointsKO-Adjacents,14
Clusia_mocoensis,56,34,22,Alphahull-PointsKO-Adjacents,2636
Clusia_modesta,1,1,0,Points-PointsKO-Adjacents,9
Clusia_monantha,31,22,9,Alphahull-PointsKO-Adjacents,275
Clusia_multiflora,753,659,94,Alphahull-PointsKO-Adjacents,8516
Clusia_multilineata,1,1,0,Points-PointsKO-Adjacents,9
Clusia_mutica,7,3,4,Points-PointsKO-Adjacents,39
Clusia_mutisiana,36,29,7,Alphahull-PointsKO-Adjacents,484
Clusia_myriandra,55,39,16,Alphahull-PointsKO-Adjacents,870
Clusia_myrsinites,4,4,0,Points-PointsKO-Adjacents,36
Clusia_nemorosa,1248,1102,146,Alphahull-PointsKO-Adjacents,31440
Clusia_nervosa,1,1,0,Points-PointsKO-Adjacents,9
Clusia_neumphylla,0,0,0,NA,0
Clusia_neurosa,19,9,10,Points-PointsKO-Adjacents,131
Clusia_nutans,14,5,9,Points-PointsKO-Adjacents,95
Clusia_obdeltifolia,104,88,16,Alphahull-PointsKO-Adjacents,802
Clusia_oblanceolata,21,11,10,Points-PointsKO-Adjacents,125
Clusia_obovata,202,0,202,Points-PointsKO-Adjacents,1446
Clusia_octandra,158,112,46,Alphahull-PointsKO-Adjacents,12126
Clusia_octopetala,14,7,7,Points-PointsKO-Adjacents,109
Clusia_odorata,14,8,6,Points-PointsKO-Adjacents,48
Clusia_opaca,22,15,7,Points-PointsKO-Adjacents,155
Clusia_organensis,98,83,15,Alphahull-PointsKO-Adjacents,1297
Clusia_orthoneura,38,24,14,Alphahull-PointsKO-Adjacents,702
Clusia_osseocarpa,24,18,6,Points-PointsKO-Adjacents,102
Clusia_ovalis,11,5,6,Points-PointsKO-Adjacents,69
Clusia_pachamamae,13,6,7,Points-PointsKO-Adjacents,69
Clusia_pachyphylla,16,11,5,Points-PointsKO-Adjacents,94
Clusia_paisarum,4,4,0,Points-PointsKO-Adjacents,24
Clusia_pallida,149,119,30,Alphahull-PointsKO-Adjacents,3186
Clusia_palmana,128,87,41,Alphahull-PointsKO-Adjacents,837
Clusia_palmicida,163,94,69,Alphahull-PointsKO-Adjacents,14579
Clusia_panapanari,512,432,80,Alphahull-PointsKO-Adjacents,36427
Clusia_paralicola,109,79,30,Alphahull-PointsKO-Adjacents,1438
Clusia_parvifolia,3,3,0,Points-PointsKO-Adjacents,21
Clusia_pavonii,9,1,8,Points-PointsKO-Adjacents,81
Clusia_penduliflora,149,84,65,Alphahull-PointsKO-Adjacents,5571
Clusia_pentandra,42,25,17,Alphahull-PointsKO-Adjacents,478
Clusia_pentarhyncha,2,2,0,Points-PointsKO-Adjacents,18
Clusia_pernambucensis,30,13,17,Points-PointsKO-Adjacents,191
Clusia_perscariosa,17,9,8,Points-PointsKO-Adjacents,53
Clusia_peruviana,22,6,16,Points-PointsKO-Adjacents,190
Clusia_petiolaris,4,4,0,Points-PointsKO-Adjacents,36
Clusia_phelpsiae,4,4,0,Points-PointsKO-Adjacents,36
Clusia_phelpsiana,4,4,0,Points-PointsKO-Adjacents,24
Clusia_picardae,4,4,0,Points-PointsKO-Adjacents,24
Clusia_planchoniana,9,0,9,Points-PointsKO-Adjacents,72
Clusia_platystigma,21,13,8,Points-PointsKO-Adjacents,141
Clusia_plukenetii,8,2,6,Points-PointsKO-Adjacents,24
Clusia_plumeri,4,4,0,Points-PointsKO-Adjacents,35
Clusia_plurivalvis,0,0,0,NA,0
Clusia_poeppigiana,18,4,14,Points-PointsKO-Adjacents,138
Clusia_polyandra,22,12,10,Points-PointsKO-Adjacents,185
Clusia_polyantha,8,0,8,Points-PointsKO-Adjacents,64
Clusia_polysepala,28,14,14,Points-PointsKO-Adjacents,197
Clusia_polystigma,5,5,0,Points-PointsKO-Adjacents,36
Clusia_popayenensis,0,0,0,NA,0
Clusia_portlandiana,0,0,0,NA,0
Clusia_pseudochina,1,1,0,Points-PointsKO-Adjacents,9
Clusia_pseudohavetia,4,4,0,Points-PointsKO-Adjacents,36
Clusia_pseudomangle,7,1,6,Points-PointsKO-Adjacents,63
Clusia_ptaritepuiensis,8,2,6,Points-PointsKO-Adjacents,53
Clusia_pulcherrima,4,4,0,Points-PointsKO-Adjacents,36
Clusia_purpurea,7,2,5,Points-PointsKO-Adjacents,63
Clusia_pusilla,128,110,18,Alphahull-PointsKO-Adjacents,2147
Clusia_quadrangula,94,74,20,Alphahull-PointsKO-Adjacents,856
Clusia_radiata,6,3,3,Points-PointsKO-Adjacents,36
Clusia_radicans,2,2,0,Points-PointsKO-Adjacents,18
Clusia_ramosa,11,5,6,Points-PointsKO-Adjacents,78
Clusia_renggerioides,200,151,49,Alphahull-PointsKO-Adjacents,15617
Clusia_riedeliana,5,5,0,Points-PointsKO-Adjacents,41
Clusia_robusta,1,1,0,Points-PointsKO-Adjacents,9
Clusia_rosea,373,234,139,Alphahull-PointsKO-Adjacents,7833
Clusia_rosiflora,NA,NA,NA,NA,NA
Clusia_rotundata,37,25,12,Alphahull-PointsKO-Adjacents,124
Clusia_rotundifolia,9,4,5,Points-PointsKO-Adjacents,68
Clusia_salvinii,444,384,60,Alphahull-PointsKO-Adjacents,8279
Clusia_sandiensis,4,4,0,Points-PointsKO-Adjacents,33
Clusia_savannarum,11,5,6,Points-PointsKO-Adjacents,51
Clusia_schomburgkiana,286,245,41,Alphahull-PointsKO-Adjacents,11314
Clusia_schomburgkii,4,4,0,Points-PointsKO-Adjacents,36
Clusia_schultesii,16,4,12,Points-PointsKO-Adjacents,125
Clusia_sclerophylla,6,1,5,Points-PointsKO-Adjacents,38
Clusia_scrobiculata,42,30,12,Alphahull-PointsKO-Adjacents,1896
Clusia_seemanii,0,0,0,NA,0
Clusia_sellowiana,119,69,50,Alphahull-PointsKO-Adjacents,804
Clusia_sipapoana,48,19,29,Points-PointsKO-Adjacents,290
Clusia_skotaster,1,1,0,Points-PointsKO-Adjacents,9
Clusia_spathulifolia,79,49,30,Alphahull-PointsKO-Adjacents,2242
Clusia_sphaerocarpa,120,75,45,Alphahull-PointsKO-Adjacents,1363
Clusia_spiritu-sanctensis,58,38,20,Alphahull-PointsKO-Adjacents,333
Clusia_spruceana,6,0,6,Points-PointsKO-Adjacents,45
Clusia_stenophylla,271,224,47,Alphahull-PointsKO-Adjacents,2164
Clusia_steyermarkii,7,0,7,Points-PointsKO-Adjacents,63
Clusia_studartiana,9,6,3,Points-PointsKO-Adjacents,65
Clusia_stylosa,7,3,4,Points-PointsKO-Adjacents,36
Clusia_subsessilis,0,0,0,NA,0
Clusia_tabulamontana,19,7,12,Points-PointsKO-Adjacents,129
Clusia_tarmensis,9,4,5,Points-PointsKO-Adjacents,68
Clusia_tenuifolia,6,0,6,Points-PointsKO-Adjacents,48
Clusia_tequendamae,4,4,0,Points-PointsKO-Adjacents,36
Clusia_ternstroemioides,20,10,10,Points-PointsKO-Adjacents,91
Clusia_tetragona,7,2,5,Points-PointsKO-Adjacents,33
Clusia_tetrandra,NA,NA,NA,NA,NA
Clusia_tetra-trianthera,12,7,5,Points-PointsKO-Adjacents,83
Clusia_thurifera,70,42,28,Alphahull-PointsKO-Adjacents,901
Clusia_tocuchensis,1,1,0,Points-PointsKO-Adjacents,9
Clusia_torresii,91,79,12,Alphahull-PointsKO-Adjacents,265
Clusia_triflora,50,33,17,Alphahull-PointsKO-Adjacents,2130
Clusia_trochiformis,220,166,54,Alphahull-PointsKO-Adjacents,4132
Clusia_troncosii,5,5,0,Points-PointsKO-Adjacents,39
Clusia_uleana,13,0,13,Points-PointsKO-Adjacents,117
Clusia_uniflora,2,2,0,Points-PointsKO-Adjacents,18
Clusia_uvitana,125,101,24,Alphahull-PointsKO-Adjacents,1334
Clusia_vaginata,27,14,13,Points-PointsKO-Adjacents,152
Clusia_valerii,10,8,2,Points-PointsKO-Adjacents,55
Clusia_veneralensis,25,12,13,Points-PointsKO-Adjacents,155
Clusia_venulosa,15,6,9,Points-PointsKO-Adjacents,104
Clusia_venusta,56,36,20,Alphahull-PointsKO-Adjacents,502
Clusia_verapazensis,6,1,5,Points-PointsKO-Adjacents,54
Clusia_viscida,92,52,40,Alphahull-PointsKO-Adjacents,7769
Clusia_vittata,3,3,0,Points-PointsKO-Adjacents,27
Clusia_volubilis,29,13,16,Points-PointsKO-Adjacents,202
Clusia_weberbaueri,27,7,20,Points-PointsKO-Adjacents,212
Clusia_weddelliana,202,146,56,Alphahull-PointsKO-Adjacents,16632
Clusiella_albiflora,2,2,0,Points-PointsKO-Adjacents,18
Clusiella_amplexicaulis,1,1,0,Points-PointsKO-Adjacents,9
Clusiella_axillaris,87,49,38,Alphahull-PointsKO-Adjacents,5805
Clusiella_cordifolia,17,11,6,Points-PointsKO-Adjacents,76
Clusiella_macropetala,19,10,9,Points-PointsKO-Adjacents,103
Clutia_abyssinica,239,169,70,Alphahull-PointsKO-Adjacents,8697
Clutia_kamerunica,7,3,4,Points-PointsKO-Adjacents,30
Clutia_kilimandscharica,22,11,11,Points-PointsKO-Adjacents,169
Clutia_lanceolata,16,2,14,Points-PointsKO-Adjacents,144
Clutia_richardiana,14,3,11,Points-PointsKO-Adjacents,124
Clymenia_platypoda,2,2,0,Points-PointsKO-Adjacents,10
Clymenia_polyandra,5,5,0,Points-PointsKO-Adjacents,44
Cnesmocarpon_dasyantha,89,70,19,Alphahull-PointsKO-Adjacents,305
Cnesmocarpon_dentata,1,1,0,Points-PointsKO-Adjacents,9
Cnesmocarpon_discoloroides,6,1,5,Points-PointsKO-Adjacents,47
Cnesmocarpon_montana,1,1,0,Points-PointsKO-Adjacents,9
Cnestis_mildbraedii,16,5,11,Points-PointsKO-Adjacents,90
Cnestis_palala,30,8,22,Points-PointsKO-Adjacents,229
Cnestis_polyphylla,131,71,60,Alphahull-PointsKO-Adjacents,1509
Cnicothamnus_azafran,32,21,11,Alphahull-PointsKO-Adjacents,1030
Cnicothamnus_lorentzii,102,82,20,Alphahull-PointsKO-Adjacents,1278
Cnidoscolus_aconitifolius,587,464,123,Alphahull-PointsKO-Adjacents,12077
Cnidoscolus_acrandrus,8,2,6,Points-PointsKO-Adjacents,64
Cnidoscolus_adenoblepharus,2,2,0,Points-PointsKO-Adjacents,18
Cnidoscolus_autlanensis,2,2,0,Points-PointsKO-Adjacents,18
Cnidoscolus_bahianus,340,313,27,Alphahull-PointsKO-Adjacents,6808
Cnidoscolus_basiacanthus,1,1,0,Points-PointsKO-Adjacents,9
Cnidoscolus_bellator,3,3,0,Points-PointsKO-Adjacents,26
Cnidoscolus_elasticus,11,0,11,Points-PointsKO-Adjacents,75
Cnidoscolus_froesii,12,4,8,Points-PointsKO-Adjacents,95
Cnidoscolus_hamosus,24,0,24,Points-PointsKO-Adjacents,157
Cnidoscolus_magni-gerdtii,2,2,0,Points-PointsKO-Adjacents,18
Cnidoscolus_matosii,1,1,0,Points-PointsKO-Adjacents,6
Cnidoscolus_megacanthus,14,4,10,Points-PointsKO-Adjacents,82
Cnidoscolus_monsanto,5,5,0,Points-PointsKO-Adjacents,27
Cnidoscolus_multilobus,344,283,61,Alphahull-PointsKO-Adjacents,8194
Cnidoscolus_oligandrus,126,99,27,Alphahull-PointsKO-Adjacents,4215
Cnidoscolus_paucistamineus,8,0,8,Points-PointsKO-Adjacents,62
Cnidoscolus_pubescens,245,219,26,Alphahull-PointsKO-Adjacents,6180
Cnidoscolus_quercifolius,476,430,46,Alphahull-PointsKO-Adjacents,8199
Cnidoscolus_rangel,1,1,0,Points-PointsKO-Adjacents,9
Cnidoscolus_regina,2,2,0,Points-PointsKO-Adjacents,14
Cnidoscolus_rupestris,2,2,0,Points-PointsKO-Adjacents,18
Cnidoscolus_sinaloensis,9,0,9,Points-PointsKO-Adjacents,48
Cnidoscolus_spinosus,58,45,13,Alphahull-PointsKO-Adjacents,614
Cnidoscolus_tubulosus,228,141,87,Alphahull-PointsKO-Adjacents,8238
Cnidoscolus_ulei,40,27,13,Alphahull-PointsKO-Adjacents,674
Cnidoscolus_urens,1518,1179,339,Alphahull-PointsKO-Adjacents,38949
Cnidoscolus_vitifolius,467,0,467,Points-PointsKO-Adjacents,3353
Coccochondra_phelpsiana,6,1,5,Points-PointsKO-Adjacents,39
Coccoloba_acapulcensis,226,179,47,Alphahull-PointsKO-Adjacents,4776
Coccoloba_acuminata,416,336,80,Alphahull-PointsKO-Adjacents,21161
Coccoloba_albicans,3,3,0,Points-PointsKO-Adjacents,25
Coccoloba_alnifolia,325,245,80,Alphahull-PointsKO-Adjacents,9824
Coccoloba_argentinensis,41,21,20,Alphahull-PointsKO-Adjacents,2100
Coccoloba_armata,7,1,6,Points-PointsKO-Adjacents,58
Coccoloba_ascendens,86,40,46,Alphahull-PointsKO-Adjacents,1545
Coccoloba_barbadensis,896,762,134,Alphahull-PointsKO-Adjacents,10399
Coccoloba_belizensis,71,50,21,Alphahull-PointsKO-Adjacents,766
Coccoloba_benitensis,3,3,0,Points-PointsKO-Adjacents,26
Coccoloba_x_boxii,1,1,0,Points-PointsKO-Adjacents,8
Coccoloba_brasiliensis,203,176,27,Alphahull-PointsKO-Adjacents,5604
Coccoloba_buchii,17,8,9,Points-PointsKO-Adjacents,121
Coccoloba_caesia,6,1,5,Points-PointsKO-Adjacents,34
Coccoloba_caracasana,127,99,28,Alphahull-PointsKO-Adjacents,8675
Coccoloba_caravellae,0,0,0,NA,0
Coccoloba_ceibensis,8,4,4,Points-PointsKO-Adjacents,60
Coccoloba_charitostachya,25,8,17,Points-PointsKO-Adjacents,201
Coccoloba_chiapensis,12,4,8,Points-PointsKO-Adjacents,80
Coccoloba_cholutecensis,2,2,0,Points-PointsKO-Adjacents,16
Coccoloba_colombiana,9,0,9,Points-PointsKO-Adjacents,66
Coccoloba_cordata,139,95,44,Alphahull-PointsKO-Adjacents,8718
Coccoloba_coriacea,7,1,6,Points-PointsKO-Adjacents,48
Coccoloba_coronata,333,225,108,Alphahull-PointsKO-Adjacents,12735
Coccoloba_costata,62,40,22,Alphahull-PointsKO-Adjacents,546
Coccoloba_cozumelensis,459,423,36,Alphahull-PointsKO-Adjacents,3043
Coccoloba_cruegeri,16,0,16,Points-PointsKO-Adjacents,94
Coccoloba_cujabensis,106,76,30,Alphahull-PointsKO-Adjacents,4050
Coccoloba_darienensis,7,3,4,Points-PointsKO-Adjacents,41
Coccoloba_declinata,113,55,58,Alphahull-PointsKO-Adjacents,2990
Coccoloba_densifrons,562,463,99,Alphahull-PointsKO-Adjacents,62553
Coccoloba_diversifolia,312,228,84,Alphahull-PointsKO-Adjacents,6865
Coccoloba_escuintlensis,47,17,30,Points-PointsKO-Adjacents,254
Coccoloba_excelsa,362,279,83,Alphahull-PointsKO-Adjacents,40919
Coccoloba_fallax,9,2,7,Points-PointsKO-Adjacents,81
Coccoloba_fastigiata,15,0,15,Points-PointsKO-Adjacents,119
Coccoloba_fawcettii,1,1,0,Points-PointsKO-Adjacents,9
Coccoloba_flavescens,9,5,4,Points-PointsKO-Adjacents,59
Coccoloba_floribunda,252,194,58,Alphahull-PointsKO-Adjacents,2671
Coccoloba_fuertesii,17,7,10,Points-PointsKO-Adjacents,142
Coccoloba_gentryi,16,11,5,Points-PointsKO-Adjacents,78
Coccoloba_glaziovii,126,81,45,Alphahull-PointsKO-Adjacents,4524
Coccoloba_goldmanii,28,13,15,Points-PointsKO-Adjacents,146
Coccoloba_gracilis,11,6,5,Points-PointsKO-Adjacents,99
Coccoloba_guanacastensis,47,38,9,Alphahull-PointsKO-Adjacents,408
Coccoloba_guaranitica,55,38,17,Alphahull-PointsKO-Adjacents,1548
Coccoloba_hirtella,22,11,11,Points-PointsKO-Adjacents,119
Coccoloba_hondurensis,116,91,25,Alphahull-PointsKO-Adjacents,2257
Coccoloba_hotteana,0,0,0,NA,0
Coccoloba_humboldtii,125,83,42,Alphahull-PointsKO-Adjacents,1958
Coccoloba_incrassata,14,11,3,Points-PointsKO-Adjacents,63
Coccoloba_johnstonii,14,8,6,Points-PointsKO-Adjacents,69
Coccoloba_krugii,59,28,31,Alphahull-PointsKO-Adjacents,983
Coccoloba_lasseri,27,14,13,Points-PointsKO-Adjacents,143
Coccoloba_latifolia,217,135,82,Alphahull-PointsKO-Adjacents,13640
Coccoloba_lehmannii,161,0,161,Points-PointsKO-Adjacents,1100
Coccoloba_leoganensis,14,8,6,Points-PointsKO-Adjacents,64
Coccoloba_leonardii,0,0,0,NA,0
Coccoloba_liebmannii,163,124,39,Alphahull-PointsKO-Adjacents,2256
Coccoloba_lindaviana,7,1,6,Points-PointsKO-Adjacents,61
Coccoloba_lindeniana,9,2,7,Points-PointsKO-Adjacents,60
Coccoloba_liportizii,45,32,13,Alphahull-PointsKO-Adjacents,102
Coccoloba_llewelynii,21,10,11,Points-PointsKO-Adjacents,182
Coccoloba_manzinellensis,55,40,15,Alphahull-PointsKO-Adjacents,179
Coccoloba_marginata,473,362,111,Alphahull-PointsKO-Adjacents,30960
Coccoloba_microstachya,48,27,21,Alphahull-PointsKO-Adjacents,251
Coccoloba_mollis,1221,1039,182,Alphahull-PointsKO-Adjacents,95889
Coccoloba_montana,79,50,29,Alphahull-PointsKO-Adjacents,1925
Coccoloba_nicaraguensis,8,4,4,Points-PointsKO-Adjacents,48
Coccoloba_nigrescens,1,1,0,Points-PointsKO-Adjacents,5
Coccoloba_nodosa,8,4,4,Points-PointsKO-Adjacents,41
Coccoloba_obovata,171,141,30,Alphahull-PointsKO-Adjacents,3650
Coccoloba_obtusifolia,87,69,18,Alphahull-PointsKO-Adjacents,8366
Coccoloba_ochreolata,76,31,45,Alphahull-PointsKO-Adjacents,1125
Coccoloba_orinocana,42,25,17,Alphahull-PointsKO-Adjacents,917
Coccoloba_ortizii,10,6,4,Points-PointsKO-Adjacents,40
Coccoloba_ovata,215,143,72,Alphahull-PointsKO-Adjacents,26383
Coccoloba_padiformis,160,110,50,Alphahull-PointsKO-Adjacents,7234
Coccoloba_pallida,4,4,0,Points-PointsKO-Adjacents,29
Coccoloba_paraensis,9,1,8,Points-PointsKO-Adjacents,68
Coccoloba_paraguariensis,63,41,22,Alphahull-PointsKO-Adjacents,2643
Coccoloba_pauciflora,10,4,6,Points-PointsKO-Adjacents,60
Coccoloba_persicaria,19,8,11,Points-PointsKO-Adjacents,123
Coccoloba_peruviana,65,40,25,Alphahull-PointsKO-Adjacents,1510
Coccoloba_picardae,15,10,5,Points-PointsKO-Adjacents,91
Coccoloba_plumieri,2,2,0,Points-PointsKO-Adjacents,18
Coccoloba_porphyrostachys,43,31,12,Alphahull-PointsKO-Adjacents,261
Coccoloba_portuguesana,18,10,8,Points-PointsKO-Adjacents,141
Coccoloba_proctorii,2,2,0,Points-PointsKO-Adjacents,16
Coccoloba_pubescens,51,25,26,Alphahull-PointsKO-Adjacents,490
Coccoloba_pyrifolia,30,26,4,Alphahull-PointsKO-Adjacents,80
Coccoloba_ramosisissima,77,1,76,Points-PointsKO-Adjacents,345
Coccoloba_ramosissima,158,83,75,Alphahull-PointsKO-Adjacents,1286
Coccoloba_reflexiflora,20,13,7,Points-PointsKO-Adjacents,128
Coccoloba_retirensis,0,0,0,NA,0
Coccoloba_retusa,22,8,14,Points-PointsKO-Adjacents,151
Coccoloba_rosea,128,0,128,Points-PointsKO-Adjacents,648
Coccoloba_rugosa,12,6,6,Points-PointsKO-Adjacents,38
Coccoloba_ruiziana,73,59,14,Alphahull-PointsKO-Adjacents,598
Coccoloba_salicifolia,46,29,17,Alphahull-PointsKO-Adjacents,249
Coccoloba_samanensis,2,2,0,Points-PointsKO-Adjacents,15
Coccoloba_savannarum,21,16,5,Points-PointsKO-Adjacents,155
Coccoloba_scandens,64,40,24,Alphahull-PointsKO-Adjacents,2650
Coccoloba_shaferi,7,3,4,Points-PointsKO-Adjacents,41
Coccoloba_sintenisii,13,10,3,Points-PointsKO-Adjacents,33
Coccoloba_spicata,191,171,20,Alphahull-PointsKO-Adjacents,2205
Coccoloba_spinescens,58,40,18,Alphahull-PointsKO-Adjacents,3071
Coccoloba_standleyana,15,8,7,Points-PointsKO-Adjacents,56
Coccoloba_striata,93,47,46,Alphahull-PointsKO-Adjacents,2337
Coccoloba_swartzii,136,76,60,Alphahull-PointsKO-Adjacents,2123
Coccoloba_tenuiflora,3,3,0,Points-PointsKO-Adjacents,26
Coccoloba_tenuifolia,15,2,13,Points-PointsKO-Adjacents,90
Coccoloba_tiliacea,67,48,19,Alphahull-PointsKO-Adjacents,705
Coccoloba_troyana,6,2,4,Points-PointsKO-Adjacents,43
Coccoloba_tuerckheimii,148,113,35,Alphahull-PointsKO-Adjacents,2360
Coccoloba_uvifera,544,351,193,Alphahull-PointsKO-Adjacents,9143
Coccoloba_venosa,125,50,75,Alphahull-PointsKO-Adjacents,2584
Coccoloba_warmingii,227,179,48,Alphahull-PointsKO-Adjacents,5492
Coccoloba_williamsii,24,7,17,Points-PointsKO-Adjacents,214
Coccoloba_wrightii,61,41,20,Alphahull-PointsKO-Adjacents,418
Coccoloba_yaracuyensis,2,2,0,Points-PointsKO-Adjacents,18
Coccoloba_zebra,5,5,0,Points-PointsKO-Adjacents,29
Coccoloba_zuliana,0,0,0,NA,0
Cocconerion_balansae,9,4,5,Points-PointsKO-Adjacents,31
Cocconerion_minus,28,18,10,Points-PointsKO-Adjacents,106
Coccothrinax_acunana,0,0,0,NA,0
Coccothrinax_alexandri,1,1,0,Points-PointsKO-Adjacents,4
Coccothrinax_alta,2,2,0,Points-PointsKO-Adjacents,18
Coccothrinax_argentata,27,10,17,Points-PointsKO-Adjacents,120
Coccothrinax_argentea,16,6,10,Points-PointsKO-Adjacents,105
Coccothrinax_baracoensis,NA,NA,NA,NA,NA
Coccothrinax_barbadensis,42,22,20,Alphahull-PointsKO-Adjacents,221
Coccothrinax_bermudezii,0,0,0,NA,0
Coccothrinax_borhidiana,0,0,0,NA,0
Coccothrinax_boschiana,4,3,1,Points-PointsKO-Adjacents,26
Coccothrinax_camagueyana,NA,NA,NA,NA,NA
Coccothrinax_clarensis,1,0,1,Points-PointsKO-Adjacents,9
Coccothrinax_concolor,0,0,0,NA,0
Coccothrinax_crinita,6,0,6,Points-PointsKO-Adjacents,54
Coccothrinax_cupularis,0,0,0,NA,0
Coccothrinax_ekmanii,4,4,0,Points-PointsKO-Adjacents,24
Coccothrinax_elegans,NA,NA,NA,NA,NA
Coccothrinax_fagildei,NA,NA,NA,NA,NA
Coccothrinax_fragrans,1,1,0,Points-PointsKO-Adjacents,9
Coccothrinax_garciana,1,1,0,Points-PointsKO-Adjacents,9
Coccothrinax_gracilis,3,3,0,Points-PointsKO-Adjacents,21
Coccothrinax_guantanamensis,0,0,0,NA,0
Coccothrinax_gundlachii,5,5,0,Points-PointsKO-Adjacents,44
Coccothrinax_hioramii,3,3,0,Points-PointsKO-Adjacents,27
Coccothrinax_inaguensis,1,1,0,Points-PointsKO-Adjacents,7
Coccothrinax_jamaicensis,1,1,0,Points-PointsKO-Adjacents,9
Coccothrinax_leonis,NA,NA,NA,NA,NA
Coccothrinax_litoralis,0,0,0,NA,0
Coccothrinax_macroglossa,NA,NA,NA,NA,NA
Coccothrinax_microphylla,NA,NA,NA,NA,NA
Coccothrinax_miraguama,15,5,10,Points-PointsKO-Adjacents,113
Coccothrinax_moaensis,NA,NA,NA,NA,NA
Coccothrinax_montana,0,0,0,NA,0
Coccothrinax_munizii,1,1,0,Points-PointsKO-Adjacents,6
Coccothrinax_muricata,1,1,0,Points-PointsKO-Adjacents,9
Coccothrinax_nipensis,NA,NA,NA,NA,NA
Coccothrinax_orientalis,1,1,0,Points-PointsKO-Adjacents,9
Coccothrinax_pauciramosa,4,4,0,Points-PointsKO-Adjacents,36
Coccothrinax_proctorii,1,1,0,Points-PointsKO-Adjacents,4
Coccothrinax_pseudorigida,1,1,0,Points-PointsKO-Adjacents,9
Coccothrinax_pumila,1,1,0,Points-PointsKO-Adjacents,8
Coccothrinax_readii,82,56,26,Alphahull-PointsKO-Adjacents,551
Coccothrinax_rigida,4,4,0,Points-PointsKO-Adjacents,35
Coccothrinax_salvatoris,6,0,6,Points-PointsKO-Adjacents,54
Coccothrinax_saxicola,1,1,0,Points-PointsKO-Adjacents,9
Coccothrinax_scoparia,4,4,0,Points-PointsKO-Adjacents,15
Coccothrinax_spissa,12,5,7,Points-PointsKO-Adjacents,67
Coccothrinax_torrida,4,4,0,Points-PointsKO-Adjacents,28
Coccothrinax_trinitensis,NA,NA,NA,NA,NA
Coccothrinax_yunquensis,1,1,0,Points-PointsKO-Adjacents,8
Coccothrinax_yuraguana,3,3,0,Points-PointsKO-Adjacents,16
Cocculus_laurifolius,54,13,41,Points-PointsKO-Adjacents,398
Cocculus_orbiculatus,717,439,278,Alphahull-PointsKO-Adjacents,27004
Cochlospermum_angolense,13,4,9,Points-PointsKO-Adjacents,103
Cochlospermum_fraseri,1591,1,1590,Points-PointsKO-Adjacents,2880
Cochlospermum_gillivraei,373,328,45,Alphahull-PointsKO-Adjacents,7899
Cochlospermum_orinocense,601,508,93,Alphahull-PointsKO-Adjacents,70361
Cochlospermum_regium,308,237,71,Alphahull-PointsKO-Adjacents,35708
Cochlospermum_religiosum,3,0,3,Points-PointsKO-Adjacents,27
Cochlospermum_tetraporum,22,0,22,Points-PointsKO-Adjacents,183
Cochlospermum_vitifolium,1842,1538,304,Alphahull-PointsKO-Adjacents,60058
Cocos_nucifera,188,71,117,Alphahull-PointsKO-Adjacents,1902
Codia_albicans,10,6,4,Points-PointsKO-Adjacents,59
Codia_belepensis,0,0,0,NA,0
Codia_discolor,21,13,8,Points-PointsKO-Adjacents,75
Codia_ferruginea,4,4,0,Points-PointsKO-Adjacents,27
Codia_incrassata,36,27,9,Alphahull-PointsKO-Adjacents,89
Codia_jaffrei,2,2,0,Points-PointsKO-Adjacents,16
Codia_mackeeana,6,2,4,Points-PointsKO-Adjacents,24
Codia_montana,22,10,12,Points-PointsKO-Adjacents,143
Codia_nitida,25,13,12,Points-PointsKO-Adjacents,94
Codia_spatulata,9,5,4,Points-PointsKO-Adjacents,57
Codia_triverticillata,0,0,0,NA,0
Codiaeum_membranaceum,13,5,8,Points-PointsKO-Adjacents,44
Codiaeum_peltatum,27,18,9,Points-PointsKO-Adjacents,134
Codiaeum_tenerifolium,3,3,0,Points-PointsKO-Adjacents,18
Codiaeum_variegatum,206,147,59,Alphahull-PointsKO-Adjacents,2379
Codiocarpus_andamanicus,0,0,0,NA,0
Codiocarpus_merrittii,2,2,0,Points-PointsKO-Adjacents,18
Codonocarpus_attenuatus,224,190,34,Alphahull-PointsKO-Adjacents,4591
Codonocarpus_cotinifolius,1159,1083,76,Alphahull-PointsKO-Adjacents,52125
Codonocarpus_pyramidalis,223,209,14,Alphahull-PointsKO-Adjacents,869
Coelocarpum_haggierense,2,2,0,Points-PointsKO-Adjacents,9
Coelocaryon_botryoides,27,10,17,Points-PointsKO-Adjacents,193
Coelocaryon_oxycarpum,14,2,12,Points-PointsKO-Adjacents,82
Coelocaryon_preussii,315,270,45,Alphahull-PointsKO-Adjacents,8733
Coelocaryon_sphaerocarpum,5,2,3,Points-PointsKO-Adjacents,21
Coeloneurum_ferrugineum,17,7,10,Points-PointsKO-Adjacents,93
Coelospermum_fragrans,1,1,0,Points-PointsKO-Adjacents,9
Coelospermum_truncatum,11,0,11,Points-PointsKO-Adjacents,90
Coelostegia_borneensis,1,1,0,Points-PointsKO-Adjacents,9
Coelostegia_chartacea,0,0,0,NA,0
Coelostegia_griffithii,5,0,5,Points-PointsKO-Adjacents,45
Coelostegia_kostermansii,0,0,0,NA,0
Coelostegia_montana,3,3,0,Points-PointsKO-Adjacents,27
Coelostegia_neesiocarpa,0,0,0,NA,0
Coffea_abbayesii,8,3,5,Points-PointsKO-Adjacents,40
Coffea_affinis,0,0,0,NA,0
Coffea_ambongensis,6,1,5,Points-PointsKO-Adjacents,37
Coffea_andrambovatensis,3,3,0,Points-PointsKO-Adjacents,16
Coffea_ankaranensis,9,6,3,Points-PointsKO-Adjacents,28
Coffea_arabica,121,102,19,Alphahull-PointsKO-Adjacents,1809
Coffea_arenesiana,6,1,5,Points-PointsKO-Adjacents,45
Coffea_bakossii,8,5,3,Points-PointsKO-Adjacents,27
Coffea_bertrandii,9,4,5,Points-PointsKO-Adjacents,30
Coffea_betamponensis,2,2,0,Points-PointsKO-Adjacents,18
Coffea_bissetiae,8,3,5,Points-PointsKO-Adjacents,60
Coffea_boinensis,3,0,3,Points-PointsKO-Adjacents,27
Coffea_boiviniana,20,11,9,Points-PointsKO-Adjacents,116
Coffea_bonnieri,8,3,5,Points-PointsKO-Adjacents,46
Coffea_bridsoniae,5,5,0,Points-PointsKO-Adjacents,27
Coffea_canephora,180,98,82,Alphahull-PointsKO-Adjacents,6351
Coffea_congensis,50,29,21,Alphahull-PointsKO-Adjacents,2058
Coffea_costatifructa,8,2,6,Points-PointsKO-Adjacents,43
Coffea_coursiana,9,3,6,Points-PointsKO-Adjacents,45
Coffea_dubardii,25,18,7,Points-PointsKO-Adjacents,92
Coffea_eugenioides,42,26,16,Alphahull-PointsKO-Adjacents,1253
Coffea_fadenii,3,3,0,Points-PointsKO-Adjacents,12
Coffea_farafanganensis,5,5,0,Points-PointsKO-Adjacents,25
Coffea_gallienii,2,2,0,Points-PointsKO-Adjacents,18
Coffea_grevei,20,7,13,Points-PointsKO-Adjacents,130
Coffea_homollei,7,2,5,Points-PointsKO-Adjacents,45
Coffea_humblotiana,0,0,0,NA,0
Coffea_jumellei,5,5,0,Points-PointsKO-Adjacents,45
Coffea_kianjavatensis,4,4,0,Points-PointsKO-Adjacents,12
Coffea_kihansiensis,5,5,0,Points-PointsKO-Adjacents,12
Coffea_kimbozensis,6,0,6,Points-PointsKO-Adjacents,21
Coffea_kivuensis,4,4,0,Points-PointsKO-Adjacents,21
Coffea_labatii,4,4,0,Points-PointsKO-Adjacents,15
Coffea_lancifolia,3,3,0,Points-PointsKO-Adjacents,18
Coffea_leonimontana,9,5,4,Points-PointsKO-Adjacents,44
Coffea_leroyi,10,2,8,Points-PointsKO-Adjacents,63
Coffea_liberica,141,81,60,Alphahull-PointsKO-Adjacents,9956
Coffea_littoralis,5,5,0,Points-PointsKO-Adjacents,33
Coffea_lulandoensis,7,4,3,Points-PointsKO-Adjacents,28
Coffea_macrocarpa,1,1,0,Points-PointsKO-Adjacents,9
Coffea_mangoroensis,41,37,4,Alphahull-PointsKO-Adjacents,38
Coffea_mannii,231,173,58,Alphahull-PointsKO-Adjacents,7593
Coffea_manombensis,1,1,0,Points-PointsKO-Adjacents,9
Coffea_mapiana,10,7,3,Points-PointsKO-Adjacents,25
Coffea_mauritiana,7,2,5,Points-PointsKO-Adjacents,30
Coffea_mcphersonii,7,0,7,Points-PointsKO-Adjacents,46
Coffea_merguensis,2,2,0,Points-PointsKO-Adjacents,18
Coffea_millotii,24,10,14,Points-PointsKO-Adjacents,133
Coffea_minutiflora,3,3,0,Points-PointsKO-Adjacents,18
Coffea_mogenetii,10,6,4,Points-PointsKO-Adjacents,29
Coffea_mongensis,36,24,12,Alphahull-PointsKO-Adjacents,130
Coffea_montis-sacri,3,3,0,Points-PointsKO-Adjacents,14
Coffea_moratii,9,2,7,Points-PointsKO-Adjacents,42
Coffea_mufindiensis,106,79,27,Alphahull-PointsKO-Adjacents,1269
Coffea_myrtifolia,1,1,0,Points-PointsKO-Adjacents,9
Coffea_namorokensis,2,2,0,Points-PointsKO-Adjacents,9
Coffea_neoleroyi,2,2,0,Points-PointsKO-Adjacents,18
Coffea_pocsii,8,4,4,Points-PointsKO-Adjacents,42
Coffea_pseudozanguebariae,59,45,14,Alphahull-PointsKO-Adjacents,268
Coffea_pterocarpa,4,4,0,Points-PointsKO-Adjacents,18
Coffea_racemosa,25,6,19,Points-PointsKO-Adjacents,196
Coffea_rakotonasoloi,3,3,0,Points-PointsKO-Adjacents,9
Coffea_ratsimamangae,9,0,9,Points-PointsKO-Adjacents,48
Coffea_resinosa,56,56,0,Alphahull,130
Coffea_richardii,27,12,15,Points-PointsKO-Adjacents,120
Coffea_sahafaryensis,3,3,0,Points-PointsKO-Adjacents,18
Coffea_sakarahae,15,8,7,Points-PointsKO-Adjacents,91
Coffea_salvatrix,4,4,0,Points-PointsKO-Adjacents,36
Coffea_sambavensis,14,1,13,Points-PointsKO-Adjacents,72
Coffea_schliebenii,7,3,4,Points-PointsKO-Adjacents,50
Coffea_sessiliflora,36,23,13,Alphahull-PointsKO-Adjacents,190
Coffea_stenophylla,12,6,6,Points-PointsKO-Adjacents,99
Coffea_tetragona,9,1,8,Points-PointsKO-Adjacents,54
Coffea_togoensis,16,8,8,Points-PointsKO-Adjacents,126
Coffea_tricalysioides,21,9,12,Points-PointsKO-Adjacents,126
Coffea_tsirananae,14,7,7,Points-PointsKO-Adjacents,32
Coffea_vianneyi,2,2,0,Points-PointsKO-Adjacents,9
Coffea_vohemarensis,5,5,0,Points-PointsKO-Adjacents,35
Coffea_wightiana,1,1,0,Points-PointsKO-Adjacents,9
Coffea_zanguebariae,21,7,14,Points-PointsKO-Adjacents,138
Cojoba_arborea,673,538,135,Alphahull-PointsKO-Adjacents,9943
Cojoba_bahorucensis,3,3,0,Points-PointsKO-Adjacents,26
Cojoba_beckii,6,0,6,Points-PointsKO-Adjacents,50
Cojoba_catenata,119,100,19,Alphahull-PointsKO-Adjacents,717
Cojoba_chazutensis,24,5,19,Points-PointsKO-Adjacents,210
Cojoba_costaricensis,87,73,14,Alphahull-PointsKO-Adjacents,236
Cojoba_escuintlensis,11,0,11,Points-PointsKO-Adjacents,73
Cojoba_filipes,13,7,6,Points-PointsKO-Adjacents,80
Cojoba_graciliflora,190,166,24,Alphahull-PointsKO-Adjacents,2377
Cojoba_longipendula,1,1,0,Points-PointsKO-Adjacents,9
Cojoba_mariaelenae,17,1,16,Points-PointsKO-Adjacents,100
Cojoba_matudae,24,8,16,Points-PointsKO-Adjacents,142
Cojoba_rufescens,351,301,50,Alphahull-PointsKO-Adjacents,3437
Cojoba_sophorocarpa,175,1,174,Points-PointsKO-Adjacents,620
Cojoba_urbanii,NA,NA,NA,NA,NA
Cojoba_zanonii,5,5,0,Points-PointsKO-Adjacents,17
Cola_acuminata,135,101,34,Alphahull-PointsKO-Adjacents,3163
Cola_altissima,26,11,15,Points-PointsKO-Adjacents,186
Cola_angustifolia,7,2,5,Points-PointsKO-Adjacents,51
Cola_anomala,18,10,8,Points-PointsKO-Adjacents,101
Cola_argentea,24,17,7,Points-PointsKO-Adjacents,133
Cola_attiensis,18,15,3,Points-PointsKO-Adjacents,116
Cola_ballayi,14,7,7,Points-PointsKO-Adjacents,108
Cola_bilenguensis,15,10,5,Points-PointsKO-Adjacents,113
Cola_bipindensis,36,22,14,Alphahull-PointsKO-Adjacents,189
Cola_bodardii,6,2,4,Points-PointsKO-Adjacents,42
Cola_boxiana,9,6,3,Points-PointsKO-Adjacents,65
Cola_brevipes,8,1,7,Points-PointsKO-Adjacents,59
Cola_bruneelii,26,6,20,Points-PointsKO-Adjacents,190
Cola_buesgenii,NA,NA,NA,NA,NA
Cola_buntingii,33,23,10,Alphahull-PointsKO-Adjacents,477
Cola_caricifolia,96,60,36,Alphahull-PointsKO-Adjacents,3153
Cola_cauliflora,56,42,14,Alphahull-PointsKO-Adjacents,285
Cola_cecidiifolia,7,2,5,Points-PointsKO-Adjacents,45
Cola_chlamydantha,51,19,32,Points-PointsKO-Adjacents,367
Cola_chlorantha,0,0,0,NA,0
Cola_clavata,1,1,0,Points-PointsKO-Adjacents,9
Cola_congolana,39,14,25,Points-PointsKO-Adjacents,321
Cola_cordifolia,70,48,22,Alphahull-PointsKO-Adjacents,4508
Cola_crispiflora,10,9,1,Points-PointsKO-Adjacents,73
Cola_digitata,164,128,36,Alphahull-PointsKO-Adjacents,2651
Cola_discoglypremnophylla,19,7,12,Points-PointsKO-Adjacents,135
Cola_diversifolia,7,1,6,Points-PointsKO-Adjacents,50
Cola_duparquetiana,8,6,2,Points-PointsKO-Adjacents,62
Cola_edeensis,2,2,0,Points-PointsKO-Adjacents,18
Cola_fibrillosa,2,2,0,Points-PointsKO-Adjacents,18
Cola_ficifolia,56,44,12,Alphahull-PointsKO-Adjacents,1070
Cola_flaviflora,15,9,6,Points-PointsKO-Adjacents,113
Cola_flavovelutina,75,52,23,Alphahull-PointsKO-Adjacents,1626
Cola_gabonensis,54,36,18,Alphahull-PointsKO-Adjacents,1529
Cola_gigantea,343,295,48,Alphahull-PointsKO-Adjacents,729
Cola_gigas,1,1,0,Points-PointsKO-Adjacents,9
Cola_gilgiana,35,22,13,Alphahull-PointsKO-Adjacents,185
Cola_gilletii,9,3,6,Points-PointsKO-Adjacents,75
Cola_glabra,0,0,0,NA,0
Cola_greenwayi,35,11,24,Points-PointsKO-Adjacents,279
Cola_griseiflora,57,36,21,Alphahull-PointsKO-Adjacents,846
Cola_heterophylla,138,90,48,Alphahull-PointsKO-Adjacents,1711
Cola_hispida,20,8,12,Points-PointsKO-Adjacents,150
Cola_hypochrysea,4,4,0,Points-PointsKO-Adjacents,32
Cola_kimbozensis,1,1,0,Points-PointsKO-Adjacents,9
Cola_lateritia,112,0,112,Points-PointsKO-Adjacents,676
Cola_laurifolia,238,198,40,Alphahull-PointsKO-Adjacents,8645
Cola_lepidota,39,27,12,Alphahull-PointsKO-Adjacents,410
Cola_le-testui,7,1,6,Points-PointsKO-Adjacents,54
Cola_lissachensis,20,14,6,Points-PointsKO-Adjacents,117
Cola_lizae,3,3,0,Points-PointsKO-Adjacents,21
Cola_lomensis,NA,NA,NA,NA,NA
Cola_lorougnonis,3,3,0,Points-PointsKO-Adjacents,27
Cola_louisii,5,5,0,Points-PointsKO-Adjacents,45
Cola_lukei,4,4,0,Points-PointsKO-Adjacents,12
Cola_mahoundensis,22,10,12,Points-PointsKO-Adjacents,141
Cola_marsupium,73,53,20,Alphahull-PointsKO-Adjacents,1455
Cola_mayumbensis,1,1,0,Points-PointsKO-Adjacents,9
Cola_megalophylla,7,5,2,Points-PointsKO-Adjacents,33
Cola_metallica,4,4,0,Points-PointsKO-Adjacents,26
Cola_millenii,339,318,21,Alphahull-PointsKO-Adjacents,2075
Cola_minor,14,9,5,Points-PointsKO-Adjacents,69
Cola_mossambicensis,23,11,12,Points-PointsKO-Adjacents,180
Cola_mosserayana,1,1,0,Points-PointsKO-Adjacents,9
Cola_natalensis,12,3,9,Points-PointsKO-Adjacents,96
Cola_ndongensis,NA,NA,NA,NA,NA
Cola_nigerica,2,2,0,Points-PointsKO-Adjacents,18
Cola_nitida,181,136,45,Alphahull-PointsKO-Adjacents,2552
Cola_noldeae,NA,NA,NA,NA,NA
Cola_octoloboides,7,4,3,Points-PointsKO-Adjacents,41
Cola_pachycarpa,60,42,18,Alphahull-PointsKO-Adjacents,710
Cola_pallida,NA,NA,NA,NA,NA
Cola_philipi-jonesii,0,0,0,NA,0
Cola_pierlotii,24,0,24,Points-PointsKO-Adjacents,95
Cola_porphyrantha,6,0,6,Points-PointsKO-Adjacents,39
Cola_praeacuta,8,5,3,Points-PointsKO-Adjacents,50
Cola_pseudoclavata,16,5,11,Points-PointsKO-Adjacents,95
Cola_pulcherrima,0,0,0,NA,0
Cola_quentinii,2,2,0,Points-PointsKO-Adjacents,17
Cola_reticulata,57,34,23,Alphahull-PointsKO-Adjacents,733
Cola_ricinifolia,6,3,3,Points-PointsKO-Adjacents,39
Cola_rostrata,57,42,15,Alphahull-PointsKO-Adjacents,1070
Cola_scheffleri,7,0,7,Points-PointsKO-Adjacents,42
Cola_sciaphila,8,0,8,Points-PointsKO-Adjacents,72
Cola_selengana,8,3,5,Points-PointsKO-Adjacents,66
Cola_semecarpophylla,15,11,4,Points-PointsKO-Adjacents,45
Cola_simiarum,9,3,6,Points-PointsKO-Adjacents,65
Cola_sphaerocarpa,NA,NA,NA,NA,NA
Cola_stelechantha,13,7,6,Points-PointsKO-Adjacents,68
Cola_subglaucescens,NA,NA,NA,NA,NA
Cola_suboppositifolia,8,4,4,Points-PointsKO-Adjacents,55
Cola_sulcata,NA,NA,NA,NA,NA
Cola_tessmannii,NA,NA,NA,NA,NA
Cola_triloba,4,4,0,Points-PointsKO-Adjacents,36
Cola_tsandensis,6,2,4,Points-PointsKO-Adjacents,52
Cola_uloloma,8,2,6,Points-PointsKO-Adjacents,51
Cola_umbratilis,21,15,6,Points-PointsKO-Adjacents,96
Cola_urceolata,32,10,22,Points-PointsKO-Adjacents,259
Cola_usambarensis,4,4,0,Points-PointsKO-Adjacents,18
Cola_vandersmisseniana,1,1,0,Points-PointsKO-Adjacents,9
Cola_verticillata,60,41,19,Alphahull-PointsKO-Adjacents,1214
Cola_welwitschii,7,0,7,Points-PointsKO-Adjacents,63
Cola_winkleri,NA,NA,NA,NA,NA
Colea_alata,4,4,0,Points-PointsKO-Adjacents,35
Colea_alba,0,0,0,NA,0
Colea_asperrima,7,1,6,Points-PointsKO-Adjacents,34
Colea_barbatula,0,0,0,NA,0
Colea_bernieri,0,0,0,NA,0
Colea_campenonii,0,0,0,NA,0
Colea_colei,0,0,0,NA,0
Colea_concinna,0,0,0,NA,0
Colea_fusca,41,34,7,Alphahull-PointsKO-Adjacents,133
Colea_gentryi,4,4,0,Points-PointsKO-Adjacents,17
Colea_hirsuta,9,3,6,Points-PointsKO-Adjacents,67
Colea_lantziana,18,12,6,Points-PointsKO-Adjacents,104
Colea_lutescens,4,4,0,Points-PointsKO-Adjacents,34
Colea_muricata,1,1,0,Points-PointsKO-Adjacents,9
Colea_myriaptera,8,1,7,Points-PointsKO-Adjacents,46
Colea_nana,9,6,3,Points-PointsKO-Adjacents,59
Colea_obtusifolia,9,0,9,Points-PointsKO-Adjacents,42
Colea_purpurascens,6,3,3,Points-PointsKO-Adjacents,34
Colea_resupinata,NA,NA,NA,NA,NA
Colea_rosea,1,1,0,Points-PointsKO-Adjacents,9
Colea_rubra,0,0,0,NA,0
Colea_seychellarum,2,2,0,Points-PointsKO-Adjacents,13
Colea_sytsmae,2,2,0,Points-PointsKO-Adjacents,15
Colea_tetragona,39,18,21,Points-PointsKO-Adjacents,150
Coleocephalocereus_goebelianus,10,5,5,Points-PointsKO-Adjacents,70
Colicodendron_bahianum,20,12,8,Points-PointsKO-Adjacents,140
Colicodendron_scabridum,135,116,19,Alphahull-PointsKO-Adjacents,1812
Colicodendron_valerabellum,NA,NA,NA,NA,NA
Colignonia_ovalifolia,37,22,15,Alphahull-PointsKO-Adjacents,259
Collaea_argentina,47,29,18,Alphahull-PointsKO-Adjacents,286
Collaea_speciosa,305,227,78,Alphahull-PointsKO-Adjacents,4235
Colletia_spinosissima,51,11,40,Points-PointsKO-Adjacents,421
Colletoecema_dewevrei,100,70,30,Alphahull-PointsKO-Adjacents,7228
Colletoecema_gabonensis,1,1,0,Points-PointsKO-Adjacents,9
Colletoecema_magna,1,1,0,Points-PointsKO-Adjacents,9
Colliguaja_brasillensis,0,0,0,NA,0
Colona_auriculata,9,4,5,Points-PointsKO-Adjacents,72
Colona_elobata,0,0,0,NA,0
Colona_flagrocarpa,6,1,5,Points-PointsKO-Adjacents,48
Colona_floribunda,20,9,11,Points-PointsKO-Adjacents,180
Colona_javanica,1,1,0,Points-PointsKO-Adjacents,9
Colona_merguensis,1,1,0,Points-PointsKO-Adjacents,7
Colona_poilanei,1,1,0,Points-PointsKO-Adjacents,9
Colona_serratifolia,12,2,10,Points-PointsKO-Adjacents,92
Colona_thorelii,3,3,0,Points-PointsKO-Adjacents,27
Colona_velutina,0,0,0,NA,0
Colona_winitii,1,1,0,Points-PointsKO-Adjacents,9
Colophospermum_mopane,169,131,38,Alphahull-PointsKO-Adjacents,8394
Colpothrinax_aphanopetala,25,11,14,Points-PointsKO-Adjacents,191
Colpothrinax_cookii,15,10,5,Points-PointsKO-Adjacents,77
Colpothrinax_wrightii,4,4,0,Points-PointsKO-Adjacents,36
Colubrina_arborescens,485,377,108,Alphahull-PointsKO-Adjacents,7659
Colubrina_articulata,12,3,9,Points-PointsKO-Adjacents,78
Colubrina_asiatica,359,155,204,Alphahull-PointsKO-Adjacents,4533
Colubrina_beccariana,2,2,0,Points-PointsKO-Adjacents,18
Colubrina_berteroana,12,9,3,Points-PointsKO-Adjacents,56
Colubrina_celtidifolia,47,24,23,Alphahull-PointsKO-Adjacents,813
Colubrina_cordifolia,85,65,20,Alphahull-PointsKO-Adjacents,3070
Colubrina_cubensis,17,6,11,Points-PointsKO-Adjacents,124
Colubrina_decipiens,39,23,16,Alphahull-PointsKO-Adjacents,501
Colubrina_ehrenbergii,79,62,17,Alphahull-PointsKO-Adjacents,607
Colubrina_elliptica,439,321,118,Alphahull-PointsKO-Adjacents,5931
Colubrina_faraloatra,42,27,15,Alphahull-PointsKO-Adjacents,432
Colubrina_glandulosa,631,455,176,Alphahull-PointsKO-Adjacents,29768
Colubrina_greggii,525,467,58,Alphahull-PointsKO-Adjacents,5545
Colubrina_heteroneura,227,142,85,Alphahull-PointsKO-Adjacents,4744
Colubrina_johnstonii,16,0,16,Points-PointsKO-Adjacents,54
Colubrina_nicholsonii,8,1,7,Points-PointsKO-Adjacents,70
Colubrina_obscura,5,5,0,Points-PointsKO-Adjacents,35
Colubrina_oppositifolia,4,2,2,Points-PointsKO-Adjacents,11
Colubrina_pedunculata,5,4,1,Points-PointsKO-Adjacents,7
Colubrina_retusa,104,49,55,Alphahull-PointsKO-Adjacents,3307
Colubrina_spinosa,218,199,19,Alphahull-PointsKO-Adjacents,530
Colubrina_travancorica,0,0,0,NA,0
Colubrina_triflora,379,307,72,Alphahull-PointsKO-Adjacents,7827
Colubrina_verrucosa,8,0,8,Points-PointsKO-Adjacents,22
Colubrina_viridis,146,124,22,Alphahull-PointsKO-Adjacents,2648
Columellia_oblonga,124,88,36,Alphahull-PointsKO-Adjacents,766
Columellia_obovata,15,8,7,Points-PointsKO-Adjacents,58
Columnea_pulcherrima,35,26,9,Alphahull-PointsKO-Adjacents,351
Colutea_atabaevii,NA,NA,NA,NA,NA
Colvillea_racemosa,55,41,14,Alphahull-PointsKO-Adjacents,559
Comarostaphylis_arbutoides,162,127,35,Alphahull-PointsKO-Adjacents,399
Comarostaphylis_discolor,476,443,33,Alphahull-PointsKO-Adjacents,4075
Comarostaphylis_diversifolia,211,169,42,Alphahull-PointsKO-Adjacents,319
Comarostaphylis_glaucescens,156,128,28,Alphahull-PointsKO-Adjacents,3169
Comarostaphylis_longifolia,71,57,14,Alphahull-PointsKO-Adjacents,741
Combretocarpus_rotundatus,14,3,11,Points-PointsKO-Adjacents,94
Combretum_aculeatum,265,168,97,Alphahull-PointsKO-Adjacents,14308
Combretum_adenogonium,532,414,118,Alphahull-PointsKO-Adjacents,33582
Combretum_albopunctatum,44,29,15,Alphahull-PointsKO-Adjacents,1352
Combretum_apiculatum,334,260,74,Alphahull-PointsKO-Adjacents,22587
Combretum_aureonitens,11,8,3,Points-PointsKO-Adjacents,84
Combretum_bracteatum,77,57,20,Alphahull-PointsKO-Adjacents,2900
Combretum_bracteosum,22,3,19,Points-PointsKO-Adjacents,181
Combretum_cacoucia,123,57,66,Alphahull-PointsKO-Adjacents,2168
Combretum_caffrum,24,12,12,Points-PointsKO-Adjacents,204
Combretum_camporum,19,5,14,Points-PointsKO-Adjacents,139
Combretum_celastroides,93,43,50,Alphahull-PointsKO-Adjacents,744
Combretum_collinum,148,109,39,Alphahull-PointsKO-Adjacents,4218
Combretum_discolor,46,18,28,Points-PointsKO-Adjacents,374
Combretum_duarteanum,462,406,56,Alphahull-PointsKO-Adjacents,27115
Combretum_edwardsii,19,5,14,Points-PointsKO-Adjacents,150
Combretum_elaeagnoides,53,33,20,Alphahull-PointsKO-Adjacents,905
Combretum_engleri,29,19,10,Points-PointsKO-Adjacents,240
Combretum_erythrophyllum,142,114,28,Alphahull-PointsKO-Adjacents,6075
Combretum_farinosum,394,316,78,Alphahull-PointsKO-Adjacents,7495
Combretum_frangulifolium,19,12,7,Points-PointsKO-Adjacents,135
Combretum_fruticosum,437,374,63,Alphahull-PointsKO-Adjacents,5502
Combretum_gillettianum,9,5,4,Points-PointsKO-Adjacents,52
Combretum_glaucocarpum,305,244,61,Alphahull-PointsKO-Adjacents,11783
Combretum_glutinosum,985,918,67,Alphahull-PointsKO-Adjacents,21151
Combretum_harrisii,2,2,0,Points-PointsKO-Adjacents,16
Combretum_hartmannianum,2,2,0,Points-PointsKO-Adjacents,18
Combretum_hereroense,343,269,74,Alphahull-PointsKO-Adjacents,18804
Combretum_holstii,18,0,18,Points-PointsKO-Adjacents,155
Combretum_imberbe,252,194,58,Alphahull-PointsKO-Adjacents,15475
Combretum_kasaiense,1,1,0,Points-PointsKO-Adjacents,9
Combretum_kraussii,120,94,26,Alphahull-PointsKO-Adjacents,2834
Combretum_lasiocarpum,1,1,0,Points-PointsKO-Adjacents,9
Combretum_latifolium,25,1,24,Points-PointsKO-Adjacents,212
Combretum_laxum,1163,929,234,Alphahull-PointsKO-Adjacents,93756
Combretum_leprosum,987,918,69,Alphahull-PointsKO-Adjacents,36469
Combretum_lokele,15,8,7,Points-PointsKO-Adjacents,57
Combretum_marginatum,27,6,21,Points-PointsKO-Adjacents,198
Combretum_mellifluum,508,452,56,Alphahull-PointsKO-Adjacents,22096
Combretum_micranthum,531,479,52,Alphahull-PointsKO-Adjacents,15144
Combretum_mkuzense,12,4,8,Points-PointsKO-Adjacents,85
Combretum_moggii,19,0,19,Points-PointsKO-Adjacents,169
Combretum_molle,1311,1124,187,Alphahull-PointsKO-Adjacents,59176
Combretum_monetaria,265,231,34,Alphahull-PointsKO-Adjacents,11094
Combretum_mossambicense,81,26,55,Alphahull-PointsKO-Adjacents,2565
Combretum_nigricans,656,611,45,Alphahull-PointsKO-Adjacents,6032
Combretum_obovatum,43,23,20,Alphahull-PointsKO-Adjacents,1445
Combretum_padoides,39,15,24,Points-PointsKO-Adjacents,296
Combretum_paraguariense,62,14,48,Points-PointsKO-Adjacents,535
Combretum_petrophilum,11,6,5,Points-PointsKO-Adjacents,81
Combretum_platypterum,265,182,83,Alphahull-PointsKO-Adjacents,10341
Combretum_psidioides,73,49,24,Alphahull-PointsKO-Adjacents,2733
Combretum_pyramidatum,119,67,52,Alphahull-PointsKO-Adjacents,4028
Combretum_quadrangulare,19,7,12,Points-PointsKO-Adjacents,142
Combretum_rotundifolium,353,277,76,Alphahull-PointsKO-Adjacents,46732
Combretum_schumannii,21,10,11,Points-PointsKO-Adjacents,162
Combretum_schweinfurthii,0,0,0,NA,0
Combretum_subglabratum,6,1,5,Points-PointsKO-Adjacents,46
Combretum_tenuipetiolatum,6,2,4,Points-PointsKO-Adjacents,28
Combretum_towaense,1,1,0,Points-PointsKO-Adjacents,9
Combretum_umbricolum,30,4,26,Points-PointsKO-Adjacents,243
Combretum_vendae,7,0,7,Points-PointsKO-Adjacents,53
Combretum_vernicosum,36,11,25,Points-PointsKO-Adjacents,252
Combretum_wattii,7,2,5,Points-PointsKO-Adjacents,63
Combretum_zeyheri,274,192,82,Alphahull-PointsKO-Adjacents,29114
Comiphyton_gabonense,6,0,6,Points-PointsKO-Adjacents,54
Commersonia_bartramia,672,0,672,Points-PointsKO-Adjacents,2302
Commersonia_craurophylla,148,122,26,Alphahull-PointsKO-Adjacents,1676
Commersonia_macrostipulata,43,29,14,Alphahull-PointsKO-Adjacents,101
Commersonia_novoguinensis,23,14,9,Points-PointsKO-Adjacents,147
Commersonia_obliqua,2,2,0,Points-PointsKO-Adjacents,16
Commidendrum_burchellii,3,3,0,Points-PointsKO-Adjacents,7
Commidendrum_robustum,0,0,0,NA,0
Commidendrum_rotundifolium,0,0,0,NA,0
Commidendrum_rugosum,0,0,0,NA,0
Commidendrum_spurium,0,0,0,NA,0
Commiphora_acuminata,8,2,6,Points-PointsKO-Adjacents,62
Commiphora_africana,380,272,108,Alphahull-PointsKO-Adjacents,24433
Commiphora_alata,NA,NA,NA,NA,NA
Commiphora_alaticaulis,0,0,0,NA,0
Commiphora_albiflora,24,6,18,Points-PointsKO-Adjacents,166
Commiphora_allophylla,47,0,47,Points-PointsKO-Adjacents,349
Commiphora_anacardiifolia,9,3,6,Points-PointsKO-Adjacents,81
Commiphora_ancistrophora,24,6,18,Points-PointsKO-Adjacents,166
Commiphora_angolensis,94,69,25,Alphahull-PointsKO-Adjacents,7853
Commiphora_ankaranensis,19,14,5,Points-PointsKO-Adjacents,75
Commiphora_antunesii,2,2,0,Points-PointsKO-Adjacents,18
Commiphora_aprevalii,65,48,17,Alphahull-PointsKO-Adjacents,871
Commiphora_arafy,15,0,15,Points-PointsKO-Adjacents,87
Commiphora_arenaria,0,0,0,NA,0
Commiphora_baluensis,4,4,0,Points-PointsKO-Adjacents,36
Commiphora_berryi,0,0,0,NA,0
Commiphora_boranensis,2,2,0,Points-PointsKO-Adjacents,18
Commiphora_brevicalyx,37,26,11,Alphahull-PointsKO-Adjacents,585
Commiphora_bruceae,59,26,33,Alphahull-PointsKO-Adjacents,2961
Commiphora_caerulea,8,2,6,Points-PointsKO-Adjacents,61
Commiphora_campestris,53,42,11,Alphahull-PointsKO-Adjacents,2422
Commiphora_capensis,14,0,14,Points-PointsKO-Adjacents,111
Commiphora_capuronii,13,10,3,Points-PointsKO-Adjacents,61
Commiphora_caudata,0,0,0,NA,0
Commiphora_cervifolia,4,4,0,Points-PointsKO-Adjacents,36
Commiphora_chaetocarpa,2,2,0,Points-PointsKO-Adjacents,18
Commiphora_chiovendana,9,3,6,Points-PointsKO-Adjacents,75
Commiphora_ciliata,4,4,0,Points-PointsKO-Adjacents,30
Commiphora_confusa,4,4,0,Points-PointsKO-Adjacents,36
Commiphora_corrugata,1,1,0,Points-PointsKO-Adjacents,9
Commiphora_crenatoserrata,10,5,5,Points-PointsKO-Adjacents,90
Commiphora_cuneifolia,NA,NA,NA,NA,NA
Commiphora_cyclophylla,3,3,0,Points-PointsKO-Adjacents,27
Commiphora_dalzielii,7,2,5,Points-PointsKO-Adjacents,40
Commiphora_dinteri,28,15,13,Points-PointsKO-Adjacents,209
Commiphora_discolor,5,4,1,Points-PointsKO-Adjacents,45
Commiphora_edulis,40,12,28,Points-PointsKO-Adjacents,341
Commiphora_ellenbeckii,35,12,23,Points-PointsKO-Adjacents,274
Commiphora_eminii,36,17,19,Points-PointsKO-Adjacents,262
Commiphora_engleri,0,0,0,NA,0
Commiphora_enneaphylla,2,2,0,Points-PointsKO-Adjacents,18
Commiphora_erlangeriana,2,2,0,Points-PointsKO-Adjacents,18
Commiphora_erosa,2,2,0,Points-PointsKO-Adjacents,18
Commiphora_erythraea,51,0,51,Points-PointsKO-Adjacents,383
Commiphora_foliacea,22,8,14,Points-PointsKO-Adjacents,127
Commiphora_fraxinifolia,8,1,7,Points-PointsKO-Adjacents,57
Commiphora_fulvotomentosa,9,2,7,Points-PointsKO-Adjacents,78
Commiphora_gardoensis,2,2,0,Points-PointsKO-Adjacents,18
Commiphora_gariepensis,NA,NA,NA,NA,NA
Commiphora_gileadensis,29,6,23,Points-PointsKO-Adjacents,211
Commiphora_glandulosa,153,103,50,Alphahull-PointsKO-Adjacents,6507
Commiphora_glaucescens,50,34,16,Alphahull-PointsKO-Adjacents,1794
Commiphora_gracilifrondosa,21,13,8,Points-PointsKO-Adjacents,189
Commiphora_grandifolia,64,38,26,Alphahull-PointsKO-Adjacents,748
Commiphora_guidottii,3,3,0,Points-PointsKO-Adjacents,27
Commiphora_guillauminii,17,5,12,Points-PointsKO-Adjacents,101
Commiphora_gurreh,6,1,5,Points-PointsKO-Adjacents,43
Commiphora_habessinica,85,37,48,Alphahull-PointsKO-Adjacents,3615
Commiphora_harveyi,71,49,22,Alphahull-PointsKO-Adjacents,1425
Commiphora_hildebrandtii,10,4,6,Points-PointsKO-Adjacents,72
Commiphora_hodai,0,0,0,NA,0
Commiphora_holtziana,46,24,22,Alphahull-PointsKO-Adjacents,1928
Commiphora_hornbyi,10,5,5,Points-PointsKO-Adjacents,66
Commiphora_incisa,39,15,24,Points-PointsKO-Adjacents,306
Commiphora_kaokoensis,6,1,5,Points-PointsKO-Adjacents,33
Commiphora_karibensis,3,3,0,Points-PointsKO-Adjacents,27
Commiphora_kataf,29,14,15,Points-PointsKO-Adjacents,205
Commiphora_kerstingii,3,3,0,Points-PointsKO-Adjacents,27
Commiphora_kua,78,36,42,Alphahull-PointsKO-Adjacents,3368
Commiphora_kucharii,2,2,0,Points-PointsKO-Adjacents,15
Commiphora_kuneneana,5,5,0,Points-PointsKO-Adjacents,45
Commiphora_lasiodisca,20,10,10,Points-PointsKO-Adjacents,93
Commiphora_laxecymigera,8,0,8,Points-PointsKO-Adjacents,33
Commiphora_leptophloeos,834,749,85,Alphahull-PointsKO-Adjacents,16232
Commiphora_lindensis,39,15,24,Points-PointsKO-Adjacents,281
Commiphora_lobatospathulata,2,2,0,Points-PointsKO-Adjacents,12
Commiphora_longipedicellata,1,1,0,Points-PointsKO-Adjacents,9
Commiphora_madagascariensis,9,2,7,Points-PointsKO-Adjacents,75
Commiphora_mafaidoha,6,1,5,Points-PointsKO-Adjacents,40
Commiphora_marchandii,116,97,19,Alphahull-PointsKO-Adjacents,2380
Commiphora_marlothii,56,42,14,Alphahull-PointsKO-Adjacents,990
Commiphora_merkeri,13,7,6,Points-PointsKO-Adjacents,95
Commiphora_mildbraedii,3,3,0,Points-PointsKO-Adjacents,27
Commiphora_mollis,174,121,53,Alphahull-PointsKO-Adjacents,6288
Commiphora_mombassensis,8,2,6,Points-PointsKO-Adjacents,54
Commiphora_monoica,3,3,0,Points-PointsKO-Adjacents,21
Commiphora_mossambicensis,46,32,14,Alphahull-PointsKO-Adjacents,2480
Commiphora_mukul,7,0,7,Points-PointsKO-Adjacents,60
Commiphora_mulelame,1,1,0,Points-PointsKO-Adjacents,9
Commiphora_multijuga,20,10,10,Points-PointsKO-Adjacents,180
Commiphora_myrrha,14,2,12,Points-PointsKO-Adjacents,115
Commiphora_namaensis,17,7,10,Points-PointsKO-Adjacents,153
Commiphora_neglecta,61,48,13,Alphahull-PointsKO-Adjacents,2111
Commiphora_oblanceolata,7,2,5,Points-PointsKO-Adjacents,63
Commiphora_oblongifolia,8,3,5,Points-PointsKO-Adjacents,43
Commiphora_obovata,1,1,0,Points-PointsKO-Adjacents,9
Commiphora_oddurensis,2,2,0,Points-PointsKO-Adjacents,18
Commiphora_ogadensis,8,0,8,Points-PointsKO-Adjacents,56
Commiphora_ornifolia,6,2,4,Points-PointsKO-Adjacents,42
Commiphora_otjihipana,NA,NA,NA,NA,NA
Commiphora_ovalifolia,7,2,5,Points-PointsKO-Adjacents,60
Commiphora_paolii,1,1,0,Points-PointsKO-Adjacents,9
Commiphora_parvifolia,1,1,0,Points-PointsKO-Adjacents,5
Commiphora_pedunculata,55,25,30,Alphahull-PointsKO-Adjacents,435
Commiphora_pervilleana,42,27,15,Alphahull-PointsKO-Adjacents,626
Commiphora_planifrons,6,1,5,Points-PointsKO-Adjacents,24
Commiphora_playfairii,1,1,0,Points-PointsKO-Adjacents,9
Commiphora_pseudopaolii,1,1,0,Points-PointsKO-Adjacents,9
Commiphora_pteleifolia,9,4,5,Points-PointsKO-Adjacents,76
Commiphora_pterocarpa,21,5,16,Points-PointsKO-Adjacents,138
Commiphora_pyracanthoides,120,86,34,Alphahull-PointsKO-Adjacents,7823
Commiphora_quadricincta,1,1,0,Points-PointsKO-Adjacents,9
Commiphora_rostrata,7,0,7,Points-PointsKO-Adjacents,63
Commiphora_ruspolii,NA,NA,NA,NA,NA
Commiphora_samharensis,12,0,12,Points-PointsKO-Adjacents,98
Commiphora_saxicola,29,21,8,Alphahull-PointsKO-Adjacents,588
Commiphora_schimperi,112,68,44,Alphahull-PointsKO-Adjacents,3759
Commiphora_schlechteri,13,2,11,Points-PointsKO-Adjacents,86
Commiphora_serrata,22,7,15,Points-PointsKO-Adjacents,182
Commiphora_serrulata,6,2,4,Points-PointsKO-Adjacents,45
Commiphora_socotrana,8,5,3,Points-PointsKO-Adjacents,24
Commiphora_spathulata,2,2,0,Points-PointsKO-Adjacents,16
Commiphora_sphaerocarpa,2,2,0,Points-PointsKO-Adjacents,18
Commiphora_sphaerophylla,2,2,0,Points-PointsKO-Adjacents,18
Commiphora_staphyleifolia,NA,NA,NA,NA,NA
Commiphora_stellatopubescens,1,1,0,Points-PointsKO-Adjacents,9
Commiphora_stellulata,10,2,8,Points-PointsKO-Adjacents,58
Commiphora_steynii,NA,NA,NA,NA,NA
Commiphora_stocksiana,0,0,0,NA,0
Commiphora_sulcata,1,1,0,Points-PointsKO-Adjacents,9
Commiphora_swynnertonii,5,5,0,Points-PointsKO-Adjacents,45
Commiphora_tenuipetiolata,57,38,19,Alphahull-PointsKO-Adjacents,2093
Commiphora_tetramera,13,2,11,Points-PointsKO-Adjacents,95
Commiphora_truncata,5,5,0,Points-PointsKO-Adjacents,41
Commiphora_ugogensis,17,8,9,Points-PointsKO-Adjacents,104
Commiphora_ulugurensis,1,1,0,Points-PointsKO-Adjacents,9
Commiphora_unilobata,2,2,0,Points-PointsKO-Adjacents,18
Commiphora_velutina,7,0,7,Points-PointsKO-Adjacents,57
Commiphora_virgata,26,13,13,Points-PointsKO-Adjacents,225
Commiphora_wightii,1,1,0,Points-PointsKO-Adjacents,9
Commiphora_wildii,23,12,11,Points-PointsKO-Adjacents,207
Commiphora_zanzibarica,33,10,23,Points-PointsKO-Adjacents,262
Comocladia_cordata,3,3,0,Points-PointsKO-Adjacents,25
Comocladia_cuneata,16,8,8,Points-PointsKO-Adjacents,105
Comocladia_dentata,45,22,23,Alphahull-PointsKO-Adjacents,605
Comocladia_dodonaea,74,41,33,Alphahull-PointsKO-Adjacents,604
Comocladia_domingensis,14,6,8,Points-PointsKO-Adjacents,95
Comocladia_ebrenbergii,1,1,0,Points-PointsKO-Adjacents,9
Comocladia_ekmaniana,1,1,0,Points-PointsKO-Adjacents,9
Comocladia_gilgiana,1,1,0,Points-PointsKO-Adjacents,9
Comocladia_glabra,47,34,13,Alphahull-PointsKO-Adjacents,350
Comocladia_grandidentata,1,1,0,Points-PointsKO-Adjacents,9
Comocladia_guatemalensis,34,0,34,Points-PointsKO-Adjacents,166
Comocladia_macrophylla,177,143,34,Alphahull-PointsKO-Adjacents,5475
Comocladia_mayana,5,5,0,Points-PointsKO-Adjacents,45
Comocladia_mollifolia,2,2,0,Points-PointsKO-Adjacents,17
Comocladia_mollissima,21,11,10,Points-PointsKO-Adjacents,154
Comocladia_pinnatifolia,31,17,14,Points-PointsKO-Adjacents,188
Comocladia_platyphylla,3,3,0,Points-PointsKO-Adjacents,23
Comocladia_pubescens,0,0,0,NA,0
Comocladia_undulata,NA,NA,NA,NA,NA
Comocladia_velutina,7,2,5,Points-PointsKO-Adjacents,44
Comoranthus_madagascariensis,6,1,5,Points-PointsKO-Adjacents,35
Comoranthus_minor,34,26,8,Alphahull-PointsKO-Adjacents,524
Comoranthus_obconicus,42,25,17,Alphahull-PointsKO-Adjacents,282
Compsoneura_anoriensis,7,5,2,Points-PointsKO-Adjacents,36
Compsoneura_atopa,43,31,12,Alphahull-PointsKO-Adjacents,403
Compsoneura_capitellata,162,138,24,Alphahull-PointsKO-Adjacents,6102
Compsoneura_claroensis,16,9,7,Points-PointsKO-Adjacents,119
Compsoneura_cuatrecasasii,27,13,14,Points-PointsKO-Adjacents,147
Compsoneura_debilis,103,88,15,Alphahull-PointsKO-Adjacents,2230
Compsoneura_diazii,7,3,4,Points-PointsKO-Adjacents,56
Compsoneura_excelsa,103,91,12,Alphahull-PointsKO-Adjacents,215
Compsoneura_lapidiflora,9,6,3,Points-PointsKO-Adjacents,80
Compsoneura_mexicana,182,146,36,Alphahull-PointsKO-Adjacents,1297
Compsoneura_mutisii,158,141,17,Alphahull-PointsKO-Adjacents,4055
Compsoneura_racemosa,6,0,6,Points-PointsKO-Adjacents,45
Compsoneura_rigidifolia,39,17,22,Points-PointsKO-Adjacents,198
Compsoneura_schultesiana,6,3,3,Points-PointsKO-Adjacents,36
Compsoneura_sprucei,252,209,43,Alphahull-PointsKO-Adjacents,18988
Compsoneura_ulei,260,207,53,Alphahull-PointsKO-Adjacents,26908
Comptonella_baudouinii,3,3,0,Points-PointsKO-Adjacents,27
Comptonella_drupacea,36,18,18,Points-PointsKO-Adjacents,165
Comptonella_lactea,15,10,5,Points-PointsKO-Adjacents,59
Comptonella_microcarpa,9,4,5,Points-PointsKO-Adjacents,56
Comptonella_oreophila,12,2,10,Points-PointsKO-Adjacents,89
Comptonella_sessilifoliola,31,17,14,Points-PointsKO-Adjacents,123
Conandrium_polyanthum,102,73,29,Alphahull-PointsKO-Adjacents,2884
Conceveiba_guianensis,743,673,70,Alphahull-PointsKO-Adjacents,62536
Conceveiba_hostmanii,10,4,6,Points-PointsKO-Adjacents,60
Conceveiba_krukoffii,24,7,17,Points-PointsKO-Adjacents,176
Conceveiba_latifolia,16,3,13,Points-PointsKO-Adjacents,120
Conceveiba_martiana,209,150,59,Alphahull-PointsKO-Adjacents,15093
Conceveiba_maynasensis,9,4,5,Points-PointsKO-Adjacents,45
Conceveiba_pleiostemona,68,48,20,Alphahull-PointsKO-Adjacents,1386
Conceveiba_praealta,1,1,0,Points-PointsKO-Adjacents,9
Conceveiba_ptariana,31,15,16,Points-PointsKO-Adjacents,231
Conceveiba_rhytidocarpa,220,186,34,Alphahull-PointsKO-Adjacents,5502
Conceveiba_santanderensis,9,4,5,Points-PointsKO-Adjacents,78
Conceveiba_terminalis,184,143,41,Alphahull-PointsKO-Adjacents,14599
Conceveiba_tristigmata,22,10,12,Points-PointsKO-Adjacents,146
Conchocarpus_acuminatus,20,5,15,Points-PointsKO-Adjacents,160
Conchocarpus_adenantherus,30,0,30,Points-PointsKO-Adjacents,207
Conchocarpus_cyrtanthus,33,19,14,Points-PointsKO-Adjacents,157
Conchocarpus_diadematus,37,22,15,Alphahull-PointsKO-Adjacents,327
Conchocarpus_fanshawei,9,1,8,Points-PointsKO-Adjacents,57
Conchocarpus_fontanesianus,28,0,28,Points-PointsKO-Adjacents,182
Conchocarpus_furcatus,4,4,0,Points-PointsKO-Adjacents,12
Conchocarpus_grandis,15,0,15,Points-PointsKO-Adjacents,120
Conchocarpus_guyanensis,71,38,33,Alphahull-PointsKO-Adjacents,1225
Conchocarpus_heterophyllus,51,1,50,Points-PointsKO-Adjacents,333
Conchocarpus_insignis,13,3,10,Points-PointsKO-Adjacents,83
Conchocarpus_larensis,33,23,10,Alphahull-PointsKO-Adjacents,109
Conchocarpus_longifolius,129,82,47,Alphahull-PointsKO-Adjacents,1592
Conchocarpus_macrocarpus,15,0,15,Points-PointsKO-Adjacents,97
Conchocarpus_nicaraguensis,99,81,18,Alphahull-PointsKO-Adjacents,758
Conchocarpus_ramiflorus,8,2,6,Points-PointsKO-Adjacents,63
Conchocarpus_santosii,3,3,0,Points-PointsKO-Adjacents,27
Conchocarpus_sordidus,2,2,0,Points-PointsKO-Adjacents,18
Conchocarpus_toxicarius,45,13,32,Points-PointsKO-Adjacents,340
Conchocarpus_transitionalis,27,14,13,Points-PointsKO-Adjacents,200
Conchocarpus_ucayalinus,68,23,45,Alphahull-PointsKO-Adjacents,1093
Conchopetalum_brachysepalum,19,6,13,Points-PointsKO-Adjacents,88
Conchopetalum_madagascariense,4,3,1,Points-PointsKO-Adjacents,17
Condalia_buxifolia,83,0,83,Points-PointsKO-Adjacents,651
Condalia_globosa,207,187,20,Alphahull-PointsKO-Adjacents,2926
Condalia_henriquezii,6,0,6,Points-PointsKO-Adjacents,45
Condalia_hookeri,350,0,350,Points-PointsKO-Adjacents,1494
Condalia_montana,10,5,5,Points-PointsKO-Adjacents,90
Condalia_weberbaueri,7,0,7,Points-PointsKO-Adjacents,63
Condaminea_corymbosa,568,498,70,Alphahull-PointsKO-Adjacents,11094
Condaminea_elegans,9,4,5,Points-PointsKO-Adjacents,81
Condaminea_glabrata,2,2,0,Points-PointsKO-Adjacents,18
Condaminea_microcarpa,3,3,0,Points-PointsKO-Adjacents,27
Condea_albida,280,211,69,Alphahull-PointsKO-Adjacents,5305
Condea_subtilis,13,5,8,Points-PointsKO-Adjacents,93
Condea_tafallae,55,35,20,Alphahull-PointsKO-Adjacents,884
Condylopodium_cuatrecasasii,5,5,0,Points-PointsKO-Adjacents,43
Connarus_agamae,1,1,0,Points-PointsKO-Adjacents,9
Connarus_brachybotryosus,3,3,0,Points-PointsKO-Adjacents,25
Connarus_celatus,3,3,0,Points-PointsKO-Adjacents,27
Connarus_cochinchinensis,9,1,8,Points-PointsKO-Adjacents,70
Connarus_detersoides,2,2,0,Points-PointsKO-Adjacents,18
Connarus_detersus,84,48,36,Alphahull-PointsKO-Adjacents,902
Connarus_ecuadorensis,5,5,0,Points-PointsKO-Adjacents,45
Connarus_elsae,7,1,6,Points-PointsKO-Adjacents,61
Connarus_erianthus,84,31,53,Alphahull-PointsKO-Adjacents,5639
Connarus_fasciculatus,201,148,53,Alphahull-PointsKO-Adjacents,17268
Connarus_grandis,16,6,10,Points-PointsKO-Adjacents,138
Connarus_incomptus,54,26,28,Alphahull-PointsKO-Adjacents,933
Connarus_lentiginosus,26,13,13,Points-PointsKO-Adjacents,113
Connarus_longistipitatus,51,37,14,Alphahull-PointsKO-Adjacents,456
Connarus_marlenei,17,8,9,Points-PointsKO-Adjacents,109
Connarus_martii,21,2,19,Points-PointsKO-Adjacents,181
Connarus_megacarpus,6,1,5,Points-PointsKO-Adjacents,45
Connarus_monocarpus,24,4,20,Points-PointsKO-Adjacents,199
Connarus_nodosus,18,4,14,Points-PointsKO-Adjacents,119
Connarus_ovatifolius,14,1,13,Points-PointsKO-Adjacents,82
Connarus_panamensis,106,76,30,Alphahull-PointsKO-Adjacents,1887
Connarus_paniculatus,20,2,18,Points-PointsKO-Adjacents,172
Connarus_patrisii,37,7,30,Points-PointsKO-Adjacents,315
Connarus_perrottetii,307,251,56,Alphahull-PointsKO-Adjacents,29070
Connarus_popenoei,8,2,6,Points-PointsKO-Adjacents,49
Connarus_rigidus,57,0,57,Points-PointsKO-Adjacents,418
Connarus_rostratus,70,49,21,Alphahull-PointsKO-Adjacents,894
Connarus_semidecandrus,62,7,55,Points-PointsKO-Adjacents,482
Connarus_silvanensis,9,0,9,Points-PointsKO-Adjacents,45
Connarus_stenophyllus,4,3,1,Points-PointsKO-Adjacents,27
Connarus_suberosus,897,0,897,Points-PointsKO-Adjacents,5888
Connarus_venezuelanus,157,134,23,Alphahull-PointsKO-Adjacents,4645
Connarus_williamsii,22,13,9,Points-PointsKO-Adjacents,142
Conocarpus_erectus,1766,1323,443,Alphahull-PointsKO-Adjacents,24432
Conocarpus_lancifolius,5,4,1,Points-PointsKO-Adjacents,32
Conospermum_triplinervium,193,138,55,Alphahull-PointsKO-Adjacents,1941
Conostegia_apiculata,44,24,20,Alphahull-PointsKO-Adjacents,294
Conostegia_arborea,73,52,21,Alphahull-PointsKO-Adjacents,300
Conostegia_attenuata,48,22,26,Alphahull-PointsKO-Adjacents,384
Conostegia_bigibbosa,25,13,12,Points-PointsKO-Adjacents,86
Conostegia_bracteata,127,100,27,Alphahull-PointsKO-Adjacents,821
Conostegia_caelestis,62,38,24,Alphahull-PointsKO-Adjacents,914
Conostegia_centronioides,77,64,13,Alphahull-PointsKO-Adjacents,869
Conostegia_chiriquensis,15,0,15,Points-PointsKO-Adjacents,42
Conostegia_cinnamomea,123,89,34,Alphahull-PointsKO-Adjacents,1441
Conostegia_dentata,52,37,15,Alphahull-PointsKO-Adjacents,426
Conostegia_extinctoria,23,15,8,Points-PointsKO-Adjacents,143
Conostegia_formosa,22,13,9,Points-PointsKO-Adjacents,136
Conostegia_hirtella,40,28,12,Alphahull-PointsKO-Adjacents,200
Conostegia_icosandra,455,338,117,Alphahull-PointsKO-Adjacents,7859
Conostegia_lasiopoda,164,124,40,Alphahull-PointsKO-Adjacents,1768
Conostegia_macrantha,66,57,9,Alphahull-PointsKO-Adjacents,150
Conostegia_micrantha,184,160,24,Alphahull-PointsKO-Adjacents,717
Conostegia_montana,356,299,57,Alphahull-PointsKO-Adjacents,4055
Conostegia_muriculata,25,15,10,Points-PointsKO-Adjacents,112
Conostegia_oerstediana,137,116,21,Alphahull-PointsKO-Adjacents,346
Conostegia_pittieri,95,78,17,Alphahull-PointsKO-Adjacents,227
Conostegia_plumosa,25,15,10,Points-PointsKO-Adjacents,154
Conostegia_polyandra,39,15,24,Points-PointsKO-Adjacents,214
Conostegia_rhodopetala,67,58,9,Alphahull-PointsKO-Adjacents,161
Conostegia_rufescens,211,169,42,Alphahull-PointsKO-Adjacents,1468
Conostegia_setifera,70,58,12,Alphahull-PointsKO-Adjacents,294
Conostegia_subcrustulata,280,241,39,Alphahull-PointsKO-Adjacents,1817
Conostegia_superba,3,2,1,Points-PointsKO-Adjacents,23
Conostegia_tenuifolia,150,110,40,Alphahull-PointsKO-Adjacents,2762
Conostegia_volcanalis,164,123,41,Alphahull-PointsKO-Adjacents,2310
Conostegia_vulcanicola,29,21,8,Alphahull-PointsKO-Adjacents,111
Conostegia_xalapensis,1651,1489,162,Alphahull-PointsKO-Adjacents,14015
Consolea_corallicola,2,2,0,Points-PointsKO-Adjacents,17
Consolea_falcata,6,1,5,Points-PointsKO-Adjacents,38
Consolea_macracantha,9,1,8,Points-PointsKO-Adjacents,68
Consolea_millspaughii,8,2,6,Points-PointsKO-Adjacents,52
Consolea_moniliformis,21,10,11,Points-PointsKO-Adjacents,98
Consolea_nashii,14,5,9,Points-PointsKO-Adjacents,88
Consolea_rubescens,21,12,9,Points-PointsKO-Adjacents,90
Consolea_spinosissima,1,1,0,Points-PointsKO-Adjacents,9
Conyza_vernonioides,9,0,9,Points-PointsKO-Adjacents,69
Conzattia_chiapensis,4,4,0,Points-PointsKO-Adjacents,21
Conzattia_multiflora,221,185,36,Alphahull-PointsKO-Adjacents,2113
Conzattia_sericea,26,14,12,Points-PointsKO-Adjacents,165
Copaifera_aromatica,51,34,17,Alphahull-PointsKO-Adjacents,774
Copaifera_bracteata,NA,NA,NA,NA,NA
Copaifera_brasiliensis,3,3,0,Points-PointsKO-Adjacents,27
Copaifera_camibar,36,25,11,Alphahull-PointsKO-Adjacents,98
Copaifera_canime,17,7,10,Points-PointsKO-Adjacents,147
Copaifera_coriacea,183,148,35,Alphahull-PointsKO-Adjacents,7649
Copaifera_duckei,167,112,55,Alphahull-PointsKO-Adjacents,18026
Copaifera_epunctata,4,4,0,Points-PointsKO-Adjacents,25
Copaifera_glycycarpa,31,10,21,Points-PointsKO-Adjacents,269
Copaifera_gynohirsuta,1,1,0,Points-PointsKO-Adjacents,9
Copaifera_laevis,2,2,0,Points-PointsKO-Adjacents,18
Copaifera_langsdorffii,2153,2006,147,Alphahull-PointsKO-Adjacents,57721
Copaifera_lucens,109,0,109,Points-PointsKO-Adjacents,677
Copaifera_luetzelburgii,218,197,21,Alphahull-PointsKO-Adjacents,9838
Copaifera_majorina,15,5,10,Points-PointsKO-Adjacents,88
Copaifera_marginata,67,43,24,Alphahull-PointsKO-Adjacents,3314
Copaifera_martii,365,315,50,Alphahull-PointsKO-Adjacents,25968
Copaifera_mildbraedii,69,44,25,Alphahull-PointsKO-Adjacents,1681
Copaifera_multijuga,185,141,44,Alphahull-PointsKO-Adjacents,17186
Copaifera_oblongifolia,287,237,50,Alphahull-PointsKO-Adjacents,18267
Copaifera_officinalis,46,0,46,Points-PointsKO-Adjacents,392
Copaifera_panamensis,27,13,14,Points-PointsKO-Adjacents,154
Copaifera_paupera,40,0,40,Points-PointsKO-Adjacents,331
Copaifera_piresii,24,3,21,Points-PointsKO-Adjacents,210
Copaifera_pubiflora,162,0,162,Points-PointsKO-Adjacents,1213
Copaifera_religiosa,32,24,8,Alphahull-PointsKO-Adjacents,376
Copaifera_reticulata,211,149,62,Alphahull-PointsKO-Adjacents,27792
Copaifera_rondonii,1,1,0,Points-PointsKO-Adjacents,9
Copaifera_sabulicola,78,64,14,Alphahull-PointsKO-Adjacents,2765
Copaifera_salikounda,57,33,24,Alphahull-PointsKO-Adjacents,1432
Copaifera_trapezifolia,372,311,61,Alphahull-PointsKO-Adjacents,4621
Copaifera_venezuelana,4,4,0,Points-PointsKO-Adjacents,36
Copernicia_alba,196,0,196,Points-PointsKO-Adjacents,1326
Copernicia_baileyana,4,4,0,Points-PointsKO-Adjacents,36
Copernicia_berteroana,10,5,5,Points-PointsKO-Adjacents,85
Copernicia_brittonorum,3,3,0,Points-PointsKO-Adjacents,27
Copernicia_cowellii,6,2,4,Points-PointsKO-Adjacents,41
Copernicia_curbeloi,1,1,0,Points-PointsKO-Adjacents,9
Copernicia_curtissii,12,6,6,Points-PointsKO-Adjacents,48
Copernicia_ekmanii,2,2,0,Points-PointsKO-Adjacents,18
Copernicia_fallaensis,1,0,1,Points-PointsKO-Adjacents,9
Copernicia_gigas,5,5,0,Points-PointsKO-Adjacents,45
Copernicia_glabrescens,11,0,11,Points-PointsKO-Adjacents,73
Copernicia_hospita,9,2,7,Points-PointsKO-Adjacents,79
Copernicia_humicola,0,0,0,NA,0
Copernicia_longiglossa,0,0,0,NA,0
Copernicia_macroglossa,4,4,0,Points-PointsKO-Adjacents,36
Copernicia_oxycalyx,0,0,0,NA,0
Copernicia_prunifera,170,0,170,Points-PointsKO-Adjacents,1229
Copernicia_rigida,7,1,6,Points-PointsKO-Adjacents,63
Copernicia_roigii,1,1,0,Points-PointsKO-Adjacents,9
Copernicia_tectorum,58,31,27,Alphahull-PointsKO-Adjacents,1935
Copernicia_yarey,4,3,1,Points-PointsKO-Adjacents,32
Coprosma_acutifolia,9,2,7,Points-PointsKO-Adjacents,30
Coprosma_arborea,359,317,42,Alphahull-PointsKO-Adjacents,1344
Coprosma_areolata,472,403,69,Alphahull-PointsKO-Adjacents,4242
Coprosma_baueri,4,1,3,Points-PointsKO-Adjacents,3
Coprosma_benefica,1,0,1,Points-PointsKO-Adjacents,2
Coprosma_chathamica,26,15,11,Points-PointsKO-Adjacents,99
Coprosma_cookei,3,3,0,Points-PointsKO-Adjacents,4
Coprosma_esulcata,3,3,0,Points-PointsKO-Adjacents,5
Coprosma_foetidissima,10199,10126,73,Alphahull-PointsKO-Adjacents,4005
Coprosma_foliosa,9,2,7,Points-PointsKO-Adjacents,55
Coprosma_grandifolia,5215,5134,81,Alphahull-PointsKO-Adjacents,4229
Coprosma_huttoniana,9,3,6,Points-PointsKO-Adjacents,5
Coprosma_kauensis,9,5,4,Points-PointsKO-Adjacents,17
Coprosma_laevigata,8,3,5,Points-PointsKO-Adjacents,5
Coprosma_linariifolia,2389,2346,43,Alphahull-PointsKO-Adjacents,3800
Coprosma_longifolia,7,3,4,Points-PointsKO-Adjacents,28
Coprosma_lucida,4906,4806,100,Alphahull-PointsKO-Adjacents,4566
Coprosma_macrocarpa,191,143,48,Alphahull-PointsKO-Adjacents,1280
Coprosma_menziesii,13,6,7,Points-PointsKO-Adjacents,59
Coprosma_montana,18,12,6,Points-PointsKO-Adjacents,75
Coprosma_novaehebridae,NA,NA,NA,NA,NA
Coprosma_ochracea,20,12,8,Points-PointsKO-Adjacents,74
Coprosma_oliveri,3,3,0,Points-PointsKO-Adjacents,5
Coprosma_papuensis,80,63,17,Alphahull-PointsKO-Adjacents,409
Coprosma_parviflora,4798,4729,69,Alphahull-PointsKO-Adjacents,3914
Coprosma_pedicellata,76,47,29,Alphahull-PointsKO-Adjacents,406
Coprosma_persicifolia,0,0,0,NA,0
Coprosma_petiolata,5,2,3,Points-PointsKO-Adjacents,4
Coprosma_pilosa,6,1,5,Points-PointsKO-Adjacents,3
Coprosma_prisca,11,4,7,Points-PointsKO-Adjacents,5
Coprosma_propinqua,3001,2916,85,Alphahull-PointsKO-Adjacents,4377
Coprosma_pubens,8,3,5,Points-PointsKO-Adjacents,67
Coprosma_putida,19,13,6,Points-PointsKO-Adjacents,5
Coprosma_pyrifolia,3,3,0,Points-PointsKO-Adjacents,18
Coprosma_quadrifida,10089,9935,154,Alphahull-PointsKO-Adjacents,5917
Coprosma_rapensis,5,5,0,Points-PointsKO-Adjacents,4
Coprosma_repens,324,256,68,Alphahull-PointsKO-Adjacents,3482
Coprosma_rhynchocarpa,15,9,6,Points-PointsKO-Adjacents,74
Coprosma_robusta,2478,2333,145,Alphahull-PointsKO-Adjacents,4336
Coprosma_rotundifolia,2347,1844,503,Alphahull-PointsKO-Adjacents,3629
Coprosma_savaiiensis,5,5,0,Points-PointsKO-Adjacents,12
Coprosma_strigulosa,4,4,0,Points-PointsKO-Adjacents,12
Coprosma_tahitensis,12,8,4,Points-PointsKO-Adjacents,19
Coprosma_tenuifolia,1458,1432,26,Alphahull-PointsKO-Adjacents,1568
Coprosma_ternata,5,5,0,Points-PointsKO-Adjacents,20
Coprosma_waimeae,9,5,4,Points-PointsKO-Adjacents,25
Coprosma_wallii,102,76,26,Alphahull-PointsKO-Adjacents,2082
Coprosma_wollastonii,16,4,12,Points-PointsKO-Adjacents,107
Coptosapelta_flavescens,7,0,7,Points-PointsKO-Adjacents,63
Coptosperma_bernierianum,36,12,24,Points-PointsKO-Adjacents,190
Coptosperma_borbonicum,1,1,0,Points-PointsKO-Adjacents,8
Coptosperma_cymosum,0,0,0,NA,0
Coptosperma_graveolens,160,111,49,Alphahull-PointsKO-Adjacents,10814
Coptosperma_humblotii,10,2,8,Points-PointsKO-Adjacents,87
Coptosperma_littorale,74,45,29,Alphahull-PointsKO-Adjacents,1444
Coptosperma_mitochondrioides,14,2,12,Points-PointsKO-Adjacents,90
Coptosperma_neurophyllum,115,80,35,Alphahull-PointsKO-Adjacents,11558
Coptosperma_nigrescens,94,44,50,Alphahull-PointsKO-Adjacents,656
Coptosperma_pachyphyllum,8,2,6,Points-PointsKO-Adjacents,56
Coptosperma_rhodesiacum,41,23,18,Alphahull-PointsKO-Adjacents,752
Coptosperma_sessiliflorum,0,0,0,NA,0
Coptosperma_supra-axillare,177,117,60,Alphahull-PointsKO-Adjacents,4633
Corchorus_hirsutus,101,60,41,Alphahull-PointsKO-Adjacents,863
Cordeauxia_edulis,3,3,0,Points-PointsKO-Adjacents,24
Cordia_aberrans,54,29,25,Alphahull-PointsKO-Adjacents,899
Cordia_acunae,2,2,0,Points-PointsKO-Adjacents,9
Cordia_acutifolia,52,23,29,Alphahull-PointsKO-Adjacents,328
Cordia_africana,155,94,61,Alphahull-PointsKO-Adjacents,9178
Cordia_allartii,9,1,8,Points-PointsKO-Adjacents,77
Cordia_alliodora,2395,2053,342,Alphahull-PointsKO-Adjacents,82938
Cordia_americana,705,629,76,Alphahull-PointsKO-Adjacents,17864
Cordia_anabaptista,37,8,29,Points-PointsKO-Adjacents,274
Cordia_andersonii,4,4,0,Points-PointsKO-Adjacents,23
Cordia_anisophylla,20,11,9,Points-PointsKO-Adjacents,94
Cordia_aristeguietae,7,3,4,Points-PointsKO-Adjacents,53
Cordia_aspera,28,3,25,Points-PointsKO-Adjacents,176
Cordia_aurantiaca,69,0,69,Points-PointsKO-Adjacents,390
Cordia_bahamensis,7,1,6,Points-PointsKO-Adjacents,42
Cordia_barbata,22,16,6,Points-PointsKO-Adjacents,154
Cordia_bellonis,14,11,3,Points-PointsKO-Adjacents,36
Cordia_bequaertii,1,1,0,Points-PointsKO-Adjacents,9
Cordia_bicolor,812,648,164,Alphahull-PointsKO-Adjacents,59562
Cordia_blancoi,0,0,0,NA,0
Cordia_bogotensis,64,46,18,Alphahull-PointsKO-Adjacents,1673
Cordia_boissieri,619,1,618,Points-PointsKO-Adjacents,1711
Cordia_borinquensis,46,25,21,Alphahull-PointsKO-Adjacents,65
Cordia_brasiliensis,26,0,26,Points-PointsKO-Adjacents,114
Cordia_brunnea,NA,NA,NA,NA,NA
Cordia_buddleoides,48,17,31,Points-PointsKO-Adjacents,345
Cordia_cabanayensis,2,1,1,Points-PointsKO-Adjacents,18
Cordia_caffra,51,23,28,Alphahull-PointsKO-Adjacents,648
Cordia_cardenasiana,3,3,0,Points-PointsKO-Adjacents,27
Cordia_cicatricosa,3,3,0,Points-PointsKO-Adjacents,27
Cordia_clarendonensis,1,1,0,Points-PointsKO-Adjacents,6
Cordia_clarkei,0,0,0,NA,0
Cordia_cochinchinensis,2,2,0,Points-PointsKO-Adjacents,9
Cordia_colimensis,5,4,1,Points-PointsKO-Adjacents,43
Cordia_collococca,585,440,145,Alphahull-PointsKO-Adjacents,16067
Cordia_colombiana,44,23,21,Alphahull-PointsKO-Adjacents,687
Cordia_cordiformis,3,3,0,Points-PointsKO-Adjacents,27
Cordia_correae,7,2,5,Points-PointsKO-Adjacents,30
Cordia_crenata,6,0,6,Points-PointsKO-Adjacents,52
Cordia_croatii,51,35,16,Alphahull-PointsKO-Adjacents,344
Cordia_curassavica,365,252,113,Alphahull-PointsKO-Adjacents,17166
Cordia_cymosa,151,136,15,Alphahull-PointsKO-Adjacents,827
Cordia_decandra,50,0,50,Points-PointsKO-Adjacents,247
Cordia_decipiens,44,15,29,Points-PointsKO-Adjacents,372
Cordia_dentata,544,388,156,Alphahull-PointsKO-Adjacents,15824
Cordia_dewevrei,5,5,0,Points-PointsKO-Adjacents,45
Cordia_dichotoma,429,260,169,Alphahull-PointsKO-Adjacents,8298
Cordia_discolor,14,0,14,Points-PointsKO-Adjacents,120
Cordia_diversifolia,287,229,58,Alphahull-PointsKO-Adjacents,5833
Cordia_dodecandra,326,252,74,Alphahull-PointsKO-Adjacents,4113
Cordia_domestica,0,0,0,NA,0
Cordia_domingensis,0,0,0,NA,0
Cordia_dumosa,0,0,0,NA,0
Cordia_dwyeri,99,70,29,Alphahull-PointsKO-Adjacents,1366
Cordia_ecalyculata,840,748,92,Alphahull-PointsKO-Adjacents,17652
Cordia_elaeagnoides,418,333,85,Alphahull-PointsKO-Adjacents,2958
Cordia_ellenbeckii,2,2,0,Points-PointsKO-Adjacents,18
Cordia_elliptica,29,18,11,Points-PointsKO-Adjacents,78
Cordia_ensifolia,1,1,0,Points-PointsKO-Adjacents,9
Cordia_eriostigma,158,102,56,Alphahull-PointsKO-Adjacents,1668
Cordia_exaltata,404,336,68,Alphahull-PointsKO-Adjacents,37327
Cordia_fallax,23,13,10,Points-PointsKO-Adjacents,185
Cordia_fischeri,NA,NA,NA,NA,NA
Cordia_fitchii,8,4,4,Points-PointsKO-Adjacents,55
Cordia_fragrantissima,0,0,0,NA,0
Cordia_fuertesii,7,3,4,Points-PointsKO-Adjacents,55
Cordia_fulva,8,4,4,Points-PointsKO-Adjacents,70
Cordia_furcans,21,2,19,Points-PointsKO-Adjacents,180
Cordia_galeottiana,4,3,1,Points-PointsKO-Adjacents,27
Cordia_gardneri,6,0,6,Points-PointsKO-Adjacents,54
Cordia_gerascanthus,301,218,83,Alphahull-PointsKO-Adjacents,9417
Cordia_gilletii,5,2,3,Points-PointsKO-Adjacents,43
Cordia_glabrata,668,607,61,Alphahull-PointsKO-Adjacents,33401
Cordia_glazioviana,212,177,35,Alphahull-PointsKO-Adjacents,5729
Cordia_globifera,NA,NA,NA,NA,NA
Cordia_globulifera,25,0,25,Points-PointsKO-Adjacents,157
Cordia_goeldiana,92,51,41,Alphahull-PointsKO-Adjacents,5510
Cordia_goetzei,28,15,13,Points-PointsKO-Adjacents,211
Cordia_gracilipes,5,4,1,Points-PointsKO-Adjacents,44
Cordia_grandicalyx,7,2,5,Points-PointsKO-Adjacents,61
Cordia_grandis,2,2,0,Points-PointsKO-Adjacents,18
Cordia_guacharaca,6,0,6,Points-PointsKO-Adjacents,40
Cordia_guerkeana,2,2,0,Points-PointsKO-Adjacents,18
Cordia_guineensis,22,10,12,Points-PointsKO-Adjacents,120
Cordia_haitiensis,8,4,4,Points-PointsKO-Adjacents,58
Cordia_harrisii,0,0,0,NA,0
Cordia_hatschbachii,6,0,6,Points-PointsKO-Adjacents,24
Cordia_iberica,0,0,0,NA,0
Cordia_ignea,4,4,0,Points-PointsKO-Adjacents,19
Cordia_iguaguana,23,0,23,Points-PointsKO-Adjacents,145
Cordia_igualensis,16,14,2,Points-PointsKO-Adjacents,78
Cordia_incognita,215,194,21,Alphahull-PointsKO-Adjacents,4096
Cordia_insignis,164,130,34,Alphahull-PointsKO-Adjacents,8422
Cordia_intricata,0,0,0,NA,0
Cordia_kanehirai,1,1,0,Points-PointsKO-Adjacents,6
Cordia_kingstoniana,76,27,49,Alphahull-PointsKO-Adjacents,2003
Cordia_koemariae,2,2,0,Points-PointsKO-Adjacents,15
Cordia_laevifrons,17,11,6,Points-PointsKO-Adjacents,119
Cordia_laevigata,98,53,45,Alphahull-PointsKO-Adjacents,1120
Cordia_laevior,3,3,0,Points-PointsKO-Adjacents,27
Cordia_lasiocalyx,39,27,12,Alphahull-PointsKO-Adjacents,227
Cordia_lasseri,2,2,0,Points-PointsKO-Adjacents,18
Cordia_latiloba,20,4,16,Points-PointsKO-Adjacents,160
Cordia_leonis,0,0,0,NA,0
Cordia_leslieae,8,5,3,Points-PointsKO-Adjacents,18
Cordia_leucophlyctis,4,4,0,Points-PointsKO-Adjacents,22
Cordia_liesneri,38,30,8,Alphahull-PointsKO-Adjacents,53
Cordia_linearicalycina,1,1,0,Points-PointsKO-Adjacents,9
Cordia_lomatoloba,170,88,82,Alphahull-PointsKO-Adjacents,8077
Cordia_lowryana,23,8,15,Points-PointsKO-Adjacents,113
Cordia_lucidula,171,151,20,Alphahull-PointsKO-Adjacents,792
Cordia_lutea,232,180,52,Alphahull-PointsKO-Adjacents,2457
Cordia_macleodii,0,0,0,NA,0
Cordia_macrantha,25,15,10,Points-PointsKO-Adjacents,95
Cordia_macrophylla,3,3,0,Points-PointsKO-Adjacents,15
Cordia_macvaughii,2,2,0,Points-PointsKO-Adjacents,18
Cordia_magnoliifolia,193,144,49,Alphahull-PointsKO-Adjacents,4649
Cordia_mairei,52,38,14,Alphahull-PointsKO-Adjacents,349
Cordia_mandimbana,1,1,0,Points-PointsKO-Adjacents,9
Cordia_martinicensis,3,3,0,Points-PointsKO-Adjacents,15
Cordia_megalantha,90,62,28,Alphahull-PointsKO-Adjacents,554
Cordia_meridensis,1,0,1,Points-PointsKO-Adjacents,9
Cordia_mexiana,50,24,26,Alphahull-PointsKO-Adjacents,2147
Cordia_mhaya,NA,NA,NA,NA,NA
Cordia_micronesica,0,0,0,NA,0
Cordia_millenii,76,31,45,Alphahull-PointsKO-Adjacents,500
Cordia_monoica,88,36,52,Alphahull-PointsKO-Adjacents,2610
Cordia_morelosana,174,150,24,Alphahull-PointsKO-Adjacents,1294
Cordia_mukuensis,6,1,5,Points-PointsKO-Adjacents,53
Cordia_myxa,7,0,7,Points-PointsKO-Adjacents,56
Cordia_naidophila,67,30,37,Alphahull-PointsKO-Adjacents,865
Cordia_nervosa,40,21,19,Alphahull-PointsKO-Adjacents,336
Cordia_nodosa,2042,1905,137,Alphahull-PointsKO-Adjacents,85305
Cordia_oaxacana,199,157,42,Alphahull-PointsKO-Adjacents,4044
Cordia_obovata,3,3,0,Points-PointsKO-Adjacents,15
Cordia_obtusa,0,0,0,NA,0
Cordia_ochnacea,31,16,15,Points-PointsKO-Adjacents,171
Cordia_octandra,0,0,0,NA,0
Cordia_oliverii,2,2,0,Points-PointsKO-Adjacents,18
Cordia_oncocalyx,143,118,25,Alphahull-PointsKO-Adjacents,2154
Cordia_panamensis,618,535,83,Alphahull-PointsKO-Adjacents,17698
Cordia_panicularis,76,28,48,Alphahull-PointsKO-Adjacents,2142
Cordia_perrottetii,2,1,1,Points-PointsKO-Adjacents,18
Cordia_peteri,3,3,0,Points-PointsKO-Adjacents,15
Cordia_pilosissima,11,0,11,Points-PointsKO-Adjacents,97
Cordia_platythyrsa,31,11,20,Points-PointsKO-Adjacents,254
Cordia_porcata,154,134,20,Alphahull-PointsKO-Adjacents,700
Cordia_protracta,38,29,9,Alphahull-PointsKO-Adjacents,471
Cordia_prunifolia,42,21,21,Alphahull-PointsKO-Adjacents,453
Cordia_pulverulenta,2,2,0,Points-PointsKO-Adjacents,13
Cordia_ramirezii,2,2,0,Points-PointsKO-Adjacents,16
Cordia_resinosa,21,12,9,Points-PointsKO-Adjacents,141
Cordia_rhombifolia,14,7,7,Points-PointsKO-Adjacents,70
Cordia_ripicola,8,1,7,Points-PointsKO-Adjacents,72
Cordia_rosei,1,1,0,Points-PointsKO-Adjacents,9
Cordia_rubescens,13,8,5,Points-PointsKO-Adjacents,71
Cordia_rufescens,499,445,54,Alphahull-PointsKO-Adjacents,16051
Cordia_saccellia,109,75,34,Alphahull-PointsKO-Adjacents,1051
Cordia_sagotii,216,152,64,Alphahull-PointsKO-Adjacents,23696
Cordia_salvadorensis,122,88,34,Alphahull-PointsKO-Adjacents,1652
Cordia_scaberrima,12,6,6,Points-PointsKO-Adjacents,106
Cordia_scabrifolia,214,141,73,Alphahull-PointsKO-Adjacents,26110
Cordia_schatziana,7,0,7,Points-PointsKO-Adjacents,53
Cordia_scouleri,3,3,0,Points-PointsKO-Adjacents,25
Cordia_sebestena,316,197,119,Alphahull-PointsKO-Adjacents,7203
Cordia_seleriana,138,87,51,Alphahull-PointsKO-Adjacents,644
Cordia_sellowiana,1075,933,142,Alphahull-PointsKO-Adjacents,41675
Cordia_senegalensis,38,18,20,Points-PointsKO-Adjacents,272
Cordia_sericicalyx,183,0,183,Points-PointsKO-Adjacents,1391
Cordia_silvestris,147,91,56,Alphahull-PointsKO-Adjacents,1320
Cordia_sinensis,205,100,105,Alphahull-PointsKO-Adjacents,7691
Cordia_skutchii,2,2,0,Points-PointsKO-Adjacents,18
Cordia_somaliensis,11,4,7,Points-PointsKO-Adjacents,70
Cordia_sonorae,128,97,31,Alphahull-PointsKO-Adjacents,1112
Cordia_splendida,1,1,0,Points-PointsKO-Adjacents,9
Cordia_sprucei,114,60,54,Alphahull-PointsKO-Adjacents,3828
Cordia_stellifera,226,189,37,Alphahull-PointsKO-Adjacents,3491
Cordia_stenoclada,107,0,107,Points-PointsKO-Adjacents,489
Cordia_stuhlmannii,1,1,0,Points-PointsKO-Adjacents,9
Cordia_subcordata,227,113,114,Alphahull-PointsKO-Adjacents,2285
Cordia_suckertii,9,5,4,Points-PointsKO-Adjacents,65
Cordia_suffruticosa,NA,NA,NA,NA,NA
Cordia_sulcata,94,50,44,Alphahull-PointsKO-Adjacents,473
Cordia_superba,786,671,115,Alphahull-PointsKO-Adjacents,27316
Cordia_tacarcunensis,1,1,0,Points-PointsKO-Adjacents,9
Cordia_taguahyensis,323,252,71,Alphahull-PointsKO-Adjacents,10023
Cordia_tetrandra,354,256,98,Alphahull-PointsKO-Adjacents,29696
Cordia_thaisiana,31,15,16,Points-PointsKO-Adjacents,243
Cordia_tinifolia,25,12,13,Points-PointsKO-Adjacents,156
Cordia_toqueve,317,197,120,Alphahull-PointsKO-Adjacents,18347
Cordia_torrei,9,1,8,Points-PointsKO-Adjacents,58
Cordia_tortuensis,2,2,0,Points-PointsKO-Adjacents,7
Cordia_trachyphylla,75,50,25,Alphahull-PointsKO-Adjacents,1558
Cordia_triangularis,0,0,0,NA,0
Cordia_trichoclada,234,194,40,Alphahull-PointsKO-Adjacents,4215
Cordia_trichotoma,1837,1690,147,Alphahull-PointsKO-Adjacents,52594
Cordia_troyana,NA,NA,NA,NA,NA
Cordia_truncatifolia,103,72,31,Alphahull-PointsKO-Adjacents,475
Cordia_ucayaliensis,249,189,60,Alphahull-PointsKO-Adjacents,15065
Cordia_ulei,39,10,29,Points-PointsKO-Adjacents,328
Cordia_umbellifera,9,1,8,Points-PointsKO-Adjacents,81
Cordia_uncinulata,6,0,6,Points-PointsKO-Adjacents,48
Cordia_valenzuelana,1,1,0,Points-PointsKO-Adjacents,9
Cordia_vanhermannii,0,0,0,NA,0
Cordia_vestita,3,3,0,Points-PointsKO-Adjacents,23
Cordia_vignei,7,1,6,Points-PointsKO-Adjacents,61
Cordia_wagnerorum,1,1,0,Points-PointsKO-Adjacents,9
Cordia_weddellii,52,41,11,Alphahull-PointsKO-Adjacents,1163
Cordia_williamsii,10,2,8,Points-PointsKO-Adjacents,88
Cordiera_concolor,1122,1016,106,Alphahull-PointsKO-Adjacents,31767
Cordiera_elliptica,619,564,55,Alphahull-PointsKO-Adjacents,22192
Cordiera_garapatica,84,54,30,Alphahull-PointsKO-Adjacents,1809
Cordiera_hadrantha,33,10,23,Points-PointsKO-Adjacents,281
Cordiera_humilis,118,66,52,Alphahull-PointsKO-Adjacents,9822
Cordiera_longicaudata,4,4,0,Points-PointsKO-Adjacents,20
Cordiera_macrophylla,398,340,58,Alphahull-PointsKO-Adjacents,18236
Cordiera_myrciifolia,853,684,169,Alphahull-PointsKO-Adjacents,91741
Cordiera_sessilis,1278,1190,88,Alphahull-PointsKO-Adjacents,45772
Cordiera_triflora,130,67,63,Alphahull-PointsKO-Adjacents,3979
Cordyla_africana,54,19,35,Points-PointsKO-Adjacents,399
Cordyla_densiflora,11,5,6,Points-PointsKO-Adjacents,74
Cordyla_pinnata,60,41,19,Alphahull-PointsKO-Adjacents,1137
Cordyla_richardii,0,0,0,NA,0
Cordyla_somalensis,5,2,3,Points-PointsKO-Adjacents,45
Cordyline_australis,1083,942,141,Alphahull-PointsKO-Adjacents,4410
Cordyline_banksii,523,475,48,Alphahull-PointsKO-Adjacents,2345
Cordyline_congesta,163,143,20,Alphahull-PointsKO-Adjacents,490
Cordyline_fruticosa,219,118,101,Alphahull-PointsKO-Adjacents,4077
Cordyline_indivisa,667,632,35,Alphahull-PointsKO-Adjacents,3282
Cordyline_manners-suttoniae,82,52,30,Alphahull-PointsKO-Adjacents,535
Cordyline_neocaledonica,4,4,0,Points-PointsKO-Adjacents,32
Cordyline_obtecta,19,6,13,Points-PointsKO-Adjacents,57
Cordyline_petiolaris,673,644,29,Alphahull-PointsKO-Adjacents,934
Cordyline_rubra,430,399,31,Alphahull-PointsKO-Adjacents,987
Cordyline_sellowiana,0,0,0,NA,0
Cordyline_stricta,1504,1414,90,Alphahull-PointsKO-Adjacents,1007
Coriaria_arborea,928,854,74,Alphahull-PointsKO-Adjacents,4389
Cornus_alternifolia,1803,1429,374,Alphahull-PointsKO-Adjacents,42461
Cornus_asperifolia,108,77,31,Alphahull-PointsKO-Adjacents,2637
Cornus_austrosinensis,3,3,0,Points-PointsKO-Adjacents,27
Cornus_bretschneideri,32,9,23,Points-PointsKO-Adjacents,288
Cornus_capitata,202,161,41,Alphahull-PointsKO-Adjacents,11647
Cornus_chinensis,60,36,24,Alphahull-PointsKO-Adjacents,3344
Cornus_controversa,724,491,233,Alphahull-PointsKO-Adjacents,21904
Cornus_darvasica,0,0,0,NA,0
Cornus_disciflora,943,876,67,Alphahull-PointsKO-Adjacents,8283
Cornus_drummondii,1702,0,1702,Points-PointsKO-Adjacents,9290
Cornus_excelsa,563,507,56,Alphahull-PointsKO-Adjacents,5405
Cornus_florida,31257,29495,1762,Alphahull-PointsKO-Adjacents,38347
Cornus_foemina,781,609,172,Alphahull-PointsKO-Adjacents,27795
Cornus_glabrata,367,309,58,Alphahull-PointsKO-Adjacents,3290
Cornus_hemsleyi,60,37,23,Alphahull-PointsKO-Adjacents,4087
Cornus_hongkongensis,150,114,36,Alphahull-PointsKO-Adjacents,13771
Cornus_iberica,0,0,0,NA,0
Cornus_koehneana,5,4,1,Points-PointsKO-Adjacents,45
Cornus_kousa,347,264,83,Alphahull-PointsKO-Adjacents,6994
Cornus_macrophylla,530,306,224,Alphahull-PointsKO-Adjacents,12242
Cornus_mas,6796,5219,1577,Alphahull-PointsKO-Adjacents,24765
Cornus_multinervosa,32,11,21,Points-PointsKO-Adjacents,283
Cornus_nuttallii,1150,1050,100,Alphahull-PointsKO-Adjacents,6686
Cornus_oblonga,87,56,31,Alphahull-PointsKO-Adjacents,3371
Cornus_officinalis,44,6,38,Points-PointsKO-Adjacents,350
Cornus_oligophlebia,1,1,0,Points-PointsKO-Adjacents,9
Cornus_papillosa,NA,NA,NA,NA,NA
Cornus_parviflora,12,3,9,Points-PointsKO-Adjacents,108
Cornus_peruviana,182,129,53,Alphahull-PointsKO-Adjacents,2473
Cornus_racemosa,1036,741,295,Alphahull-PointsKO-Adjacents,25920
Cornus_rugosa,684,521,163,Alphahull-PointsKO-Adjacents,23074
Cornus_schindleri,45,24,21,Alphahull-PointsKO-Adjacents,1673
Cornus_sericea,4627,3792,835,Alphahull-PointsKO-Adjacents,137459
Cornus_sessilis,165,151,14,Alphahull-PointsKO-Adjacents,560
Cornus_ulotricha,12,2,10,Points-PointsKO-Adjacents,108
Cornus_volkensii,49,23,26,Alphahull-PointsKO-Adjacents,5122
Cornus_walteri,64,25,39,Alphahull-PointsKO-Adjacents,3510
Cornutia_australis,0,0,0,NA,0
Cornutia_obovata,5,4,1,Points-PointsKO-Adjacents,30
Cornutia_odorata,67,37,30,Alphahull-PointsKO-Adjacents,4176
Cornutia_pyramidata,1162,981,181,Alphahull-PointsKO-Adjacents,16723
Cornutia_thyrsoidea,1,0,1,Points-PointsKO-Adjacents,9
Corokia_carpodetoides,7,0,7,Points-PointsKO-Adjacents,5
Corokia_collenettei,4,4,0,Points-PointsKO-Adjacents,4
Corokia_macrocarpa,24,0,24,Points-PointsKO-Adjacents,88
Corokia_whiteana,92,85,7,Alphahull-PointsKO-Adjacents,54
Coronanthera_pancheri,7,2,5,Points-PointsKO-Adjacents,35
Coronanthera_sericea,8,4,4,Points-PointsKO-Adjacents,40
Correa_lawrenceana,1938,4,1934,Points-PointsKO-Adjacents,2058
Corryocactus_brachypetalus,2,2,0,Points-PointsKO-Adjacents,16
Corryocactus_brevistylus,3,2,1,Points-PointsKO-Adjacents,23
Corryocactus_pulquinensis,9,3,6,Points-PointsKO-Adjacents,60
Corylopsis_glaucescens,22,16,6,Points-PointsKO-Adjacents,75
Corylopsis_henryi,2,2,0,Points-PointsKO-Adjacents,18
Corylopsis_himalayana,7,1,6,Points-PointsKO-Adjacents,57
Corylopsis_multiflora,42,22,20,Alphahull-PointsKO-Adjacents,1724
Corylopsis_pauciflora,35,17,18,Points-PointsKO-Adjacents,168
Corylopsis_sinensis,73,43,30,Alphahull-PointsKO-Adjacents,4781
Corylopsis_trabeculosa,9,6,3,Points-PointsKO-Adjacents,27
Corylopsis_willmottiae,17,9,8,Points-PointsKO-Adjacents,152
Corylus_americana,1674,0,1674,Points-PointsKO-Adjacents,12045
Corylus_avellana,12493,10688,1805,Alphahull-PointsKO-Adjacents,36190
Corylus_chinensis,37,16,21,Points-PointsKO-Adjacents,295
Corylus_colurna,16,4,12,Points-PointsKO-Adjacents,114
Corylus_cornuta,2599,2170,429,Alphahull-PointsKO-Adjacents,44156
Corylus_fargesii,6,0,6,Points-PointsKO-Adjacents,45
Corylus_ferox,92,0,92,Points-PointsKO-Adjacents,707
Corylus_heterophylla,343,223,120,Alphahull-PointsKO-Adjacents,12290
Corylus_jacquemontii,19,7,12,Points-PointsKO-Adjacents,150
Corylus_maxima,0,0,0,NA,0
Corylus_potaninii,NA,NA,NA,NA,NA
Corylus_wangii,1,1,0,Points-PointsKO-Adjacents,9
Corylus_wulingensis,NA,NA,NA,NA,NA
Corylus_yunnanensis,58,40,18,Alphahull-PointsKO-Adjacents,1975
Corymbia_abbreviata,112,98,14,Alphahull-PointsKO-Adjacents,1152
Corymbia_abergiana,139,0,139,Points-PointsKO-Adjacents,243
Corymbia_aparrerinja,697,646,51,Alphahull-PointsKO-Adjacents,10830
Corymbia_arafurica,96,77,19,Alphahull-PointsKO-Adjacents,1295
Corymbia_arenaria,80,66,14,Alphahull-PointsKO-Adjacents,410
Corymbia_arnhemensis,287,266,21,Alphahull-PointsKO-Adjacents,668
Corymbia_aspera,464,419,45,Alphahull-PointsKO-Adjacents,13723
Corymbia_aureola,25,16,9,Points-PointsKO-Adjacents,79
Corymbia_bella,1229,1180,49,Alphahull-PointsKO-Adjacents,13355
Corymbia_blakei,107,96,11,Alphahull-PointsKO-Adjacents,2026
Corymbia_bleeseri,306,289,17,Alphahull-PointsKO-Adjacents,2967
Corymbia_bloxsomei,137,0,137,Points-PointsKO-Adjacents,266
Corymbia_brachycarpa,159,0,159,Points-PointsKO-Adjacents,535
Corymbia_bunites,84,0,84,Points-PointsKO-Adjacents,138
Corymbia_cadophora,200,189,11,Alphahull-PointsKO-Adjacents,1463
Corymbia_calophylla,921,662,259,Alphahull-PointsKO-Adjacents,2242
Corymbia_candida,364,0,364,Points-PointsKO-Adjacents,1599
Corymbia_chartacea,97,0,97,Points-PointsKO-Adjacents,240
Corymbia_chippendalei,213,188,25,Alphahull-PointsKO-Adjacents,6750
Corymbia_citriodora,1454,1274,180,Alphahull-PointsKO-Adjacents,6691
Corymbia_clandestina,21,14,7,Points-PointsKO-Adjacents,53
Corymbia_clarksoniana,1345,1,1344,Points-PointsKO-Adjacents,4013
Corymbia_clavigera,830,0,830,Points-PointsKO-Adjacents,1638
Corymbia_cliftoniana,133,113,20,Alphahull-PointsKO-Adjacents,1160
Corymbia_collina,122,0,122,Points-PointsKO-Adjacents,321
Corymbia_confertiflora,1412,1367,45,Alphahull-PointsKO-Adjacents,11938
Corymbia_dallachiana,414,377,37,Alphahull-PointsKO-Adjacents,7731
Corymbia_dendromerinx,38,35,3,Alphahull-PointsKO-Adjacents,600
Corymbia_deserticola,232,191,41,Alphahull-PointsKO-Adjacents,7555
Corymbia_dichromophloia,1788,1731,57,Alphahull-PointsKO-Adjacents,10443
Corymbia_disjuncta,413,375,38,Alphahull-PointsKO-Adjacents,4169
Corymbia_dunlopiana,256,0,256,Points-PointsKO-Adjacents,594
Corymbia_ellipsoidea,144,0,144,Points-PointsKO-Adjacents,358
Corymbia_eremaea,640,603,37,Alphahull-PointsKO-Adjacents,4559
Corymbia_erythrophloia,555,520,35,Alphahull-PointsKO-Adjacents,4953
Corymbia_eximia,824,0,824,Points-PointsKO-Adjacents,440
Corymbia_ferriticola,180,158,22,Alphahull-PointsKO-Adjacents,4258
Corymbia_ferruginea,1347,0,1347,Points-PointsKO-Adjacents,3792
Corymbia_ficifolia,123,0,123,Points-PointsKO-Adjacents,450
Corymbia_flavescens,370,328,42,Alphahull-PointsKO-Adjacents,10549
Corymbia_foelscheana,1010,981,29,Alphahull-PointsKO-Adjacents,3740
Corymbia_gilbertensis,75,65,10,Alphahull-PointsKO-Adjacents,544
Corymbia_grandifolia,955,923,32,Alphahull-PointsKO-Adjacents,10006
Corymbia_greeniana,580,535,45,Alphahull-PointsKO-Adjacents,7769
Corymbia_gummifera,4612,4155,457,Alphahull-PointsKO-Adjacents,2974
Corymbia_haematoxylon,113,95,18,Alphahull-PointsKO-Adjacents,186
Corymbia_hamersleyana,387,360,27,Alphahull-PointsKO-Adjacents,2915
Corymbia_hendersonii,132,111,21,Alphahull-PointsKO-Adjacents,660
Corymbia_henryi,356,0,356,Points-PointsKO-Adjacents,448
Corymbia_hylandii,198,179,19,Alphahull-PointsKO-Adjacents,912
Corymbia_intermedia,3445,3327,118,Alphahull-PointsKO-Adjacents,6443
Corymbia_jacobsiana,182,164,18,Alphahull-PointsKO-Adjacents,1242
Corymbia_kombolgiensis,385,370,15,Alphahull-PointsKO-Adjacents,2291
Corymbia_lamprophylla,133,120,13,Alphahull-PointsKO-Adjacents,1205
Corymbia_latifolia,460,439,21,Alphahull-PointsKO-Adjacents,3287
Corymbia_leichhardtii,346,321,25,Alphahull-PointsKO-Adjacents,2575
Corymbia_lenziana,127,107,20,Alphahull-PointsKO-Adjacents,2847
Corymbia_leptoloma,21,0,21,Points-PointsKO-Adjacents,65
Corymbia_ligans,48,0,48,Points-PointsKO-Adjacents,228
Corymbia_maculata,2900,0,2900,Points-PointsKO-Adjacents,1660
Corymbia_nesophila,870,0,870,Points-PointsKO-Adjacents,979
Corymbia_novoguinensis,131,113,18,Alphahull-PointsKO-Adjacents,616
Corymbia_oocarpa,221,0,221,Points-PointsKO-Adjacents,333
Corymbia_pachycarpa,107,88,19,Alphahull-PointsKO-Adjacents,1285
Corymbia_papillosa,167,140,27,Alphahull-PointsKO-Adjacents,1447
Corymbia_papuana,93,64,29,Alphahull-PointsKO-Adjacents,997
Corymbia_paractia,11,8,3,Points-PointsKO-Adjacents,28
Corymbia_pauciseta,54,47,7,Alphahull-PointsKO-Adjacents,656
Corymbia_peltata,203,0,203,Points-PointsKO-Adjacents,656
Corymbia_petalophylla,39,1,38,Points-PointsKO-Adjacents,64
Corymbia_plena,117,102,15,Alphahull-PointsKO-Adjacents,786
Corymbia_pocillum,184,166,18,Alphahull-PointsKO-Adjacents,1295
Corymbia_polycarpa,2169,2073,96,Alphahull-PointsKO-Adjacents,15886
Corymbia_polysciada,916,879,37,Alphahull-PointsKO-Adjacents,3498
Corymbia_porrecta,532,0,532,Points-PointsKO-Adjacents,680
Corymbia_ptychocarpa,644,610,34,Alphahull-PointsKO-Adjacents,6055
Corymbia_rhodops,53,48,5,Alphahull-PointsKO-Adjacents,100
Corymbia_scabrida,41,0,41,Points-PointsKO-Adjacents,77
Corymbia_serendipita,54,0,54,Points-PointsKO-Adjacents,200
Corymbia_setosa,504,474,30,Alphahull-PointsKO-Adjacents,12946
Corymbia_sphaerica,71,63,8,Alphahull-PointsKO-Adjacents,969
Corymbia_stockeri,343,319,24,Alphahull-PointsKO-Adjacents,1626
Corymbia_terminalis,3318,3216,102,Alphahull-PointsKO-Adjacents,43777
Corymbia_tessellaris,737,663,74,Alphahull-PointsKO-Adjacents,11458
Corymbia_torelliana,153,98,55,Alphahull-PointsKO-Adjacents,2042
Corymbia_torta,70,65,5,Alphahull-PointsKO-Adjacents,691
Corymbia_trachyphloia,1509,0,1509,Points-PointsKO-Adjacents,2730
Corymbia_umbonata,155,146,9,Alphahull-PointsKO-Adjacents,1412
Corymbia_watsoniana,248,0,248,Points-PointsKO-Adjacents,503
Corymbia_xanthope,60,0,60,Points-PointsKO-Adjacents,105
Corymbia_zygophylla,202,175,27,Alphahull-PointsKO-Adjacents,3420
Corynabutilon_vitifolium,14,4,10,Points-PointsKO-Adjacents,106
Corynanthe_mayumbensis,78,69,9,Alphahull-PointsKO-Adjacents,1617
Corynanthe_pachyceras,162,115,47,Alphahull-PointsKO-Adjacents,5350
Corynanthe_paniculata,31,15,16,Points-PointsKO-Adjacents,207
Corynocarpus_cribbianus,119,87,32,Alphahull-PointsKO-Adjacents,1128
Corynocarpus_dissimilis,25,15,10,Points-PointsKO-Adjacents,132
Corynocarpus_laevigatus,796,0,796,Points-PointsKO-Adjacents,1397
Corynocarpus_rupestris,77,0,77,Points-PointsKO-Adjacents,247
Corynocarpus_similis,23,8,15,Points-PointsKO-Adjacents,107
Corynopuntia_kunzei,55,43,12,Alphahull-PointsKO-Adjacents,868
Corypha_lecomtei,8,2,6,Points-PointsKO-Adjacents,57
Corypha_microclada,NA,NA,NA,NA,NA
Corypha_taliera,2,0,2,Points-PointsKO-Adjacents,18
Corypha_umbraculifera,1,1,0,Points-PointsKO-Adjacents,9
Corypha_utan,134,105,29,Alphahull-PointsKO-Adjacents,774
Corythophora_alta,72,54,18,Alphahull-PointsKO-Adjacents,757
Corythophora_amapaensis,51,36,15,Alphahull-PointsKO-Adjacents,409
Corythophora_labriculata,24,16,8,Points-PointsKO-Adjacents,101
Corythophora_rimosa,86,58,28,Alphahull-PointsKO-Adjacents,1424
Cosmibuena_grandiflora,334,246,88,Alphahull-PointsKO-Adjacents,10686
Cosmibuena_macrocarpa,82,47,35,Alphahull-PointsKO-Adjacents,1212
Cosmibuena_matudae,52,0,52,Points-PointsKO-Adjacents,281
Cosmibuena_valerioi,106,83,23,Alphahull-PointsKO-Adjacents,364
Cosmocalyx_spectabilis,68,57,11,Alphahull-PointsKO-Adjacents,838
Cossinia_australiana,39,28,11,Alphahull-PointsKO-Adjacents,363
Cossinia_pacifica,1,1,0,Points-PointsKO-Adjacents,9
Cossinia_pinnata,4,3,1,Points-PointsKO-Adjacents,16
Cossinia_trifoliata,26,10,16,Points-PointsKO-Adjacents,74
Cossinia_triphylla,4,3,1,Points-PointsKO-Adjacents,16
Cotinus_coggygria,983,624,359,Alphahull-PointsKO-Adjacents,21745
Cotinus_kanaka,NA,NA,NA,NA,NA
Cotinus_obovatus,107,70,37,Alphahull-PointsKO-Adjacents,5685
Cotinus_szechuanensis,12,3,9,Points-PointsKO-Adjacents,108
Cotoneaster_ellipticus,0,0,0,NA,0
Cotoneaster_frigidus,8,1,7,Points-PointsKO-Adjacents,61
Cotoneaster_karatavicus,0,0,0,NA,0
Cotoneaster_morulus,0,0,0,NA,0
Cotoneaster_racemiflorus,8,0,8,Points-PointsKO-Adjacents,59
Cotoneaster_taylorii,3,3,0,Points-PointsKO-Adjacents,24
Cotoneaster_transcaucasicus,8,1,7,Points-PointsKO-Adjacents,68
Cotylelobium_burckii,1,1,0,Points-PointsKO-Adjacents,9
Cotylelobium_lanceolatum,4,1,3,Points-PointsKO-Adjacents,36
Cotylelobium_lewisianum,0,0,0,NA,0
Cotylelobium_melanoxylon,5,1,4,Points-PointsKO-Adjacents,43
Cotylelobium_scabriusculum,0,0,0,NA,0
Couepia_bernardii,20,11,9,Points-PointsKO-Adjacents,133
Couepia_bondarii,8,0,8,Points-PointsKO-Adjacents,44
Couepia_bracteosa,201,136,65,Alphahull-PointsKO-Adjacents,20384
Couepia_carautae,9,0,9,Points-PointsKO-Adjacents,70
Couepia_caryophylloides,38,19,19,Points-PointsKO-Adjacents,277
Couepia_cataractae,26,3,23,Points-PointsKO-Adjacents,227
Couepia_chrysocalyx,228,0,228,Points-PointsKO-Adjacents,1570
Couepia_cidiana,3,3,0,Points-PointsKO-Adjacents,27
Couepia_coarctata,9,5,4,Points-PointsKO-Adjacents,18
Couepia_comosa,19,12,7,Points-PointsKO-Adjacents,121
Couepia_eriantha,23,7,16,Points-PointsKO-Adjacents,183
Couepia_excelsa,18,2,16,Points-PointsKO-Adjacents,137
Couepia_exflexa,8,3,5,Points-PointsKO-Adjacents,45
Couepia_froesii,2,2,0,Points-PointsKO-Adjacents,18
Couepia_glabra,8,2,6,Points-PointsKO-Adjacents,68
Couepia_grandiflora,609,557,52,Alphahull-PointsKO-Adjacents,27977
Couepia_guianensis,504,432,72,Alphahull-PointsKO-Adjacents,47051
Couepia_habrantha,54,21,33,Alphahull-PointsKO-Adjacents,874
Couepia_hondurasensis,2,2,0,Points-PointsKO-Adjacents,18
Couepia_impressa,114,81,33,Alphahull-PointsKO-Adjacents,1471
Couepia_insignis,12,4,8,Points-PointsKO-Adjacents,61
Couepia_joaquinae,3,3,0,Points-PointsKO-Adjacents,27
Couepia_krukovii,21,4,17,Points-PointsKO-Adjacents,171
Couepia_leitaofilhoi,4,3,1,Points-PointsKO-Adjacents,27
Couepia_longipetiolata,7,2,5,Points-PointsKO-Adjacents,33
Couepia_macrophylla,78,47,31,Alphahull-PointsKO-Adjacents,3527
Couepia_magnoliifolia,37,21,16,Alphahull-PointsKO-Adjacents,177
Couepia_maguirei,15,5,10,Points-PointsKO-Adjacents,109
Couepia_marleneae,8,1,7,Points-PointsKO-Adjacents,63
Couepia_martini,3,3,0,Points-PointsKO-Adjacents,27
Couepia_meridionalis,5,4,1,Points-PointsKO-Adjacents,32
Couepia_monteclarensis,41,22,19,Alphahull-PointsKO-Adjacents,1335
Couepia_morii,7,2,5,Points-PointsKO-Adjacents,34
Couepia_multiflora,35,0,35,Points-PointsKO-Adjacents,221
Couepia_nutans,2,2,0,Points-PointsKO-Adjacents,18
Couepia_obovata,131,72,59,Alphahull-PointsKO-Adjacents,8298
Couepia_osaensis,4,4,0,Points-PointsKO-Adjacents,24
Couepia_ovalifolia,138,84,54,Alphahull-PointsKO-Adjacents,2197
Couepia_paraensis,464,397,67,Alphahull-PointsKO-Adjacents,45739
Couepia_parvifolia,8,4,4,Points-PointsKO-Adjacents,45
Couepia_pernambucensis,15,5,10,Points-PointsKO-Adjacents,99
Couepia_polyandra,238,169,69,Alphahull-PointsKO-Adjacents,8813
Couepia_rankiniae,6,1,5,Points-PointsKO-Adjacents,37
Couepia_reflexa,4,4,0,Points-PointsKO-Adjacents,36
Couepia_robusta,50,25,25,Alphahull-PointsKO-Adjacents,3286
Couepia_rufa,66,31,35,Alphahull-PointsKO-Adjacents,496
Couepia_sandwithii,5,5,0,Points-PointsKO-Adjacents,33
Couepia_schottii,46,0,46,Points-PointsKO-Adjacents,284
Couepia_scottmorii,3,3,0,Points-PointsKO-Adjacents,23
Couepia_spicata,17,6,11,Points-PointsKO-Adjacents,135
Couepia_stipularis,8,0,8,Points-PointsKO-Adjacents,43
Couepia_subcordata,37,15,22,Points-PointsKO-Adjacents,290
Couepia_trapezioana,16,4,12,Points-PointsKO-Adjacents,127
Couepia_uiti,229,158,71,Alphahull-PointsKO-Adjacents,28756
Couepia_ulei,94,51,43,Alphahull-PointsKO-Adjacents,5876
Couepia_venosa,85,63,22,Alphahull-PointsKO-Adjacents,832
Couepia_williamsii,72,0,72,Points-PointsKO-Adjacents,538
Coula_edulis,449,407,42,Alphahull-PointsKO-Adjacents,3952
Coulteria_platyloba,31,13,18,Points-PointsKO-Adjacents,164
Couma_catingae,91,69,22,Alphahull-PointsKO-Adjacents,4275
Couma_guianensis,108,60,48,Alphahull-PointsKO-Adjacents,9507
Couma_macrocarpa,560,461,99,Alphahull-PointsKO-Adjacents,48553
Couma_rigida,38,0,38,Points-PointsKO-Adjacents,165
Couma_utilis,243,188,55,Alphahull-PointsKO-Adjacents,18471
Couratari_asterophora,9,4,5,Points-PointsKO-Adjacents,39
Couratari_asterotricha,17,8,9,Points-PointsKO-Adjacents,121
Couratari_atrovinosa,9,0,9,Points-PointsKO-Adjacents,65
Couratari_calycina,2,2,0,Points-PointsKO-Adjacents,18
Couratari_gloriosa,25,11,14,Points-PointsKO-Adjacents,147
Couratari_guianensis,601,503,98,Alphahull-PointsKO-Adjacents,66153
Couratari_longipedicellata,19,9,10,Points-PointsKO-Adjacents,124
Couratari_macrosperma,205,156,49,Alphahull-PointsKO-Adjacents,10503
Couratari_multiflora,179,121,58,Alphahull-PointsKO-Adjacents,13997
Couratari_oblongifolia,90,43,47,Alphahull-PointsKO-Adjacents,4822
Couratari_oligantha,102,65,37,Alphahull-PointsKO-Adjacents,8202
Couratari_prancei,1,1,0,Points-PointsKO-Adjacents,9
Couratari_pyramidata,19,0,19,Points-PointsKO-Adjacents,102
Couratari_riparia,36,25,11,Alphahull-PointsKO-Adjacents,167
Couratari_sandwithii,6,0,6,Points-PointsKO-Adjacents,54
Couratari_scottmorii,31,24,7,Alphahull-PointsKO-Adjacents,66
Couratari_stellata,159,99,60,Alphahull-PointsKO-Adjacents,11951
Couratari_tauari,33,14,19,Points-PointsKO-Adjacents,251
Couratari_tenuicarpa,76,42,34,Alphahull-PointsKO-Adjacents,5210
Couroupita_guianensis,361,236,125,Alphahull-PointsKO-Adjacents,26573
Couroupita_nicaraguarensis,79,53,26,Alphahull-PointsKO-Adjacents,867
Couroupita_subsessilis,78,39,39,Alphahull-PointsKO-Adjacents,3706
Coursetia_apantensis,26,22,4,Alphahull-PointsKO-Adjacents,51
Coursetia_brachyrhachis,74,50,24,Alphahull-PointsKO-Adjacents,979
Coursetia_caribaea,946,766,180,Alphahull-PointsKO-Adjacents,21272
Coursetia_elliptica,57,47,10,Alphahull-PointsKO-Adjacents,190
Coursetia_ferruginea,220,166,54,Alphahull-PointsKO-Adjacents,11929
Coursetia_glandulosa,358,310,48,Alphahull-PointsKO-Adjacents,6158
Coursetia_hypoleuca,21,0,21,Points-PointsKO-Adjacents,140
Coursetia_intermontana,1,1,0,Points-PointsKO-Adjacents,9
Coursetia_madrensis,32,19,13,Points-PointsKO-Adjacents,97
Coursetia_mollis,57,0,57,Points-PointsKO-Adjacents,342
Coursetia_paniculata,6,1,5,Points-PointsKO-Adjacents,30
Coursetia_paucifoliolata,23,17,6,Points-PointsKO-Adjacents,47
Coursetia_planipetiolata,3,2,1,Points-PointsKO-Adjacents,26
Coursetia_polyphylla,29,18,11,Points-PointsKO-Adjacents,123
Coursetia_robinioides,2,2,0,Points-PointsKO-Adjacents,16
Coursetia_rostrata,205,179,26,Alphahull-PointsKO-Adjacents,3579
Coursetia_tumbezensis,3,3,0,Points-PointsKO-Adjacents,25
Coursetia_vicioides,12,5,7,Points-PointsKO-Adjacents,81
Coussapoa_angustifolia,61,37,24,Alphahull-PointsKO-Adjacents,3635
Coussapoa_arachnoidea,2,2,0,Points-PointsKO-Adjacents,18
Coussapoa_argentea,5,5,0,Points-PointsKO-Adjacents,39
Coussapoa_asperifolia,182,109,73,Alphahull-PointsKO-Adjacents,21748
Coussapoa_batavorum,5,5,0,Points-PointsKO-Adjacents,34
Coussapoa_brevipes,44,34,10,Alphahull-PointsKO-Adjacents,168
Coussapoa_chocoensis,1,1,0,Points-PointsKO-Adjacents,9
Coussapoa_cinnamomea,4,4,0,Points-PointsKO-Adjacents,36
Coussapoa_cinnamomifolia,31,13,18,Points-PointsKO-Adjacents,191
Coussapoa_contorta,86,70,16,Alphahull-PointsKO-Adjacents,2025
Coussapoa_crassivenosa,102,0,102,Points-PointsKO-Adjacents,732
Coussapoa_cupularis,5,5,0,Points-PointsKO-Adjacents,43
Coussapoa_curranii,49,29,20,Alphahull-PointsKO-Adjacents,704
Coussapoa_darienensis,3,3,0,Points-PointsKO-Adjacents,27
Coussapoa_david-smithii,4,4,0,Points-PointsKO-Adjacents,36
Coussapoa_duquei,29,17,12,Points-PointsKO-Adjacents,179
Coussapoa_echinata,3,3,0,Points-PointsKO-Adjacents,27
Coussapoa_ferruginea,11,1,10,Points-PointsKO-Adjacents,81
Coussapoa_floccosa,21,16,5,Points-PointsKO-Adjacents,138
Coussapoa_fulvescens,1,1,0,Points-PointsKO-Adjacents,9
Coussapoa_glaberrima,28,14,14,Points-PointsKO-Adjacents,160
Coussapoa_herthae,69,56,13,Alphahull-PointsKO-Adjacents,1171
Coussapoa_jatun-sachensis,15,8,7,Points-PointsKO-Adjacents,117
Coussapoa_latifolia,105,61,44,Alphahull-PointsKO-Adjacents,3308
Coussapoa_leprieurii,6,0,6,Points-PointsKO-Adjacents,54
Coussapoa_longipedunculata,0,0,0,NA,0
Coussapoa_macerrima,21,11,10,Points-PointsKO-Adjacents,70
Coussapoa_manuensis,16,5,11,Points-PointsKO-Adjacents,117
Coussapoa_microcarpa,606,520,86,Alphahull-PointsKO-Adjacents,5520
Coussapoa_microcephala,69,53,16,Alphahull-PointsKO-Adjacents,1380
Coussapoa_napoensis,20,8,12,Points-PointsKO-Adjacents,157
Coussapoa_nitida,85,43,42,Alphahull-PointsKO-Adjacents,4504
Coussapoa_nymphaeifolia,38,31,7,Alphahull-PointsKO-Adjacents,113
Coussapoa_oligocephala,81,68,13,Alphahull-PointsKO-Adjacents,1054
Coussapoa_orthoneura,232,191,41,Alphahull-PointsKO-Adjacents,15284
Coussapoa_ovalifolia,166,119,47,Alphahull-PointsKO-Adjacents,13287
Coussapoa_pachyphylla,30,18,12,Points-PointsKO-Adjacents,128
Coussapoa_parviceps,118,89,29,Alphahull-PointsKO-Adjacents,912
Coussapoa_parvifolia,40,14,26,Points-PointsKO-Adjacents,317
Coussapoa_purpusii,90,61,29,Alphahull-PointsKO-Adjacents,1313
Coussapoa_scabra,7,3,4,Points-PointsKO-Adjacents,63
Coussapoa_sprucei,16,9,7,Points-PointsKO-Adjacents,118
Coussapoa_tessmannii,65,34,31,Alphahull-PointsKO-Adjacents,3007
Coussapoa_tolimensis,0,0,0,NA,0
Coussapoa_trinervia,247,184,63,Alphahull-PointsKO-Adjacents,13644
Coussapoa_valaria,5,3,2,Points-PointsKO-Adjacents,27
Coussapoa_vannifolia,18,7,11,Points-PointsKO-Adjacents,128
Coussapoa_villosa,798,664,134,Alphahull-PointsKO-Adjacents,51170
Coussapoa_viridifolia,35,15,20,Points-PointsKO-Adjacents,255
Coussarea_accedens,31,0,31,Points-PointsKO-Adjacents,148
Coussarea_acuminata,4,4,0,Points-PointsKO-Adjacents,36
Coussarea_albescens,117,55,62,Alphahull-PointsKO-Adjacents,5619
Coussarea_amapaensis,21,0,21,Points-PointsKO-Adjacents,137
Coussarea_ampla,18,0,18,Points-PointsKO-Adjacents,103
Coussarea_amplifolia,19,12,7,Points-PointsKO-Adjacents,108
Coussarea_antioquiana,13,9,4,Points-PointsKO-Adjacents,55
Coussarea_auriculata,5,5,0,Points-PointsKO-Adjacents,45
Coussarea_bernardii,12,2,10,Points-PointsKO-Adjacents,106
Coussarea_biflora,NA,NA,NA,NA,NA
Coussarea_bocainae,4,4,0,Points-PointsKO-Adjacents,15
Coussarea_boliviensis,20,11,9,Points-PointsKO-Adjacents,119
Coussarea_brevicaulis,137,106,31,Alphahull-PointsKO-Adjacents,8254
Coussarea_brevipedunculata,5,5,0,Points-PointsKO-Adjacents,21
Coussarea_capitata,28,8,20,Points-PointsKO-Adjacents,169
Coussarea_caroliana,117,107,10,Alphahull-PointsKO-Adjacents,314
Coussarea_cephaeloides,16,9,7,Points-PointsKO-Adjacents,99
Coussarea_cerroazulensis,33,29,4,Alphahull-PointsKO-Adjacents,56
Coussarea_chiapensis,2,0,2,Points-PointsKO-Adjacents,16
Coussarea_coffeoides,6,0,6,Points-PointsKO-Adjacents,45
Coussarea_congestiflora,55,29,26,Alphahull-PointsKO-Adjacents,1603
Coussarea_contracta,690,586,104,Alphahull-PointsKO-Adjacents,19528
Coussarea_cuatrecasasii,5,5,0,Points-PointsKO-Adjacents,39
Coussarea_curvigemma,17,5,12,Points-PointsKO-Adjacents,133
Coussarea_duckei,3,3,0,Points-PointsKO-Adjacents,27
Coussarea_dulcifolia,33,26,7,Alphahull-PointsKO-Adjacents,416
Coussarea_duplex,9,0,9,Points-PointsKO-Adjacents,53
Coussarea_durifolia,7,3,4,Points-PointsKO-Adjacents,21
Coussarea_ecuadorensis,39,32,7,Alphahull-PointsKO-Adjacents,350
Coussarea_enneantha,54,38,16,Alphahull-PointsKO-Adjacents,890
Coussarea_evoluta,3,3,0,Points-PointsKO-Adjacents,27
Coussarea_fanshawei,9,4,5,Points-PointsKO-Adjacents,50
Coussarea_flava,69,41,28,Alphahull-PointsKO-Adjacents,6109
Coussarea_friburgensis,6,2,4,Points-PointsKO-Adjacents,35
Coussarea_frondosa,2,2,0,Points-PointsKO-Adjacents,18
Coussarea_garciae,35,25,10,Alphahull-PointsKO-Adjacents,990
Coussarea_graciliflora,80,0,80,Points-PointsKO-Adjacents,450
Coussarea_grandifolia,36,24,12,Alphahull-PointsKO-Adjacents,900
Coussarea_grandis,19,0,19,Points-PointsKO-Adjacents,101
Coussarea_granvillei,5,5,0,Points-PointsKO-Adjacents,24
Coussarea_hallei,4,4,0,Points-PointsKO-Adjacents,14
Coussarea_hirticalyx,103,56,47,Alphahull-PointsKO-Adjacents,10902
Coussarea_hyacinthiflora,5,5,0,Points-PointsKO-Adjacents,45
Coussarea_hydrangeifolia,1041,948,93,Alphahull-PointsKO-Adjacents,38003
Coussarea_ilheotica,74,49,25,Alphahull-PointsKO-Adjacents,715
Coussarea_imitans,32,22,10,Alphahull-PointsKO-Adjacents,361
Coussarea_impetiolaris,96,78,18,Alphahull-PointsKO-Adjacents,572
Coussarea_insignis,14,0,14,Points-PointsKO-Adjacents,121
Coussarea_insolita,8,0,8,Points-PointsKO-Adjacents,66
Coussarea_janeirensis,1,1,0,Points-PointsKO-Adjacents,9
Coussarea_japurana,3,3,0,Points-PointsKO-Adjacents,27
Coussarea_jefensis,8,5,3,Points-PointsKO-Adjacents,25
Coussarea_klugii,37,25,12,Alphahull-PointsKO-Adjacents,986
Coussarea_krukovii,3,3,0,Points-PointsKO-Adjacents,27
Coussarea_lagoensis,1,1,0,Points-PointsKO-Adjacents,9
Coussarea_lanceolata,NA,NA,NA,NA,NA
Coussarea_lasseri,3,3,0,Points-PointsKO-Adjacents,27
Coussarea_latifolia,96,67,29,Alphahull-PointsKO-Adjacents,840
Coussarea_leptoloba,44,11,33,Points-PointsKO-Adjacents,342
Coussarea_leptophragma,27,0,27,Points-PointsKO-Adjacents,170
Coussarea_leptopus,18,7,11,Points-PointsKO-Adjacents,124
Coussarea_liesneri,6,1,5,Points-PointsKO-Adjacents,46
Coussarea_liliiflora,10,0,10,Points-PointsKO-Adjacents,79
Coussarea_locuples,2,2,0,Points-PointsKO-Adjacents,18
Coussarea_loftonii,89,66,23,Alphahull-PointsKO-Adjacents,676
Coussarea_longiacuminata,6,0,6,Points-PointsKO-Adjacents,50
Coussarea_longiflora,167,103,64,Alphahull-PointsKO-Adjacents,8591
Coussarea_longifolia,2,2,0,Points-PointsKO-Adjacents,18
Coussarea_longilaciniata,3,3,0,Points-PointsKO-Adjacents,27
Coussarea_machadoana,9,2,7,Points-PointsKO-Adjacents,69
Coussarea_macrophylla,99,63,36,Alphahull-PointsKO-Adjacents,6196
Coussarea_mapourioides,8,2,6,Points-PointsKO-Adjacents,72
Coussarea_megalocarpa,16,2,14,Points-PointsKO-Adjacents,140
Coussarea_megistophylla,7,0,7,Points-PointsKO-Adjacents,51
Coussarea_meridionalis,90,57,33,Alphahull-PointsKO-Adjacents,347
Coussarea_mexiae,3,3,0,Points-PointsKO-Adjacents,27
Coussarea_mexicana,12,0,12,Points-PointsKO-Adjacents,64
Coussarea_micrococca,14,4,10,Points-PointsKO-Adjacents,94
Coussarea_moritziana,38,19,19,Points-PointsKO-Adjacents,201
Coussarea_nodosa,161,0,161,Points-PointsKO-Adjacents,907
Coussarea_obliqua,11,2,9,Points-PointsKO-Adjacents,99
Coussarea_obscura,4,4,0,Points-PointsKO-Adjacents,36
Coussarea_ovalis,4,4,0,Points-PointsKO-Adjacents,36
Coussarea_paniculata,545,431,114,Alphahull-PointsKO-Adjacents,52435
Coussarea_penetantha,1,1,0,Points-PointsKO-Adjacents,9
Coussarea_petiolaris,0,0,0,NA,0
Coussarea_pilosiflora,37,25,12,Alphahull-PointsKO-Adjacents,292
Coussarea_pittieri,3,3,0,Points-PointsKO-Adjacents,27
Coussarea_platyphylla,303,238,65,Alphahull-PointsKO-Adjacents,20893
Coussarea_procumbens,NA,NA,NA,NA,NA
Coussarea_regnelliana,1,1,0,Points-PointsKO-Adjacents,9
Coussarea_resinosa,75,50,25,Alphahull-PointsKO-Adjacents,698
Coussarea_revoluta,9,3,6,Points-PointsKO-Adjacents,77
Coussarea_rudgeoides,55,36,19,Alphahull-PointsKO-Adjacents,3916
Coussarea_sancti-ciprianii,31,24,7,Alphahull-PointsKO-Adjacents,682
Coussarea_schiffneri,1,1,0,Points-PointsKO-Adjacents,9
Coussarea_sessilifolia,2,2,0,Points-PointsKO-Adjacents,18
Coussarea_speciosa,4,4,0,Points-PointsKO-Adjacents,34
Coussarea_spicata,1,1,0,Points-PointsKO-Adjacents,9
Coussarea_spiciformis,18,10,8,Points-PointsKO-Adjacents,123
Coussarea_strigosipes,13,5,8,Points-PointsKO-Adjacents,62
Coussarea_surinamensis,1,1,0,Points-PointsKO-Adjacents,9
Coussarea_talamancana,66,57,9,Alphahull-PointsKO-Adjacents,346
Coussarea_tenuiflora,36,15,21,Points-PointsKO-Adjacents,294
Coussarea_terepaimensis,2,2,0,Points-PointsKO-Adjacents,18
Coussarea_tortilis,36,18,18,Points-PointsKO-Adjacents,298
Coussarea_tricephala,1,1,0,Points-PointsKO-Adjacents,9
Coussarea_triflora,13,3,10,Points-PointsKO-Adjacents,104
Coussarea_uniflora,3,3,0,Points-PointsKO-Adjacents,27
Coussarea_urbaniana,8,0,8,Points-PointsKO-Adjacents,33
Coussarea_urophylla,2,2,0,Points-PointsKO-Adjacents,18
Coussarea_vallis,5,1,4,Points-PointsKO-Adjacents,45
Coussarea_venosa,27,16,11,Points-PointsKO-Adjacents,192
Coussarea_veraguensis,30,19,11,Points-PointsKO-Adjacents,191
Coussarea_verticillata,44,33,11,Alphahull-PointsKO-Adjacents,1202
Coussarea_violacea,63,32,31,Alphahull-PointsKO-Adjacents,2192
Coussarea_viridis,6,0,6,Points-PointsKO-Adjacents,44
Coutaportla_guatemalensis,31,17,14,Points-PointsKO-Adjacents,124
Coutarea_andrei,8,5,3,Points-PointsKO-Adjacents,55
Coutarea_hexandra,2584,2283,301,Alphahull-PointsKO-Adjacents,106996
Cowiea_borneensis,22,15,7,Points-PointsKO-Adjacents,153
Cowiea_philippinensis,0,0,0,NA,0
Craibia_affinis,1,1,0,Points-PointsKO-Adjacents,9
Craibia_atlantica,29,9,20,Points-PointsKO-Adjacents,251
Craibia_brevicaudata,112,71,41,Alphahull-PointsKO-Adjacents,3443
Craibia_brownii,19,6,13,Points-PointsKO-Adjacents,151
Craibia_grandiflora,31,8,23,Points-PointsKO-Adjacents,215
Craibia_laurentii,19,1,18,Points-PointsKO-Adjacents,151
Craibia_simplex,6,1,5,Points-PointsKO-Adjacents,41
Craibia_zimmermannii,37,13,24,Points-PointsKO-Adjacents,233
Craibiodendron_henryi,31,14,17,Points-PointsKO-Adjacents,222
Craibiodendron_scleranthum,0,0,0,NA,0
Craibiodendron_stellatum,61,0,61,Points-PointsKO-Adjacents,492
Craibiodendron_vietnamense,1,1,0,Points-PointsKO-Adjacents,9
Craibiodendron_yunnanense,37,23,14,Alphahull-PointsKO-Adjacents,773
Craigia_kwangsiensis,1,1,0,Points-PointsKO-Adjacents,9
Craigia_yunnanensis,6,0,6,Points-PointsKO-Adjacents,50
Craspidospermum_verticillatum,203,182,21,Alphahull-PointsKO-Adjacents,1838
Crassula_acinaciformis,19,11,8,Points-PointsKO-Adjacents,159
Crataegus_aemula,5,0,5,Points-PointsKO-Adjacents,36
Crataegus_aestivalis,57,32,25,Alphahull-PointsKO-Adjacents,1338
Crataegus_ambigua,7,2,5,Points-PointsKO-Adjacents,42
Crataegus_ambitiosa,0,0,0,NA,0
Crataegus_anamesa,3,2,1,Points-PointsKO-Adjacents,27
Crataegus_ancisa,2,1,1,Points-PointsKO-Adjacents,18
Crataegus_annosa,2,1,1,Points-PointsKO-Adjacents,18
Crataegus_apiomorpha,11,3,8,Points-PointsKO-Adjacents,84
Crataegus_aprica,56,28,28,Alphahull-PointsKO-Adjacents,1703
Crataegus_arborea,6,1,5,Points-PointsKO-Adjacents,54
Crataegus_arcana,3,3,0,Points-PointsKO-Adjacents,21
Crataegus_arnoldiana,3,3,0,Points-PointsKO-Adjacents,27
Crataegus_ashei,18,8,10,Points-PointsKO-Adjacents,126
Crataegus_ater,1,1,0,Points-PointsKO-Adjacents,9
Crataegus_atrovirens,17,8,9,Points-PointsKO-Adjacents,39
Crataegus_aurantia,2,2,0,Points-PointsKO-Adjacents,18
Crataegus_austromontana,0,0,0,NA,0
Crataegus_azarolus,356,2,354,Points-PointsKO-Adjacents,376
Crataegus_baroussana,35,14,21,Points-PointsKO-Adjacents,197
Crataegus_beadlei,0,0,0,NA,0
Crataegus_beata,5,1,4,Points-PointsKO-Adjacents,42
Crataegus_berberifolia,94,57,37,Alphahull-PointsKO-Adjacents,2359
Crataegus_bona,1,1,0,Points-PointsKO-Adjacents,9
Crataegus_brachyacantha,95,70,25,Alphahull-PointsKO-Adjacents,1878
Crataegus_brainerdii,80,48,32,Alphahull-PointsKO-Adjacents,2971
Crataegus_brazoria,0,0,0,NA,0
Crataegus_calpodendron,438,293,145,Alphahull-PointsKO-Adjacents,21145
Crataegus_canadensis,5,0,5,Points-PointsKO-Adjacents,27
Crataegus_carrollensis,0,0,0,NA,0
Crataegus_castlegarensis,55,24,31,Alphahull-PointsKO-Adjacents,240
Crataegus_chlorocarpa,5,5,0,Points-PointsKO-Adjacents,45
Crataegus_chlorosarca,5,3,2,Points-PointsKO-Adjacents,39
Crataegus_chrysocarpa,630,463,167,Alphahull-PointsKO-Adjacents,32044
Crataegus_coccinioides,63,27,36,Alphahull-PointsKO-Adjacents,1421
Crataegus_coleae,3,2,1,Points-PointsKO-Adjacents,18
Crataegus_compacta,14,9,5,Points-PointsKO-Adjacents,69
Crataegus_compta,2,2,0,Points-PointsKO-Adjacents,18
Crataegus_condigna,2,2,0,Points-PointsKO-Adjacents,18
Crataegus_contrita,1,1,0,Points-PointsKO-Adjacents,9
Crataegus_corusca,22,1,21,Points-PointsKO-Adjacents,135
Crataegus_crus-galli,1197,885,312,Alphahull-PointsKO-Adjacents,38514
Crataegus_dahurica,4,4,0,Points-PointsKO-Adjacents,33
Crataegus_dallasiana,4,3,1,Points-PointsKO-Adjacents,36
Crataegus_desueta,3,3,0,Points-PointsKO-Adjacents,15
Crataegus_dilatata,12,4,8,Points-PointsKO-Adjacents,90
Crataegus_dispar,6,0,6,Points-PointsKO-Adjacents,51
Crataegus_disperma,55,26,29,Alphahull-PointsKO-Adjacents,2782
Crataegus_dispessa,15,6,9,Points-PointsKO-Adjacents,111
Crataegus_dissona,87,40,47,Alphahull-PointsKO-Adjacents,1956
Crataegus_distincta,1,1,0,Points-PointsKO-Adjacents,9
Crataegus_dodgei,67,34,33,Alphahull-PointsKO-Adjacents,1554
Crataegus_douglasii,855,714,141,Alphahull-PointsKO-Adjacents,23470
Crataegus_enderbyensis,12,1,11,Points-PointsKO-Adjacents,20
Crataegus_engelmannii,53,24,29,Alphahull-PointsKO-Adjacents,1157
Crataegus_erythrocarpa,2,1,1,Points-PointsKO-Adjacents,18
Crataegus_erythropoda,97,72,25,Alphahull-PointsKO-Adjacents,2587
Crataegus_exilis,2,1,1,Points-PointsKO-Adjacents,12
Crataegus_extraria,3,1,2,Points-PointsKO-Adjacents,18
Crataegus_flabellata,290,191,99,Alphahull-PointsKO-Adjacents,10855
Crataegus_flava,198,142,56,Alphahull-PointsKO-Adjacents,6958
Crataegus_formosa,73,34,39,Alphahull-PointsKO-Adjacents,1430
Crataegus_fragilis,0,0,0,NA,0
Crataegus_fulleriana,38,12,26,Points-PointsKO-Adjacents,294
Crataegus_furtiva,1,1,0,Points-PointsKO-Adjacents,9
Crataegus_glareosa,0,0,0,NA,0
Crataegus_gracilior,304,259,45,Alphahull-PointsKO-Adjacents,3515
Crataegus_grandis,3,2,1,Points-PointsKO-Adjacents,12
Crataegus_greggiana,42,24,18,Alphahull-PointsKO-Adjacents,874
Crataegus_harbisonii,24,14,10,Points-PointsKO-Adjacents,156
Crataegus_harveyana,1,1,0,Points-PointsKO-Adjacents,9
Crataegus_heldreichii,19,9,10,Points-PointsKO-Adjacents,142
Crataegus_holmesiana,83,32,51,Alphahull-PointsKO-Adjacents,3386
Crataegus_hupehensis,18,1,17,Points-PointsKO-Adjacents,158
Crataegus_ideae,0,0,0,NA,0
Crataegus_ignava,0,0,0,NA,0
Crataegus_impar,2,0,2,Points-PointsKO-Adjacents,9
Crataegus_indicens,0,0,0,NA,0
Crataegus_insidiosa,3,2,1,Points-PointsKO-Adjacents,18
Crataegus_integra,2,0,2,Points-PointsKO-Adjacents,18
Crataegus_intricata,328,221,107,Alphahull-PointsKO-Adjacents,17466
Crataegus_invicta,0,0,0,NA,0
Crataegus_irrasa,26,4,22,Points-PointsKO-Adjacents,175
Crataegus_jesupii,11,5,6,Points-PointsKO-Adjacents,87
Crataegus_jonesae,3,3,0,Points-PointsKO-Adjacents,27
Crataegus_kansuensis,29,5,24,Points-PointsKO-Adjacents,258
Crataegus_kelloggii,8,0,8,Points-PointsKO-Adjacents,68
Crataegus_kingstonensis,0,0,0,NA,0
Crataegus_knieskerniana,1,0,1,Points-PointsKO-Adjacents,9
Crataegus_knorringiana,NA,NA,NA,NA,NA
Crataegus_lacrimata,13,0,13,Points-PointsKO-Adjacents,103
Crataegus_laevigata,30169,26134,4035,Alphahull-PointsKO-Adjacents,32997
Crataegus_lanata,7,0,7,Points-PointsKO-Adjacents,57
Crataegus_lanuginosa,90,43,47,Alphahull-PointsKO-Adjacents,5234
Crataegus_latebrosa,14,7,7,Points-PointsKO-Adjacents,95
Crataegus_lemingtonensis,0,0,0,NA,0
Crataegus_limata,1,1,0,Points-PointsKO-Adjacents,9
Crataegus_limnophila,0,0,0,NA,0
Crataegus_lindenii,1,1,0,Points-PointsKO-Adjacents,9
Crataegus_lucorum,19,0,19,Points-PointsKO-Adjacents,171
Crataegus_lumaria,7,4,3,Points-PointsKO-Adjacents,63
Crataegus_macrosperma,385,279,106,Alphahull-PointsKO-Adjacents,20520
Crataegus_margarettae,75,28,47,Alphahull-PointsKO-Adjacents,1611
Crataegus_marshallii,567,446,121,Alphahull-PointsKO-Adjacents,12116
Crataegus_maximowiczii,16,2,14,Points-PointsKO-Adjacents,128
Crataegus_membranacea,1,1,0,Points-PointsKO-Adjacents,9
Crataegus_menandiana,1,1,0,Points-PointsKO-Adjacents,9
Crataegus_mendosa,4,4,0,Points-PointsKO-Adjacents,27
Crataegus_meridionalis,65,26,39,Alphahull-PointsKO-Adjacents,4572
Crataegus_mexicana,131,105,26,Alphahull-PointsKO-Adjacents,3039
Crataegus_meyeri,33,22,11,Alphahull-PointsKO-Adjacents,95
Crataegus_mollis,771,526,245,Alphahull-PointsKO-Adjacents,35089
Crataegus_monogyna,15194,12925,2269,Alphahull-PointsKO-Adjacents,36554
Crataegus_necopinata,NA,NA,NA,NA,NA
Crataegus_nigra,2,1,1,Points-PointsKO-Adjacents,18
Crataegus_nitida,18,0,18,Points-PointsKO-Adjacents,143
Crataegus_nitidula,4,4,0,Points-PointsKO-Adjacents,24
Crataegus_nuda,3,3,0,Points-PointsKO-Adjacents,24
Crataegus_okennonii,47,25,22,Alphahull-PointsKO-Adjacents,768
Crataegus_opaca,70,51,19,Alphahull-PointsKO-Adjacents,1570
Crataegus_opima,22,12,10,Points-PointsKO-Adjacents,163
Crataegus_opulens,0,0,0,NA,0
Crataegus_orbicularis,16,7,9,Points-PointsKO-Adjacents,25
Crataegus_orientalis,60,32,28,Alphahull-PointsKO-Adjacents,541
Crataegus_ovata,21,9,12,Points-PointsKO-Adjacents,145
Crataegus_pallasii,0,0,0,NA,0
Crataegus_panda,0,0,0,NA,0
Crataegus_pearsonii,11,1,10,Points-PointsKO-Adjacents,99
Crataegus_pedicellata,163,78,85,Alphahull-PointsKO-Adjacents,5656
Crataegus_penita,2,1,1,Points-PointsKO-Adjacents,16
Crataegus_pennsylvanica,6,0,6,Points-PointsKO-Adjacents,43
Crataegus_pentagyna,27,12,15,Points-PointsKO-Adjacents,159
Crataegus_perjucunda,1,0,1,Points-PointsKO-Adjacents,9
Crataegus_persimilis,5,1,4,Points-PointsKO-Adjacents,36
Crataegus_phaenopyrum,221,128,93,Alphahull-PointsKO-Adjacents,14013
Crataegus_phippsii,32,8,24,Points-PointsKO-Adjacents,70
Crataegus_pinetorum,1,1,0,Points-PointsKO-Adjacents,9
Crataegus_pinnatifida,49,13,36,Points-PointsKO-Adjacents,416
Crataegus_piperi,72,23,49,Alphahull-PointsKO-Adjacents,1410
Crataegus_poliophylla,0,0,0,NA,0
Crataegus_porrecta,3,1,2,Points-PointsKO-Adjacents,27
Crataegus_pratensis,2,2,0,Points-PointsKO-Adjacents,18
Crataegus_pringlei,39,1,38,Points-PointsKO-Adjacents,297
Crataegus_prona,4,1,3,Points-PointsKO-Adjacents,36
Crataegus_pruinosa,597,416,181,Alphahull-PointsKO-Adjacents,22956
Crataegus_pseudoheterophylla,3,1,2,Points-PointsKO-Adjacents,27
Crataegus_punctata,796,0,796,Points-PointsKO-Adjacents,5512
Crataegus_putata,0,0,0,NA,0
Crataegus_pycnoloba,17,9,8,Points-PointsKO-Adjacents,77
Crataegus_ravida,0,0,0,NA,0
Crataegus_remotilobata,0,0,0,NA,0
Crataegus_resima,2,1,1,Points-PointsKO-Adjacents,12
Crataegus_reverchonii,100,0,100,Points-PointsKO-Adjacents,703
Crataegus_rhipidophylla,6250,5328,922,Alphahull-PointsKO-Adjacents,24997
Crataegus_rigens,4,2,2,Points-PointsKO-Adjacents,27
Crataegus_rivularis,222,192,30,Alphahull-PointsKO-Adjacents,7789
Crataegus_rosei,81,65,16,Alphahull-PointsKO-Adjacents,1007
Crataegus_rufula,2,2,0,Points-PointsKO-Adjacents,18
Crataegus_saligna,56,41,15,Alphahull-PointsKO-Adjacents,679
Crataegus_sanguinea,33,12,21,Points-PointsKO-Adjacents,224
Crataegus_sargentii,6,0,6,Points-PointsKO-Adjacents,54
Crataegus_scabrida,49,19,30,Points-PointsKO-Adjacents,367
Crataegus_scabrifolia,64,46,18,Alphahull-PointsKO-Adjacents,2619
Crataegus_schuettei,40,12,28,Points-PointsKO-Adjacents,326
Crataegus_segnis,8,1,7,Points-PointsKO-Adjacents,57
Crataegus_shaferi,1,0,1,Points-PointsKO-Adjacents,9
Crataegus_songarica,33,19,14,Points-PointsKO-Adjacents,262
Crataegus_spathulata,310,246,64,Alphahull-PointsKO-Adjacents,11755
Crataegus_spatiosa,2,2,0,Points-PointsKO-Adjacents,11
Crataegus_sphaenophylla,9,5,4,Points-PointsKO-Adjacents,18
Crataegus_spissa,0,0,0,NA,0
Crataegus_stenosepala,3,3,0,Points-PointsKO-Adjacents,27
Crataegus_submollis,83,32,51,Alphahull-PointsKO-Adjacents,3976
Crataegus_suborbiculata,25,3,22,Points-PointsKO-Adjacents,144
Crataegus_succulenta,517,341,176,Alphahull-PointsKO-Adjacents,36407
Crataegus_suksdorfii,194,140,54,Alphahull-PointsKO-Adjacents,5874
Crataegus_sutherlandensis,1,1,0,Points-PointsKO-Adjacents,9
Crataegus_tanacetifolia,4,4,0,Points-PointsKO-Adjacents,36
Crataegus_tanuphylla,0,0,0,NA,0
Crataegus_texana,84,38,46,Alphahull-PointsKO-Adjacents,4671
Crataegus_thermopegaea,1,1,0,Points-PointsKO-Adjacents,9
Crataegus_tinctoria,0,0,0,NA,0
Crataegus_tracyi,31,10,21,Points-PointsKO-Adjacents,219
Crataegus_triflora,36,21,15,Alphahull-PointsKO-Adjacents,1823
Crataegus_turnerorum,13,7,6,Points-PointsKO-Adjacents,104
Crataegus_uniflora,473,359,114,Alphahull-PointsKO-Adjacents,13831
Crataegus_vailiae,14,0,14,Points-PointsKO-Adjacents,105
Crataegus_valida,1,1,0,Points-PointsKO-Adjacents,9
Crataegus_versuta,2,1,1,Points-PointsKO-Adjacents,12
Crataegus_viburnifolia,63,27,36,Alphahull-PointsKO-Adjacents,4323
Crataegus_viridis,582,445,137,Alphahull-PointsKO-Adjacents,21300
Crataegus_visenda,8,2,6,Points-PointsKO-Adjacents,63
Crataegus_vulsa,1,0,1,Points-PointsKO-Adjacents,9
Crataegus_warneri,1,0,1,Points-PointsKO-Adjacents,9
Crataegus_wattiana,1,1,0,Points-PointsKO-Adjacents,9
Crataegus_wootoniana,15,10,5,Points-PointsKO-Adjacents,80
Crataegus_xanthophylla,0,0,0,NA,0
Crateva_religiosa,74,17,57,Points-PointsKO-Adjacents,475
Crateranthus_congolensis,5,0,5,Points-PointsKO-Adjacents,36
Crateranthus_le-testui,13,9,4,Points-PointsKO-Adjacents,59
Crateranthus_talbotii,17,14,3,Points-PointsKO-Adjacents,86
Craterispermum_aristatum,34,26,8,Alphahull-PointsKO-Adjacents,113
Craterispermum_caudatum,106,66,40,Alphahull-PointsKO-Adjacents,2076
Craterispermum_cerinanthum,134,69,65,Alphahull-PointsKO-Adjacents,3528
Craterispermum_dewevrei,8,0,8,Points-PointsKO-Adjacents,64
Craterispermum_laurinum,59,34,25,Alphahull-PointsKO-Adjacents,1308
Craterispermum_ledermannii,67,53,14,Alphahull-PointsKO-Adjacents,1041
Craterispermum_longipedunculatum,14,8,6,Points-PointsKO-Adjacents,95
Craterispermum_microdon,1,1,0,Points-PointsKO-Adjacents,8
Craterispermum_montanum,7,4,3,Points-PointsKO-Adjacents,14
Craterispermum_schweinfurthii,174,104,70,Alphahull-PointsKO-Adjacents,16163
Craterosiphon_beniensis,30,8,22,Points-PointsKO-Adjacents,238
Craterosiphon_quarrei,46,19,27,Points-PointsKO-Adjacents,329
Crateva_adansonii,149,102,47,Alphahull-PointsKO-Adjacents,7250
Crateva_excelsa,60,35,25,Alphahull-PointsKO-Adjacents,3212
Crateva_greveana,31,16,15,Points-PointsKO-Adjacents,193
Crateva_hygrophila,NA,NA,NA,NA,NA
Crateva_obovata,53,23,30,Alphahull-PointsKO-Adjacents,256
Crateva_palmeri,98,64,34,Alphahull-PointsKO-Adjacents,1156
Crateva_tapia,1886,1568,318,Alphahull-PointsKO-Adjacents,107178
Crateva_unilocularis,17,3,14,Points-PointsKO-Adjacents,153
Crateva_urbaniana,4,4,0,Points-PointsKO-Adjacents,36
Cratoxylum_arborescens,30,14,16,Points-PointsKO-Adjacents,223
Cratoxylum_cochinchinense,112,52,60,Alphahull-PointsKO-Adjacents,3058
Cratoxylum_formosum,86,33,53,Alphahull-PointsKO-Adjacents,2080
Cratoxylum_glaucum,17,0,17,Points-PointsKO-Adjacents,145
Cratoxylum_maingayi,8,0,8,Points-PointsKO-Adjacents,71
Cratoxylum_sumatranum,58,19,39,Points-PointsKO-Adjacents,451
Cratylia_argentea,243,160,83,Alphahull-PointsKO-Adjacents,27102
Cratylia_bahiensis,22,0,22,Points-PointsKO-Adjacents,117
Cremaspora_triflora,674,536,138,Alphahull-PointsKO-Adjacents,48107
Cremastosperma_antioquense,5,5,0,Points-PointsKO-Adjacents,36
Cremastosperma_awaense,28,21,7,Alphahull-PointsKO-Adjacents,170
Cremastosperma_brevipes,24,16,8,Points-PointsKO-Adjacents,118
Cremastosperma_bullatum,7,4,3,Points-PointsKO-Adjacents,15
Cremastosperma_cauliflorum,42,27,15,Alphahull-PointsKO-Adjacents,743
Cremastosperma_cenepense,5,5,0,Points-PointsKO-Adjacents,24
Cremastosperma_chococola,3,3,0,Points-PointsKO-Adjacents,21
Cremastosperma_dolichocarpum,10,8,2,Points-PointsKO-Adjacents,48
Cremastosperma_gracilipes,108,87,21,Alphahull-PointsKO-Adjacents,3142
Cremastosperma_juruense,34,12,22,Points-PointsKO-Adjacents,251
Cremastosperma_killipii,9,4,5,Points-PointsKO-Adjacents,57
Cremastosperma_leiophyllum,60,47,13,Alphahull-PointsKO-Adjacents,734
Cremastosperma_longicuspe,9,1,8,Points-PointsKO-Adjacents,57
Cremastosperma_longipes,11,5,6,Points-PointsKO-Adjacents,94
Cremastosperma_macrocarpum,7,2,5,Points-PointsKO-Adjacents,46
Cremastosperma_magdalenae,6,2,4,Points-PointsKO-Adjacents,27
Cremastosperma_megalophyllum,18,8,10,Points-PointsKO-Adjacents,146
Cremastosperma_microcarpum,56,32,24,Alphahull-PointsKO-Adjacents,1027
Cremastosperma_monospermum,151,113,38,Alphahull-PointsKO-Adjacents,11143
Cremastosperma_napoense,29,24,5,Alphahull-PointsKO-Adjacents,96
Cremastosperma_novogranatense,8,2,6,Points-PointsKO-Adjacents,45
Cremastosperma_oblongum,27,16,11,Points-PointsKO-Adjacents,187
Cremastosperma_pacificum,12,6,6,Points-PointsKO-Adjacents,86
Cremastosperma_panamense,48,40,8,Alphahull-PointsKO-Adjacents,118
Cremastosperma_pedunculatum,37,22,15,Alphahull-PointsKO-Adjacents,1609
Cremastosperma_peruvianum,14,9,5,Points-PointsKO-Adjacents,75
Cremastosperma_stenophyllum,5,5,0,Points-PointsKO-Adjacents,45
Cremastosperma_venezuelanum,5,5,0,Points-PointsKO-Adjacents,33
Cremastosperma_westrae,8,7,1,Points-PointsKO-Adjacents,41
Cremastosperma_yamayakatense,16,12,4,Points-PointsKO-Adjacents,84
Cremocarpon_lantzii,50,27,23,Alphahull-PointsKO-Adjacents,158
Cremocarpon_trichanthum,7,5,2,Points-PointsKO-Adjacents,12
Crepidospermum_atlanticum,45,21,24,Alphahull-PointsKO-Adjacents,702
Crepidospermum_cuneifolium,6,1,5,Points-PointsKO-Adjacents,39
Crepidospermum_goudotianum,231,176,55,Alphahull-PointsKO-Adjacents,18576
Crepidospermum_multijugum,7,0,7,Points-PointsKO-Adjacents,63
Crepidospermum_prancei,93,65,28,Alphahull-PointsKO-Adjacents,5005
Crepidospermum_rhoifolium,742,680,62,Alphahull-PointsKO-Adjacents,55703
Crescentia_alata,445,346,99,Alphahull-PointsKO-Adjacents,8016
Crescentia_amazonica,122,83,39,Alphahull-PointsKO-Adjacents,9982
Crescentia_cujete,692,524,168,Alphahull-PointsKO-Adjacents,23542
Crescentia_linearifolia,22,11,11,Points-PointsKO-Adjacents,84
Crescentia_mirabilis,4,4,0,Points-PointsKO-Adjacents,24
Crescentia_portoricensis,6,4,2,Points-PointsKO-Adjacents,26
Crinodendron_hookerianum,22,0,22,Points-PointsKO-Adjacents,134
Crinodendron_patagua,13,6,7,Points-PointsKO-Adjacents,102
Crinodendron_tucumanum,61,0,61,Points-PointsKO-Adjacents,320
Crioceras_dipladeniiflorus,26,14,12,Points-PointsKO-Adjacents,173
Critonia_aromatisans,11,3,8,Points-PointsKO-Adjacents,89
Critonia_daleoides,326,266,60,Alphahull-PointsKO-Adjacents,5663
Critonia_hebebotrya,94,50,44,Alphahull-PointsKO-Adjacents,3595
Critonia_heteroneura,8,0,8,Points-PointsKO-Adjacents,66
Critonia_inaequidens,10,2,8,Points-PointsKO-Adjacents,80
Critonia_morifolia,594,457,137,Alphahull-PointsKO-Adjacents,13477
Critonia_nubigenus,61,41,20,Alphahull-PointsKO-Adjacents,462
Critonia_paneroi,1,1,0,Points-PointsKO-Adjacents,9
Critonia_portoricensis,18,12,6,Points-PointsKO-Adjacents,80
Critonia_stigmatica,1,1,0,Points-PointsKO-Adjacents,7
Critoniadelphus_microdon,8,0,8,Points-PointsKO-Adjacents,63
Critoniadelphus_nubigenus,73,54,19,Alphahull-PointsKO-Adjacents,1078
Critoniella_acuminata,103,77,26,Alphahull-PointsKO-Adjacents,991
Critoniopsis_ayabacensis,1,1,0,Points-PointsKO-Adjacents,9
Critoniopsis_bitriflora,2,2,0,Points-PointsKO-Adjacents,18
Critoniopsis_bogotana,38,24,14,Alphahull-PointsKO-Adjacents,255
Critoniopsis_choquetangensis,4,4,0,Points-PointsKO-Adjacents,27
Critoniopsis_cinerea,3,3,0,Points-PointsKO-Adjacents,18
Critoniopsis_cotopaxensis,2,2,0,Points-PointsKO-Adjacents,12
Critoniopsis_cuatrecasasii,5,5,0,Points-PointsKO-Adjacents,36
Critoniopsis_dorrii,3,3,0,Points-PointsKO-Adjacents,27
Critoniopsis_elbertiana,9,2,7,Points-PointsKO-Adjacents,73
Critoniopsis_floribunda,27,15,12,Points-PointsKO-Adjacents,163
Critoniopsis_franciscana,4,4,0,Points-PointsKO-Adjacents,27
Critoniopsis_glandulata,33,24,9,Alphahull-PointsKO-Adjacents,304
Critoniopsis_harlingii,2,2,0,Points-PointsKO-Adjacents,18
Critoniopsis_jelskii,26,13,13,Points-PointsKO-Adjacents,170
Critoniopsis_killipii,2,2,0,Points-PointsKO-Adjacents,18
Critoniopsis_lindenii,42,30,12,Alphahull-PointsKO-Adjacents,815
Critoniopsis_macrofoliata,2,2,0,Points-PointsKO-Adjacents,18
Critoniopsis_occidentalis,42,33,9,Alphahull-PointsKO-Adjacents,249
Critoniopsis_palaciosii,7,3,4,Points-PointsKO-Adjacents,27
Critoniopsis_pallida,5,1,4,Points-PointsKO-Adjacents,45
Critoniopsis_paucartambensis,5,5,0,Points-PointsKO-Adjacents,43
Critoniopsis_popayanensis,12,6,6,Points-PointsKO-Adjacents,94
Critoniopsis_pycnantha,14,4,10,Points-PointsKO-Adjacents,124
Critoniopsis_quinqueflora,217,0,217,Points-PointsKO-Adjacents,905
Critoniopsis_sagasteguii,3,3,0,Points-PointsKO-Adjacents,27
Critoniopsis_salicifolia,190,165,25,Alphahull-PointsKO-Adjacents,4340
Critoniopsis_sevillana,20,9,11,Points-PointsKO-Adjacents,115
Critoniopsis_shannonii,7,0,7,Points-PointsKO-Adjacents,46
Critoniopsis_sodiroi,36,27,9,Alphahull-PointsKO-Adjacents,199
Critoniopsis_tungurahuae,8,2,6,Points-PointsKO-Adjacents,68
Critoniopsis_uribei,3,3,0,Points-PointsKO-Adjacents,23
Critoniopsis_ursicola,13,8,5,Points-PointsKO-Adjacents,63
Critoniopsis_yamboyensis,1,1,0,Points-PointsKO-Adjacents,9
Croizatia_brevipetiolata,18,11,7,Points-PointsKO-Adjacents,89
Croizatia_naiguatensis,6,0,6,Points-PointsKO-Adjacents,39
Croizatia_neotropica,4,4,0,Points-PointsKO-Adjacents,21
Croizatia_panamensis,17,6,11,Points-PointsKO-Adjacents,99
Crossopetalum_densiflorum,14,10,4,Points-PointsKO-Adjacents,46
Crossopetalum_enervium,38,25,13,Alphahull-PointsKO-Adjacents,202
Crossopetalum_gentlei,17,12,5,Points-PointsKO-Adjacents,78
Crossopetalum_glabrum,1,1,0,Points-PointsKO-Adjacents,9
Crossopetalum_lanceifolium,0,0,0,NA,0
Crossopetalum_lobatum,4,3,1,Points-PointsKO-Adjacents,28
Crossopetalum_minimiflorum,17,12,5,Points-PointsKO-Adjacents,70
Crossopetalum_parviflorum,455,397,58,Alphahull-PointsKO-Adjacents,6637
Crossopetalum_parvifolium,39,14,25,Points-PointsKO-Adjacents,139
Crossopetalum_rhacoma,126,72,54,Alphahull-PointsKO-Adjacents,2472
Crossopetalum_uragoga,248,193,55,Alphahull-PointsKO-Adjacents,3737
Crossopteryx_febrifuga,1856,1691,165,Alphahull-PointsKO-Adjacents,41666
Crossosoma_californicum,66,55,11,Alphahull-PointsKO-Adjacents,72
Crossosperma_cauliflora,3,3,0,Points-PointsKO-Adjacents,21
Crossosperma_velutina,5,5,0,Points-PointsKO-Adjacents,23
Crossostylis_banksiana,1,1,0,Points-PointsKO-Adjacents,9
Crossostylis_biflora,25,8,17,Points-PointsKO-Adjacents,90
Crossostylis_cominsii,0,0,0,NA,0
Crossostylis_dimera,0,0,0,NA,0
Crossostylis_grandiflora,17,9,8,Points-PointsKO-Adjacents,101
Crossostylis_harveyi,0,0,0,NA,0
Crossostylis_multiflora,10,3,7,Points-PointsKO-Adjacents,64
Crossostylis_parksii,1,1,0,Points-PointsKO-Adjacents,9
Crossostylis_pedunculata,0,0,0,NA,0
Crossostylis_raiateensis,0,0,0,NA,0
Crossostylis_richii,1,1,0,Points-PointsKO-Adjacents,9
Crossostylis_seemannii,1,1,0,Points-PointsKO-Adjacents,9
Crossothamnus_gentryi,5,5,0,Points-PointsKO-Adjacents,32
Crotalaria_agatiflora,108,83,25,Alphahull-PointsKO-Adjacents,3156
Crotalaria_cajanifolia,456,350,106,Alphahull-PointsKO-Adjacents,11088
Crotalaria_dinteri,7,0,7,Points-PointsKO-Adjacents,55
Crotalaria_exaltata,1,1,0,Points-PointsKO-Adjacents,9
Crotalaria_longirostrata,365,286,79,Alphahull-PointsKO-Adjacents,7673
Crotalaria_socotrana,2,2,0,Points-PointsKO-Adjacents,11
Croton_abonari,3,3,0,Points-PointsKO-Adjacents,23
Croton_abutilifolius,9,4,5,Points-PointsKO-Adjacents,45
Croton_abutiloides,58,46,12,Alphahull-PointsKO-Adjacents,411
Croton_aceroides,NA,NA,NA,NA,NA
Croton_acronychioides,213,0,213,Points-PointsKO-Adjacents,905
Croton_acutifolius,3,2,1,Points-PointsKO-Adjacents,27
Croton_adenophorus,44,28,16,Alphahull-PointsKO-Adjacents,293
Croton_adipatus,9,0,9,Points-PointsKO-Adjacents,60
Croton_aequatoris,13,7,6,Points-PointsKO-Adjacents,88
Croton_agoensis,100,78,22,Alphahull-PointsKO-Adjacents,3941
Croton_alagoensis,10,0,10,Points-PointsKO-Adjacents,90
Croton_alamosanus,95,65,30,Alphahull-PointsKO-Adjacents,1369
Croton_alchorneicarpus,41,35,6,Alphahull-PointsKO-Adjacents,264
Croton_alienus,11,4,7,Points-PointsKO-Adjacents,67
Croton_amazonicus,6,0,6,Points-PointsKO-Adjacents,54
Croton_amplifolius,3,3,0,Points-PointsKO-Adjacents,21
Croton_antae,1,1,0,Points-PointsKO-Adjacents,9
Croton_arboreus,292,263,29,Alphahull-PointsKO-Adjacents,2760
Croton_argyratus,72,34,38,Alphahull-PointsKO-Adjacents,3445
Croton_argyrodaphne,93,69,24,Alphahull-PointsKO-Adjacents,3056
Croton_argyrophyllus,333,270,63,Alphahull-PointsKO-Adjacents,11538
Croton_aripoensis,0,0,0,NA,0
Croton_aristophlebius,8,3,5,Points-PointsKO-Adjacents,30
Croton_arnhemicus,1071,1016,55,Alphahull-PointsKO-Adjacents,11301
Croton_aromaticus,2,2,0,Points-PointsKO-Adjacents,18
Croton_astianus,1,1,0,Points-PointsKO-Adjacents,9
Croton_astroites,4,1,3,Points-PointsKO-Adjacents,27
Croton_ater,3,3,0,Points-PointsKO-Adjacents,27
Croton_aubrevillei,11,3,8,Points-PointsKO-Adjacents,93
Croton_axillaris,61,33,28,Alphahull-PointsKO-Adjacents,249
Croton_baillonianus,3,3,0,Points-PointsKO-Adjacents,27
Croton_barorum,11,4,7,Points-PointsKO-Adjacents,82
Croton_beetlei,35,18,17,Points-PointsKO-Adjacents,137
Croton_belintae,0,0,0,NA,0
Croton_betulinus,50,0,50,Points-PointsKO-Adjacents,176
Croton_billbergianus,349,293,56,Alphahull-PointsKO-Adjacents,3100
Croton_blanchetianus,735,690,45,Alphahull-PointsKO-Adjacents,10426
Croton_boavitanus,4,4,0,Points-PointsKO-Adjacents,36
Croton_bolivarensis,4,4,0,Points-PointsKO-Adjacents,36
Croton_borneensis,0,0,0,NA,0
Croton_brachypus,19,14,5,Points-PointsKO-Adjacents,37
Croton_brassii,3,3,0,Points-PointsKO-Adjacents,18
Croton_brevipes,70,47,23,Alphahull-PointsKO-Adjacents,467
Croton_brieyi,6,0,6,Points-PointsKO-Adjacents,44
Croton_bryophorus,2,2,0,Points-PointsKO-Adjacents,18
Croton_buchii,0,0,0,NA,0
Croton_cajucara,167,103,64,Alphahull-PointsKO-Adjacents,13748
Croton_calycularis,9,0,9,Points-PointsKO-Adjacents,81
Croton_campanulatus,9,0,9,Points-PointsKO-Adjacents,37
Croton_capitis-york,63,51,12,Alphahull-PointsKO-Adjacents,166
Croton_caracasanus,13,4,9,Points-PointsKO-Adjacents,105
Croton_carpostellatus,2,2,0,Points-PointsKO-Adjacents,18
Croton_carrii,3,3,0,Points-PointsKO-Adjacents,9
Croton_caryocarpus,3,3,0,Points-PointsKO-Adjacents,16
Croton_cascarilloides,126,80,46,Alphahull-PointsKO-Adjacents,689
Croton_catati,42,25,17,Alphahull-PointsKO-Adjacents,652
Croton_caudatus,38,7,31,Points-PointsKO-Adjacents,300
Croton_ceanothifolius,54,29,25,Alphahull-PointsKO-Adjacents,1413
Croton_cearensis,4,4,0,Points-PointsKO-Adjacents,30
Croton_celtidifolius,301,258,43,Alphahull-PointsKO-Adjacents,5518
Croton_chamelensis,21,14,7,Points-PointsKO-Adjacents,30
Croton_charaguensis,13,7,6,Points-PointsKO-Adjacents,108
Croton_chittagongensis,NA,NA,NA,NA,NA
Croton_chlorocalyx,1,1,0,Points-PointsKO-Adjacents,9
Croton_chocoanus,39,26,13,Alphahull-PointsKO-Adjacents,450
Croton_choristadenius,29,6,23,Points-PointsKO-Adjacents,153
Croton_churutensis,9,4,5,Points-PointsKO-Adjacents,45
Croton_claussenianus,3,3,0,Points-PointsKO-Adjacents,27
Croton_coccymelophyllus,7,1,6,Points-PointsKO-Adjacents,29
Croton_colombianus,1,1,0,Points-PointsKO-Adjacents,9
Croton_confertus,8,4,4,Points-PointsKO-Adjacents,40
Croton_congensis,2,1,1,Points-PointsKO-Adjacents,18
Croton_cordatulus,5,5,0,Points-PointsKO-Adjacents,29
Croton_coriaceus,24,13,11,Points-PointsKO-Adjacents,120
Croton_coriifolius,0,0,0,NA,0
Croton_corinthius,8,3,5,Points-PointsKO-Adjacents,27
Croton_cortesianus,509,441,68,Alphahull-PointsKO-Adjacents,6018
Croton_corylifolius,41,19,22,Points-PointsKO-Adjacents,285
Croton_costatus,34,18,16,Points-PointsKO-Adjacents,245
Croton_cuneatus,309,244,65,Alphahull-PointsKO-Adjacents,35237
Croton_cupreatus,6,1,5,Points-PointsKO-Adjacents,54
Croton_curranii,9,2,7,Points-PointsKO-Adjacents,57
Croton_damayeshu,6,2,4,Points-PointsKO-Adjacents,54
Croton_decalobus,19,4,15,Points-PointsKO-Adjacents,92
Croton_delpyi,5,5,0,Points-PointsKO-Adjacents,45
Croton_deserticola,1,1,0,Points-PointsKO-Adjacents,9
Croton_diasii,10,2,8,Points-PointsKO-Adjacents,77
Croton_dibindi,NA,NA,NA,NA,NA
Croton_dichogamus,50,32,18,Alphahull-PointsKO-Adjacents,1781
Croton_dictyophlebodes,7,3,4,Points-PointsKO-Adjacents,33
Croton_dinghuensis,NA,NA,NA,NA,NA
Croton_discolor,44,26,18,Alphahull-PointsKO-Adjacents,155
Croton_dispar,3,3,0,Points-PointsKO-Adjacents,27
Croton_domatifer,3,3,0,Points-PointsKO-Adjacents,27
Croton_draco,768,674,94,Alphahull-PointsKO-Adjacents,8729
Croton_draconoides,35,3,32,Points-PointsKO-Adjacents,296
Croton_draconopsis,5,4,1,Points-PointsKO-Adjacents,45
Croton_eichleri,9,4,5,Points-PointsKO-Adjacents,74
Croton_ekmanii,6,2,4,Points-PointsKO-Adjacents,27
Croton_elbertii,2,2,0,Points-PointsKO-Adjacents,9
Croton_eluteria,20,2,18,Points-PointsKO-Adjacents,147
Croton_erythrochyloides,4,4,0,Points-PointsKO-Adjacents,36
Croton_erythrostachys,1,1,0,Points-PointsKO-Adjacents,9
Croton_euryphyllus,18,6,12,Points-PointsKO-Adjacents,162
Croton_exuberans,0,0,0,NA,0
Croton_fantzianus,26,0,26,Points-PointsKO-Adjacents,147
Croton_flavens,237,158,79,Alphahull-PointsKO-Adjacents,1304
Croton_floribundus,996,888,108,Alphahull-PointsKO-Adjacents,21965
Croton_fluviatilis,NA,NA,NA,NA,NA
Croton_fragilis,15,2,13,Points-PointsKO-Adjacents,119
Croton_fragrans,87,54,33,Alphahull-PointsKO-Adjacents,5786
Croton_fragrantulus,9,2,7,Points-PointsKO-Adjacents,81
Croton_fraseri,12,6,6,Points-PointsKO-Adjacents,80
Croton_gageanus,0,0,0,NA,0
Croton_gibsonianus,1,1,0,Points-PointsKO-Adjacents,9
Croton_glabellus,353,287,66,Alphahull-PointsKO-Adjacents,4312
Croton_gossweileri,1,1,0,Points-PointsKO-Adjacents,9
Croton_gossypiifolius,209,160,49,Alphahull-PointsKO-Adjacents,7637
Croton_goudotii,72,55,17,Alphahull-PointsKO-Adjacents,590
Croton_gracilipes,207,151,56,Alphahull-PointsKO-Adjacents,11085
Croton_gratissimus,386,301,85,Alphahull-PointsKO-Adjacents,18989
Croton_grewiifolius,19,11,8,Points-PointsKO-Adjacents,124
Croton_griffithii,11,0,11,Points-PointsKO-Adjacents,92
Croton_grisebachianus,2,2,0,Points-PointsKO-Adjacents,13
Croton_griseus,2,2,0,Points-PointsKO-Adjacents,12
Croton_guatemalensis,251,202,49,Alphahull-PointsKO-Adjacents,3091
Croton_guianensis,33,24,9,Alphahull-PointsKO-Adjacents,886
Croton_habrophyllus,408,379,29,Alphahull-PointsKO-Adjacents,4305
Croton_hancei,0,0,0,NA,0
Croton_haumanianus,69,48,21,Alphahull-PointsKO-Adjacents,7265
Croton_hecatonandrus,2,1,1,Points-PointsKO-Adjacents,18
Croton_hemiargyreus,31,10,21,Points-PointsKO-Adjacents,206
Croton_heterocarpus,4,4,0,Points-PointsKO-Adjacents,36
Croton_heterotrichus,0,0,0,NA,0
Croton_hibiscifolius,73,53,20,Alphahull-PointsKO-Adjacents,2263
Croton_hircinus,39,15,24,Points-PointsKO-Adjacents,220
Croton_hoffmannii,27,11,16,Points-PointsKO-Adjacents,117
Croton_hostmannii,22,8,14,Points-PointsKO-Adjacents,108
Croton_hovarum,33,25,8,Alphahull-PointsKO-Adjacents,524
Croton_howii,4,4,0,Points-PointsKO-Adjacents,36
Croton_huberi,10,5,5,Points-PointsKO-Adjacents,45
Croton_huitotorus,2,2,0,Points-PointsKO-Adjacents,18
Croton_humblotii,2,2,0,Points-PointsKO-Adjacents,8
Croton_hutchinsonianus,6,1,5,Points-PointsKO-Adjacents,54
Croton_icabarui,2,2,0,Points-PointsKO-Adjacents,18
Croton_icche,79,0,79,Points-PointsKO-Adjacents,365
Croton_ignifex,0,0,0,NA,0
Croton_impressus,22,12,10,Points-PointsKO-Adjacents,76
Croton_indivisus,NA,NA,NA,NA,NA
Croton_inhambanensis,0,0,0,NA,0
Croton_insularis,606,535,71,Alphahull-PointsKO-Adjacents,6199
Croton_isomonensis,13,4,9,Points-PointsKO-Adjacents,101
Croton_ivohibensis,33,18,15,Points-PointsKO-Adjacents,214
Croton_jacmelianus,8,1,7,Points-PointsKO-Adjacents,57
Croton_jamaicensis,4,4,0,Points-PointsKO-Adjacents,30
Croton_jamesonii,1,1,0,Points-PointsKO-Adjacents,9
Croton_jansii,2,2,0,Points-PointsKO-Adjacents,15
Croton_jatrophoides,6,2,4,Points-PointsKO-Adjacents,46
Croton_jimenezii,21,14,7,Points-PointsKO-Adjacents,79
Croton_jorgei,22,14,8,Points-PointsKO-Adjacents,123
Croton_joufra,0,0,0,NA,0
Croton_kelantanicus,NA,NA,NA,NA,NA
Croton_kerrii,6,0,6,Points-PointsKO-Adjacents,54
Croton_killipianus,61,48,13,Alphahull-PointsKO-Adjacents,883
Croton_klotzschianus,1,1,0,Points-PointsKO-Adjacents,9
Croton_kongensis,25,8,17,Points-PointsKO-Adjacents,190
Croton_kongkandanus,2,2,0,Points-PointsKO-Adjacents,18
Croton_laccifer,4,0,4,Points-PointsKO-Adjacents,36
Croton_laciniatistylus,5,4,1,Points-PointsKO-Adjacents,45
Croton_laevigatus,7,2,5,Points-PointsKO-Adjacents,54
Croton_lagoensis,11,5,6,Points-PointsKO-Adjacents,95
Croton_lamdongensis,NA,NA,NA,NA,NA
Croton_laui,1,1,0,Points-PointsKO-Adjacents,9
Croton_lauioides,NA,NA,NA,NA,NA
Croton_laurinus,3,3,0,Points-PointsKO-Adjacents,18
Croton_lawianus,1,1,0,Points-PointsKO-Adjacents,9
Croton_lechleri,41,16,25,Points-PointsKO-Adjacents,321
Croton_leiophyllus,9,1,8,Points-PointsKO-Adjacents,61
Croton_leptanthus,0,0,0,NA,0
Croton_leuconeurus,8,0,8,Points-PointsKO-Adjacents,66
Croton_levatii,3,3,0,Points-PointsKO-Adjacents,25
Croton_lichenisilvae,30,1,29,Points-PointsKO-Adjacents,82
Croton_lissophyllus,0,0,0,NA,0
Croton_longipedicellatus,18,4,14,Points-PointsKO-Adjacents,132
Croton_longiracemosus,21,10,11,Points-PointsKO-Adjacents,120
Croton_loukandensis,2,2,0,Points-PointsKO-Adjacents,18
Croton_luciae,1,1,0,Points-PointsKO-Adjacents,9
Croton_lucidus,0,0,0,NA,0
Croton_maasii,6,0,6,Points-PointsKO-Adjacents,54
Croton_macrobothrys,217,164,53,Alphahull-PointsKO-Adjacents,1907
Croton_macrocarpus,0,0,0,NA,0
Croton_macrostachyus,193,126,67,Alphahull-PointsKO-Adjacents,10887
Croton_madandensis,2,2,0,Points-PointsKO-Adjacents,18
Croton_maevaranensis,3,3,0,Points-PointsKO-Adjacents,18
Croton_magdalenensis,130,108,22,Alphahull-PointsKO-Adjacents,694
Croton_magneticus,25,14,11,Points-PointsKO-Adjacents,85
Croton_malabaricus,1,0,1,Points-PointsKO-Adjacents,9
Croton_malambo,23,12,11,Points-PointsKO-Adjacents,129
Croton_mallotophyllus,1,1,0,Points-PointsKO-Adjacents,9
Croton_matourensis,504,391,113,Alphahull-PointsKO-Adjacents,64560
Croton_mayumbensis,3,3,0,Points-PointsKO-Adjacents,27
Croton_megaladenus,0,0,0,NA,0
Croton_megalobotrys,88,59,29,Alphahull-PointsKO-Adjacents,2694
Croton_megalocarpoides,7,2,5,Points-PointsKO-Adjacents,50
Croton_megalocarpus,42,15,27,Points-PointsKO-Adjacents,301
Croton_megalodendron,41,22,19,Alphahull-PointsKO-Adjacents,1721
Croton_megistocarpus,62,54,8,Alphahull-PointsKO-Adjacents,162
Croton_menthodorus,38,27,11,Alphahull-PointsKO-Adjacents,144
Croton_menyharthii,88,40,48,Alphahull-PointsKO-Adjacents,1885
Croton_metallicus,1,1,0,Points-PointsKO-Adjacents,9
Croton_mexicanus,25,14,11,Points-PointsKO-Adjacents,108
Croton_micans,15,4,11,Points-PointsKO-Adjacents,91
Croton_microtiglium,0,0,0,NA,0
Croton_mongue,93,68,25,Alphahull-PointsKO-Adjacents,1458
Croton_moonii,1,1,0,Points-PointsKO-Adjacents,9
Croton_morobensis,13,0,13,Points-PointsKO-Adjacents,52
Croton_morotaeus,3,3,0,Points-PointsKO-Adjacents,21
Croton_mubango,22,5,17,Points-PointsKO-Adjacents,192
Croton_multicostatus,20,14,6,Points-PointsKO-Adjacents,79
Croton_muriculatus,5,4,1,Points-PointsKO-Adjacents,43
Croton_mutisianus,87,56,31,Alphahull-PointsKO-Adjacents,1192
Croton_neblinae,2,2,0,Points-PointsKO-Adjacents,14
Croton_nitens,95,67,28,Alphahull-PointsKO-Adjacents,2179
Croton_nitidulus,125,107,18,Alphahull-PointsKO-Adjacents,1461
Croton_nitrariifolius,6,0,6,Points-PointsKO-Adjacents,50
Croton_niveus,652,509,143,Alphahull-PointsKO-Adjacents,14108
Croton_nobilis,33,19,14,Points-PointsKO-Adjacents,171
Croton_novi-friburgi,2,2,0,Points-PointsKO-Adjacents,18
Croton_nubigenus,17,8,9,Points-PointsKO-Adjacents,88
Croton_nuntians,18,10,8,Points-PointsKO-Adjacents,109
Croton_oblongus,23,10,13,Points-PointsKO-Adjacents,165
Croton_oerstedianus,133,109,24,Alphahull-PointsKO-Adjacents,2133
Croton_oligandrus,21,12,9,Points-PointsKO-Adjacents,147
Croton_oreades,17,0,17,Points-PointsKO-Adjacents,110
Croton_organensis,69,53,16,Alphahull-PointsKO-Adjacents,501
Croton_orinocensis,33,9,24,Points-PointsKO-Adjacents,253
Croton_pachypodus,107,65,42,Alphahull-PointsKO-Adjacents,2161
Croton_palanostigma,324,253,71,Alphahull-PointsKO-Adjacents,34219
Croton_pavonis,8,3,5,Points-PointsKO-Adjacents,45
Croton_peekelii,NA,NA,NA,NA,NA
Croton_pendens,4,3,1,Points-PointsKO-Adjacents,30
Croton_penduliflorus,18,1,17,Points-PointsKO-Adjacents,106
Croton_persimilis,22,4,18,Points-PointsKO-Adjacents,198
Croton_perspeciosus,26,10,16,Points-PointsKO-Adjacents,189
Croton_phebalioides,409,371,38,Alphahull-PointsKO-Adjacents,8705
Croton_phuquocensis,0,0,0,NA,0
Croton_pilgeri,6,1,5,Points-PointsKO-Adjacents,54
Croton_pilophorus,3,3,0,Points-PointsKO-Adjacents,18
Croton_piluliferus,29,14,15,Points-PointsKO-Adjacents,204
Croton_piptocalyx,106,69,37,Alphahull-PointsKO-Adjacents,2280
Croton_poecilanthus,24,18,6,Points-PointsKO-Adjacents,41
Croton_poggei,1,1,0,Points-PointsKO-Adjacents,9
Croton_poilanei,6,1,5,Points-PointsKO-Adjacents,45
Croton_polytrichus,28,15,13,Points-PointsKO-Adjacents,171
Croton_pontis,0,0,0,NA,0
Croton_poomae,2,2,0,Points-PointsKO-Adjacents,18
Croton_potabilis,1,1,0,Points-PointsKO-Adjacents,9
Croton_priscus,22,16,6,Points-PointsKO-Adjacents,123
Croton_pseudoglabellus,2,2,0,Points-PointsKO-Adjacents,18
Croton_pseudoniveus,92,49,43,Alphahull-PointsKO-Adjacents,471
Croton_pseudopopulus,3,3,0,Points-PointsKO-Adjacents,25
Croton_pseudopulchellus,84,0,84,Points-PointsKO-Adjacents,645
Croton_pullei,36,14,22,Points-PointsKO-Adjacents,285
Croton_pungens,67,0,67,Points-PointsKO-Adjacents,336
Croton_purdiei,21,12,9,Points-PointsKO-Adjacents,139
Croton_purpurascens,1,1,0,Points-PointsKO-Adjacents,9
Croton_pyrifolius,3,3,0,Points-PointsKO-Adjacents,27
Croton_quadrisetosus,25,6,19,Points-PointsKO-Adjacents,177
Croton_quercetorum,2,2,0,Points-PointsKO-Adjacents,18
Croton_reflexifolius,329,281,48,Alphahull-PointsKO-Adjacents,8030
Croton_regeneratrix,8,2,6,Points-PointsKO-Adjacents,63
Croton_rimbachii,33,13,20,Points-PointsKO-Adjacents,204
Croton_ripensis,2,2,0,Points-PointsKO-Adjacents,7
Croton_rivinifolius,27,16,11,Points-PointsKO-Adjacents,165
Croton_robustus,3,3,0,Points-PointsKO-Adjacents,27
Croton_roraimensis,13,5,8,Points-PointsKO-Adjacents,88
Croton_rosarianus,5,5,0,Points-PointsKO-Adjacents,9
Croton_rosmarinoides,1,1,0,Points-PointsKO-Adjacents,8
Croton_rottlerifolius,33,17,16,Points-PointsKO-Adjacents,225
Croton_roxanae,32,13,19,Points-PointsKO-Adjacents,185
Croton_rufoargenteus,4,4,0,Points-PointsKO-Adjacents,36
Croton_rufolepidotus,6,1,5,Points-PointsKO-Adjacents,40
Croton_ruizianus,49,15,34,Points-PointsKO-Adjacents,400
Croton_rusbyi,33,22,11,Alphahull-PointsKO-Adjacents,297
Croton_sacaquinha,34,0,34,Points-PointsKO-Adjacents,278
Croton_saipanensis,0,0,0,NA,0
Croton_salutaris,111,84,27,Alphahull-PointsKO-Adjacents,2226
Croton_sampatik,215,142,73,Alphahull-PointsKO-Adjacents,26184
Croton_santisukii,0,0,0,NA,0
Croton_sapiifolius,10,4,6,Points-PointsKO-Adjacents,44
Croton_sarocarpus,4,4,0,Points-PointsKO-Adjacents,13
Croton_scabiosus,0,0,0,NA,0
Croton_scheffleri,25,13,12,Points-PointsKO-Adjacents,188
Croton_schiedeanus,1111,984,127,Alphahull-PointsKO-Adjacents,15587
Croton_schimperianus,8,0,8,Points-PointsKO-Adjacents,59
Croton_scouleri,12,0,12,Points-PointsKO-Adjacents,70
Croton_scutatus,24,4,20,Points-PointsKO-Adjacents,171
Croton_sepalinus,1,1,0,Points-PointsKO-Adjacents,9
Croton_sexmetralis,5,5,0,Points-PointsKO-Adjacents,45
Croton_sibundoyensis,4,4,0,Points-PointsKO-Adjacents,27
Croton_singularis,4,4,0,Points-PointsKO-Adjacents,36
Croton_smithianus,149,112,37,Alphahull-PointsKO-Adjacents,2787
Croton_socotranus,11,7,4,Points-PointsKO-Adjacents,40
Croton_sonderianus,225,197,28,Alphahull-PointsKO-Adjacents,7180
Croton_sordidus,6,0,6,Points-PointsKO-Adjacents,54
Croton_speciosus,21,6,15,Points-PointsKO-Adjacents,104
Croton_sphaerogynus,53,0,53,Points-PointsKO-Adjacents,314
Croton_spruceanus,53,17,36,Points-PointsKO-Adjacents,451
Croton_staminosus,0,0,0,NA,0
Croton_stanneum,21,6,15,Points-PointsKO-Adjacents,166
Croton_steenkampianus,18,3,15,Points-PointsKO-Adjacents,136
Croton_stelluliferus,2,2,0,Points-PointsKO-Adjacents,9
Croton_stenopetalus,0,0,0,NA,0
Croton_stenosepalus,0,0,0,NA,0
Croton_stigmatosus,134,104,30,Alphahull-PointsKO-Adjacents,672
Croton_sublyratus,0,0,0,NA,0
Croton_sulcifructus,6,3,3,Points-PointsKO-Adjacents,12
Croton_sylvaticus,142,54,88,Alphahull-PointsKO-Adjacents,1520
Croton_tabascensis,11,0,11,Points-PointsKO-Adjacents,84
Croton_tacanensis,1,1,0,Points-PointsKO-Adjacents,9
Croton_talaeporos,8,0,8,Points-PointsKO-Adjacents,48
Croton_tarapotensis,6,0,6,Points-PointsKO-Adjacents,54
Croton_tchibangensis,0,0,0,NA,0
Croton_tenuicaudatus,40,27,13,Alphahull-PointsKO-Adjacents,287
Croton_tessmannii,49,33,16,Alphahull-PointsKO-Adjacents,3054
Croton_thoii,NA,NA,NA,NA,NA
Croton_thorelii,6,1,5,Points-PointsKO-Adjacents,54
Croton_thurifer,0,0,0,NA,0
Croton_tiglium,102,0,102,Points-PointsKO-Adjacents,863
Croton_tiliifolius,0,0,0,NA,0
Croton_tomentellus,97,77,20,Alphahull-PointsKO-Adjacents,2243
Croton_tonantinensis,1,1,0,Points-PointsKO-Adjacents,9
Croton_tonduzii,12,6,6,Points-PointsKO-Adjacents,86
Croton_touranensis,0,0,0,NA,0
Croton_triacros,76,58,18,Alphahull-PointsKO-Adjacents,261
Croton_tricolor,415,372,43,Alphahull-PointsKO-Adjacents,9016
Croton_triglandulatus,0,0,0,NA,0
Croton_trombetensis,11,3,8,Points-PointsKO-Adjacents,95
Croton_turumiquirensis,5,4,1,Points-PointsKO-Adjacents,39
Croton_tyndaridum,1,1,0,Points-PointsKO-Adjacents,9
Croton_urucurana,1024,903,121,Alphahull-PointsKO-Adjacents,49335
Croton_vatomandrensis,4,4,0,Points-PointsKO-Adjacents,33
Croton_vaughanii,1,1,0,Points-PointsKO-Adjacents,9
Croton_verapazensis,8,0,8,Points-PointsKO-Adjacents,33
Croton_verreauxii,969,880,89,Alphahull-PointsKO-Adjacents,1475
Croton_vogelianus,2,2,0,Points-PointsKO-Adjacents,6
Croton_vohibariensis,4,4,0,Points-PointsKO-Adjacents,30
Croton_vulnerarius,61,37,24,Alphahull-PointsKO-Adjacents,1454
Croton_wallichii,2,2,0,Points-PointsKO-Adjacents,18
Croton_wassi-kussae,3,3,0,Points-PointsKO-Adjacents,27
Croton_watsonii,52,29,23,Alphahull-PointsKO-Adjacents,369
Croton_websteri,9,3,6,Points-PointsKO-Adjacents,36
Croton_wellensii,8,2,6,Points-PointsKO-Adjacents,68
Croton_womersleyi,10,2,8,Points-PointsKO-Adjacents,72
Croton_xalapensis,278,212,66,Alphahull-PointsKO-Adjacents,3793
Croton_xanthochylus,3,3,0,Points-PointsKO-Adjacents,27
Croton_xiaopadou,16,6,10,Points-PointsKO-Adjacents,144
Croton_yanhuii,0,0,0,NA,0
Croton_yavitensis,70,39,31,Alphahull-PointsKO-Adjacents,2589
Croton_ynesae,8,2,6,Points-PointsKO-Adjacents,68
Croton_yucatanensis,62,42,20,Alphahull-PointsKO-Adjacents,376
Croton_yungensis,8,1,7,Points-PointsKO-Adjacents,70
Croton_zeylanicus,1,1,0,Points-PointsKO-Adjacents,9
Crotonogyne_angustifolia,0,0,0,NA,0
Crotonogyne_caterviflora,93,71,22,Alphahull-PointsKO-Adjacents,1869
Crotonogyne_gabunensis,96,74,22,Alphahull-PointsKO-Adjacents,1779
Crotonogyne_giorgii,27,12,15,Points-PointsKO-Adjacents,206
Crotonogyne_laurentii,NA,NA,NA,NA,NA
Crotonogyne_ledermanniana,NA,NA,NA,NA,NA
Crotonogyne_manniana,126,100,26,Alphahull-PointsKO-Adjacents,2740
Crotonogyne_parvifolia,5,5,0,Points-PointsKO-Adjacents,39
Crotonogyne_poggei,39,16,23,Points-PointsKO-Adjacents,276
Crotonogyne_preussii,37,27,10,Alphahull-PointsKO-Adjacents,147
Crotonogyne_strigosa,14,7,7,Points-PointsKO-Adjacents,70
Crotonogyne_zenkeri,28,15,13,Points-PointsKO-Adjacents,128
Crotonogynopsis_akeassii,8,1,7,Points-PointsKO-Adjacents,57
Crotonogynopsis_usambarica,10,0,10,Points-PointsKO-Adjacents,61
Crudia_acuminata,17,2,15,Points-PointsKO-Adjacents,129
Crudia_acuta,0,0,0,NA,0
Crudia_aequalis,43,13,30,Points-PointsKO-Adjacents,324
Crudia_amazonica,255,221,34,Alphahull-PointsKO-Adjacents,13344
Crudia_aromatica,15,8,7,Points-PointsKO-Adjacents,130
Crudia_balachandrae,NA,NA,NA,NA,NA
Crudia_bantamensis,2,2,0,Points-PointsKO-Adjacents,18
Crudia_beccarii,2,2,0,Points-PointsKO-Adjacents,18
Crudia_bibundina,NA,NA,NA,NA,NA
Crudia_blancoi,0,0,0,NA,0
Crudia_bracteata,42,22,20,Alphahull-PointsKO-Adjacents,914
Crudia_caudata,3,3,0,Points-PointsKO-Adjacents,23
Crudia_cauliflora,0,0,0,NA,0
Crudia_chrysantha,2,2,0,Points-PointsKO-Adjacents,18
Crudia_curtisii,2,2,0,Points-PointsKO-Adjacents,18
Crudia_cynometroides,1,1,0,Points-PointsKO-Adjacents,6
Crudia_dewitii,0,0,0,NA,0
Crudia_evansii,NA,NA,NA,NA,NA
Crudia_gabonensis,57,31,26,Alphahull-PointsKO-Adjacents,1515
Crudia_glaberrima,243,153,90,Alphahull-PointsKO-Adjacents,17420
Crudia_gracilis,1,1,0,Points-PointsKO-Adjacents,6
Crudia_harmsiana,7,0,7,Points-PointsKO-Adjacents,53
Crudia_katikii,3,3,0,Points-PointsKO-Adjacents,21
Crudia_klainei,71,41,30,Alphahull-PointsKO-Adjacents,574
Crudia_lanceolata,1,1,0,Points-PointsKO-Adjacents,9
Crudia_laurentii,9,2,7,Points-PointsKO-Adjacents,72
Crudia_ledermannii,19,10,9,Points-PointsKO-Adjacents,145
Crudia_mansonii,NA,NA,NA,NA,NA
Crudia_michelsonii,4,4,0,Points-PointsKO-Adjacents,36
Crudia_mutabilis,0,0,0,NA,0
Crudia_oblonga,174,107,67,Alphahull-PointsKO-Adjacents,10804
Crudia_ornata,5,5,0,Points-PointsKO-Adjacents,37
Crudia_papuana,9,4,5,Points-PointsKO-Adjacents,49
Crudia_penduliflora,NA,NA,NA,NA,NA
Crudia_reticulata,17,5,12,Points-PointsKO-Adjacents,104
Crudia_ripicola,1,1,0,Points-PointsKO-Adjacents,9
Crudia_scortechinii,0,0,0,NA,0
Crudia_senegalensis,51,21,30,Alphahull-PointsKO-Adjacents,718
Crudia_sparei,NA,NA,NA,NA,NA
Crudia_speciosa,0,0,0,NA,0
Crudia_spicata,15,5,10,Points-PointsKO-Adjacents,128
Crudia_splendens,NA,NA,NA,NA,NA
Crudia_subsimplicifolia,7,2,5,Points-PointsKO-Adjacents,63
Crudia_tenuipes,18,6,12,Points-PointsKO-Adjacents,125
Crudia_teysmannii,2,2,0,Points-PointsKO-Adjacents,18
Crudia_tomentosa,78,35,43,Alphahull-PointsKO-Adjacents,4785
Crudia_velutina,0,0,0,NA,0
Crudia_venenosa,NA,NA,NA,NA,NA
Crudia_viridiflora,0,0,0,NA,0
Crudia_wrayi,1,0,1,Points-PointsKO-Adjacents,9
Crudia_zenkeri,44,33,11,Alphahull-PointsKO-Adjacents,472
Crudia_zeylanica,1,1,0,Points-PointsKO-Adjacents,9
Crumenaria_decumbens,86,0,86,Points-PointsKO-Adjacents,554
Cryosophila_bartlettii,3,3,0,Points-PointsKO-Adjacents,15
Cryosophila_cookii,5,5,0,Points-PointsKO-Adjacents,27
Cryosophila_grayumii,19,10,9,Points-PointsKO-Adjacents,77
Cryosophila_kalbreyeri,52,40,12,Alphahull-PointsKO-Adjacents,1143
Cryosophila_macrocarpa,1,1,0,Points-PointsKO-Adjacents,5
Cryosophila_nana,17,8,9,Points-PointsKO-Adjacents,123
Cryosophila_stauracantha,174,158,16,Alphahull-PointsKO-Adjacents,1711
Cryosophila_warscewiczii,135,107,28,Alphahull-PointsKO-Adjacents,946
Cryosophila_williamsii,6,0,6,Points-PointsKO-Adjacents,41
Crypteronia_borneensis,0,0,0,NA,0
Crypteronia_cumingii,22,3,19,Points-PointsKO-Adjacents,132
Crypteronia_elegans,0,0,0,NA,0
Crypteronia_glabriflora,3,3,0,Points-PointsKO-Adjacents,17
Crypteronia_griffithii,18,3,15,Points-PointsKO-Adjacents,161
Crypteronia_macrophylla,4,4,0,Points-PointsKO-Adjacents,36
Crypteronia_paniculata,45,12,33,Points-PointsKO-Adjacents,385
Cryptocarya_acuminata,0,0,0,NA,0
Cryptocarya_acutifolia,2,2,0,Points-PointsKO-Adjacents,18
Cryptocarya_agathophylla,15,9,6,Points-PointsKO-Adjacents,83
Cryptocarya_alba,44,29,15,Alphahull-PointsKO-Adjacents,903
Cryptocarya_albifrons,2,2,0,Points-PointsKO-Adjacents,16
Cryptocarya_alleniana,4,4,0,Points-PointsKO-Adjacents,18
Cryptocarya_alseodaphnifolia,2,2,0,Points-PointsKO-Adjacents,9
Cryptocarya_alticola,3,3,0,Points-PointsKO-Adjacents,9
Cryptocarya_ambrensis,9,2,7,Points-PointsKO-Adjacents,27
Cryptocarya_ampla,2,2,0,Points-PointsKO-Adjacents,15
Cryptocarya_amygdalina,3,0,3,Points-PointsKO-Adjacents,27
Cryptocarya_anamalayana,0,0,0,NA,0
Cryptocarya_andamanica,0,0,0,NA,0
Cryptocarya_angica,0,0,0,NA,0
Cryptocarya_angulata,174,153,21,Alphahull-PointsKO-Adjacents,294
Cryptocarya_angustifolia,13,7,6,Points-PointsKO-Adjacents,114
Cryptocarya_apamifolia,1,1,0,Points-PointsKO-Adjacents,9
Cryptocarya_archboldiana,2,2,0,Points-PointsKO-Adjacents,18
Cryptocarya_arfakensis,0,0,0,NA,0
Cryptocarya_argyrophylla,0,0,0,NA,0
Cryptocarya_aristata,19,9,10,Points-PointsKO-Adjacents,70
Cryptocarya_aschersoniana,564,0,564,Points-PointsKO-Adjacents,3088
Cryptocarya_atra,NA,NA,NA,NA,NA
Cryptocarya_aurea,0,0,0,NA,0
Cryptocarya_aureobrunnea,2,2,0,Points-PointsKO-Adjacents,18
Cryptocarya_aureosericea,4,4,0,Points-PointsKO-Adjacents,27
Cryptocarya_austrokweichouensis,NA,NA,NA,NA,NA
Cryptocarya_balakrishnanii,NA,NA,NA,NA,NA
Cryptocarya_bamagana,16,8,8,Points-PointsKO-Adjacents,66
Cryptocarya_barbellata,0,0,0,NA,0
Cryptocarya_beddomei,0,0,0,NA,0
Cryptocarya_beilschmiediifolia,0,0,0,NA,0
Cryptocarya_bellendenkeriana,NA,NA,NA,NA,NA
Cryptocarya_bernhardiensis,1,1,0,Points-PointsKO-Adjacents,9
Cryptocarya_bhutanica,1,1,0,Points-PointsKO-Adjacents,9
Cryptocarya_bidwillii,229,190,39,Alphahull-PointsKO-Adjacents,1312
Cryptocarya_biswasii,NA,NA,NA,NA,NA
Cryptocarya_bitriplinervia,2,2,0,Points-PointsKO-Adjacents,14
Cryptocarya_boemiensis,NA,NA,NA,NA,NA
Cryptocarya_botelhensis,21,13,8,Points-PointsKO-Adjacents,84
Cryptocarya_brachythyrsa,2,2,0,Points-PointsKO-Adjacents,18
Cryptocarya_bracteolata,0,0,0,NA,0
Cryptocarya_brassii,61,44,17,Alphahull-PointsKO-Adjacents,273
Cryptocarya_brevipes,1,1,0,Points-PointsKO-Adjacents,9
Cryptocarya_bullata,1,1,0,Points-PointsKO-Adjacents,9
Cryptocarya_burckeana,6,3,3,Points-PointsKO-Adjacents,15
Cryptocarya_burkillii,NA,NA,NA,NA,NA
Cryptocarya_caesia,2,1,1,Points-PointsKO-Adjacents,18
Cryptocarya_cagayanensis,4,4,0,Points-PointsKO-Adjacents,35
Cryptocarya_calandoi,1,1,0,Points-PointsKO-Adjacents,9
Cryptocarya_calcicola,8,1,7,Points-PointsKO-Adjacents,72
Cryptocarya_calderi,NA,NA,NA,NA,NA
Cryptocarya_calelanensis,1,1,0,Points-PointsKO-Adjacents,6
Cryptocarya_caloneura,8,2,6,Points-PointsKO-Adjacents,49
Cryptocarya_camptodroma,6,0,6,Points-PointsKO-Adjacents,45
Cryptocarya_capuronii,3,3,0,Points-PointsKO-Adjacents,18
Cryptocarya_carrii,1,1,0,Points-PointsKO-Adjacents,9
Cryptocarya_caryoptera,0,0,0,NA,0
Cryptocarya_cavei,NA,NA,NA,NA,NA
Cryptocarya_celebica,2,2,0,Points-PointsKO-Adjacents,17
Cryptocarya_ceramica,NA,NA,NA,NA,NA
Cryptocarya_chanthaburiensis,1,1,0,Points-PointsKO-Adjacents,9
Cryptocarya_chartacea,5,1,4,Points-PointsKO-Adjacents,32
Cryptocarya_chinensis,210,176,34,Alphahull-PointsKO-Adjacents,2538
Cryptocarya_chingii,57,34,23,Alphahull-PointsKO-Adjacents,2697
Cryptocarya_citriformis,27,0,27,Points-PointsKO-Adjacents,187
Cryptocarya_clarksoniana,93,82,11,Alphahull-PointsKO-Adjacents,204
Cryptocarya_claudiana,48,42,6,Alphahull-PointsKO-Adjacents,71
Cryptocarya_cocosoides,54,49,5,Alphahull-PointsKO-Adjacents,59
Cryptocarya_concinna,133,91,42,Alphahull-PointsKO-Adjacents,2801
Cryptocarya_constricta,1,1,0,Points-PointsKO-Adjacents,8
Cryptocarya_cordata,0,0,0,NA,0
Cryptocarya_cordifolia,3,3,0,Points-PointsKO-Adjacents,19
Cryptocarya_corrugata,182,157,25,Alphahull-PointsKO-Adjacents,331
Cryptocarya_costata,3,3,0,Points-PointsKO-Adjacents,27
Cryptocarya_crassifolia,42,30,12,Alphahull-PointsKO-Adjacents,463
Cryptocarya_crassinerviopsis,2,2,0,Points-PointsKO-Adjacents,18
Cryptocarya_cunninghamii,494,451,43,Alphahull-PointsKO-Adjacents,3491
Cryptocarya_cuprea,NA,NA,NA,NA,NA
Cryptocarya_darusensis,NA,NA,NA,NA,NA
Cryptocarya_dealbata,5,5,0,Points-PointsKO-Adjacents,30
Cryptocarya_dekae,NA,NA,NA,NA,NA
Cryptocarya_densiflora,194,136,58,Alphahull-PointsKO-Adjacents,2407
Cryptocarya_depauperata,NA,NA,NA,NA,NA
Cryptocarya_depressa,17,6,11,Points-PointsKO-Adjacents,118
Cryptocarya_dipterocarpifolia,1,1,0,Points-PointsKO-Adjacents,9
Cryptocarya_diversifolia,1,1,0,Points-PointsKO-Adjacents,9
Cryptocarya_dorrigoensis,68,62,6,Alphahull-PointsKO-Adjacents,52
Cryptocarya_durifolia,0,0,0,NA,0
Cryptocarya_edanoii,0,0,0,NA,0
Cryptocarya_elegans,4,4,0,Points-PointsKO-Adjacents,22
Cryptocarya_elliptica,30,18,12,Points-PointsKO-Adjacents,148
Cryptocarya_elliptifolia,3,2,1,Points-PointsKO-Adjacents,22
Cryptocarya_elongata,0,0,0,NA,0
Cryptocarya_endiandrifolia,26,15,11,Points-PointsKO-Adjacents,66
Cryptocarya_enervis,NA,NA,NA,NA,NA
Cryptocarya_engleriana,1,1,0,Points-PointsKO-Adjacents,9
Cryptocarya_erythroxylon,285,261,24,Alphahull-PointsKO-Adjacents,939
Cryptocarya_euphlebia,0,0,0,NA,0
Cryptocarya_everettii,2,2,0,Points-PointsKO-Adjacents,17
Cryptocarya_exfoliata,312,280,32,Alphahull-PointsKO-Adjacents,1048
Cryptocarya_fagifolia,9,3,6,Points-PointsKO-Adjacents,54
Cryptocarya_ferrarsi,0,0,0,NA,0
Cryptocarya_ferrea,26,9,17,Points-PointsKO-Adjacents,199
Cryptocarya_filicifolia,3,3,0,Points-PointsKO-Adjacents,21
Cryptocarya_flavisperma,0,0,0,NA,0
Cryptocarya_floydii,59,47,12,Alphahull-PointsKO-Adjacents,263
Cryptocarya_fluminensis,0,0,0,NA,0
Cryptocarya_foetida,124,99,25,Alphahull-PointsKO-Adjacents,157
Cryptocarya_forbesii,4,4,0,Points-PointsKO-Adjacents,30
Cryptocarya_foveolata,300,0,300,Points-PointsKO-Adjacents,486
Cryptocarya_foxworthyi,0,0,0,NA,0
Cryptocarya_fulva,4,4,0,Points-PointsKO-Adjacents,33
Cryptocarya_fusca,0,0,0,NA,0
Cryptocarya_fuscopilosa,2,2,0,Points-PointsKO-Adjacents,18
Cryptocarya_gigantocarpa,4,4,0,Points-PointsKO-Adjacents,25
Cryptocarya_glabriflora,1,1,0,Points-PointsKO-Adjacents,9
Cryptocarya_glauca,11,0,11,Points-PointsKO-Adjacents,89
Cryptocarya_glaucescens,1751,1618,133,Alphahull-PointsKO-Adjacents,1847
Cryptocarya_glauciphylla,3,3,0,Points-PointsKO-Adjacents,17
Cryptocarya_glaucocarpa,11,5,6,Points-PointsKO-Adjacents,15
Cryptocarya_globosa,3,3,0,Points-PointsKO-Adjacents,25
Cryptocarya_gonioclada,0,0,0,NA,0
Cryptocarya_gracilis,13,2,11,Points-PointsKO-Adjacents,71
Cryptocarya_graehneriana,NA,NA,NA,NA,NA
Cryptocarya_grandis,175,151,24,Alphahull-PointsKO-Adjacents,544
Cryptocarya_griffithiana,14,0,14,Points-PointsKO-Adjacents,118
Cryptocarya_guianensis,42,14,28,Points-PointsKO-Adjacents,355
Cryptocarya_guillauminii,35,26,9,Alphahull-PointsKO-Adjacents,86
Cryptocarya_hainanensis,10,3,7,Points-PointsKO-Adjacents,90
Cryptocarya_hartleyi,3,3,0,Points-PointsKO-Adjacents,21
Cryptocarya_helicina,2,2,0,Points-PointsKO-Adjacents,18
Cryptocarya_hornei,5,5,0,Points-PointsKO-Adjacents,35
Cryptocarya_howii,8,1,7,Points-PointsKO-Adjacents,63
Cryptocarya_hypospodia,351,0,351,Points-PointsKO-Adjacents,1354
Cryptocarya_idenburgensis,8,4,4,Points-PointsKO-Adjacents,72
Cryptocarya_ilocana,0,0,0,NA,0
Cryptocarya_impressa,4,0,4,Points-PointsKO-Adjacents,36
Cryptocarya_impressinervia,7,0,7,Points-PointsKO-Adjacents,63
Cryptocarya_impressivena,0,0,0,NA,0
Cryptocarya_insularis,NA,NA,NA,NA,NA
Cryptocarya_intermedia,1,1,0,Points-PointsKO-Adjacents,9
Cryptocarya_invasiorum,2,2,0,Points-PointsKO-Adjacents,18
Cryptocarya_iridescens,5,4,1,Points-PointsKO-Adjacents,40
Cryptocarya_jacarepaguensis,NA,NA,NA,NA,NA
Cryptocarya_kajewskii,2,2,0,Points-PointsKO-Adjacents,18
Cryptocarya_kamahar,14,6,8,Points-PointsKO-Adjacents,118
Cryptocarya_konishii,53,32,21,Alphahull-PointsKO-Adjacents,244
Cryptocarya_krameri,8,5,3,Points-PointsKO-Adjacents,33
Cryptocarya_kurzii,7,3,4,Points-PointsKO-Adjacents,54
Cryptocarya_kwangtungensis,1,1,0,Points-PointsKO-Adjacents,9
Cryptocarya_laevigata,319,259,60,Alphahull-PointsKO-Adjacents,737
Cryptocarya_lanceolata,0,0,0,NA,0
Cryptocarya_lancifolia,0,0,0,NA,0
Cryptocarya_lancilimba,0,0,0,NA,0
Cryptocarya_lanuginosa,1,1,0,Points-PointsKO-Adjacents,9
Cryptocarya_laotica,5,5,0,Points-PointsKO-Adjacents,36
Cryptocarya_latifolia,18,0,18,Points-PointsKO-Adjacents,142
Cryptocarya_laui,38,22,16,Alphahull-PointsKO-Adjacents,939
Cryptocarya_lauriflora,1,1,0,Points-PointsKO-Adjacents,9
Cryptocarya_lawsonii,0,0,0,NA,0
Cryptocarya_ledermannii,8,0,8,Points-PointsKO-Adjacents,48
Cryptocarya_leiana,1,1,0,Points-PointsKO-Adjacents,9
Cryptocarya_leptospermoides,6,2,4,Points-PointsKO-Adjacents,17
Cryptocarya_leucophylla,76,63,13,Alphahull-PointsKO-Adjacents,205
Cryptocarya_liebertiana,86,52,34,Alphahull-PointsKO-Adjacents,1420
Cryptocarya_lifuensis,7,5,2,Points-PointsKO-Adjacents,22
Cryptocarya_litoralis,37,19,18,Points-PointsKO-Adjacents,152
Cryptocarya_lividula,120,102,18,Alphahull-PointsKO-Adjacents,189
Cryptocarya_loheri,0,0,0,NA,0
Cryptocarya_longifolia,16,3,13,Points-PointsKO-Adjacents,90
Cryptocarya_loureirii,NA,NA,NA,NA,NA
Cryptocarya_louvelii,0,0,0,NA,0
Cryptocarya_lucida,0,0,0,NA,0
Cryptocarya_lyoniifolia,5,5,0,Points-PointsKO-Adjacents,43
Cryptocarya_macdonaldii,126,99,27,Alphahull-PointsKO-Adjacents,511
Cryptocarya_mackeei,9,4,5,Points-PointsKO-Adjacents,36
Cryptocarya_mackinnoniana,160,137,23,Alphahull-PointsKO-Adjacents,312
Cryptocarya_maclurei,7,2,5,Points-PointsKO-Adjacents,54
Cryptocarya_macrocarpa,9,5,4,Points-PointsKO-Adjacents,47
Cryptocarya_macrodesme,21,12,9,Points-PointsKO-Adjacents,83
Cryptocarya_macrophylla,0,0,0,NA,0
Cryptocarya_maculata,NA,NA,NA,NA,NA
Cryptocarya_magnifolia,0,0,0,NA,0
Cryptocarya_mandioccana,342,299,43,Alphahull-PointsKO-Adjacents,3939
Cryptocarya_mannii,9,5,4,Points-PointsKO-Adjacents,24
Cryptocarya_massoy,17,8,9,Points-PointsKO-Adjacents,113
Cryptocarya_medicinalis,0,0,0,NA,0
Cryptocarya_megaphylla,1,1,0,Points-PointsKO-Adjacents,9
Cryptocarya_meisneriana,504,484,20,Alphahull-PointsKO-Adjacents,612
Cryptocarya_melanocarpa,96,87,9,Alphahull-PointsKO-Adjacents,113
Cryptocarya_membranacea,0,0,0,NA,0
Cryptocarya_merrilliana,39,22,17,Alphahull-PointsKO-Adjacents,939
Cryptocarya_metcalfiana,6,3,3,Points-PointsKO-Adjacents,45
Cryptocarya_micrantha,95,71,24,Alphahull-PointsKO-Adjacents,1524
Cryptocarya_microcos,2,2,0,Points-PointsKO-Adjacents,18
Cryptocarya_microneura,1735,1593,142,Alphahull-PointsKO-Adjacents,1971
Cryptocarya_mindanaensis,0,0,0,NA,0
Cryptocarya_minutifolia,8,2,6,Points-PointsKO-Adjacents,59
Cryptocarya_moschata,422,352,70,Alphahull-PointsKO-Adjacents,11735
Cryptocarya_multinervis,13,3,10,Points-PointsKO-Adjacents,92
Cryptocarya_multipaniculata,14,8,6,Points-PointsKO-Adjacents,81
Cryptocarya_murrayi,170,149,21,Alphahull-PointsKO-Adjacents,503
Cryptocarya_myrcioides,4,4,0,Points-PointsKO-Adjacents,15
Cryptocarya_myristicoides,8,6,2,Points-PointsKO-Adjacents,44
Cryptocarya_myrtifolia,16,0,16,Points-PointsKO-Adjacents,134
Cryptocarya_nana,0,0,0,NA,0
Cryptocarya_natalensis,8,3,5,Points-PointsKO-Adjacents,52
Cryptocarya_nigra,1,1,0,Points-PointsKO-Adjacents,9
Cryptocarya_nitens,6,0,6,Points-PointsKO-Adjacents,39
Cryptocarya_nothofagetorum,4,4,0,Points-PointsKO-Adjacents,27
Cryptocarya_nova-anglica,91,85,6,Alphahull-PointsKO-Adjacents,99
Cryptocarya_oblata,122,103,19,Alphahull-PointsKO-Adjacents,239
Cryptocarya_obliqua,1,1,0,Points-PointsKO-Adjacents,9
Cryptocarya_oblonga,5,5,0,Points-PointsKO-Adjacents,26
Cryptocarya_oblongata,0,0,0,NA,0
Cryptocarya_obovata,682,654,28,Alphahull-PointsKO-Adjacents,1307
Cryptocarya_obtusifolia,0,0,0,NA,0
Cryptocarya_occidentalis,22,12,10,Points-PointsKO-Adjacents,182
Cryptocarya_ocoteifolia,1,1,0,Points-PointsKO-Adjacents,9
Cryptocarya_odorata,30,15,15,Points-PointsKO-Adjacents,136
Cryptocarya_oligocarpa,0,0,0,NA,0
Cryptocarya_oligophlebia,0,0,0,NA,0
Cryptocarya_onoprienkoana,97,70,27,Alphahull-PointsKO-Adjacents,420
Cryptocarya_oubatchensis,32,22,10,Alphahull-PointsKO-Adjacents,76
Cryptocarya_ovalifolia,16,12,4,Points-PointsKO-Adjacents,82
Cryptocarya_ovata,NA,NA,NA,NA,NA
Cryptocarya_ovatocaudata,0,0,0,NA,0
Cryptocarya_pachyphylla,0,0,0,NA,0
Cryptocarya_palawanensis,1,1,0,Points-PointsKO-Adjacents,8
Cryptocarya_pallens,0,0,0,NA,0
Cryptocarya_pallida,0,0,0,NA,0
Cryptocarya_pallidifolia,1,1,0,Points-PointsKO-Adjacents,9
Cryptocarya_palmerensis,1,1,0,Points-PointsKO-Adjacents,9
Cryptocarya_panamensis,2,2,0,Points-PointsKO-Adjacents,14
Cryptocarya_parallelinervia,3,3,0,Points-PointsKO-Adjacents,9
Cryptocarya_parinarifolia,NA,NA,NA,NA,NA
Cryptocarya_parinarioides,0,0,0,NA,0
Cryptocarya_parvifolia,0,0,0,NA,0
Cryptocarya_pergamentacea,1,1,0,Points-PointsKO-Adjacents,9
Cryptocarya_pergracilis,3,3,0,Points-PointsKO-Adjacents,27
Cryptocarya_perlucida,1,1,0,Points-PointsKO-Adjacents,9
Cryptocarya_pervillei,40,31,9,Alphahull-PointsKO-Adjacents,118
Cryptocarya_phyllostemon,14,0,14,Points-PointsKO-Adjacents,50
Cryptocarya_pleurosperma,87,72,15,Alphahull-PointsKO-Adjacents,110
Cryptocarya_pluricostata,8,1,7,Points-PointsKO-Adjacents,55
Cryptocarya_polyneura,27,21,6,Alphahull-PointsKO-Adjacents,48
Cryptocarya_praetervisa,NA,NA,NA,NA,NA
Cryptocarya_procera,NA,NA,NA,NA,NA
Cryptocarya_pulchella,8,0,8,Points-PointsKO-Adjacents,70
Cryptocarya_pulchrinervia,1,1,0,Points-PointsKO-Adjacents,9
Cryptocarya_pullenii,1,1,0,Points-PointsKO-Adjacents,9
Cryptocarya_pusilla,0,0,0,NA,0
Cryptocarya_pustulata,1,1,0,Points-PointsKO-Adjacents,9
Cryptocarya_putida,69,56,13,Alphahull-PointsKO-Adjacents,160
Cryptocarya_ramosii,0,0,0,NA,0
Cryptocarya_rarinervia,2,2,0,Points-PointsKO-Adjacents,12
Cryptocarya_renicarpa,0,0,0,NA,0
Cryptocarya_resinosa,1,1,0,Points-PointsKO-Adjacents,9
Cryptocarya_reticulata,0,0,0,NA,0
Cryptocarya_retusa,18,7,11,Points-PointsKO-Adjacents,80
Cryptocarya_revoluta,8,0,8,Points-PointsKO-Adjacents,54
Cryptocarya_rhizophoretum,2,2,0,Points-PointsKO-Adjacents,12
Cryptocarya_rhodosperma,55,38,17,Alphahull-PointsKO-Adjacents,133
Cryptocarya_riedeliana,42,0,42,Points-PointsKO-Adjacents,254
Cryptocarya_rifaii,0,0,0,NA,0
Cryptocarya_rigida,1319,1260,59,Alphahull-PointsKO-Adjacents,1306
Cryptocarya_rigidifolia,19,15,4,Points-PointsKO-Adjacents,92
Cryptocarya_robynsiana,NA,NA,NA,NA,NA
Cryptocarya_roemeri,0,0,0,NA,0
Cryptocarya_rotundifolia,3,3,0,Points-PointsKO-Adjacents,15
Cryptocarya_rubiginosa,NA,NA,NA,NA,NA
Cryptocarya_rubra,0,0,0,NA,0
Cryptocarya_rugulosa,5,0,5,Points-PointsKO-Adjacents,45
Cryptocarya_ruruvaiensis,0,0,0,NA,0
Cryptocarya_saccharata,79,67,12,Alphahull-PointsKO-Adjacents,161
Cryptocarya_saligna,214,181,33,Alphahull-PointsKO-Adjacents,2624
Cryptocarya_samarensis,0,0,0,NA,0
Cryptocarya_samoensis,0,0,0,NA,0
Cryptocarya_schlechteri,0,0,0,NA,0
Cryptocarya_schmidii,3,3,0,Points-PointsKO-Adjacents,18
Cryptocarya_schoddei,1,1,0,Points-PointsKO-Adjacents,7
Cryptocarya_sclerophylla,86,70,16,Alphahull-PointsKO-Adjacents,245
Cryptocarya_sellowiana,2,2,0,Points-PointsKO-Adjacents,18
Cryptocarya_septentrionalis,11,3,8,Points-PointsKO-Adjacents,63
Cryptocarya_sericeotriplinervia,0,0,0,NA,0
Cryptocarya_simonsii,NA,NA,NA,NA,NA
Cryptocarya_sleumeri,0,0,0,NA,0
Cryptocarya_smaragdina,37,31,6,Alphahull-PointsKO-Adjacents,67
Cryptocarya_spathulata,15,4,11,Points-PointsKO-Adjacents,78
Cryptocarya_splendens,3,3,0,Points-PointsKO-Adjacents,9
Cryptocarya_stocksii,1,1,0,Points-PointsKO-Adjacents,9
Cryptocarya_strictifolia,0,0,0,NA,0
Cryptocarya_subbullata,3,3,0,Points-PointsKO-Adjacents,18
Cryptocarya_subfalcata,1,1,0,Points-PointsKO-Adjacents,9
Cryptocarya_sublanuginosa,1,1,0,Points-PointsKO-Adjacents,9
Cryptocarya_subtrinervis,0,0,0,NA,0
Cryptocarya_subtriplinervia,25,12,13,Points-PointsKO-Adjacents,90
Cryptocarya_subvelutina,1,1,0,Points-PointsKO-Adjacents,9
Cryptocarya_sulavesiana,0,0,0,NA,0
Cryptocarya_sulcata,2,2,0,Points-PointsKO-Adjacents,18
Cryptocarya_sumatrana,0,0,0,NA,0
Cryptocarya_sumbawaensis,0,0,0,NA,0
Cryptocarya_tannaensis,4,4,0,Points-PointsKO-Adjacents,27
Cryptocarya_tawaensis,1,0,1,Points-PointsKO-Adjacents,9
Cryptocarya_tebaensis,NA,NA,NA,NA,NA
Cryptocarya_tesselata,0,0,0,NA,0
Cryptocarya_tetragona,1,1,0,Points-PointsKO-Adjacents,9
Cryptocarya_teysmanniana,4,4,0,Points-PointsKO-Adjacents,35
Cryptocarya_thouvenotii,15,7,8,Points-PointsKO-Adjacents,89
Cryptocarya_todayensis,2,2,0,Points-PointsKO-Adjacents,18
Cryptocarya_transvaalensis,31,16,15,Points-PointsKO-Adjacents,276
Cryptocarya_transversa,18,9,9,Points-PointsKO-Adjacents,91
Cryptocarya_triplinervis,761,681,80,Alphahull-PointsKO-Adjacents,2702
Cryptocarya_tsangii,3,3,0,Points-PointsKO-Adjacents,27
Cryptocarya_tuanku-bujangii,1,1,0,Points-PointsKO-Adjacents,9
Cryptocarya_turbinata,16,0,16,Points-PointsKO-Adjacents,103
Cryptocarya_turrilliana,1,1,0,Points-PointsKO-Adjacents,9
Cryptocarya_umbonata,4,4,0,Points-PointsKO-Adjacents,29
Cryptocarya_vacciniifolia,1,1,0,Points-PointsKO-Adjacents,9
Cryptocarya_vellozoana,NA,NA,NA,NA,NA
Cryptocarya_velutina,1,1,0,Points-PointsKO-Adjacents,7
Cryptocarya_velutinosa,16,9,7,Points-PointsKO-Adjacents,57
Cryptocarya_verrucosa,2,2,0,Points-PointsKO-Adjacents,9
Cryptocarya_vidalii,1,1,0,Points-PointsKO-Adjacents,8
Cryptocarya_villarii,0,0,0,NA,0
Cryptocarya_viridiflora,3,3,0,Points-PointsKO-Adjacents,27
Cryptocarya_vulgaris,192,160,32,Alphahull-PointsKO-Adjacents,713
Cryptocarya_weinlandii,12,0,12,Points-PointsKO-Adjacents,107
Cryptocarya_whiffiniana,14,7,7,Points-PointsKO-Adjacents,37
Cryptocarya_whiteana,1,1,0,Points-PointsKO-Adjacents,9
Cryptocarya_wiedensis,4,4,0,Points-PointsKO-Adjacents,14
Cryptocarya_wightiana,0,0,0,NA,0
Cryptocarya_wilderiana,0,0,0,NA,0
Cryptocarya_williwilliana,40,34,6,Alphahull-PointsKO-Adjacents,48
Cryptocarya_wilsonii,0,0,0,NA,0
Cryptocarya_womersleyi,1,1,0,Points-PointsKO-Adjacents,9
Cryptocarya_woodii,65,30,35,Alphahull-PointsKO-Adjacents,1236
Cryptocarya_wrayi,NA,NA,NA,NA,NA
Cryptocarya_wyliei,19,9,10,Points-PointsKO-Adjacents,99
Cryptocarya_xylophylla,8,0,8,Points-PointsKO-Adjacents,50
Cryptocarya_yaanica,NA,NA,NA,NA,NA
Cryptocarya_yasuniensis,9,5,4,Points-PointsKO-Adjacents,69
Cryptocarya_yunnanensis,2,2,0,Points-PointsKO-Adjacents,18
Cryptocarya_zamboangensis,NA,NA,NA,NA,NA
Cryptocarya_zollingeriana,1,1,0,Points-PointsKO-Adjacents,9
Cryptolepis_arbuscula,4,4,0,Points-PointsKO-Adjacents,26
Cryptolepis_macrophylla,6,0,6,Points-PointsKO-Adjacents,34
Cryptomeria_japonica,472,256,216,Alphahull-PointsKO-Adjacents,8183
Cryptosepalum_congolanum,21,9,12,Points-PointsKO-Adjacents,149
Cryptosepalum_diphyllum,NA,NA,NA,NA,NA
Cryptosepalum_exfoliatum,9,0,9,Points-PointsKO-Adjacents,72
Cryptosepalum_minutifolium,9,4,5,Points-PointsKO-Adjacents,65
Cryptosepalum_pellegrinianum,17,0,17,Points-PointsKO-Adjacents,112
Cryptosepalum_staudtii,19,14,5,Points-PointsKO-Adjacents,100
Cryptosepalum_tetraphyllum,62,49,13,Alphahull-PointsKO-Adjacents,1618
Csapodya_splendens,3,3,0,Points-PointsKO-Adjacents,15
Ctenardisia_amplifolia,31,23,8,Alphahull-PointsKO-Adjacents,206
Ctenardisia_ovandensis,19,10,9,Points-PointsKO-Adjacents,90
Ctenardisia_purpusii,20,1,19,Points-PointsKO-Adjacents,99
Ctenardisia_speciosa,3,3,0,Points-PointsKO-Adjacents,27
Ctenardisia_stenobotrys,9,0,9,Points-PointsKO-Adjacents,65
Ctenolophon_englerianus,14,0,14,Points-PointsKO-Adjacents,84
Ctenolophon_parvifolius,22,10,12,Points-PointsKO-Adjacents,152
Cuatresia_riparia,249,193,56,Alphahull-PointsKO-Adjacents,5737
Cuatresia_trianae,6,2,4,Points-PointsKO-Adjacents,52
Cubanola_domingensis,13,8,5,Points-PointsKO-Adjacents,60
Cubilia_cubili,6,2,4,Points-PointsKO-Adjacents,53
Cuervea_integrifolia,4,4,0,Points-PointsKO-Adjacents,33
Cuminia_eriantha,2,2,0,Points-PointsKO-Adjacents,12
Cunninghamia_konishii,48,0,48,Points-PointsKO-Adjacents,243
Cunninghamia_lanceolata,382,333,49,Alphahull-PointsKO-Adjacents,23027
Cunonia_alticola,8,4,4,Points-PointsKO-Adjacents,52
Cunonia_aoupiniensis,8,2,6,Points-PointsKO-Adjacents,22
Cunonia_atrorubens,14,8,6,Points-PointsKO-Adjacents,59
Cunonia_austrocaledonica,14,5,9,Points-PointsKO-Adjacents,72
Cunonia_balansae,25,14,11,Points-PointsKO-Adjacents,100
Cunonia_bernieri,5,5,0,Points-PointsKO-Adjacents,27
Cunonia_bullata,8,5,3,Points-PointsKO-Adjacents,37
Cunonia_capensis,90,58,32,Alphahull-PointsKO-Adjacents,589
Cunonia_cerifera,8,4,4,Points-PointsKO-Adjacents,28
Cunonia_koghicola,2,2,0,Points-PointsKO-Adjacents,9
Cunonia_linearisepala,6,1,5,Points-PointsKO-Adjacents,43
Cunonia_montana,17,7,10,Points-PointsKO-Adjacents,73
Cunonia_pterophylla,15,9,6,Points-PointsKO-Adjacents,64
Cunonia_pulchella,18,10,8,Points-PointsKO-Adjacents,76
Cunonia_rotundifolia,3,3,0,Points-PointsKO-Adjacents,25
Cunonia_varijuga,7,4,3,Points-PointsKO-Adjacents,46
Cunonia_vieillardii,29,21,8,Alphahull-PointsKO-Adjacents,81
Cupania_americana,544,434,110,Alphahull-PointsKO-Adjacents,14629
Cupania_belizensis,49,38,11,Alphahull-PointsKO-Adjacents,167
Cupania_bracteosa,108,0,108,Points-PointsKO-Adjacents,587
Cupania_cinerea,638,528,110,Alphahull-PointsKO-Adjacents,32191
Cupania_concolor,38,23,15,Alphahull-PointsKO-Adjacents,501
Cupania_crassifolia,21,8,13,Points-PointsKO-Adjacents,144
Cupania_dentata,171,121,50,Alphahull-PointsKO-Adjacents,5544
Cupania_diphylla,151,108,43,Alphahull-PointsKO-Adjacents,8545
Cupania_dukei,4,4,0,Points-PointsKO-Adjacents,35
Cupania_emarginata,329,266,63,Alphahull-PointsKO-Adjacents,4836
Cupania_fluminensis,7,0,7,Points-PointsKO-Adjacents,48
Cupania_furfuracea,79,55,24,Alphahull-PointsKO-Adjacents,917
Cupania_glabra,427,346,81,Alphahull-PointsKO-Adjacents,10287
Cupania_grandiflora,14,11,3,Points-PointsKO-Adjacents,39
Cupania_guatemalensis,232,185,47,Alphahull-PointsKO-Adjacents,3021
Cupania_hirsuta,67,45,22,Alphahull-PointsKO-Adjacents,1680
Cupania_hispida,76,36,40,Alphahull-PointsKO-Adjacents,1387
Cupania_impressinervia,349,285,64,Alphahull-PointsKO-Adjacents,6176
Cupania_inaequilatera,NA,NA,NA,NA,NA
Cupania_juglandifolia,96,58,38,Alphahull-PointsKO-Adjacents,2094
Cupania_kukenanica,6,1,5,Points-PointsKO-Adjacents,45
Cupania_lanuginosa,1,1,0,Points-PointsKO-Adjacents,9
Cupania_largifolia,16,7,9,Points-PointsKO-Adjacents,95
Cupania_latifolia,20,1,19,Points-PointsKO-Adjacents,167
Cupania_livida,46,33,13,Alphahull-PointsKO-Adjacents,480
Cupania_ludowigii,187,129,58,Alphahull-PointsKO-Adjacents,2782
Cupania_mollis,10,6,4,Points-PointsKO-Adjacents,69
Cupania_moraesiana,NA,NA,NA,NA,NA
Cupania_oblongifolia,703,567,136,Alphahull-PointsKO-Adjacents,9379
Cupania_olivacea,11,1,10,Points-PointsKO-Adjacents,89
Cupania_paniculata,196,175,21,Alphahull-PointsKO-Adjacents,4056
Cupania_platycarpa,128,93,35,Alphahull-PointsKO-Adjacents,7106
Cupania_polyodonta,13,2,11,Points-PointsKO-Adjacents,102
Cupania_racemosa,467,378,89,Alphahull-PointsKO-Adjacents,4315
Cupania_radlkoferi,9,0,9,Points-PointsKO-Adjacents,69
Cupania_rigida,144,124,20,Alphahull-PointsKO-Adjacents,2088
Cupania_riopalenquensis,2,2,0,Points-PointsKO-Adjacents,18
Cupania_rubiginosa,198,122,76,Alphahull-PointsKO-Adjacents,12910
Cupania_rufescens,260,192,68,Alphahull-PointsKO-Adjacents,4659
Cupania_rugosa,112,82,30,Alphahull-PointsKO-Adjacents,2154
Cupania_schizoneura,8,0,8,Points-PointsKO-Adjacents,62
Cupania_scrobiculata,670,548,122,Alphahull-PointsKO-Adjacents,78136
Cupania_seemannii,55,34,21,Alphahull-PointsKO-Adjacents,423
Cupania_semiglabra,3,3,0,Points-PointsKO-Adjacents,27
Cupania_spectabilis,38,18,20,Points-PointsKO-Adjacents,272
Cupania_tenuivalvis,113,0,113,Points-PointsKO-Adjacents,802
Cupania_triquetra,30,9,21,Points-PointsKO-Adjacents,184
Cupania_vernalis,1856,1711,145,Alphahull-PointsKO-Adjacents,52360
Cupania_zanthoxyloides,112,0,112,Points-PointsKO-Adjacents,655
Cupaniopsis_acuticarpa,2,2,0,Points-PointsKO-Adjacents,18
Cupaniopsis_amoena,1,1,0,Points-PointsKO-Adjacents,9
Cupaniopsis_anacardioides,1585,1378,207,Alphahull-PointsKO-Adjacents,11548
Cupaniopsis_apiocarpa,23,10,13,Points-PointsKO-Adjacents,101
Cupaniopsis_azantha,7,1,6,Points-PointsKO-Adjacents,47
Cupaniopsis_baileyana,158,125,33,Alphahull-PointsKO-Adjacents,676
Cupaniopsis_bilocularis,6,0,6,Points-PointsKO-Adjacents,30
Cupaniopsis_bullata,2,2,0,Points-PointsKO-Adjacents,12
Cupaniopsis_celebica,1,1,0,Points-PointsKO-Adjacents,9
Cupaniopsis_chytradenia,6,0,6,Points-PointsKO-Adjacents,50
Cupaniopsis_concolor,2,2,0,Points-PointsKO-Adjacents,9
Cupaniopsis_cooperorum,16,12,4,Points-PointsKO-Adjacents,31
Cupaniopsis_crassivalvis,0,0,0,NA,0
Cupaniopsis_curvidens,32,12,20,Points-PointsKO-Adjacents,183
Cupaniopsis_dallachyi,31,19,12,Points-PointsKO-Adjacents,97
Cupaniopsis_diploglottoides,16,11,5,Points-PointsKO-Adjacents,46
Cupaniopsis_euneura,2,2,0,Points-PointsKO-Adjacents,12
Cupaniopsis_flagelliformis,261,231,30,Alphahull-PointsKO-Adjacents,512
Cupaniopsis_foveolata,177,141,36,Alphahull-PointsKO-Adjacents,733
Cupaniopsis_fruticosa,24,11,13,Points-PointsKO-Adjacents,106
Cupaniopsis_glabra,4,4,0,Points-PointsKO-Adjacents,12
Cupaniopsis_globosa,7,2,5,Points-PointsKO-Adjacents,34
Cupaniopsis_glomeriflora,53,41,12,Alphahull-PointsKO-Adjacents,290
Cupaniopsis_grandiflora,11,4,7,Points-PointsKO-Adjacents,34
Cupaniopsis_grisea,2,2,0,Points-PointsKO-Adjacents,9
Cupaniopsis_guillauminii,0,0,0,NA,0
Cupaniopsis_hypodermatica,6,2,4,Points-PointsKO-Adjacents,35
Cupaniopsis_inoplea,32,25,7,Alphahull-PointsKO-Adjacents,75
Cupaniopsis_kajewskii,0,0,0,NA,0
Cupaniopsis_leptobotrys,7,1,6,Points-PointsKO-Adjacents,32
Cupaniopsis_mackeeana,9,4,5,Points-PointsKO-Adjacents,50
Cupaniopsis_macrocarpa,34,24,10,Alphahull-PointsKO-Adjacents,100
Cupaniopsis_macropetala,13,5,8,Points-PointsKO-Adjacents,98
Cupaniopsis_megalocarpa,4,4,0,Points-PointsKO-Adjacents,28
Cupaniopsis_mouana,1,1,0,Points-PointsKO-Adjacents,9
Cupaniopsis_myrmoctona,38,24,14,Alphahull-PointsKO-Adjacents,102
Cupaniopsis_napaensis,0,0,0,NA,0
Cupaniopsis_newmanii,249,234,15,Alphahull-PointsKO-Adjacents,199
Cupaniopsis_oedipoda,65,52,13,Alphahull-PointsKO-Adjacents,198
Cupaniopsis_papillosa,8,5,3,Points-PointsKO-Adjacents,15
Cupaniopsis_pennelii,5,5,0,Points-PointsKO-Adjacents,35
Cupaniopsis_petiolulata,48,36,12,Alphahull-PointsKO-Adjacents,115
Cupaniopsis_phalacrocarpa,9,0,9,Points-PointsKO-Adjacents,35
Cupaniopsis_phanerophlebia,1,1,0,Points-PointsKO-Adjacents,9
Cupaniopsis_platycarpa,7,4,3,Points-PointsKO-Adjacents,41
Cupaniopsis_rhytidocarpa,6,1,5,Points-PointsKO-Adjacents,42
Cupaniopsis_rosea,1,1,0,Points-PointsKO-Adjacents,9
Cupaniopsis_rotundifolia,0,0,0,NA,0
Cupaniopsis_samoensis,1,1,0,Points-PointsKO-Adjacents,6
Cupaniopsis_serrata,85,0,85,Points-PointsKO-Adjacents,219
Cupaniopsis_shirleyana,26,14,12,Points-PointsKO-Adjacents,123
Cupaniopsis_simulatus,23,8,15,Points-PointsKO-Adjacents,136
Cupaniopsis_squamosa,8,1,7,Points-PointsKO-Adjacents,33
Cupaniopsis_stenopetala,3,3,0,Points-PointsKO-Adjacents,26
Cupaniopsis_strigosa,0,0,0,NA,0
Cupaniopsis_subfalcata,1,1,0,Points-PointsKO-Adjacents,9
Cupaniopsis_sylvatica,34,23,11,Alphahull-PointsKO-Adjacents,131
Cupaniopsis_tomentella,25,22,3,Alphahull-PointsKO-Adjacents,29
Cupaniopsis_tontoutensis,6,2,4,Points-PointsKO-Adjacents,17
Cupaniopsis_trigonocarpa,8,2,6,Points-PointsKO-Adjacents,44
Cupaniopsis_vitiensis,1,1,0,Points-PointsKO-Adjacents,9
Cupaniopsis_wadsworthii,90,67,23,Alphahull-PointsKO-Adjacents,507
Cuphea_melvilla,378,250,128,Alphahull-PointsKO-Adjacents,37150
Cupressus_arizonica,552,487,65,Alphahull-PointsKO-Adjacents,16674
Cupressus_bakeri,109,1,108,Points-PointsKO-Adjacents,335
Cupressus_cashmeriana,19,11,8,Points-PointsKO-Adjacents,76
Cupressus_chengiana,16,8,8,Points-PointsKO-Adjacents,104
Cupressus_duclouxiana,51,1,50,Points-PointsKO-Adjacents,348
Cupressus_dupreziana,20,12,8,Points-PointsKO-Adjacents,78
Cupressus_funebris,166,135,31,Alphahull-PointsKO-Adjacents,14506
Cupressus_gigantea,11,0,11,Points-PointsKO-Adjacents,63
Cupressus_goveniana,178,138,40,Alphahull-PointsKO-Adjacents,712
Cupressus_guadalupensis,142,125,17,Alphahull-PointsKO-Adjacents,586
Cupressus_lusitanica,862,744,118,Alphahull-PointsKO-Adjacents,11426
Cupressus_macnabiana,241,1,240,Points-PointsKO-Adjacents,551
Cupressus_macrocarpa,311,213,98,Alphahull-PointsKO-Adjacents,1401
Cupressus_nootkatensis,146,124,22,Alphahull-PointsKO-Adjacents,2831
Cupressus_sargentii,286,259,27,Alphahull-PointsKO-Adjacents,930
Cupressus_sempervirens,113,70,43,Alphahull-PointsKO-Adjacents,2501
Cupressus_tonkinensis,5,5,0,Points-PointsKO-Adjacents,15
Cupressus_torulosa,28,9,19,Points-PointsKO-Adjacents,183
Cupressus_vietnamensis,6,3,3,Points-PointsKO-Adjacents,12
Curarea_candicans,26,1,25,Points-PointsKO-Adjacents,208
Curarea_tecunarum,82,0,82,Points-PointsKO-Adjacents,554
Curatella_americana,2109,1820,289,Alphahull-PointsKO-Adjacents,83219
Curitiba_prismatica,36,27,9,Alphahull-PointsKO-Adjacents,318
Curtisia_dentata,101,62,39,Alphahull-PointsKO-Adjacents,2220
Curupira_tefeensis,21,7,14,Points-PointsKO-Adjacents,179
Cuspidaria_lateriflora,147,89,58,Alphahull-PointsKO-Adjacents,8388
Cussonia_angolensis,8,1,7,Points-PointsKO-Adjacents,66
Cussonia_arborea,326,239,87,Alphahull-PointsKO-Adjacents,7398
Cussonia_bancoensis,16,12,4,Points-PointsKO-Adjacents,122
Cussonia_brieyi,3,3,0,Points-PointsKO-Adjacents,27
Cussonia_gamtoosensis,7,2,5,Points-PointsKO-Adjacents,51
Cussonia_holstii,142,99,43,Alphahull-PointsKO-Adjacents,5412
Cussonia_jatrophoides,0,0,0,NA,0
Cussonia_natalensis,62,49,13,Alphahull-PointsKO-Adjacents,1435
Cussonia_nicholsonii,18,1,17,Points-PointsKO-Adjacents,141
Cussonia_ostinii,7,2,5,Points-PointsKO-Adjacents,51
Cussonia_paniculata,159,127,32,Alphahull-PointsKO-Adjacents,5371
Cussonia_sessilis,8,4,4,Points-PointsKO-Adjacents,72
Cussonia_sphaerocephala,21,9,12,Points-PointsKO-Adjacents,176
Cussonia_spicata,243,182,61,Alphahull-PointsKO-Adjacents,6292
Cussonia_thyrsiflora,46,27,19,Alphahull-PointsKO-Adjacents,247
Cussonia_transvaalensis,31,21,10,Alphahull-PointsKO-Adjacents,618
Cussonia_zimmermannii,49,31,18,Alphahull-PointsKO-Adjacents,549
Cussonia_zuluensis,36,22,14,Alphahull-PointsKO-Adjacents,463
Cuviera_acutiflora,67,32,35,Alphahull-PointsKO-Adjacents,891
Cuviera_angolensis,30,7,23,Points-PointsKO-Adjacents,225
Cuviera_calycosa,7,2,5,Points-PointsKO-Adjacents,63
Cuviera_le-testui,9,3,6,Points-PointsKO-Adjacents,75
Cuviera_longiflora,62,52,10,Alphahull-PointsKO-Adjacents,2569
Cuviera_macroura,75,54,21,Alphahull-PointsKO-Adjacents,243
Cuviera_migeodii,1,1,0,Points-PointsKO-Adjacents,9
Cuviera_nigrescens,30,11,19,Points-PointsKO-Adjacents,210
Cuviera_physinodes,28,14,14,Points-PointsKO-Adjacents,147
Cuviera_pierrei,17,9,8,Points-PointsKO-Adjacents,101
Cuviera_schliebenii,5,5,0,Points-PointsKO-Adjacents,24
Cuviera_semseii,15,5,10,Points-PointsKO-Adjacents,113
Cuviera_subuliflora,53,36,17,Alphahull-PointsKO-Adjacents,1159
Cuviera_talbotii,15,8,7,Points-PointsKO-Adjacents,78
Cuviera_tomentosa,8,1,7,Points-PointsKO-Adjacents,50
Cuviera_trilocularis,12,9,3,Points-PointsKO-Adjacents,43
Cuviera_truncata,5,2,3,Points-PointsKO-Adjacents,30
Cyanea_aculeatiflora,1,1,0,Points-PointsKO-Adjacents,8
Cyanea_angustifolia,8,3,5,Points-PointsKO-Adjacents,39
Cyanea_arborea,2,2,0,Points-PointsKO-Adjacents,15
Cyanea_coriacea,2,2,0,Points-PointsKO-Adjacents,18
Cyanea_cylindrocalyx,2,2,0,Points-PointsKO-Adjacents,17
Cyanea_duvalliorum,7,4,3,Points-PointsKO-Adjacents,21
Cyanea_fissa,6,1,5,Points-PointsKO-Adjacents,35
Cyanea_floribunda,19,12,7,Points-PointsKO-Adjacents,48
Cyanea_gibsonii,2,2,0,Points-PointsKO-Adjacents,9
Cyanea_giffardii,1,1,0,Points-PointsKO-Adjacents,9
Cyanea_grimesiana,3,3,0,Points-PointsKO-Adjacents,21
Cyanea_hamatiflora,3,3,0,Points-PointsKO-Adjacents,17
Cyanea_hardyi,1,1,0,Points-PointsKO-Adjacents,9
Cyanea_hirtella,20,0,20,Points-PointsKO-Adjacents,38
Cyanea_horrida,6,5,1,Points-PointsKO-Adjacents,17
Cyanea_kunthiana,3,3,0,Points-PointsKO-Adjacents,22
Cyanea_leptostegia,4,4,0,Points-PointsKO-Adjacents,14
Cyanea_lobata,4,4,0,Points-PointsKO-Adjacents,23
Cyanea_macrostegia,13,9,4,Points-PointsKO-Adjacents,41
Cyanea_marksii,1,1,0,Points-PointsKO-Adjacents,9
Cyanea_membranacea,0,0,0,NA,0
Cyanea_munroi,0,0,0,NA,0
Cyanea_obtusa,1,1,0,Points-PointsKO-Adjacents,8
Cyanea_pilosa,16,9,7,Points-PointsKO-Adjacents,66
Cyanea_pohaku,2,2,0,Points-PointsKO-Adjacents,17
Cyanea_procera,1,1,0,Points-PointsKO-Adjacents,9
Cyanea_pycnocarpa,1,1,0,Points-PointsKO-Adjacents,9
Cyanea_quercifolia,1,1,0,Points-PointsKO-Adjacents,8
Cyanea_rivularis,3,3,0,Points-PointsKO-Adjacents,11
Cyanea_solanacea,12,6,6,Points-PointsKO-Adjacents,25
Cyanea_solenocalyx,6,2,4,Points-PointsKO-Adjacents,15
Cyanea_stictophylla,2,2,0,Points-PointsKO-Adjacents,17
Cyanea_superba,4,3,1,Points-PointsKO-Adjacents,20
Cyanea_tritomantha,6,2,4,Points-PointsKO-Adjacents,31
Cyanocephalus_lippioides,30,21,9,Alphahull-PointsKO-Adjacents,1068
Cyathocalyx_annamensis,0,0,0,NA,0
Cyathocalyx_globosus,1,1,0,Points-PointsKO-Adjacents,9
Cyathocalyx_magnifructus,2,2,0,Points-PointsKO-Adjacents,18
Cyathocalyx_martabanicus,0,0,0,NA,0
Cyathocalyx_olivaceus,3,3,0,Points-PointsKO-Adjacents,23
Cyathocalyx_sumatranus,0,0,0,NA,0
Cyathocalyx_zeylanicus,1,1,0,Points-PointsKO-Adjacents,9
Cyathostegia_matthewsii,42,32,10,Alphahull-PointsKO-Adjacents,121
Cyathostemma_yunnanense,3,3,0,Points-PointsKO-Adjacents,27
Cybianthus_agostinianus,10,5,5,Points-PointsKO-Adjacents,49
Cybianthus_amplus,256,167,89,Alphahull-PointsKO-Adjacents,33688
Cybianthus_antillanus,4,4,0,Points-PointsKO-Adjacents,14
Cybianthus_apiculatus,20,10,10,Points-PointsKO-Adjacents,118
Cybianthus_barbosae,3,3,0,Points-PointsKO-Adjacents,27
Cybianthus_boissieri,4,4,0,Points-PointsKO-Adjacents,36
Cybianthus_breweri,7,1,6,Points-PointsKO-Adjacents,42
Cybianthus_buchtienii,9,0,9,Points-PointsKO-Adjacents,81
Cybianthus_caracasanus,9,0,9,Points-PointsKO-Adjacents,48
Cybianthus_cardonae,31,0,31,Points-PointsKO-Adjacents,169
Cybianthus_cogolloi,12,8,4,Points-PointsKO-Adjacents,64
Cybianthus_colombianus,3,3,0,Points-PointsKO-Adjacents,16
Cybianthus_comperuvianus,53,36,17,Alphahull-PointsKO-Adjacents,708
Cybianthus_costaricanus,122,105,17,Alphahull-PointsKO-Adjacents,392
Cybianthus_crotonoides,26,15,11,Points-PointsKO-Adjacents,129
Cybianthus_cruegeri,0,0,0,NA,0
Cybianthus_cuatrecasasii,26,13,13,Points-PointsKO-Adjacents,191
Cybianthus_cuspidatus,14,8,6,Points-PointsKO-Adjacents,67
Cybianthus_densiflorus,35,10,25,Points-PointsKO-Adjacents,247
Cybianthus_detergens,235,182,53,Alphahull-PointsKO-Adjacents,15497
Cybianthus_duidae,41,26,15,Alphahull-PointsKO-Adjacents,516
Cybianthus_dussii,1,0,1,Points-PointsKO-Adjacents,8
Cybianthus_fendleri,2,2,0,Points-PointsKO-Adjacents,18
Cybianthus_flavovirens,10,0,10,Points-PointsKO-Adjacents,87
Cybianthus_fosteri,4,4,0,Points-PointsKO-Adjacents,36
Cybianthus_frigidicola,2,2,0,Points-PointsKO-Adjacents,18
Cybianthus_fulvopulverulentus,408,355,53,Alphahull-PointsKO-Adjacents,17533
Cybianthus_gardneri,173,124,49,Alphahull-PointsKO-Adjacents,13526
Cybianthus_gigantophyllus,24,13,11,Points-PointsKO-Adjacents,181
Cybianthus_glabrus,1,1,0,Points-PointsKO-Adjacents,9
Cybianthus_grandifolius,7,2,5,Points-PointsKO-Adjacents,63
Cybianthus_guyanensis,275,200,75,Alphahull-PointsKO-Adjacents,33373
Cybianthus_huampamiensis,15,0,15,Points-PointsKO-Adjacents,91
Cybianthus_idroboi,13,1,12,Points-PointsKO-Adjacents,92
Cybianthus_incognitus,9,0,9,Points-PointsKO-Adjacents,66
Cybianthus_iteoides,148,120,28,Alphahull-PointsKO-Adjacents,3196
Cybianthus_jensonii,4,4,0,Points-PointsKO-Adjacents,27
Cybianthus_kayapii,34,12,22,Points-PointsKO-Adjacents,272
Cybianthus_laetus,25,5,20,Points-PointsKO-Adjacents,171
Cybianthus_laurifolius,118,97,21,Alphahull-PointsKO-Adjacents,2716
Cybianthus_lawrencei,1,1,0,Points-PointsKO-Adjacents,9
Cybianthus_lepidotus,82,48,34,Alphahull-PointsKO-Adjacents,2154
Cybianthus_leprieurii,4,4,0,Points-PointsKO-Adjacents,36
Cybianthus_liesneri,3,3,0,Points-PointsKO-Adjacents,27
Cybianthus_longifolius,22,5,17,Points-PointsKO-Adjacents,178
Cybianthus_magnus,138,101,37,Alphahull-PointsKO-Adjacents,2143
Cybianthus_maguirei,1,1,0,Points-PointsKO-Adjacents,9
Cybianthus_marginatus,286,239,47,Alphahull-PointsKO-Adjacents,4219
Cybianthus_microbotrys,20,15,5,Points-PointsKO-Adjacents,107
Cybianthus_minutiflorus,65,24,41,Alphahull-PointsKO-Adjacents,2170
Cybianthus_montanus,28,15,13,Points-PointsKO-Adjacents,161
Cybianthus_multicostatus,3,3,0,Points-PointsKO-Adjacents,27
Cybianthus_multiflorus,39,15,24,Points-PointsKO-Adjacents,306
Cybianthus_nanayensis,20,12,8,Points-PointsKO-Adjacents,86
Cybianthus_nemophilus,1,1,0,Points-PointsKO-Adjacents,9
Cybianthus_nestorii,5,5,0,Points-PointsKO-Adjacents,34
Cybianthus_nevadensis,8,1,7,Points-PointsKO-Adjacents,57
Cybianthus_occigranatensis,138,115,23,Alphahull-PointsKO-Adjacents,3138
Cybianthus_pastensis,277,225,52,Alphahull-PointsKO-Adjacents,2687
Cybianthus_penduliflorus,71,12,59,Points-PointsKO-Adjacents,553
Cybianthus_perseoides,20,6,14,Points-PointsKO-Adjacents,141
Cybianthus_peruvianus,512,381,131,Alphahull-PointsKO-Adjacents,25861
Cybianthus_plowmanii,9,2,7,Points-PointsKO-Adjacents,35
Cybianthus_poeppigii,112,78,34,Alphahull-PointsKO-Adjacents,2807
Cybianthus_potiaei,42,16,26,Points-PointsKO-Adjacents,295
Cybianthus_prieurii,134,70,64,Alphahull-PointsKO-Adjacents,5276
Cybianthus_pseudolongifolius,2,2,0,Points-PointsKO-Adjacents,18
Cybianthus_punctatus,24,12,12,Points-PointsKO-Adjacents,152
Cybianthus_quelchii,83,0,83,Points-PointsKO-Adjacents,392
Cybianthus_resinosus,98,59,39,Alphahull-PointsKO-Adjacents,4527
Cybianthus_reticulatus,80,57,23,Alphahull-PointsKO-Adjacents,4107
Cybianthus_roraimae,21,7,14,Points-PointsKO-Adjacents,157
Cybianthus_rostratus,7,3,4,Points-PointsKO-Adjacents,37
Cybianthus_ruforamulus,5,5,0,Points-PointsKO-Adjacents,39
Cybianthus_schlimii,264,217,47,Alphahull-PointsKO-Adjacents,6149
Cybianthus_simplex,58,46,12,Alphahull-PointsKO-Adjacents,1423
Cybianthus_sintenisii,10,5,5,Points-PointsKO-Adjacents,28
Cybianthus_sipapoensis,3,3,0,Points-PointsKO-Adjacents,23
Cybianthus_spathulifolius,0,0,0,NA,0
Cybianthus_spicatus,304,237,67,Alphahull-PointsKO-Adjacents,19402
Cybianthus_spichigeri,18,9,9,Points-PointsKO-Adjacents,123
Cybianthus_sprucei,114,93,21,Alphahull-PointsKO-Adjacents,3232
Cybianthus_stapfii,14,4,10,Points-PointsKO-Adjacents,80
Cybianthus_steyermarkianus,13,0,13,Points-PointsKO-Adjacents,68
Cybianthus_subspicatus,5,4,1,Points-PointsKO-Adjacents,38
Cybianthus_sulcatus,16,7,9,Points-PointsKO-Adjacents,106
Cybianthus_surinamensis,100,72,28,Alphahull-PointsKO-Adjacents,4438
Cybianthus_tamanus,1,1,0,Points-PointsKO-Adjacents,9
Cybianthus_vasquezii,3,3,0,Points-PointsKO-Adjacents,27
Cybianthus_venezuelanus,426,306,120,Alphahull-PointsKO-Adjacents,46037
Cybistax_antisyphilitica,1023,890,133,Alphahull-PointsKO-Adjacents,49726
Cyclocarya_paliurus,43,19,24,Points-PointsKO-Adjacents,366
Cyclolobium_brasiliense,189,125,64,Alphahull-PointsKO-Adjacents,17085
Cyclophyllum_barbatum,69,30,39,Alphahull-PointsKO-Adjacents,229
Cyclophyllum_brevipes,55,34,21,Alphahull-PointsKO-Adjacents,1161
Cyclophyllum_coprosmoides,369,288,81,Alphahull-PointsKO-Adjacents,3639
Cyclophyllum_costatum,16,12,4,Points-PointsKO-Adjacents,39
Cyclophyllum_longipetalum,448,392,56,Alphahull-PointsKO-Adjacents,1087
Cyclophyllum_maritimum,42,29,13,Alphahull-PointsKO-Adjacents,187
Cyclophyllum_marquesense,0,0,0,NA,0
Cyclophyllum_multiflorum,149,130,19,Alphahull-PointsKO-Adjacents,296
Cyclophyllum_protractum,36,28,8,Alphahull-PointsKO-Adjacents,96
Cyclophyllum_rectinervium,0,0,0,NA,0
Cyclophyllum_rostellatum,58,38,20,Alphahull-PointsKO-Adjacents,323
Cyclophyllum_schultzii,290,269,21,Alphahull-PointsKO-Adjacents,1910
Cyclophyllum_tenuipes,3,3,0,Points-PointsKO-Adjacents,9
Cydonia_oblonga,23,10,13,Points-PointsKO-Adjacents,171
Cylicodiscus_gabunensis,99,73,26,Alphahull-PointsKO-Adjacents,2313
Cylicomorpha_parviflora,36,25,11,Alphahull-PointsKO-Adjacents,272
Cylicomorpha_solmsii,38,23,15,Alphahull-PointsKO-Adjacents,333
Cylindropuntia_alcahes,195,169,26,Alphahull-PointsKO-Adjacents,1147
Cylindropuntia_cholla,182,0,182,Points-PointsKO-Adjacents,620
Cylindropuntia_fulgida,64,45,19,Alphahull-PointsKO-Adjacents,1199
Cylindropuntia_imbricata,1473,1381,92,Alphahull-PointsKO-Adjacents,22193
Cylindropuntia_prolifera,251,159,92,Alphahull-PointsKO-Adjacents,349
Cylindropuntia_spinosior,475,435,40,Alphahull-PointsKO-Adjacents,3396
Cylindropuntia_thurberi,50,31,19,Alphahull-PointsKO-Adjacents,946
Cylindropuntia_versicolor,257,229,28,Alphahull-PointsKO-Adjacents,1361
Cymbopetalum_abacophyllum,12,4,8,Points-PointsKO-Adjacents,76
Cymbopetalum_aequale,28,13,15,Points-PointsKO-Adjacents,187
Cymbopetalum_alkekengi,9,0,9,Points-PointsKO-Adjacents,54
Cymbopetalum_baillonii,102,91,11,Alphahull-PointsKO-Adjacents,1115
Cymbopetalum_brasiliense,283,161,122,Alphahull-PointsKO-Adjacents,21541
Cymbopetalum_coriaceum,18,8,10,Points-PointsKO-Adjacents,145
Cymbopetalum_costaricense,132,119,13,Alphahull-PointsKO-Adjacents,521
Cymbopetalum_euneurum,8,0,8,Points-PointsKO-Adjacents,58
Cymbopetalum_fosteri,1,1,0,Points-PointsKO-Adjacents,9
Cymbopetalum_gracile,8,0,8,Points-PointsKO-Adjacents,52
Cymbopetalum_hintonii,17,6,11,Points-PointsKO-Adjacents,90
Cymbopetalum_lanugipetalum,85,72,13,Alphahull-PointsKO-Adjacents,713
Cymbopetalum_longipes,70,40,30,Alphahull-PointsKO-Adjacents,3621
Cymbopetalum_loretoyacuense,4,4,0,Points-PointsKO-Adjacents,26
Cymbopetalum_mayanum,38,29,9,Alphahull-PointsKO-Adjacents,716
Cymbopetalum_mirabile,6,0,6,Points-PointsKO-Adjacents,54
Cymbopetalum_oppositiflorum,12,2,10,Points-PointsKO-Adjacents,84
Cymbopetalum_penduliflorum,104,76,28,Alphahull-PointsKO-Adjacents,1640
Cymbopetalum_rugulosum,26,17,9,Points-PointsKO-Adjacents,87
Cymbopetalum_sanchezii,6,2,4,Points-PointsKO-Adjacents,36
Cymbopetalum_schunkei,9,1,8,Points-PointsKO-Adjacents,73
Cymbopetalum_stenophyllum,21,11,10,Points-PointsKO-Adjacents,109
Cymbopetalum_steyermarkii,3,3,0,Points-PointsKO-Adjacents,27
Cymbopetalum_tessmannii,5,5,0,Points-PointsKO-Adjacents,45
Cymbopetalum_torulosum,55,44,11,Alphahull-PointsKO-Adjacents,256
Cynanchum_absconditum,3,3,0,Points-PointsKO-Adjacents,24
Cynanchum_antsiranense,3,3,0,Points-PointsKO-Adjacents,23
Cynometra_abrahamii,37,22,15,Alphahull-PointsKO-Adjacents,1200
Cynometra_alexandri,52,36,16,Alphahull-PointsKO-Adjacents,878
Cynometra_americana,3,3,0,Points-PointsKO-Adjacents,25
Cynometra_ananta,51,37,14,Alphahull-PointsKO-Adjacents,281
Cynometra_ankaranensis,6,6,0,Points-PointsKO-Adjacents,14
Cynometra_aurita,34,21,13,Alphahull-PointsKO-Adjacents,228
Cynometra_bauhiniifolia,389,303,86,Alphahull-PointsKO-Adjacents,45288
Cynometra_beddomei,1,1,0,Points-PointsKO-Adjacents,9
Cynometra_bourdillonii,0,0,0,NA,0
Cynometra_brachymischa,4,4,0,Points-PointsKO-Adjacents,18
Cynometra_brachyrrhachis,6,1,5,Points-PointsKO-Adjacents,38
Cynometra_capuronii,6,3,3,Points-PointsKO-Adjacents,20
Cynometra_cauliflora,9,0,9,Points-PointsKO-Adjacents,59
Cynometra_commersoniana,61,33,28,Alphahull-PointsKO-Adjacents,576
Cynometra_congensis,1,0,1,Points-PointsKO-Adjacents,9
Cynometra_copelandii,2,2,0,Points-PointsKO-Adjacents,8
Cynometra_craibii,2,2,0,Points-PointsKO-Adjacents,18
Cynometra_crassifolia,14,7,7,Points-PointsKO-Adjacents,94
Cynometra_cubensis,0,0,0,NA,0
Cynometra_cuneata,15,0,15,Points-PointsKO-Adjacents,135
Cynometra_dauphinensis,22,12,10,Points-PointsKO-Adjacents,59
Cynometra_dongnaiensis,0,0,0,NA,0
Cynometra_duckei,11,5,6,Points-PointsKO-Adjacents,79
Cynometra_elmeri,8,0,8,Points-PointsKO-Adjacents,54
Cynometra_engleri,5,5,0,Points-PointsKO-Adjacents,27
Cynometra_falcata,0,0,0,NA,0
Cynometra_filifera,6,0,6,Points-PointsKO-Adjacents,37
Cynometra_fissicuspis,5,5,0,Points-PointsKO-Adjacents,41
Cynometra_gillmanii,3,3,0,Points-PointsKO-Adjacents,23
Cynometra_glomerulata,0,0,0,NA,0
Cynometra_greenwayi,9,3,6,Points-PointsKO-Adjacents,53
Cynometra_hankei,76,47,29,Alphahull-PointsKO-Adjacents,3506
Cynometra_hemitomophylla,33,17,16,Points-PointsKO-Adjacents,156
Cynometra_hondurensis,2,2,0,Points-PointsKO-Adjacents,18
Cynometra_hostmanniana,47,28,19,Alphahull-PointsKO-Adjacents,2682
Cynometra_inaequifolia,1,1,0,Points-PointsKO-Adjacents,9
Cynometra_insularis,3,3,0,Points-PointsKO-Adjacents,12
Cynometra_iripa,122,76,46,Alphahull-PointsKO-Adjacents,518
Cynometra_katikii,1,1,0,Points-PointsKO-Adjacents,9
Cynometra_leonensis,12,7,5,Points-PointsKO-Adjacents,93
Cynometra_le-testui,4,4,0,Points-PointsKO-Adjacents,36
Cynometra_longicuspis,34,14,20,Points-PointsKO-Adjacents,224
Cynometra_longifolia,4,4,0,Points-PointsKO-Adjacents,36
Cynometra_longipedicellata,5,3,2,Points-PointsKO-Adjacents,12
Cynometra_lujae,15,8,7,Points-PointsKO-Adjacents,92
Cynometra_lukei,9,5,4,Points-PointsKO-Adjacents,50
Cynometra_lyallii,13,7,6,Points-PointsKO-Adjacents,81
Cynometra_macrocarpa,3,3,0,Points-PointsKO-Adjacents,27
Cynometra_madagascariensis,76,51,25,Alphahull-PointsKO-Adjacents,436
Cynometra_malaccensis,6,3,3,Points-PointsKO-Adjacents,48
Cynometra_mannii,71,54,17,Alphahull-PointsKO-Adjacents,1613
Cynometra_marginata,208,154,54,Alphahull-PointsKO-Adjacents,18065
Cynometra_marleneae,8,3,5,Points-PointsKO-Adjacents,69
Cynometra_megalophylla,171,156,15,Alphahull-PointsKO-Adjacents,2943
Cynometra_michelsonii,1,1,0,Points-PointsKO-Adjacents,9
Cynometra_minutiflora,5,4,1,Points-PointsKO-Adjacents,30
Cynometra_mirabilis,4,4,0,Points-PointsKO-Adjacents,35
Cynometra_nyangensis,3,3,0,Points-PointsKO-Adjacents,27
Cynometra_oaxacana,53,30,23,Alphahull-PointsKO-Adjacents,344
Cynometra_oddonii,14,1,13,Points-PointsKO-Adjacents,122
Cynometra_palustris,1,1,0,Points-PointsKO-Adjacents,9
Cynometra_parvifolia,16,1,15,Points-PointsKO-Adjacents,144
Cynometra_pedicellata,3,3,0,Points-PointsKO-Adjacents,27
Cynometra_pervilleana,15,9,6,Points-PointsKO-Adjacents,101
Cynometra_portoricensis,19,8,11,Points-PointsKO-Adjacents,128
Cynometra_ramiflora,65,0,65,Points-PointsKO-Adjacents,400
Cynometra_retusa,143,109,34,Alphahull-PointsKO-Adjacents,1159
Cynometra_sakalava,46,30,16,Alphahull-PointsKO-Adjacents,752
Cynometra_sanagaensis,26,9,17,Points-PointsKO-Adjacents,162
Cynometra_schlechteri,23,7,16,Points-PointsKO-Adjacents,142
Cynometra_schottiana,2,2,0,Points-PointsKO-Adjacents,18
Cynometra_sessiliflora,26,12,14,Points-PointsKO-Adjacents,181
Cynometra_simplicifolia,7,1,6,Points-PointsKO-Adjacents,50
Cynometra_spruceana,298,238,60,Alphahull-PointsKO-Adjacents,25036
Cynometra_stenopetala,7,0,7,Points-PointsKO-Adjacents,57
Cynometra_suaheliensis,30,13,17,Points-PointsKO-Adjacents,152
Cynometra_travancorica,1,1,0,Points-PointsKO-Adjacents,9
Cynometra_trinitensis,1,1,0,Points-PointsKO-Adjacents,9
Cynometra_ulugurensis,2,2,0,Points-PointsKO-Adjacents,12
Cynometra_vogelii,52,29,23,Alphahull-PointsKO-Adjacents,772
Cynometra_warburgii,0,0,0,NA,0
Cynometra_webberi,29,13,16,Points-PointsKO-Adjacents,173
Cynometra_zeylanica,0,0,0,NA,0
Cynophalla_amplissima,267,178,89,Alphahull-PointsKO-Adjacents,7630
Cynophalla_didymobotrys,5,5,0,Points-PointsKO-Adjacents,45
Cynophalla_ecuadorica,45,32,13,Alphahull-PointsKO-Adjacents,516
Cynophalla_flexuosa,1763,1381,382,Alphahull-PointsKO-Adjacents,52913
Cynophalla_hastata,812,706,106,Alphahull-PointsKO-Adjacents,17153
Cynophalla_heterophylla,52,0,52,Points-PointsKO-Adjacents,262
Cynophalla_linearis,45,25,20,Alphahull-PointsKO-Adjacents,471
Cynophalla_mattogrossensis,39,23,16,Alphahull-PointsKO-Adjacents,634
Cynophalla_polyantha,114,86,28,Alphahull-PointsKO-Adjacents,4954
Cynophalla_retusa,341,302,39,Alphahull-PointsKO-Adjacents,13496
Cynophalla_sclerophylla,8,2,6,Points-PointsKO-Adjacents,58
Cynophalla_sessilis,33,14,19,Points-PointsKO-Adjacents,220
Cynophalla_verrucosa,323,217,106,Alphahull-PointsKO-Adjacents,8944
Cyphanthera_tasmanica,90,10,80,Points-PointsKO-Adjacents,96
Cyphokentia_cerifera,7,1,6,Points-PointsKO-Adjacents,34
Cyphokentia_macrostachya,12,5,7,Points-PointsKO-Adjacents,59
Cypholophus_decipiens,37,11,26,Points-PointsKO-Adjacents,219
Cypholophus_lutescens,7,0,7,Points-PointsKO-Adjacents,54
Cypholophus_macrocephalus,9,0,9,Points-PointsKO-Adjacents,60
Cyphomandra_betacea,76,11,65,Points-PointsKO-Adjacents,556
Cyphomandra_tobagensis,15,5,10,Points-PointsKO-Adjacents,99
Cyphophoenix_alba,11,7,4,Points-PointsKO-Adjacents,23
Cyphophoenix_elegans,8,3,5,Points-PointsKO-Adjacents,15
Cyphophoenix_fulcita,9,7,2,Points-PointsKO-Adjacents,29
Cyphophoenix_nucele,1,1,0,Points-PointsKO-Adjacents,6
Cyphosperma_balansae,7,1,6,Points-PointsKO-Adjacents,35
Cyphosperma_tanga,0,0,0,NA,0
Cyphosperma_trichospadix,0,0,0,NA,0
Cyphosperma_voutmelense,0,0,0,NA,0
Cyphostemma_bainesii,12,8,4,Points-PointsKO-Adjacents,60
Cyphostemma_currorii,15,9,6,Points-PointsKO-Adjacents,116
Cyphostemma_juttae,7,2,5,Points-PointsKO-Adjacents,63
Cyphostemma_laza,16,5,11,Points-PointsKO-Adjacents,106
Cyphostemma_mappia,1,1,0,Points-PointsKO-Adjacents,9
Cyrilla_racemiflora,1067,885,182,Alphahull-PointsKO-Adjacents,18629
Cyrillopsis_paraensis,25,0,25,Points-PointsKO-Adjacents,188
Cyrtandra_anthropophagorum,2,2,0,Points-PointsKO-Adjacents,11
Cyrtandra_ciliata,1,1,0,Points-PointsKO-Adjacents,6
Cyrtandra_coleoides,1,1,0,Points-PointsKO-Adjacents,9
Cyrtandra_compressa,1,1,0,Points-PointsKO-Adjacents,9
Cyrtandra_cordifolia,2,1,1,Points-PointsKO-Adjacents,15
Cyrtandra_denhamii,0,0,0,NA,0
Cyrtandra_dentata,0,0,0,NA,0
Cyrtandra_dinocalyx,1,1,0,Points-PointsKO-Adjacents,9
Cyrtandra_divertae,1,1,0,Points-PointsKO-Adjacents,9
Cyrtandra_elbertii,0,0,0,NA,0
Cyrtandra_esothrix,0,0,0,NA,0
Cyrtandra_feaniana,9,2,7,Points-PointsKO-Adjacents,13
Cyrtandra_filibracteata,1,1,0,Points-PointsKO-Adjacents,6
Cyrtandra_garnotiana,1,1,0,Points-PointsKO-Adjacents,9
Cyrtandra_giffardii,4,4,0,Points-PointsKO-Adjacents,19
Cyrtandra_grayana,4,4,0,Points-PointsKO-Adjacents,31
Cyrtandra_harveyi,1,1,0,Points-PointsKO-Adjacents,9
Cyrtandra_heintzelmaniana,0,0,0,NA,0
Cyrtandra_induta,3,3,0,Points-PointsKO-Adjacents,9
Cyrtandra_involucrata,2,2,0,Points-PointsKO-Adjacents,18
Cyrtandra_jonesii,2,2,0,Points-PointsKO-Adjacents,6
Cyrtandra_jugalis,0,0,0,NA,0
Cyrtandra_kandavuensis,0,0,0,NA,0
Cyrtandra_laxiflora,3,3,0,Points-PointsKO-Adjacents,24
Cyrtandra_longiflora,5,5,0,Points-PointsKO-Adjacents,15
Cyrtandra_lysiosepala,11,6,5,Points-PointsKO-Adjacents,47
Cyrtandra_macrotricha,0,0,0,NA,0
Cyrtandra_magentiflora,0,0,0,NA,0
Cyrtandra_montana,0,0,0,NA,0
Cyrtandra_natewaensis,0,0,0,NA,0
Cyrtandra_nukuhivensis,2,2,0,Points-PointsKO-Adjacents,9
Cyrtandra_paludosa,16,3,13,Points-PointsKO-Adjacents,75
Cyrtandra_pritchardii,2,2,0,Points-PointsKO-Adjacents,8
Cyrtandra_pulchella,0,0,0,NA,0
Cyrtandra_purpurifolia,0,0,0,NA,0
Cyrtandra_spathacea,0,0,0,NA,0
Cyrtandra_subulibractea,0,0,0,NA,0
Cyrtandra_taviunensis,0,0,0,NA,0
Cyrtandra_tempestii,0,0,0,NA,0
Cyrtandra_thibaultii,6,0,6,Points-PointsKO-Adjacents,14
Cyrtandra_tohiveaensis,2,2,0,Points-PointsKO-Adjacents,6
Cyrtandra_vitiensis,0,0,0,NA,0
Cyrtandra_wagneri,4,4,0,Points-PointsKO-Adjacents,10
Cyrtandra_waianaeensis,0,0,0,NA,0
Cyrtandra_xanthantha,0,0,0,NA,0
Cyrtocarpa_caatingae,112,95,17,Alphahull-PointsKO-Adjacents,3066
Cyrtocarpa_edulis,98,78,20,Alphahull-PointsKO-Adjacents,300
Cyrtocarpa_kruseana,6,2,4,Points-PointsKO-Adjacents,53
Cyrtocarpa_procera,293,263,30,Alphahull-PointsKO-Adjacents,1654
Cyrtocarpa_velutinifolia,65,40,25,Alphahull-PointsKO-Adjacents,3451
Cyrtocymura_scorpioides,1072,820,252,Alphahull-PointsKO-Adjacents,28629
Cyrtogonone_argentea,54,42,12,Alphahull-PointsKO-Adjacents,1657
Cyrtostachys_bakeri,1,1,0,Points-PointsKO-Adjacents,9
Cyrtostachys_barbata,0,0,0,NA,0
Cyrtostachys_elegans,2,2,0,Points-PointsKO-Adjacents,18
Cyrtostachys_excelsa,1,1,0,Points-PointsKO-Adjacents,9
Cyrtostachys_glauca,2,2,0,Points-PointsKO-Adjacents,16
Cyrtostachys_loriae,17,2,15,Points-PointsKO-Adjacents,139
Cyrtostachys_renda,8,0,8,Points-PointsKO-Adjacents,64
Cytisus_arboreus,65,43,22,Alphahull-PointsKO-Adjacents,921
Cytisus_proliferus,673,655,18,Alphahull-PointsKO-Adjacents,164
Dacrycarpus_cinctus,104,77,27,Alphahull-PointsKO-Adjacents,835
Dacrycarpus_compactus,87,62,25,Alphahull-PointsKO-Adjacents,763
Dacrycarpus_cumingii,9,1,8,Points-PointsKO-Adjacents,77
Dacrycarpus_dacrydioides,4140,4004,136,Alphahull-PointsKO-Adjacents,4519
Dacrycarpus_expansus,15,10,5,Points-PointsKO-Adjacents,106
Dacrycarpus_imbricatus,337,198,139,Alphahull-PointsKO-Adjacents,5043
Dacrycarpus_kinabaluensis,9,2,7,Points-PointsKO-Adjacents,12
Dacrycarpus_vieillardii,50,38,12,Alphahull-PointsKO-Adjacents,141
Dacrydium_balansae,64,51,13,Alphahull-PointsKO-Adjacents,143
Dacrydium_beccarii,47,7,40,Points-PointsKO-Adjacents,366
Dacrydium_cornwallianum,18,8,10,Points-PointsKO-Adjacents,65
Dacrydium_cupressinum,3728,3657,71,Alphahull-PointsKO-Adjacents,4413
Dacrydium_ericoides,2,2,0,Points-PointsKO-Adjacents,18
Dacrydium_gibbsiae,6,2,4,Points-PointsKO-Adjacents,12
Dacrydium_gracile,4,4,0,Points-PointsKO-Adjacents,12
Dacrydium_leptophyllum,2,2,0,Points-PointsKO-Adjacents,18
Dacrydium_lycopodioides,19,15,4,Points-PointsKO-Adjacents,41
Dacrydium_magnum,3,3,0,Points-PointsKO-Adjacents,26
Dacrydium_medium,5,5,0,Points-PointsKO-Adjacents,45
Dacrydium_nausoriense,4,4,0,Points-PointsKO-Adjacents,35
Dacrydium_nidulum,68,28,40,Alphahull-PointsKO-Adjacents,1820
Dacrydium_novoguineense,42,21,21,Alphahull-PointsKO-Adjacents,203
Dacrydium_pectinatum,21,6,15,Points-PointsKO-Adjacents,166
Dacrydium_spathoides,2,2,0,Points-PointsKO-Adjacents,18
Dacrydium_xanthandrum,18,2,16,Points-PointsKO-Adjacents,129
Dacryodes_acutipyrena,4,4,0,Points-PointsKO-Adjacents,27
Dacryodes_bampsiana,5,5,0,Points-PointsKO-Adjacents,41
Dacryodes_belemensis,7,0,7,Points-PointsKO-Adjacents,48
Dacryodes_breviracemosa,NA,NA,NA,NA,NA
Dacryodes_buettneri,197,176,21,Alphahull-PointsKO-Adjacents,2062
Dacryodes_camerunensis,8,6,2,Points-PointsKO-Adjacents,54
Dacryodes_chimantensis,93,63,30,Alphahull-PointsKO-Adjacents,2549
Dacryodes_colombiana,0,0,0,NA,0
Dacryodes_costata,23,9,14,Points-PointsKO-Adjacents,160
Dacryodes_costanensis,NA,NA,NA,NA,NA
Dacryodes_crassipes,0,0,0,NA,0
Dacryodes_cupularis,22,12,10,Points-PointsKO-Adjacents,129
Dacryodes_cuspidata,26,8,18,Points-PointsKO-Adjacents,196
Dacryodes_dungii,1,1,0,Points-PointsKO-Adjacents,9
Dacryodes_ebatom,5,5,0,Points-PointsKO-Adjacents,45
Dacryodes_edilsonii,7,0,7,Points-PointsKO-Adjacents,48
Dacryodes_edulis,302,253,49,Alphahull-PointsKO-Adjacents,9142
Dacryodes_elmeri,1,1,0,Points-PointsKO-Adjacents,9
Dacryodes_excelsa,35,15,20,Points-PointsKO-Adjacents,140
Dacryodes_expansa,3,1,2,Points-PointsKO-Adjacents,27
Dacryodes_glabra,41,0,41,Points-PointsKO-Adjacents,299
Dacryodes_granatensis,12,4,8,Points-PointsKO-Adjacents,89
Dacryodes_heterotricha,36,28,8,Alphahull-PointsKO-Adjacents,623
Dacryodes_hopkinsii,8,2,6,Points-PointsKO-Adjacents,64
Dacryodes_igaganga,89,80,9,Alphahull-PointsKO-Adjacents,1348
Dacryodes_incurvata,17,8,9,Points-PointsKO-Adjacents,131
Dacryodes_kingii,1,0,1,Points-PointsKO-Adjacents,9
Dacryodes_klaineana,261,214,47,Alphahull-PointsKO-Adjacents,5436
Dacryodes_kostermansii,2,2,0,Points-PointsKO-Adjacents,17
Dacryodes_kukachkana,5,5,0,Points-PointsKO-Adjacents,45
Dacryodes_laxa,31,14,17,Points-PointsKO-Adjacents,222
Dacryodes_ledermannii,7,0,7,Points-PointsKO-Adjacents,54
Dacryodes_leonardiana,8,4,4,Points-PointsKO-Adjacents,33
Dacryodes_le-testui,38,28,10,Alphahull-PointsKO-Adjacents,648
Dacryodes_longifolia,8,1,7,Points-PointsKO-Adjacents,47
Dacryodes_macrocarpa,3,0,3,Points-PointsKO-Adjacents,26
Dacryodes_macrophylla,84,71,13,Alphahull-PointsKO-Adjacents,1747
Dacryodes_microcarpa,124,75,49,Alphahull-PointsKO-Adjacents,4329
Dacryodes_multijuga,0,0,0,NA,0
Dacryodes_negrensis,63,38,25,Alphahull-PointsKO-Adjacents,4399
Dacryodes_nervosa,1,1,0,Points-PointsKO-Adjacents,9
Dacryodes_nitens,170,110,60,Alphahull-PointsKO-Adjacents,16461
Dacryodes_normandii,97,85,12,Alphahull-PointsKO-Adjacents,1013
Dacryodes_occidentalis,51,39,12,Alphahull-PointsKO-Adjacents,740
Dacryodes_olivifera,43,0,43,Points-PointsKO-Adjacents,286
Dacryodes_osika,20,9,11,Points-PointsKO-Adjacents,71
Dacryodes_papuana,0,0,0,NA,0
Dacryodes_paraensis,30,4,26,Points-PointsKO-Adjacents,267
Dacryodes_patentinervia,0,0,0,NA,0
Dacryodes_peruviana,54,34,20,Alphahull-PointsKO-Adjacents,2464
Dacryodes_puberula,2,2,0,Points-PointsKO-Adjacents,12
Dacryodes_pubescens,7,1,6,Points-PointsKO-Adjacents,57
Dacryodes_roraimensis,35,24,11,Alphahull-PointsKO-Adjacents,1097
Dacryodes_rostrata,73,45,28,Alphahull-PointsKO-Adjacents,3871
Dacryodes_rubiginosa,7,0,7,Points-PointsKO-Adjacents,57
Dacryodes_rugosa,64,41,23,Alphahull-PointsKO-Adjacents,3754
Dacryodes_sclerophylla,16,3,13,Points-PointsKO-Adjacents,123
Dacryodes_steyermarkii,8,3,5,Points-PointsKO-Adjacents,72
Dacryodes_tessmannii,2,2,0,Points-PointsKO-Adjacents,18
Dacryodes_trapnellii,0,0,0,NA,0
Dacryodes_trinitensis,20,4,16,Points-PointsKO-Adjacents,157
Dacryodes_villiersiana,2,2,0,Points-PointsKO-Adjacents,9
Dactyladenia_barteri,89,51,38,Alphahull-PointsKO-Adjacents,2488
Dactyladenia_buchneri,12,3,9,Points-PointsKO-Adjacents,102
Dactyladenia_campestris,53,36,17,Alphahull-PointsKO-Adjacents,700
Dactyladenia_chevalieri,20,16,4,Points-PointsKO-Adjacents,90
Dactyladenia_cinerea,3,3,0,Points-PointsKO-Adjacents,27
Dactyladenia_dewevrei,11,0,11,Points-PointsKO-Adjacents,84
Dactyladenia_dichotoma,1,1,0,Points-PointsKO-Adjacents,9
Dactyladenia_dinklagei,21,12,9,Points-PointsKO-Adjacents,163
Dactyladenia_eketensis,1,1,0,Points-PointsKO-Adjacents,9
Dactyladenia_floribunda,11,1,10,Points-PointsKO-Adjacents,72
Dactyladenia_gilletii,13,4,9,Points-PointsKO-Adjacents,79
Dactyladenia_hirsuta,3,3,0,Points-PointsKO-Adjacents,21
Dactyladenia_icondere,16,8,8,Points-PointsKO-Adjacents,73
Dactyladenia_johnstonei,6,0,6,Points-PointsKO-Adjacents,48
Dactyladenia_jongkindii,7,2,5,Points-PointsKO-Adjacents,51
Dactyladenia_laevis,6,3,3,Points-PointsKO-Adjacents,33
Dactyladenia_lehmbachii,12,8,4,Points-PointsKO-Adjacents,91
Dactyladenia_letestui,17,10,7,Points-PointsKO-Adjacents,108
Dactyladenia_librevillensis,6,4,2,Points-PointsKO-Adjacents,28
Dactyladenia_mannii,6,1,5,Points-PointsKO-Adjacents,43
Dactyladenia_ndjoleensis,3,3,0,Points-PointsKO-Adjacents,18
Dactyladenia_pallescens,64,48,16,Alphahull-PointsKO-Adjacents,1786
Dactyladenia_pierrei,2,1,1,Points-PointsKO-Adjacents,18
Dactyladenia_sapinii,1,1,0,Points-PointsKO-Adjacents,9
Dactyladenia_scabrifolia,59,45,14,Alphahull-PointsKO-Adjacents,1438
Dactyladenia_staudtii,28,15,13,Points-PointsKO-Adjacents,151
Dactyladenia_whytei,58,45,13,Alphahull-PointsKO-Adjacents,713
Dactylocladus_stenostachys,4,4,0,Points-PointsKO-Adjacents,27
Daemonorops_binnendijkii,0,0,0,NA,0
Daemonorops_jenkinsiana,61,26,35,Alphahull-PointsKO-Adjacents,1950
Dahlstedtia_araripensis,227,202,25,Alphahull-PointsKO-Adjacents,8921
Dahlstedtia_bahiana,9,4,5,Points-PointsKO-Adjacents,60
Dahlstedtia_castaneifolia,6,1,5,Points-PointsKO-Adjacents,48
Dahlstedtia_floribunda,135,112,23,Alphahull-PointsKO-Adjacents,2811
Dahlstedtia_glaziovii,5,5,0,Points-PointsKO-Adjacents,43
Dahlstedtia_grandiflora,5,4,1,Points-PointsKO-Adjacents,41
Dahlstedtia_muehlbergiana,334,274,60,Alphahull-PointsKO-Adjacents,10466
Dahlstedtia_peckoltii,6,1,5,Points-PointsKO-Adjacents,52
Dahlstedtia_pinnata,233,187,46,Alphahull-PointsKO-Adjacents,2456
Dais_cotinifolia,74,47,27,Alphahull-PointsKO-Adjacents,2786
Dais_glaucescens,16,6,10,Points-PointsKO-Adjacents,112
Dalbergia_abrahamii,12,5,7,Points-PointsKO-Adjacents,42
Dalbergia_acariiantha,9,4,5,Points-PointsKO-Adjacents,71
Dalbergia_acuta,71,53,18,Alphahull-PointsKO-Adjacents,2473
Dalbergia_agudeloi,6,0,6,Points-PointsKO-Adjacents,33
Dalbergia_albiflora,2,2,0,Points-PointsKO-Adjacents,18
Dalbergia_andapensis,11,7,4,Points-PointsKO-Adjacents,62
Dalbergia_arbutifolia,138,112,26,Alphahull-PointsKO-Adjacents,10925
Dalbergia_aurea,2,2,0,Points-PointsKO-Adjacents,18
Dalbergia_bakeri,38,21,17,Alphahull-PointsKO-Adjacents,1695
Dalbergia_balansae,49,21,28,Alphahull-PointsKO-Adjacents,2274
Dalbergia_bariensis,0,0,0,NA,0
Dalbergia_baronii,64,49,15,Alphahull-PointsKO-Adjacents,835
Dalbergia_bathiei,6,2,4,Points-PointsKO-Adjacents,28
Dalbergia_boehmii,159,110,49,Alphahull-PointsKO-Adjacents,6676
Dalbergia_bojeri,8,0,8,Points-PointsKO-Adjacents,35
Dalbergia_boniana,NA,NA,NA,NA,NA
Dalbergia_brachystachya,1,1,0,Points-PointsKO-Adjacents,9
Dalbergia_bracteolata,148,107,41,Alphahull-PointsKO-Adjacents,2739
Dalbergia_brasiliensis,143,0,143,Points-PointsKO-Adjacents,1082
Dalbergia_brownei,154,103,51,Alphahull-PointsKO-Adjacents,2621
Dalbergia_burmanica,4,4,0,Points-PointsKO-Adjacents,36
Dalbergia_calderonii,7,1,6,Points-PointsKO-Adjacents,63
Dalbergia_calycina,42,16,26,Points-PointsKO-Adjacents,195
Dalbergia_cambodiana,0,0,0,NA,0
Dalbergia_campenonii,7,2,5,Points-PointsKO-Adjacents,57
Dalbergia_cana,7,0,7,Points-PointsKO-Adjacents,57
Dalbergia_capuronii,4,4,0,Points-PointsKO-Adjacents,30
Dalbergia_carringtoniana,2,2,0,Points-PointsKO-Adjacents,18
Dalbergia_cearensis,175,148,27,Alphahull-PointsKO-Adjacents,7202
Dalbergia_chapelieri,78,58,20,Alphahull-PointsKO-Adjacents,1117
Dalbergia_chlorocarpa,40,27,13,Alphahull-PointsKO-Adjacents,630
Dalbergia_chontalensis,51,33,18,Alphahull-PointsKO-Adjacents,837
Dalbergia_cochinchinensis,6,3,3,Points-PointsKO-Adjacents,52
Dalbergia_comorensis,1,1,0,Points-PointsKO-Adjacents,7
Dalbergia_congestiflora,48,28,20,Alphahull-PointsKO-Adjacents,418
Dalbergia_cuiabensis,34,18,16,Points-PointsKO-Adjacents,235
Dalbergia_cultrata,21,9,12,Points-PointsKO-Adjacents,148
Dalbergia_cumingiana,5,5,0,Points-PointsKO-Adjacents,45
Dalbergia_darienensis,0,0,0,NA,0
Dalbergia_davidii,3,3,0,Points-PointsKO-Adjacents,21
Dalbergia_decipularis,56,36,20,Alphahull-PointsKO-Adjacents,2615
Dalbergia_delphinensis,8,2,6,Points-PointsKO-Adjacents,26
Dalbergia_discolor,1,1,0,Points-PointsKO-Adjacents,9
Dalbergia_duarensis,NA,NA,NA,NA,NA
Dalbergia_emirnensis,67,52,15,Alphahull-PointsKO-Adjacents,1973
Dalbergia_eremicola,11,5,6,Points-PointsKO-Adjacents,62
Dalbergia_ernest-ulei,1,1,0,Points-PointsKO-Adjacents,9
Dalbergia_erubescens,3,3,0,Points-PointsKO-Adjacents,27
Dalbergia_fischeri,64,27,37,Alphahull-PointsKO-Adjacents,1087
Dalbergia_floribunda,0,0,0,NA,0
Dalbergia_foliolosa,187,8,179,Points-PointsKO-Adjacents,1234
Dalbergia_foliosa,42,0,42,Points-PointsKO-Adjacents,319
Dalbergia_frutescens,1014,846,168,Alphahull-PointsKO-Adjacents,30462
Dalbergia_fusca,9,5,4,Points-PointsKO-Adjacents,63
Dalbergia_glaberrima,20,9,11,Points-PointsKO-Adjacents,70
Dalbergia_glabra,987,903,84,Alphahull-PointsKO-Adjacents,7848
Dalbergia_glaucescens,59,34,25,Alphahull-PointsKO-Adjacents,2570
Dalbergia_glaucocarpa,12,7,5,Points-PointsKO-Adjacents,78
Dalbergia_glaziovii,10,1,9,Points-PointsKO-Adjacents,70
Dalbergia_glomerata,61,37,24,Alphahull-PointsKO-Adjacents,435
Dalbergia_gracilis,63,37,26,Alphahull-PointsKO-Adjacents,1596
Dalbergia_granadillo,47,28,19,Alphahull-PointsKO-Adjacents,831
Dalbergia_greveana,158,137,21,Alphahull-PointsKO-Adjacents,2467
Dalbergia_hainanensis,5,0,5,Points-PointsKO-Adjacents,35
Dalbergia_havilandii,2,2,0,Points-PointsKO-Adjacents,18
Dalbergia_henryana,4,4,0,Points-PointsKO-Adjacents,36
Dalbergia_heudelotii,60,25,35,Alphahull-PointsKO-Adjacents,2848
Dalbergia_hildebrandtii,14,7,7,Points-PointsKO-Adjacents,94
Dalbergia_hirticalyx,4,4,0,Points-PointsKO-Adjacents,26
Dalbergia_horrida,2,1,1,Points-PointsKO-Adjacents,18
Dalbergia_hortensis,8,0,8,Points-PointsKO-Adjacents,47
Dalbergia_hullettii,1,1,0,Points-PointsKO-Adjacents,9
Dalbergia_humbertii,11,4,7,Points-PointsKO-Adjacents,67
Dalbergia_hupeana,117,80,37,Alphahull-PointsKO-Adjacents,9495
Dalbergia_hygrophila,42,15,27,Points-PointsKO-Adjacents,338
Dalbergia_intibucana,2,2,0,Points-PointsKO-Adjacents,18
Dalbergia_inundata,168,124,44,Alphahull-PointsKO-Adjacents,12619
Dalbergia_junghuhnii,8,0,8,Points-PointsKO-Adjacents,70
Dalbergia_lacei,0,0,0,NA,0
Dalbergia_lanceolaria,24,3,21,Points-PointsKO-Adjacents,207
Dalbergia_latifolia,11,1,10,Points-PointsKO-Adjacents,93
Dalbergia_laxiflora,27,7,20,Points-PointsKO-Adjacents,169
Dalbergia_lemurica,19,11,8,Points-PointsKO-Adjacents,97
Dalbergia_longepedunculata,3,3,0,Points-PointsKO-Adjacents,18
Dalbergia_louvelii,8,0,8,Points-PointsKO-Adjacents,58
Dalbergia_luteola,2,2,0,Points-PointsKO-Adjacents,18
Dalbergia_madagascariensis,106,79,27,Alphahull-PointsKO-Adjacents,975
Dalbergia_malangensis,3,3,0,Points-PointsKO-Adjacents,27
Dalbergia_mammosa,1,1,0,Points-PointsKO-Adjacents,9
Dalbergia_maritima,35,18,17,Points-PointsKO-Adjacents,149
Dalbergia_melanoxylon,272,181,91,Alphahull-PointsKO-Adjacents,15551
Dalbergia_mimosella,4,4,0,Points-PointsKO-Adjacents,36
Dalbergia_miscolobium,355,297,58,Alphahull-PointsKO-Adjacents,14132
Dalbergia_modesta,1,1,0,Points-PointsKO-Adjacents,9
Dalbergia_mollis,68,47,21,Alphahull-PointsKO-Adjacents,1449
Dalbergia_monetaria,363,233,130,Alphahull-PointsKO-Adjacents,34899
Dalbergia_monticola,76,56,20,Alphahull-PointsKO-Adjacents,1060
Dalbergia_multijuga,16,7,9,Points-PointsKO-Adjacents,133
Dalbergia_neoperrieri,26,15,11,Points-PointsKO-Adjacents,167
Dalbergia_ngounyensis,3,3,0,Points-PointsKO-Adjacents,27
Dalbergia_nigra,305,254,51,Alphahull-PointsKO-Adjacents,9125
Dalbergia_nitidula,101,52,49,Alphahull-PointsKO-Adjacents,3521
Dalbergia_normandii,9,3,6,Points-PointsKO-Adjacents,39
Dalbergia_obovata,96,54,42,Alphahull-PointsKO-Adjacents,1137
Dalbergia_obtusifolia,11,4,7,Points-PointsKO-Adjacents,88
Dalbergia_odorifera,8,1,7,Points-PointsKO-Adjacents,63
Dalbergia_oligophylla,34,18,16,Points-PointsKO-Adjacents,226
Dalbergia_oliveri,8,0,8,Points-PointsKO-Adjacents,70
Dalbergia_orientalis,34,19,15,Points-PointsKO-Adjacents,196
Dalbergia_ovata,3,3,0,Points-PointsKO-Adjacents,27
Dalbergia_palo-escrito,40,31,9,Alphahull-PointsKO-Adjacents,92
Dalbergia_peguensis,NA,NA,NA,NA,NA
Dalbergia_peishaensis,2,2,0,Points-PointsKO-Adjacents,18
Dalbergia_peltieri,36,24,12,Alphahull-PointsKO-Adjacents,551
Dalbergia_pervillei,103,75,28,Alphahull-PointsKO-Adjacents,2498
Dalbergia_pinnata,49,0,49,Points-PointsKO-Adjacents,408
Dalbergia_polyadelpha,21,12,9,Points-PointsKO-Adjacents,169
Dalbergia_prainii,NA,NA,NA,NA,NA
Dalbergia_pseudobaronii,25,18,7,Points-PointsKO-Adjacents,175
Dalbergia_pseudo-ovata,NA,NA,NA,NA,NA
Dalbergia_purpurascens,103,79,24,Alphahull-PointsKO-Adjacents,3238
Dalbergia_reniformis,7,0,7,Points-PointsKO-Adjacents,54
Dalbergia_retusa,163,127,36,Alphahull-PointsKO-Adjacents,825
Dalbergia_revoluta,6,0,6,Points-PointsKO-Adjacents,52
Dalbergia_rhachiflexa,0,0,0,NA,0
Dalbergia_riedelii,158,90,68,Alphahull-PointsKO-Adjacents,15390
Dalbergia_rimosa,52,23,29,Alphahull-PointsKO-Adjacents,3714
Dalbergia_riparia,80,0,80,Points-PointsKO-Adjacents,595
Dalbergia_ruddiae,3,3,0,Points-PointsKO-Adjacents,27
Dalbergia_salvanaturae,1,1,0,Points-PointsKO-Adjacents,9
Dalbergia_sambesiaca,1,1,0,Points-PointsKO-Adjacents,9
Dalbergia_sericea,2,2,0,Points-PointsKO-Adjacents,18
Dalbergia_setifera,2,2,0,Points-PointsKO-Adjacents,18
Dalbergia_simpsonii,2,2,0,Points-PointsKO-Adjacents,18
Dalbergia_sissoides,1,1,0,Points-PointsKO-Adjacents,9
Dalbergia_sissoo,136,31,105,Alphahull-PointsKO-Adjacents,736
Dalbergia_spinosa,1,1,0,Points-PointsKO-Adjacents,9
Dalbergia_spruceana,64,21,43,Alphahull-PointsKO-Adjacents,495
Dalbergia_stevensonii,9,6,3,Points-PointsKO-Adjacents,63
Dalbergia_stipulacea,33,17,16,Points-PointsKO-Adjacents,265
Dalbergia_suaresensis,27,0,27,Points-PointsKO-Adjacents,73
Dalbergia_subcymosa,20,0,20,Points-PointsKO-Adjacents,165
Dalbergia_teixeirae,6,3,3,Points-PointsKO-Adjacents,54
Dalbergia_tilarana,5,5,0,Points-PointsKO-Adjacents,24
Dalbergia_tinnevelliensis,NA,NA,NA,NA,NA
Dalbergia_tonkinensis,0,0,0,NA,0
Dalbergia_trichocarpa,133,114,19,Alphahull-PointsKO-Adjacents,1655
Dalbergia_tricolor,19,9,10,Points-PointsKO-Adjacents,144
Dalbergia_tsaratananensis,6,2,4,Points-PointsKO-Adjacents,53
Dalbergia_tsiandalana,10,2,8,Points-PointsKO-Adjacents,65
Dalbergia_tsoi,5,4,1,Points-PointsKO-Adjacents,36
Dalbergia_tucurensis,56,31,25,Alphahull-PointsKO-Adjacents,1337
Dalbergia_urschii,4,4,0,Points-PointsKO-Adjacents,27
Dalbergia_vacciniifolia,38,24,14,Alphahull-PointsKO-Adjacents,216
Dalbergia_viguieri,23,14,9,Points-PointsKO-Adjacents,92
Dalbergia_villosa,160,131,29,Alphahull-PointsKO-Adjacents,3495
Dalbergia_wattii,NA,NA,NA,NA,NA
Dalbergia_xerophila,17,12,5,Points-PointsKO-Adjacents,59
Dalbergia_yunnanensis,40,23,17,Alphahull-PointsKO-Adjacents,1744
Dalea_carthagenensis,316,205,111,Alphahull-PointsKO-Adjacents,5737
Dalea_frutescens,179,143,36,Alphahull-PointsKO-Adjacents,7001
Dalea_leucostachya,188,144,44,Alphahull-PointsKO-Adjacents,3166
Dalea_lutea,370,321,49,Alphahull-PointsKO-Adjacents,6907
Dalea_schiblii,2,2,0,Points-PointsKO-Adjacents,9
Dalechampia_parvibracteata,19,6,13,Points-PointsKO-Adjacents,144
Dalechampia_stenoloba,NA,NA,NA,NA,NA
Dalembertia_platanoides,3,1,2,Points-PointsKO-Adjacents,27
Damnacanthus_giganteus,47,26,21,Alphahull-PointsKO-Adjacents,266
Damnacanthus_henryi,22,9,13,Points-PointsKO-Adjacents,194
Danais_humblotii,25,12,13,Points-PointsKO-Adjacents,160
Danais_pubescens,36,26,10,Alphahull-PointsKO-Adjacents,242
Danais_rhamnifolia,49,29,20,Alphahull-PointsKO-Adjacents,341
Daniellia_alsteeniana,7,0,7,Points-PointsKO-Adjacents,59
Daniellia_glandulosa,1,1,0,Points-PointsKO-Adjacents,9
Daniellia_klainei,27,17,10,Points-PointsKO-Adjacents,158
Daniellia_oblonga,6,1,5,Points-PointsKO-Adjacents,47
Daniellia_ogea,37,13,24,Points-PointsKO-Adjacents,276
Daniellia_oliveri,1363,1303,60,Alphahull-PointsKO-Adjacents,9142
Daniellia_pilosa,9,4,5,Points-PointsKO-Adjacents,62
Daniellia_pynaertii,12,3,9,Points-PointsKO-Adjacents,84
Daniellia_soyauxii,21,15,6,Points-PointsKO-Adjacents,144
Daniellia_thurifera,42,19,23,Points-PointsKO-Adjacents,319
Dankia_langbianensis,1,1,0,Points-PointsKO-Adjacents,9
Dansiea_elliptica,24,16,8,Points-PointsKO-Adjacents,92
Dansiea_grandiflora,4,4,0,Points-PointsKO-Adjacents,7
Daphnandra_apatela,676,643,33,Alphahull-PointsKO-Adjacents,1309
Daphnandra_dielsii,3,3,0,Points-PointsKO-Adjacents,15
Daphnandra_johnsonii,68,54,14,Alphahull-PointsKO-Adjacents,54
Daphnandra_melasmena,47,37,10,Alphahull-PointsKO-Adjacents,161
Daphnandra_micrantha,531,500,31,Alphahull-PointsKO-Adjacents,1061
Daphnandra_repandula,179,0,179,Points-PointsKO-Adjacents,225
Daphnandra_tenuipes,126,113,13,Alphahull-PointsKO-Adjacents,165
Daphne_altaica,4,4,0,Points-PointsKO-Adjacents,36
Daphniphyllum_atrobadium,29,8,21,Points-PointsKO-Adjacents,217
Daphniphyllum_beddomei,1,1,0,Points-PointsKO-Adjacents,9
Daphniphyllum_borneense,9,5,4,Points-PointsKO-Adjacents,42
Daphniphyllum_buchananiifolium,5,5,0,Points-PointsKO-Adjacents,30
Daphniphyllum_calycinum,117,0,117,Points-PointsKO-Adjacents,1027
Daphniphyllum_celebense,NA,NA,NA,NA,NA
Daphniphyllum_ceramense,0,0,0,NA,0
Daphniphyllum_dichotomum,1,1,0,Points-PointsKO-Adjacents,9
Daphniphyllum_glaucescens,5,0,5,Points-PointsKO-Adjacents,45
Daphniphyllum_gracile,138,1,137,Points-PointsKO-Adjacents,593
Daphniphyllum_griffithianum,2,2,0,Points-PointsKO-Adjacents,17
Daphniphyllum_himalense,6,0,6,Points-PointsKO-Adjacents,54
Daphniphyllum_luzonense,4,0,4,Points-PointsKO-Adjacents,6
Daphniphyllum_macropodum,417,303,114,Alphahull-PointsKO-Adjacents,10010
Daphniphyllum_majus,3,3,0,Points-PointsKO-Adjacents,27
Daphniphyllum_neilgherrense,2,2,0,Points-PointsKO-Adjacents,18
Daphniphyllum_papuanum,56,39,17,Alphahull-PointsKO-Adjacents,748
Daphniphyllum_paxianum,39,16,23,Points-PointsKO-Adjacents,279
Daphniphyllum_pentandrum,513,440,73,Alphahull-PointsKO-Adjacents,12423
Daphniphyllum_scortechinii,1,1,0,Points-PointsKO-Adjacents,9
Daphniphyllum_subverticillatum,9,1,8,Points-PointsKO-Adjacents,81
Daphniphyllum_sumatraense,0,0,0,NA,0
Daphniphyllum_teysmannii,101,50,51,Alphahull-PointsKO-Adjacents,620
Daphniphyllum_timorianum,3,3,0,Points-PointsKO-Adjacents,24
Daphniphyllum_woodsonianum,0,0,0,NA,0
Daphniphyllum_yunnanense,2,2,0,Points-PointsKO-Adjacents,18
Daphnopsis_alainii,0,0,0,NA,0
Daphnopsis_americana,358,289,69,Alphahull-PointsKO-Adjacents,2613
Daphnopsis_anomala,8,3,5,Points-PointsKO-Adjacents,52
Daphnopsis_bissei,0,0,0,NA,0
Daphnopsis_boliviana,4,4,0,Points-PointsKO-Adjacents,27
Daphnopsis_brasiliensis,118,0,118,Points-PointsKO-Adjacents,739
Daphnopsis_calcicola,1,1,0,Points-PointsKO-Adjacents,9
Daphnopsis_caracasana,93,63,30,Alphahull-PointsKO-Adjacents,2036
Daphnopsis_cestrifolia,10,6,4,Points-PointsKO-Adjacents,43
Daphnopsis_coriacea,80,53,27,Alphahull-PointsKO-Adjacents,1830
Daphnopsis_crassifolia,32,24,8,Alphahull-PointsKO-Adjacents,123
Daphnopsis_crispotomentosa,6,0,6,Points-PointsKO-Adjacents,45
Daphnopsis_cuneata,7,2,5,Points-PointsKO-Adjacents,43
Daphnopsis_ekmanii,1,1,0,Points-PointsKO-Adjacents,6
Daphnopsis_equatorialis,38,28,10,Alphahull-PointsKO-Adjacents,242
Daphnopsis_espinosae,11,4,7,Points-PointsKO-Adjacents,56
Daphnopsis_fasciculata,478,428,50,Alphahull-PointsKO-Adjacents,11622
Daphnopsis_ficina,42,27,15,Alphahull-PointsKO-Adjacents,341
Daphnopsis_filipedunculata,4,4,0,Points-PointsKO-Adjacents,27
Daphnopsis_flavida,16,0,16,Points-PointsKO-Adjacents,77
Daphnopsis_folsomii,5,5,0,Points-PointsKO-Adjacents,24
Daphnopsis_gemmiflora,13,1,12,Points-PointsKO-Adjacents,88
Daphnopsis_grandis,10,7,3,Points-PointsKO-Adjacents,54
Daphnopsis_granitica,11,10,1,Points-PointsKO-Adjacents,24
Daphnopsis_granvillei,9,6,3,Points-PointsKO-Adjacents,55
Daphnopsis_hammelii,34,0,34,Points-PointsKO-Adjacents,138
Daphnopsis_helleriana,10,2,8,Points-PointsKO-Adjacents,27
Daphnopsis_hispaniolica,3,3,0,Points-PointsKO-Adjacents,27
Daphnopsis_liebmannii,7,3,4,Points-PointsKO-Adjacents,54
Daphnopsis_longipedunculata,7,2,5,Points-PointsKO-Adjacents,63
Daphnopsis_macrocarpa,3,2,1,Points-PointsKO-Adjacents,12
Daphnopsis_macrophylla,71,54,17,Alphahull-PointsKO-Adjacents,400
Daphnopsis_martii,73,0,73,Points-PointsKO-Adjacents,410
Daphnopsis_megacarpa,41,31,10,Alphahull-PointsKO-Adjacents,209
Daphnopsis_mexiae,27,0,27,Points-PointsKO-Adjacents,111
Daphnopsis_mollis,86,69,17,Alphahull-PointsKO-Adjacents,192
Daphnopsis_morii,8,2,6,Points-PointsKO-Adjacents,55
Daphnopsis_nevlingiana,3,3,0,Points-PointsKO-Adjacents,18
Daphnopsis_nevlingii,11,8,3,Points-PointsKO-Adjacents,56
Daphnopsis_occidentalis,8,4,4,Points-PointsKO-Adjacents,54
Daphnopsis_occulta,4,4,0,Points-PointsKO-Adjacents,36
Daphnopsis_pavonii,4,4,0,Points-PointsKO-Adjacents,30
Daphnopsis_perplexa,19,0,19,Points-PointsKO-Adjacents,112
Daphnopsis_peruviensis,3,3,0,Points-PointsKO-Adjacents,27
Daphnopsis_philippiana,30,27,3,Alphahull-PointsKO-Adjacents,35
Daphnopsis_pseudosalix,17,9,8,Points-PointsKO-Adjacents,92
Daphnopsis_purdiei,2,2,0,Points-PointsKO-Adjacents,18
Daphnopsis_purpusii,18,0,18,Points-PointsKO-Adjacents,97
Daphnopsis_racemosa,566,468,98,Alphahull-PointsKO-Adjacents,19258
Daphnopsis_sanctae-teresae,8,1,7,Points-PointsKO-Adjacents,51
Daphnopsis_schwackeana,83,0,83,Points-PointsKO-Adjacents,438
Daphnopsis_selerorum,35,28,7,Alphahull-PointsKO-Adjacents,225
Daphnopsis_sellowiana,73,50,23,Alphahull-PointsKO-Adjacents,785
Daphnopsis_steyermarkii,25,1,24,Points-PointsKO-Adjacents,134
Daphnopsis_strigillosa,15,9,6,Points-PointsKO-Adjacents,79
Daphnopsis_tuerckheimiana,9,2,7,Points-PointsKO-Adjacents,66
Daphnopsis_utilis,83,54,29,Alphahull-PointsKO-Adjacents,1379
Daphnopsis_witsbergeri,5,5,0,Points-PointsKO-Adjacents,30
Daphnopsis_zamorensis,2,2,0,Points-PointsKO-Adjacents,18
Darlingia_darlingiana,167,155,12,Alphahull-PointsKO-Adjacents,282
Dasylepis_blackii,18,6,12,Points-PointsKO-Adjacents,125
Dasylepis_eggelingii,17,11,6,Points-PointsKO-Adjacents,93
Dasylepis_integra,56,48,8,Alphahull-PointsKO-Adjacents,177
Dasylepis_racemosa,96,58,38,Alphahull-PointsKO-Adjacents,1168
Dasylepis_seretii,18,3,15,Points-PointsKO-Adjacents,150
Dasylepis_thomasii,23,18,5,Points-PointsKO-Adjacents,79
Dasylirion_cedrosanum,51,36,15,Alphahull-PointsKO-Adjacents,1321
Dasylirion_wheeleri,288,259,29,Alphahull-PointsKO-Adjacents,4819
Dasymaschalon_borneense,NA,NA,NA,NA,NA
Dasymaschalon_clusiflorum,10,1,9,Points-PointsKO-Adjacents,79
Dasymaschalon_dasymaschalum,29,7,22,Points-PointsKO-Adjacents,223
Dasymaschalon_ellipticum,1,1,0,Points-PointsKO-Adjacents,9
Dasymaschalon_evrardii,0,0,0,NA,0
Dasymaschalon_filipes,1,1,0,Points-PointsKO-Adjacents,9
Dasymaschalon_glaucum,5,5,0,Points-PointsKO-Adjacents,45
Dasymaschalon_lomentaceum,4,3,1,Points-PointsKO-Adjacents,36
Dasymaschalon_longiflorum,3,1,2,Points-PointsKO-Adjacents,25
Dasymaschalon_macrocalyx,4,3,1,Points-PointsKO-Adjacents,27
Dasymaschalon_robinsonii,0,0,0,NA,0
Dasymaschalon_rostratum,17,3,14,Points-PointsKO-Adjacents,144
Dasymaschalon_sootepense,3,3,0,Points-PointsKO-Adjacents,27
Dasymaschalon_tibetense,NA,NA,NA,NA,NA
Dasymaschalon_wallichii,2,2,0,Points-PointsKO-Adjacents,16
Dasymaschalon_yunnanense,3,3,0,Points-PointsKO-Adjacents,27
Dasyphyllum_armatum,21,9,12,Points-PointsKO-Adjacents,132
Dasyphyllum_brasiliense,721,620,101,Alphahull-PointsKO-Adjacents,25641
Dasyphyllum_colombianum,12,4,8,Points-PointsKO-Adjacents,95
Dasyphyllum_diacanthoides,45,30,15,Alphahull-PointsKO-Adjacents,1224
Dasyphyllum_excelsum,7,3,4,Points-PointsKO-Adjacents,39
Dasyphyllum_hystrix,2,2,0,Points-PointsKO-Adjacents,18
Dasyphyllum_spinescens,288,243,45,Alphahull-PointsKO-Adjacents,6309
Davidia_involucrata,39,17,22,Points-PointsKO-Adjacents,333
Davidsonia_jerseyana,27,19,8,Points-PointsKO-Adjacents,61
Davidsonia_pruriens,125,100,25,Alphahull-PointsKO-Adjacents,268
Daviesia_divaricata,311,235,76,Alphahull-PointsKO-Adjacents,818
Davilla_alata,9,4,5,Points-PointsKO-Adjacents,66
Davilla_lacunosa,34,1,33,Points-PointsKO-Adjacents,243
Debregeasia_elliptica,5,5,0,Points-PointsKO-Adjacents,45
Debregeasia_longifolia,161,1,160,Points-PointsKO-Adjacents,1173
Debregeasia_saeneb,24,8,16,Points-PointsKO-Adjacents,212
Debregeasia_squamata,32,0,32,Points-PointsKO-Adjacents,276
Debregeasia_wallichiana,5,5,0,Points-PointsKO-Adjacents,45
Decagonocarpus_oppositifolius,41,25,16,Alphahull-PointsKO-Adjacents,1010
Decaphalangium_peruvianum,15,0,15,Points-PointsKO-Adjacents,102
Decarya_madagascariensis,34,27,7,Alphahull-PointsKO-Adjacents,203
Decarydendron_helenae,5,5,0,Points-PointsKO-Adjacents,33
Decarydendron_lamii,23,10,13,Points-PointsKO-Adjacents,108
Decarydendron_perrieri,11,5,6,Points-PointsKO-Adjacents,58
Decarydendron_ranomafanensis,26,14,12,Points-PointsKO-Adjacents,144
Decaspermum_albociliatum,2,2,0,Points-PointsKO-Adjacents,18
Decaspermum_alpinum,43,24,19,Alphahull-PointsKO-Adjacents,219
Decaspermum_arfakense,3,3,0,Points-PointsKO-Adjacents,18
Decaspermum_austrohainanicum,NA,NA,NA,NA,NA
Decaspermum_belense,2,2,0,Points-PointsKO-Adjacents,18
Decaspermum_blancoi,1,1,0,Points-PointsKO-Adjacents,8
Decaspermum_bracteatum,110,72,38,Alphahull-PointsKO-Adjacents,4092
Decaspermum_exiguum,12,3,9,Points-PointsKO-Adjacents,63
Decaspermum_forbesii,53,33,20,Alphahull-PointsKO-Adjacents,688
Decaspermum_fruticosum,12,1,11,Points-PointsKO-Adjacents,83
Decaspermum_glabrum,0,0,0,NA,0
Decaspermum_gracilentum,119,92,27,Alphahull-PointsKO-Adjacents,3579
Decaspermum_hainanense,6,0,6,Points-PointsKO-Adjacents,54
Decaspermum_humile,391,334,57,Alphahull-PointsKO-Adjacents,1706
Decaspermum_montanum,8,0,8,Points-PointsKO-Adjacents,64
Decaspermum_neoebudicum,5,5,0,Points-PointsKO-Adjacents,27
Decaspermum_neurophyllum,81,62,19,Alphahull-PointsKO-Adjacents,1516
Decaspermum_nitentifolium,9,0,9,Points-PointsKO-Adjacents,63
Decaspermum_nivale,12,2,10,Points-PointsKO-Adjacents,72
Decaspermum_parviflorum,53,8,45,Points-PointsKO-Adjacents,399
Decaspermum_parvifolium,0,0,0,NA,0
Decaspermum_philippinum,0,0,0,NA,0
Decaspermum_prunoides,11,4,7,Points-PointsKO-Adjacents,86
Decaspermum_salomonense,0,0,0,NA,0
Decaspermum_struckoilicum,4,4,0,Points-PointsKO-Adjacents,12
Decaspermum_teretis,NA,NA,NA,NA,NA
Decaspermum_triflorum,0,0,0,NA,0
Decaspermum_urvillei,9,0,9,Points-PointsKO-Adjacents,56
Decaspermum_vitiense,1,1,0,Points-PointsKO-Adjacents,3
Decaspermum_vitis-idaea,8,0,8,Points-PointsKO-Adjacents,48
Decatropis_bicolor,208,183,25,Alphahull-PointsKO-Adjacents,975
Decatropis_coulteri,80,62,18,Alphahull-PointsKO-Adjacents,398
Decatropis_paucijuga,2,2,0,Points-PointsKO-Adjacents,18
Decazyx_esparzae,11,9,2,Points-PointsKO-Adjacents,43
Decazyx_macrophyllus,1,1,0,Points-PointsKO-Adjacents,9
Deccania_pubescens,0,0,0,NA,0
Deckenia_nobilis,2,2,0,Points-PointsKO-Adjacents,10
Degeneria_roseiflora,0,0,0,NA,0
Degeneria_vitiensis,4,4,0,Points-PointsKO-Adjacents,30
Deguelia_amazonica,123,61,62,Alphahull-PointsKO-Adjacents,13587
Deguelia_angulata,15,1,14,Points-PointsKO-Adjacents,135
Deguelia_costata,148,121,27,Alphahull-PointsKO-Adjacents,4170
Deguelia_densiflora,76,23,53,Alphahull-PointsKO-Adjacents,1285
Deguelia_hatschbachii,45,29,16,Alphahull-PointsKO-Adjacents,1340
Deguelia_rariflora,24,9,15,Points-PointsKO-Adjacents,160
Deguelia_scandens,173,92,81,Alphahull-PointsKO-Adjacents,12239
Deguelia_spruceana,64,24,40,Alphahull-PointsKO-Adjacents,3216
Dehaasia_acuminata,0,0,0,NA,0
Dehaasia_annamensis,2,2,0,Points-PointsKO-Adjacents,18
Dehaasia_arunachalensis,NA,NA,NA,NA,NA
Dehaasia_assamica,0,0,0,NA,0
Dehaasia_brachybotrys,2,2,0,Points-PointsKO-Adjacents,18
Dehaasia_caesia,5,0,5,Points-PointsKO-Adjacents,45
Dehaasia_cairocan,5,5,0,Points-PointsKO-Adjacents,39
Dehaasia_candolleana,2,2,0,Points-PointsKO-Adjacents,15
Dehaasia_celebica,4,4,0,Points-PointsKO-Adjacents,27
Dehaasia_corynantha,0,0,0,NA,0
Dehaasia_cuneata,2,0,2,Points-PointsKO-Adjacents,18
Dehaasia_firma,1,0,1,Points-PointsKO-Adjacents,9
Dehaasia_gigantocarpa,0,0,0,NA,0
Dehaasia_hainanensis,5,5,0,Points-PointsKO-Adjacents,30
Dehaasia_hirsuta,0,0,0,NA,0
Dehaasia_incrassata,17,3,14,Points-PointsKO-Adjacents,118
Dehaasia_kerrii,3,3,0,Points-PointsKO-Adjacents,12
Dehaasia_kurzii,1,1,0,Points-PointsKO-Adjacents,9
Dehaasia_kwangtungensis,NA,NA,NA,NA,NA
Dehaasia_lancifolia,0,0,0,NA,0
Dehaasia_longipedicellata,0,0,0,NA,0
Dehaasia_longipetiolata,3,3,0,Points-PointsKO-Adjacents,21
Dehaasia_membranacea,2,2,0,Points-PointsKO-Adjacents,16
Dehaasia_palembanica,0,0,0,NA,0
Dehaasia_paradoxa,0,0,0,NA,0
Dehaasia_pauciflora,0,0,0,NA,0
Dehaasia_polyneura,0,0,0,NA,0
Dehaasia_pugerensis,1,1,0,Points-PointsKO-Adjacents,9
Dehaasia_rangamattiensis,NA,NA,NA,NA,NA
Dehaasia_subcaesia,0,0,0,NA,0
Dehaasia_suborbicularis,0,0,0,NA,0
Dehaasia_sumatrana,NA,NA,NA,NA,NA
Dehaasia_sumbaensis,0,0,0,NA,0
Dehaasia_teijsmannii,NA,NA,NA,NA,NA
Dehaasia_titanophylla,0,0,0,NA,0
Dehaasia_tomentosa,0,0,0,NA,0
Dehaasia_turfosa,1,1,0,Points-PointsKO-Adjacents,9
Dehaasia_velutinosa,0,0,0,NA,0
Deherainia_lageniformis,7,2,5,Points-PointsKO-Adjacents,27
Deherainia_matudae,27,13,14,Points-PointsKO-Adjacents,170
Deherainia_smaragdina,89,76,13,Alphahull-PointsKO-Adjacents,1065
Deinbollia_acuminata,8,0,8,Points-PointsKO-Adjacents,68
Deinbollia_boinensis,11,0,11,Points-PointsKO-Adjacents,78
Deinbollia_borbonica,55,32,23,Alphahull-PointsKO-Adjacents,1148
Deinbollia_cauliflora,6,0,6,Points-PointsKO-Adjacents,54
Deinbollia_crassipes,1,1,0,Points-PointsKO-Adjacents,9
Deinbollia_cuneifolia,53,33,20,Alphahull-PointsKO-Adjacents,1527
Deinbollia_dasybotrys,2,2,0,Points-PointsKO-Adjacents,18
Deinbollia_evrardii,5,5,0,Points-PointsKO-Adjacents,45
Deinbollia_fulvotomentella,23,5,18,Points-PointsKO-Adjacents,169
Deinbollia_gossweileri,0,0,0,NA,0
Deinbollia_hierniana,0,0,0,NA,0
Deinbollia_insignis,4,4,0,Points-PointsKO-Adjacents,30
Deinbollia_kilimandscharica,59,36,23,Alphahull-PointsKO-Adjacents,1870
Deinbollia_laurentii,13,2,11,Points-PointsKO-Adjacents,90
Deinbollia_longiacuminata,1,1,0,Points-PointsKO-Adjacents,9
Deinbollia_macrantha,0,0,0,NA,0
Deinbollia_macroura,7,0,7,Points-PointsKO-Adjacents,42
Deinbollia_maxima,44,29,15,Alphahull-PointsKO-Adjacents,1260
Deinbollia_mezilii,6,2,4,Points-PointsKO-Adjacents,38
Deinbollia_neglecta,12,2,10,Points-PointsKO-Adjacents,64
Deinbollia_nyasica,1,1,0,Points-PointsKO-Adjacents,9
Deinbollia_nyikensis,5,4,1,Points-PointsKO-Adjacents,45
Deinbollia_oblongifolia,49,15,34,Points-PointsKO-Adjacents,367
Deinbollia_oreophila,33,27,6,Alphahull-PointsKO-Adjacents,117
Deinbollia_pervillei,63,38,25,Alphahull-PointsKO-Adjacents,1505
Deinbollia_pycnophylla,13,5,8,Points-PointsKO-Adjacents,74
Deinbollia_pynaertii,6,0,6,Points-PointsKO-Adjacents,54
Deinbollia_rambaensis,4,4,0,Points-PointsKO-Adjacents,32
Deinbollia_reticulata,1,0,1,Points-PointsKO-Adjacents,9
Deinbollia_saligna,7,1,6,Points-PointsKO-Adjacents,27
Deinbollia_xanthocarpa,15,4,11,Points-PointsKO-Adjacents,130
Delarbrea_balansae,3,3,0,Points-PointsKO-Adjacents,12
Delarbrea_collina,21,14,7,Points-PointsKO-Adjacents,79
Delarbrea_harmsii,8,2,6,Points-PointsKO-Adjacents,52
Delarbrea_longicarpa,5,5,0,Points-PointsKO-Adjacents,29
Delarbrea_michieana,94,79,15,Alphahull-PointsKO-Adjacents,203
Delarbrea_montana,35,24,11,Alphahull-PointsKO-Adjacents,98
Delarbrea_paradoxa,32,0,32,Points-PointsKO-Adjacents,191
Delissea_argutidentata,1,1,0,Points-PointsKO-Adjacents,9
Delissea_fallax,2,2,0,Points-PointsKO-Adjacents,16
Delissea_kauaiensis,2,2,0,Points-PointsKO-Adjacents,15
Delissea_laciniata,1,0,1,Points-PointsKO-Adjacents,9
Delissea_niihauensis,1,1,0,Points-PointsKO-Adjacents,9
Delissea_parviflora,1,1,0,Points-PointsKO-Adjacents,9
Delissea_undulata,1,1,0,Points-PointsKO-Adjacents,9
Delonix_baccal,3,3,0,Points-PointsKO-Adjacents,27
Delonix_boiviniana,104,80,24,Alphahull-PointsKO-Adjacents,747
Delonix_brachycarpa,16,5,11,Points-PointsKO-Adjacents,111
Delonix_decaryi,29,22,7,Alphahull-PointsKO-Adjacents,296
Delonix_elata,44,19,25,Points-PointsKO-Adjacents,304
Delonix_floribunda,50,35,15,Alphahull-PointsKO-Adjacents,919
Delonix_leucantha,24,13,11,Points-PointsKO-Adjacents,126
Delonix_pumila,16,13,3,Points-PointsKO-Adjacents,47
Delonix_regia,54,36,18,Alphahull-PointsKO-Adjacents,613
Delonix_tomentosa,2,2,0,Points-PointsKO-Adjacents,14
Delonix_velutina,9,5,4,Points-PointsKO-Adjacents,42
Delostoma_dentatum,9,4,5,Points-PointsKO-Adjacents,48
Delostoma_gracile,8,0,8,Points-PointsKO-Adjacents,58
Delostoma_integrifolium,267,214,53,Alphahull-PointsKO-Adjacents,3487
Delostoma_lobbii,23,8,15,Points-PointsKO-Adjacents,164
Delpydora_gracilis,47,22,25,Alphahull-PointsKO-Adjacents,494
Delpydora_macrophylla,33,22,11,Alphahull-PointsKO-Adjacents,634
Sanguisorba_menendezii,9,7,2,Points-PointsKO-Adjacents,23
Dendrobangia_boliviana,475,372,103,Alphahull-PointsKO-Adjacents,27795
Dendrobangia_multinervia,32,14,18,Points-PointsKO-Adjacents,255
Dendrocereus_nudiflorus,2,2,0,Points-PointsKO-Adjacents,17
Dendrocnide_amplissima,3,3,0,Points-PointsKO-Adjacents,27
Dendrocnide_basirotunda,0,0,0,NA,0
Dendrocnide_carriana,6,1,5,Points-PointsKO-Adjacents,46
Dendrocnide_celebica,NA,NA,NA,NA,NA
Dendrocnide_corallodesme,7,0,7,Points-PointsKO-Adjacents,37
Dendrocnide_cordata,18,1,17,Points-PointsKO-Adjacents,133
Dendrocnide_cordifolia,24,16,8,Points-PointsKO-Adjacents,76
Dendrocnide_crassifolia,1,1,0,Points-PointsKO-Adjacents,8
Dendrocnide_densiflora,0,0,0,NA,0
Dendrocnide_elliptica,6,1,5,Points-PointsKO-Adjacents,47
Dendrocnide_excelsa,1100,1046,54,Alphahull-PointsKO-Adjacents,2171
Dendrocnide_harveyi,6,1,5,Points-PointsKO-Adjacents,37
Dendrocnide_kajewskii,1,1,0,Points-PointsKO-Adjacents,9
Dendrocnide_kjellbergii,3,3,0,Points-PointsKO-Adjacents,26
Dendrocnide_kotoensis,7,4,3,Points-PointsKO-Adjacents,24
Dendrocnide_latifolia,22,0,22,Points-PointsKO-Adjacents,108
Dendrocnide_longifolia,12,2,10,Points-PointsKO-Adjacents,88
Dendrocnide_luzonensis,3,3,0,Points-PointsKO-Adjacents,27
Dendrocnide_meyeniana,115,0,115,Points-PointsKO-Adjacents,226
Dendrocnide_microstigma,13,0,13,Points-PointsKO-Adjacents,99
Dendrocnide_mirabilis,1,1,0,Points-PointsKO-Adjacents,6
Dendrocnide_morobensis,7,2,5,Points-PointsKO-Adjacents,57
Dendrocnide_moroidea,1,1,0,Points-PointsKO-Adjacents,9
Dendrocnide_nervosa,14,8,6,Points-PointsKO-Adjacents,81
Dendrocnide_oblanceolata,3,3,0,Points-PointsKO-Adjacents,26
Dendrocnide_peltata,9,1,8,Points-PointsKO-Adjacents,55
Dendrocnide_photiniphylla,26,13,13,Points-PointsKO-Adjacents,197
Dendrocnide_pruritivus,1,1,0,Points-PointsKO-Adjacents,5
Dendrocnide_rechingeri,2,2,0,Points-PointsKO-Adjacents,18
Dendrocnide_rigidifolia,0,0,0,NA,0
Dendrocnide_schlechteri,6,0,6,Points-PointsKO-Adjacents,26
Dendrocnide_sessiliflora,NA,NA,NA,NA,NA
Dendrocnide_sinuata,9,0,9,Points-PointsKO-Adjacents,81
Dendrocnide_stimulans,34,4,30,Points-PointsKO-Adjacents,271
Dendrocnide_subclausa,0,0,0,NA,0
Dendrocnide_ternatensis,8,0,8,Points-PointsKO-Adjacents,55
Dendrocnide_torricellensis,NA,NA,NA,NA,NA
Dendrocnide_urentissima,6,0,6,Points-PointsKO-Adjacents,54
Dendrocnide_venosa,4,4,0,Points-PointsKO-Adjacents,36
Dendrocnide_vitiensis,1,1,0,Points-PointsKO-Adjacents,9
Dendrocousinsia_alpina,1,1,0,Points-PointsKO-Adjacents,9
Dendrocousinsia_fasciculata,2,2,0,Points-PointsKO-Adjacents,16
Dendrocousinsia_spicata,4,4,0,Points-PointsKO-Adjacents,27
Dendrokingstonia_nervosa,3,3,0,Points-PointsKO-Adjacents,18
Dendrolobium_arbuscula,133,114,19,Alphahull-PointsKO-Adjacents,1188
Dendrolobium_lanceolatum,43,28,15,Alphahull-PointsKO-Adjacents,1359
Dendrolobium_papuacola,1,1,0,Points-PointsKO-Adjacents,9
Dendrolobium_quinquepetalum,2,2,0,Points-PointsKO-Adjacents,17
Dendrolobium_umbellatum,309,147,162,Alphahull-PointsKO-Adjacents,5392
Dendromecon_harfordii,83,80,3,Alphahull-PointsKO-Adjacents,42
Dendromecon_rigida,1226,0,1226,Points-PointsKO-Adjacents,1774
Dendropanax_alberti-smithii,28,16,12,Points-PointsKO-Adjacents,185
Dendropanax_amorimii,13,8,5,Points-PointsKO-Adjacents,64
Dendropanax_amplifolius,5,4,1,Points-PointsKO-Adjacents,35
Dendropanax_arboreus,2990,2741,249,Alphahull-PointsKO-Adjacents,53648
Dendropanax_australis,84,65,19,Alphahull-PointsKO-Adjacents,543
Dendropanax_bahiensis,29,17,12,Points-PointsKO-Adjacents,139
Dendropanax_bilocularis,4,4,0,Points-PointsKO-Adjacents,36
Dendropanax_blakeanus,1,0,1,Points-PointsKO-Adjacents,9
Dendropanax_bolivianus,7,0,7,Points-PointsKO-Adjacents,45
Dendropanax_borneensis,6,1,5,Points-PointsKO-Adjacents,21
Dendropanax_bracteatus,6,4,2,Points-PointsKO-Adjacents,29
Dendropanax_brasiliensis,29,13,16,Points-PointsKO-Adjacents,197
Dendropanax_brevistylus,2,2,0,Points-PointsKO-Adjacents,18
Dendropanax_burmanicus,0,0,0,NA,0
Dendropanax_caloneurus,1,1,0,Points-PointsKO-Adjacents,9
Dendropanax_capillaris,95,71,24,Alphahull-PointsKO-Adjacents,386
Dendropanax_caucanus,250,205,45,Alphahull-PointsKO-Adjacents,5734
Dendropanax_caudatus,8,7,1,Points-PointsKO-Adjacents,38
Dendropanax_confertus,12,4,8,Points-PointsKO-Adjacents,108
Dendropanax_cordifolius,NA,NA,NA,NA,NA
Dendropanax_crassifolius,NA,NA,NA,NA,NA
Dendropanax_cuneatus,1084,954,130,Alphahull-PointsKO-Adjacents,45296
Dendropanax_cuneifolius,16,6,10,Points-PointsKO-Adjacents,93
Dendropanax_dariensis,1,1,0,Points-PointsKO-Adjacents,9
Dendropanax_denticulatus,3,3,0,Points-PointsKO-Adjacents,19
Dendropanax_dentiger,316,278,38,Alphahull-PointsKO-Adjacents,416
Dendropanax_fendleri,25,10,15,Points-PointsKO-Adjacents,163
Dendropanax_filipes,0,0,0,NA,0
Dendropanax_geniculatus,5,5,0,Points-PointsKO-Adjacents,23
Dendropanax_glaberrimus,6,0,6,Points-PointsKO-Adjacents,44
Dendropanax_globosus,71,58,13,Alphahull-PointsKO-Adjacents,424
Dendropanax_gonatopodus,99,75,24,Alphahull-PointsKO-Adjacents,550
Dendropanax_gracilis,1,1,0,Points-PointsKO-Adjacents,9
Dendropanax_grandiflorus,1,1,0,Points-PointsKO-Adjacents,9
Dendropanax_grandis,0,0,0,NA,0
Dendropanax_hainanensis,23,8,15,Points-PointsKO-Adjacents,198
Dendropanax_heterophyllus,11,1,10,Points-PointsKO-Adjacents,75
Dendropanax_hoi,3,3,0,Points-PointsKO-Adjacents,27
Dendropanax_hondurensis,11,0,11,Points-PointsKO-Adjacents,76
Dendropanax_inflatus,2,2,0,Points-PointsKO-Adjacents,18
Dendropanax_kwangsiensis,4,4,0,Points-PointsKO-Adjacents,36
Dendropanax_lancifolius,1,1,0,Points-PointsKO-Adjacents,9
Dendropanax_langbianensis,0,0,0,NA,0
Dendropanax_langsdorfii,13,9,4,Points-PointsKO-Adjacents,60
Dendropanax_larensis,1,1,0,Points-PointsKO-Adjacents,9
Dendropanax_latilobus,26,14,12,Points-PointsKO-Adjacents,85
Dendropanax_laurifolius,26,22,4,Alphahull-PointsKO-Adjacents,41
Dendropanax_lehmannii,7,2,5,Points-PointsKO-Adjacents,54
Dendropanax_leptopodus,50,15,35,Points-PointsKO-Adjacents,366
Dendropanax_macrocarpus,55,39,16,Alphahull-PointsKO-Adjacents,1173
Dendropanax_macrophyllus,51,38,13,Alphahull-PointsKO-Adjacents,858
Dendropanax_macropodus,48,27,21,Alphahull-PointsKO-Adjacents,2604
Dendropanax_marginiferus,2,2,0,Points-PointsKO-Adjacents,18
Dendropanax_monogynus,85,60,25,Alphahull-PointsKO-Adjacents,617
Dendropanax_neblinae,21,12,9,Points-PointsKO-Adjacents,136
Dendropanax_nebulosus,11,7,4,Points-PointsKO-Adjacents,59
Dendropanax_nervosus,3,3,0,Points-PointsKO-Adjacents,21
Dendropanax_nutans,3,1,2,Points-PointsKO-Adjacents,26
Dendropanax_oblanceatus,NA,NA,NA,NA,NA
Dendropanax_oblongifolius,8,0,8,Points-PointsKO-Adjacents,55
Dendropanax_oliganthus,14,5,9,Points-PointsKO-Adjacents,87
Dendropanax_oligodontus,3,3,0,Points-PointsKO-Adjacents,27
Dendropanax_pachypodus,3,3,0,Points-PointsKO-Adjacents,27
Dendropanax_pallidus,20,6,14,Points-PointsKO-Adjacents,93
Dendropanax_palustris,34,5,29,Points-PointsKO-Adjacents,306
Dendropanax_parvifloroides,2,2,0,Points-PointsKO-Adjacents,18
Dendropanax_pendulus,4,2,2,Points-PointsKO-Adjacents,29
Dendropanax_poilanei,0,0,0,NA,0
Dendropanax_populifolius,33,23,10,Alphahull-PointsKO-Adjacents,111
Dendropanax_portlandianus,NA,NA,NA,NA,NA
Dendropanax_praestans,18,7,11,Points-PointsKO-Adjacents,109
Dendropanax_productus,7,0,7,Points-PointsKO-Adjacents,63
Dendropanax_punctatus,32,25,7,Alphahull-PointsKO-Adjacents,124
Dendropanax_querceti,119,102,17,Alphahull-PointsKO-Adjacents,620
Dendropanax_ravenii,31,26,5,Alphahull-PointsKO-Adjacents,59
Dendropanax_resinosus,30,2,28,Points-PointsKO-Adjacents,241
Dendropanax_selleanus,4,4,0,Points-PointsKO-Adjacents,36
Dendropanax_sessiliflorus,89,74,15,Alphahull-PointsKO-Adjacents,365
Dendropanax_siamensis,NA,NA,NA,NA,NA
Dendropanax_stellatus,1,1,0,Points-PointsKO-Adjacents,9
Dendropanax_swartzii,2,1,1,Points-PointsKO-Adjacents,18
Dendropanax_tessmannii,45,30,15,Alphahull-PointsKO-Adjacents,1511
Dendropanax_trifidus,156,64,92,Alphahull-PointsKO-Adjacents,1343
Dendropanax_trilobus,9,1,8,Points-PointsKO-Adjacents,38
Dendropanax_umbellatus,0,0,0,NA,0
Dendropanax_venosus,1,1,0,Points-PointsKO-Adjacents,9
Dendropanax_weberbaueri,4,4,0,Points-PointsKO-Adjacents,36
Dendropanax_williamsii,5,5,0,Points-PointsKO-Adjacents,45
Dendropanax_yunnanensis,2,2,0,Points-PointsKO-Adjacents,18
Dendrophorbium_balsapampae,13,8,5,Points-PointsKO-Adjacents,51
Dendrophorbium_lloense,26,15,11,Points-PointsKO-Adjacents,155
Dendrophorbium_moscopanum,1,1,0,Points-PointsKO-Adjacents,9
Dendrophorbium_tabacifolium,10,3,7,Points-PointsKO-Adjacents,74
Dendrophorbium_tipocochensis,47,37,10,Alphahull-PointsKO-Adjacents,431
Dendrosenecio_adnivalis,3,3,0,Points-PointsKO-Adjacents,27
Dendrosenecio_elgonensis,22,18,4,Points-PointsKO-Adjacents,27
Dendrosenecio_erici-rosenii,6,1,5,Points-PointsKO-Adjacents,54
Dendrosenecio_johnstonii,8,3,5,Points-PointsKO-Adjacents,19
Dendrosenecio_kilimanjari,15,10,5,Points-PointsKO-Adjacents,25
Dendrosenecio_meruensis,5,5,0,Points-PointsKO-Adjacents,15
Dendroseris_berteroana,1,1,0,Points-PointsKO-Adjacents,5
Dendroseris_gigantea,1,1,0,Points-PointsKO-Adjacents,4
Dendroseris_litoralis,0,0,0,NA,0
Dendroseris_macrantha,1,1,0,Points-PointsKO-Adjacents,5
Dendroseris_macrophylla,1,1,0,Points-PointsKO-Adjacents,5
Dendroseris_marginata,1,1,0,Points-PointsKO-Adjacents,5
Dendroseris_micrantha,4,3,1,Points-PointsKO-Adjacents,23
Dendroseris_neriifolia,1,1,0,Points-PointsKO-Adjacents,5
Dendroseris_pinnata,1,1,0,Points-PointsKO-Adjacents,5
Dendroseris_pruinata,1,1,0,Points-PointsKO-Adjacents,3
Dendroseris_regia,1,1,0,Points-PointsKO-Adjacents,4
Dendrosicyos_socotrana,8,4,4,Points-PointsKO-Adjacents,31
Dendrosida_batesii,7,3,4,Points-PointsKO-Adjacents,33
Dendrosida_breedlovei,33,25,8,Alphahull-PointsKO-Adjacents,105
Dendrosida_oxypetala,2,2,0,Points-PointsKO-Adjacents,18
Dendrosida_parviflora,7,0,7,Points-PointsKO-Adjacents,45
Dendrosida_sharpiana,43,28,15,Alphahull-PointsKO-Adjacents,129
Dendrosipanea_spigelioides,11,3,8,Points-PointsKO-Adjacents,97
Dendrothrix_multiglandulosa,3,3,0,Points-PointsKO-Adjacents,23
Dendrothrix_yutajensis,36,21,15,Alphahull-PointsKO-Adjacents,2056
Dendroviguiera_puruana,34,22,12,Alphahull-PointsKO-Adjacents,331
Denhamia_bilocularis,664,624,40,Alphahull-PointsKO-Adjacents,2579
Denhamia_celastroides,712,665,47,Alphahull-PointsKO-Adjacents,1284
Denhamia_disperma,287,0,287,Points-PointsKO-Adjacents,1124
Denhamia_fasciculiflora,105,86,19,Alphahull-PointsKO-Adjacents,529
Denhamia_ferdinandii,112,96,16,Alphahull-PointsKO-Adjacents,1279
Denhamia_fournieri,95,83,12,Alphahull-PointsKO-Adjacents,247
Denhamia_moorei,75,69,6,Alphahull-PointsKO-Adjacents,111
Denhamia_obscura,1075,1027,48,Alphahull-PointsKO-Adjacents,5649
Denhamia_oleaster,299,264,35,Alphahull-PointsKO-Adjacents,7299
Denhamia_pittosporoides,244,214,30,Alphahull-PointsKO-Adjacents,2719
Denhamia_silvestris,2321,2151,170,Alphahull-PointsKO-Adjacents,2779
Depanthus_glaber,12,6,6,Points-PointsKO-Adjacents,52
Depanthus_pubescens,2,2,0,Points-PointsKO-Adjacents,12
Deplanchea_bancana,8,1,7,Points-PointsKO-Adjacents,63
Deplanchea_coriacea,8,0,8,Points-PointsKO-Adjacents,63
Deplanchea_glabra,1,1,0,Points-PointsKO-Adjacents,7
Deplanchea_hirsuta,1,0,1,Points-PointsKO-Adjacents,9
Deplanchea_montana,7,2,5,Points-PointsKO-Adjacents,53
Deplanchea_sessilifolia,7,2,5,Points-PointsKO-Adjacents,53
Deplanchea_speciosa,9,3,6,Points-PointsKO-Adjacents,57
Deplanchea_tetraphylla,122,85,37,Alphahull-PointsKO-Adjacents,815
Deppea_amaranthina,6,1,5,Points-PointsKO-Adjacents,54
Deppea_cornifolia,28,15,13,Points-PointsKO-Adjacents,152
Deppea_erythrorhiza,10,3,7,Points-PointsKO-Adjacents,75
Deppea_grandiflora,287,228,59,Alphahull-PointsKO-Adjacents,2262
Deppea_guerrerensis,9,0,9,Points-PointsKO-Adjacents,81
Deppea_keniae,NA,NA,NA,NA,NA
Deppea_nitida,NA,NA,NA,NA,NA
Deppea_obtusiflora,21,11,10,Points-PointsKO-Adjacents,106
Deppea_splendens,4,4,0,Points-PointsKO-Adjacents,24
Dermatophyllum_arizonicum,2,2,0,Points-PointsKO-Adjacents,18
Dermatophyllum_secundiflorum,133,84,49,Alphahull-PointsKO-Adjacents,3381
Derris_alborubra,10,1,9,Points-PointsKO-Adjacents,90
Derris_confertiflora,5,5,0,Points-PointsKO-Adjacents,41
Derris_harrowiana,8,4,4,Points-PointsKO-Adjacents,63
Derris_hylobia,8,2,6,Points-PointsKO-Adjacents,57
Derris_microphylla,3,3,0,Points-PointsKO-Adjacents,27
Derris_robusta,12,0,12,Points-PointsKO-Adjacents,108
Derris_tonkinensis,1,1,0,Points-PointsKO-Adjacents,9
Derris_utilis,11,2,9,Points-PointsKO-Adjacents,87
Desfontainia_spinosa,65,46,19,Alphahull-PointsKO-Adjacents,523
Desmanthus_balsensis,5,5,0,Points-PointsKO-Adjacents,15
Desmanthus_fruticosus,125,105,20,Alphahull-PointsKO-Adjacents,682
Desmodium_ambiguum,16,8,8,Points-PointsKO-Adjacents,84
Desmodium_cajanifolium,230,106,124,Alphahull-PointsKO-Adjacents,6726
Desmodium_cinereum,58,31,27,Alphahull-PointsKO-Adjacents,1611
Desmodium_elegans,124,75,49,Alphahull-PointsKO-Adjacents,3167
Desmodium_pseudoamplifolium,0,0,0,NA,0
Desmodium_tortuosum,1410,881,529,Alphahull-PointsKO-Adjacents,58485
Desmoncus_polyacanthos,479,354,125,Alphahull-PointsKO-Adjacents,44276
Desmopsis_bibracteata,131,118,13,Alphahull-PointsKO-Adjacents,514
Desmopsis_dolichopetala,2,2,0,Points-PointsKO-Adjacents,18
Desmopsis_heteropetala,50,46,4,Alphahull-PointsKO-Adjacents,78
Desmopsis_lanceolata,28,18,10,Points-PointsKO-Adjacents,130
Desmopsis_maxonii,82,69,13,Alphahull-PointsKO-Adjacents,288
Desmopsis_microcarpa,109,98,11,Alphahull-PointsKO-Adjacents,499
Desmopsis_neglecta,2,2,0,Points-PointsKO-Adjacents,17
Desmopsis_oerstedii,44,29,15,Alphahull-PointsKO-Adjacents,132
Desmopsis_panamensis,74,59,15,Alphahull-PointsKO-Adjacents,521
Desmopsis_schippii,203,173,30,Alphahull-PointsKO-Adjacents,2783
Desmopsis_trunciflora,88,70,18,Alphahull-PointsKO-Adjacents,801
Desmopsis_verrucipes,27,18,9,Points-PointsKO-Adjacents,80
Desmos_ramarowii,1,1,0,Points-PointsKO-Adjacents,9
Desmos_saccopetaloides,1,1,0,Points-PointsKO-Adjacents,9
Desmoscelis_villosa,392,265,127,Alphahull-PointsKO-Adjacents,35217
Desmostachys_tenuifolius,111,94,17,Alphahull-PointsKO-Adjacents,2230
Desmostachys_vogelii,3,3,0,Points-PointsKO-Adjacents,27
Desmotes_incomparabilis,8,4,4,Points-PointsKO-Adjacents,31
Desplatsia_chrysochlamys,99,60,39,Alphahull-PointsKO-Adjacents,2849
Desplatsia_dewevrei,102,55,47,Alphahull-PointsKO-Adjacents,3862
Desplatsia_floribunda,1,1,0,Points-PointsKO-Adjacents,9
Desplatsia_mildbraedii,3,3,0,Points-PointsKO-Adjacents,18
Desplatsia_subericarpa,110,73,37,Alphahull-PointsKO-Adjacents,4708
Detarium_macrocarpum,48,31,17,Alphahull-PointsKO-Adjacents,2683
Detarium_microcarpum,1902,1849,53,Alphahull-PointsKO-Adjacents,10321
Detarium_senegalense,145,110,35,Alphahull-PointsKO-Adjacents,4472
Deutzia_crenata,721,483,238,Alphahull-PointsKO-Adjacents,3425
Deutzia_floribunda,21,7,14,Points-PointsKO-Adjacents,117
Deutzia_gracilis,355,293,62,Alphahull-PointsKO-Adjacents,1986
Deutzia_hatusimae,NA,NA,NA,NA,NA
Deutzia_mexicana,13,8,5,Points-PointsKO-Adjacents,61
Deutzia_oaxacana,1,1,0,Points-PointsKO-Adjacents,9
Deutzia_occidentalis,1,1,0,Points-PointsKO-Adjacents,9
Deutzia_ogatai,NA,NA,NA,NA,NA
Deutzia_paniculata,NA,NA,NA,NA,NA
Deutzia_pulchra,304,280,24,Alphahull-PointsKO-Adjacents,417
Deutzianthus_tonkinensis,7,3,4,Points-PointsKO-Adjacents,44
Diacidia_ferruginea,5,5,0,Points-PointsKO-Adjacents,30
Diacidia_galphimioides,91,71,20,Alphahull-PointsKO-Adjacents,2153
Diacidia_glaucifolia,12,0,12,Points-PointsKO-Adjacents,68
Diacidia_hypoleuca,2,2,0,Points-PointsKO-Adjacents,18
Diacidia_kunhardtii,5,5,0,Points-PointsKO-Adjacents,39
Diacidia_rufa,8,4,4,Points-PointsKO-Adjacents,38
Diacidia_steyermarkii,5,5,0,Points-PointsKO-Adjacents,30
Diacidia_vestita,18,11,7,Points-PointsKO-Adjacents,105
Dialium_angolense,135,100,35,Alphahull-PointsKO-Adjacents,13762
Dialium_aubrevillei,38,28,10,Alphahull-PointsKO-Adjacents,971
Dialium_bipindense,53,40,13,Alphahull-PointsKO-Adjacents,2252
Dialium_cochinchinense,13,2,11,Points-PointsKO-Adjacents,106
Dialium_dinklagei,142,107,35,Alphahull-PointsKO-Adjacents,3995
Dialium_englerianum,51,26,25,Alphahull-PointsKO-Adjacents,884
Dialium_excelsum,19,9,10,Points-PointsKO-Adjacents,114
Dialium_graciliflorum,NA,NA,NA,NA,NA
Dialium_guianense,1699,1549,150,Alphahull-PointsKO-Adjacents,83524
Dialium_guineense,347,286,61,Alphahull-PointsKO-Adjacents,15599
Dialium_hexasepalum,3,3,0,Points-PointsKO-Adjacents,21
Dialium_holtzii,40,21,19,Alphahull-PointsKO-Adjacents,1240
Dialium_hydnocarpoides,3,3,0,Points-PointsKO-Adjacents,27
Dialium_indum,24,15,9,Points-PointsKO-Adjacents,205
Dialium_kasaiense,1,1,0,Points-PointsKO-Adjacents,9
Dialium_kunstleri,5,1,4,Points-PointsKO-Adjacents,45
Dialium_latifolium,0,0,0,NA,0
Dialium_lopense,40,33,7,Alphahull-PointsKO-Adjacents,292
Dialium_madagascariense,25,16,9,Points-PointsKO-Adjacents,161
Dialium_occidentale,32,17,15,Points-PointsKO-Adjacents,146
Dialium_orientale,24,12,12,Points-PointsKO-Adjacents,125
Dialium_ovoideum,2,0,2,Points-PointsKO-Adjacents,9
Dialium_pachyphyllum,193,159,34,Alphahull-PointsKO-Adjacents,19278
Dialium_pentandrum,7,0,7,Points-PointsKO-Adjacents,54
Dialium_platysepalum,26,11,15,Points-PointsKO-Adjacents,201
Dialium_pobeguinii,10,4,6,Points-PointsKO-Adjacents,75
Dialium_poggei,NA,NA,NA,NA,NA
Dialium_polyanthum,49,23,26,Alphahull-PointsKO-Adjacents,2357
Dialium_procerum,7,0,7,Points-PointsKO-Adjacents,57
Dialium_reygaertii,5,5,0,Points-PointsKO-Adjacents,45
Dialium_schlechteri,62,45,17,Alphahull-PointsKO-Adjacents,708
Dialium_tessmannii,54,35,19,Alphahull-PointsKO-Adjacents,1423
Dialium_travancoricum,0,0,0,NA,0
Dialium_unifoliolatum,51,37,14,Alphahull-PointsKO-Adjacents,395
Dialyceras_coriaceum,7,4,3,Points-PointsKO-Adjacents,42
Dialyceras_discolor,5,5,0,Points-PointsKO-Adjacents,30
Dialyceras_parvifolium,15,9,6,Points-PointsKO-Adjacents,53
Dialypetalanthus_fuscescens,164,119,45,Alphahull-PointsKO-Adjacents,14664
Diatenopteryx_grazielae,73,58,15,Alphahull-PointsKO-Adjacents,1413
Diatenopteryx_sorbifolia,527,456,71,Alphahull-PointsKO-Adjacents,13787
Dicarpellum_baillonianum,29,17,12,Points-PointsKO-Adjacents,68
Dicarpellum_pancheri,99,88,11,Alphahull-PointsKO-Adjacents,149
Dicarpellum_paucisepalum,16,9,7,Points-PointsKO-Adjacents,73
Dicarpellum_pronyense,8,3,5,Points-PointsKO-Adjacents,27
Dicellostyles_axillaris,0,0,0,NA,0
Dichaetanthera_africana,95,75,20,Alphahull-PointsKO-Adjacents,2118
Dichaetanthera_altissima,10,3,7,Points-PointsKO-Adjacents,45
Dichaetanthera_arborea,16,4,12,Points-PointsKO-Adjacents,130
Dichaetanthera_articulata,9,1,8,Points-PointsKO-Adjacents,69
Dichaetanthera_asperrima,1,1,0,Points-PointsKO-Adjacents,9
Dichaetanthera_bifida,15,9,6,Points-PointsKO-Adjacents,91
Dichaetanthera_ciliata,1,1,0,Points-PointsKO-Adjacents,9
Dichaetanthera_cordifolia,39,27,12,Alphahull-PointsKO-Adjacents,278
Dichaetanthera_corymbosa,34,8,26,Points-PointsKO-Adjacents,286
Dichaetanthera_echinulata,0,0,0,NA,0
Dichaetanthera_grandifolia,2,2,0,Points-PointsKO-Adjacents,17
Dichaetanthera_heteromorpha,2,2,0,Points-PointsKO-Adjacents,15
Dichaetanthera_madagascariensis,3,3,0,Points-PointsKO-Adjacents,15
Dichaetanthera_oblongifolia,55,36,19,Alphahull-PointsKO-Adjacents,515
Dichaetanthera_strigosa,15,1,14,Points-PointsKO-Adjacents,66
Dichaetanthera_tsaratananensis,7,3,4,Points-PointsKO-Adjacents,55
Dichapetalum_asplundeanum,11,3,8,Points-PointsKO-Adjacents,73
Dichapetalum_axillare,111,86,25,Alphahull-PointsKO-Adjacents,1096
Dichapetalum_barbosae,19,1,18,Points-PointsKO-Adjacents,155
Dichapetalum_barteri,46,24,22,Alphahull-PointsKO-Adjacents,275
Dichapetalum_bocageanum,3,3,0,Points-PointsKO-Adjacents,16
Dichapetalum_brenesii,54,43,11,Alphahull-PointsKO-Adjacents,125
Dichapetalum_cymosum,94,64,30,Alphahull-PointsKO-Adjacents,3721
Dichapetalum_donnell-smithii,185,147,38,Alphahull-PointsKO-Adjacents,4113
Dichapetalum_foreroi,2,2,0,Points-PointsKO-Adjacents,16
Dichapetalum_fructuosum,17,0,17,Points-PointsKO-Adjacents,136
Dichapetalum_gelonioides,33,2,31,Points-PointsKO-Adjacents,279
Dichapetalum_germainii,13,3,10,Points-PointsKO-Adjacents,111
Dichapetalum_glomeratum,65,40,25,Alphahull-PointsKO-Adjacents,2381
Dichapetalum_griffithii,1,1,0,Points-PointsKO-Adjacents,9
Dichapetalum_helferianum,0,0,0,NA,0
Dichapetalum_heudelotii,460,377,83,Alphahull-PointsKO-Adjacents,14126
Dichapetalum_insigne,70,54,16,Alphahull-PointsKO-Adjacents,1634
Dichapetalum_latifolium,14,1,13,Points-PointsKO-Adjacents,126
Dichapetalum_laurocerasus,1,1,0,Points-PointsKO-Adjacents,7
Dichapetalum_longipetalum,15,2,13,Points-PointsKO-Adjacents,107
Dichapetalum_madagascariense,601,481,120,Alphahull-PointsKO-Adjacents,17166
Dichapetalum_mexicanum,4,3,1,Points-PointsKO-Adjacents,26
Dichapetalum_moralesii,19,12,7,Points-PointsKO-Adjacents,126
Dichapetalum_morenoi,29,22,7,Alphahull-PointsKO-Adjacents,354
Dichapetalum_mossambicense,70,50,20,Alphahull-PointsKO-Adjacents,424
Dichapetalum_nervatum,33,19,14,Points-PointsKO-Adjacents,133
Dichapetalum_nevermannianum,9,6,3,Points-PointsKO-Adjacents,52
Dichapetalum_obanense,1,1,0,Points-PointsKO-Adjacents,9
Dichapetalum_odoratum,53,15,38,Points-PointsKO-Adjacents,380
Dichapetalum_pulchrum,10,5,5,Points-PointsKO-Adjacents,48
Dichapetalum_rugosum,121,43,78,Alphahull-PointsKO-Adjacents,8757
Dichapetalum_sordidum,0,0,0,NA,0
Dichapetalum_spruceanum,114,84,30,Alphahull-PointsKO-Adjacents,6778
Dichapetalum_stuhlmannii,40,13,27,Points-PointsKO-Adjacents,267
Dichapetalum_tenerum,1,1,0,Points-PointsKO-Adjacents,9
Dichapetalum_tenuifolium,2,2,0,Points-PointsKO-Adjacents,18
Dichapetalum_timoriense,38,9,29,Points-PointsKO-Adjacents,295
Dichapetalum_tricapsulare,0,0,0,NA,0
Dichapetalum_ugandense,9,0,9,Points-PointsKO-Adjacents,72
Dichapetalum_virchowii,13,7,6,Points-PointsKO-Adjacents,65
Dichapetalum_zenkeri,95,59,36,Alphahull-PointsKO-Adjacents,3453
Dichilanthe_borneensis,1,1,0,Points-PointsKO-Adjacents,9
Dichilanthe_zeylanica,0,0,0,NA,0
Dichostemma_glaucescens,260,224,36,Alphahull-PointsKO-Adjacents,5231
Dichostemma_zenkeri,2,2,0,Points-PointsKO-Adjacents,18
Dichotomanthes_tristaniicarpa,19,9,10,Points-PointsKO-Adjacents,169
Dichrostachys_arborescens,22,8,14,Points-PointsKO-Adjacents,129
Dichrostachys_dehiscens,3,3,0,Points-PointsKO-Adjacents,10
Dichrostachys_kirkii,2,2,0,Points-PointsKO-Adjacents,18
Dichrostachys_myriophylla,9,4,5,Points-PointsKO-Adjacents,40
Dichrostachys_spicata,251,215,36,Alphahull-PointsKO-Adjacents,6036
Dichrostachys_unijuga,16,4,12,Points-PointsKO-Adjacents,139
Diclidanthera_octandra,16,4,12,Points-PointsKO-Adjacents,142
Diclinanona_calycina,118,81,37,Alphahull-PointsKO-Adjacents,9738
Diclinanona_matogrossensis,9,1,8,Points-PointsKO-Adjacents,80
Diclinanona_tessmannii,50,36,14,Alphahull-PointsKO-Adjacents,611
Dicoelia_beccariana,9,1,8,Points-PointsKO-Adjacents,60
Dicoelia_sumatrana,NA,NA,NA,NA,NA
Dicoma_carbonaria,23,14,9,Points-PointsKO-Adjacents,145
Dicoma_incana,30,19,11,Points-PointsKO-Adjacents,220
Dicorynia_guianensis,56,43,13,Alphahull-PointsKO-Adjacents,1270
Dicorynia_paraensis,136,95,41,Alphahull-PointsKO-Adjacents,8318
Dicoryphe_lanceolata,0,0,0,NA,0
Dicoryphe_macrophylla,14,4,10,Points-PointsKO-Adjacents,93
Dicoryphe_noronhae,8,4,4,Points-PointsKO-Adjacents,17
Dicoryphe_stipulacea,91,71,20,Alphahull-PointsKO-Adjacents,623
Dicraeopetalum_capuronianum,12,6,6,Points-PointsKO-Adjacents,80
Dicraeopetalum_mahafaliense,38,30,8,Alphahull-PointsKO-Adjacents,216
Dicraeopetalum_stipulare,2,2,0,Points-PointsKO-Adjacents,18
Dicranolepis_buchholzii,203,155,48,Alphahull-PointsKO-Adjacents,18227
Dicranolepis_disticha,286,230,56,Alphahull-PointsKO-Adjacents,10098
Dicranolepis_incisa,2,2,0,Points-PointsKO-Adjacents,18
Dicranolepis_persei,119,95,24,Alphahull-PointsKO-Adjacents,1413
Dicranolepis_pulcherrima,89,63,26,Alphahull-PointsKO-Adjacents,4232
Dicranolepis_pyramidalis,4,4,0,Points-PointsKO-Adjacents,32
Dicranolepis_soyauxii,94,74,20,Alphahull-PointsKO-Adjacents,1854
Dicranolepis_usambarica,52,42,10,Alphahull-PointsKO-Adjacents,503
Dicranolepis_vestita,54,46,8,Alphahull-PointsKO-Adjacents,1438
Dicraspidia_donnell-smithii,113,86,27,Alphahull-PointsKO-Adjacents,895
Dictyocaryum_fuscum,8,3,5,Points-PointsKO-Adjacents,59
Dictyocaryum_lamarckianum,193,141,52,Alphahull-PointsKO-Adjacents,4290
Dictyocaryum_ptarianum,35,10,25,Points-PointsKO-Adjacents,253
Dictyoloma_peruvianum,231,167,64,Alphahull-PointsKO-Adjacents,12722
Dictyoloma_vandellianum,631,538,93,Alphahull-PointsKO-Adjacents,14062
Dictyoneura_acuminata,14,3,11,Points-PointsKO-Adjacents,102
Dictyoneura_obtusa,40,26,14,Alphahull-PointsKO-Adjacents,1067
Dictyosperma_album,16,8,8,Points-PointsKO-Adjacents,51
Dicymbe_altsonii,16,10,6,Points-PointsKO-Adjacents,88
Dicymbe_amazonica,4,4,0,Points-PointsKO-Adjacents,17
Dicymbe_arenicola,19,2,17,Points-PointsKO-Adjacents,162
Dicymbe_bernardii,9,5,4,Points-PointsKO-Adjacents,46
Dicymbe_corymbosa,20,7,13,Points-PointsKO-Adjacents,111
Dicymbe_duidae,2,2,0,Points-PointsKO-Adjacents,18
Dicymbe_fraterna,24,15,9,Points-PointsKO-Adjacents,142
Dicymbe_froesii,5,5,0,Points-PointsKO-Adjacents,39
Dicymbe_heteroxylon,3,3,0,Points-PointsKO-Adjacents,23
Dicymbe_hymenaea,4,4,0,Points-PointsKO-Adjacents,24
Dicymbe_jenmanii,14,9,5,Points-PointsKO-Adjacents,50
Dicymbe_mollis,3,3,0,Points-PointsKO-Adjacents,27
Dicymbe_neblinensis,3,3,0,Points-PointsKO-Adjacents,18
Dicymbe_pharangophila,10,0,10,Points-PointsKO-Adjacents,40
Dicymbe_praeruptorum,3,3,0,Points-PointsKO-Adjacents,23
Dicymbe_puncticulosa,9,7,2,Points-PointsKO-Adjacents,54
Dicymbe_stipitata,9,2,7,Points-PointsKO-Adjacents,81
Dicymbe_uaiparuensis,27,0,27,Points-PointsKO-Adjacents,199
Dicymbe_yutajensis,2,2,0,Points-PointsKO-Adjacents,12
Dicypellium_caryophyllaceum,17,3,14,Points-PointsKO-Adjacents,153
Dicypellium_caryophyllatum,5,3,2,Points-PointsKO-Adjacents,45
Dicypellium_manausense,12,0,12,Points-PointsKO-Adjacents,53
Didelotia_africana,47,31,16,Alphahull-PointsKO-Adjacents,1726
Didelotia_afzelii,9,3,6,Points-PointsKO-Adjacents,56
Didelotia_engleri,3,3,0,Points-PointsKO-Adjacents,19
Didelotia_idae,31,19,12,Points-PointsKO-Adjacents,225
Didelotia_ledermannii,1,1,0,Points-PointsKO-Adjacents,7
Didelotia_letouzeyi,27,16,11,Points-PointsKO-Adjacents,203
Didelotia_minutiflora,16,11,5,Points-PointsKO-Adjacents,92
Didelotia_morelii,2,2,0,Points-PointsKO-Adjacents,18
Didelotia_pauli-sitai,6,4,2,Points-PointsKO-Adjacents,23
Didelotia_unifoliolata,25,5,20,Points-PointsKO-Adjacents,169
Didelta_spinosa,71,54,17,Alphahull-PointsKO-Adjacents,700
Didesmandra_aspera,1,1,0,Points-PointsKO-Adjacents,9
Didierea_madagascariensis,29,21,8,Alphahull-PointsKO-Adjacents,95
Didierea_trollii,10,3,7,Points-PointsKO-Adjacents,64
Didymeles_integrifolia,35,18,17,Points-PointsKO-Adjacents,191
Didymeles_madagascariensis,0,0,0,NA,0
Didymeles_perrieri,31,17,14,Points-PointsKO-Adjacents,133
Didymocistus_chrysadenius,63,41,22,Alphahull-PointsKO-Adjacents,730
Didymosalpinx_norae,37,19,18,Points-PointsKO-Adjacents,200
Dieffenbachia_tefensis,1,1,0,Points-PointsKO-Adjacents,9
Diegodendron_humbertii,15,7,8,Points-PointsKO-Adjacents,70
Dielsiothamnus_divaricatus,5,0,5,Points-PointsKO-Adjacents,43
Digomphia_densicoma,109,83,26,Alphahull-PointsKO-Adjacents,5633
Digomphia_laurifolia,76,60,16,Alphahull-PointsKO-Adjacents,1566
Dilkea_exilis,1,1,0,Points-PointsKO-Adjacents,9
Dilkea_retusa,129,74,55,Alphahull-PointsKO-Adjacents,10145
Dillenia_alata,251,70,181,Alphahull-PointsKO-Adjacents,1151
Dillenia_albiflos,0,0,0,NA,0
Dillenia_andamanica,0,0,0,NA,0
Dillenia_aurea,4,4,0,Points-PointsKO-Adjacents,32
Dillenia_auriculata,7,2,5,Points-PointsKO-Adjacents,57
Dillenia_beccariana,7,1,6,Points-PointsKO-Adjacents,60
Dillenia_biflora,7,0,7,Points-PointsKO-Adjacents,45
Dillenia_blanchardii,1,1,0,Points-PointsKO-Adjacents,7
Dillenia_bolsteri,6,0,6,Points-PointsKO-Adjacents,51
Dillenia_borneensis,5,0,5,Points-PointsKO-Adjacents,45
Dillenia_bracteata,0,0,0,NA,0
Dillenia_castaneifolia,38,21,17,Alphahull-PointsKO-Adjacents,666
Dillenia_celebica,6,3,3,Points-PointsKO-Adjacents,49
Dillenia_crenatifolia,0,0,0,NA,0
Dillenia_cyclopensis,0,0,0,NA,0
Dillenia_diantha,3,3,0,Points-PointsKO-Adjacents,23
Dillenia_excelsa,68,46,22,Alphahull-PointsKO-Adjacents,4257
Dillenia_eximia,7,1,6,Points-PointsKO-Adjacents,62
Dillenia_fagifolia,1,1,0,Points-PointsKO-Adjacents,9
Dillenia_ferruginea,3,3,0,Points-PointsKO-Adjacents,15
Dillenia_fischeri,1,1,0,Points-PointsKO-Adjacents,9
Dillenia_hookeri,13,4,9,Points-PointsKO-Adjacents,117
Dillenia_indica,41,9,32,Points-PointsKO-Adjacents,358
Dillenia_ingens,1,1,0,Points-PointsKO-Adjacents,9
Dillenia_insignis,0,0,0,NA,0
Dillenia_insularum,6,2,4,Points-PointsKO-Adjacents,34
Dillenia_luzoniensis,3,3,0,Points-PointsKO-Adjacents,23
Dillenia_mansonii,NA,NA,NA,NA,NA
Dillenia_marsupialis,0,0,0,NA,0
Dillenia_megalantha,2,2,0,Points-PointsKO-Adjacents,18
Dillenia_monantha,2,2,0,Points-PointsKO-Adjacents,18
Dillenia_montana,16,9,7,Points-PointsKO-Adjacents,77
Dillenia_nalagi,6,1,5,Points-PointsKO-Adjacents,26
Dillenia_obovata,7,1,6,Points-PointsKO-Adjacents,57
Dillenia_ochreata,6,0,6,Points-PointsKO-Adjacents,51
Dillenia_ovalifolia,14,7,7,Points-PointsKO-Adjacents,58
Dillenia_ovata,17,2,15,Points-PointsKO-Adjacents,136
Dillenia_papuana,30,11,19,Points-PointsKO-Adjacents,154
Dillenia_parkinsonii,0,0,0,NA,0
Dillenia_parviflora,3,0,3,Points-PointsKO-Adjacents,23
Dillenia_pentagyna,20,0,20,Points-PointsKO-Adjacents,171
Dillenia_philippinensis,6,0,6,Points-PointsKO-Adjacents,51
Dillenia_ptempoda,0,0,0,NA,0
Dillenia_pulchella,7,1,6,Points-PointsKO-Adjacents,38
Dillenia_quercifolia,9,1,8,Points-PointsKO-Adjacents,63
Dillenia_reifferscheidia,1,1,0,Points-PointsKO-Adjacents,9
Dillenia_reticulata,1,0,1,Points-PointsKO-Adjacents,9
Dillenia_retusa,1,0,1,Points-PointsKO-Adjacents,6
Dillenia_salomonensis,1,1,0,Points-PointsKO-Adjacents,9
Dillenia_scabrella,3,1,2,Points-PointsKO-Adjacents,25
Dillenia_schlechteri,23,8,15,Points-PointsKO-Adjacents,169
Dillenia_serrata,11,3,8,Points-PointsKO-Adjacents,92
Dillenia_sibuyanensis,3,3,0,Points-PointsKO-Adjacents,15
Dillenia_suffruticosa,44,19,25,Points-PointsKO-Adjacents,224
Dillenia_sumatrana,18,6,12,Points-PointsKO-Adjacents,137
Dillenia_talaudensis,0,0,0,NA,0
Dillenia_triquetra,105,76,29,Alphahull-PointsKO-Adjacents,811
Dillenia_turbinata,20,9,11,Points-PointsKO-Adjacents,165
Dilobeia_tenuinervis,5,5,0,Points-PointsKO-Adjacents,35
Dilobeia_thouarsii,177,152,25,Alphahull-PointsKO-Adjacents,2432
Dilodendron_bipinnatum,622,563,59,Alphahull-PointsKO-Adjacents,26994
Dilodendron_costaricense,130,94,36,Alphahull-PointsKO-Adjacents,2244
Dilodendron_elegans,45,16,29,Points-PointsKO-Adjacents,292
Dimocarpus_australianus,36,21,15,Alphahull-PointsKO-Adjacents,99
Dimocarpus_confinis,13,6,7,Points-PointsKO-Adjacents,117
Dimocarpus_dentatus,1,1,0,Points-PointsKO-Adjacents,9
Dimocarpus_foveolatus,0,0,0,NA,0
Dimocarpus_fumatus,3,0,3,Points-PointsKO-Adjacents,24
Dimocarpus_gardneri,1,1,0,Points-PointsKO-Adjacents,9
Dimocarpus_leichhardtii,41,35,6,Alphahull-PointsKO-Adjacents,132
Dimocarpus_longan,381,252,129,Alphahull-PointsKO-Adjacents,7099
Dimocarpus_yunnanensis,NA,NA,NA,NA,NA
Dimorphandra_campinarum,12,3,9,Points-PointsKO-Adjacents,102
Dimorphandra_caudata,13,3,10,Points-PointsKO-Adjacents,108
Dimorphandra_coccinea,22,0,22,Points-PointsKO-Adjacents,138
Dimorphandra_conjugata,21,11,10,Points-PointsKO-Adjacents,159
Dimorphandra_cuprea,149,98,51,Alphahull-PointsKO-Adjacents,12921
Dimorphandra_davisii,20,11,9,Points-PointsKO-Adjacents,144
Dimorphandra_dissimilis,3,3,0,Points-PointsKO-Adjacents,23
Dimorphandra_exaltata,51,0,51,Points-PointsKO-Adjacents,368
Dimorphandra_gardneriana,442,389,53,Alphahull-PointsKO-Adjacents,21105
Dimorphandra_gigantea,5,5,0,Points-PointsKO-Adjacents,41
Dimorphandra_ignea,9,2,7,Points-PointsKO-Adjacents,55
Dimorphandra_jorgei,50,26,24,Alphahull-PointsKO-Adjacents,1106
Dimorphandra_loretensis,9,2,7,Points-PointsKO-Adjacents,79
Dimorphandra_macrostachya,232,161,71,Alphahull-PointsKO-Adjacents,16474
Dimorphandra_mediocris,6,2,4,Points-PointsKO-Adjacents,43
Dimorphandra_mollis,829,746,83,Alphahull-PointsKO-Adjacents,34851
Dimorphandra_multiflora,12,1,11,Points-PointsKO-Adjacents,106
Dimorphandra_parviflora,78,36,42,Alphahull-PointsKO-Adjacents,4002
Dimorphandra_pennigera,125,83,42,Alphahull-PointsKO-Adjacents,9911
Dimorphandra_polyandra,19,11,8,Points-PointsKO-Adjacents,129
Dimorphandra_pullei,29,11,18,Points-PointsKO-Adjacents,220
Dimorphandra_unijuga,42,0,42,Points-PointsKO-Adjacents,332
Dimorphandra_urubuensis,16,3,13,Points-PointsKO-Adjacents,116
Dimorphandra_vernicosa,95,72,23,Alphahull-PointsKO-Adjacents,1875
Dimorphandra_williamii,2,2,0,Points-PointsKO-Adjacents,18
Dimorphandra_wilsonii,26,16,10,Points-PointsKO-Adjacents,98
Dimorphanthera_amplifolia,165,146,19,Alphahull-PointsKO-Adjacents,782
Dimorphanthera_cornuta,75,58,17,Alphahull-PointsKO-Adjacents,321
Dimorphanthera_elegantissima,39,27,12,Alphahull-PointsKO-Adjacents,346
Dimorphanthera_kalkmanii,3,3,0,Points-PointsKO-Adjacents,17
Dimorphanthera_keysseri,82,64,18,Alphahull-PointsKO-Adjacents,706
Dimorphanthera_macbainii,21,17,4,Points-PointsKO-Adjacents,74
Dimorphanthera_microphylla,15,10,5,Points-PointsKO-Adjacents,33
Dimorphanthera_pulchra,1,1,0,Points-PointsKO-Adjacents,9
Dimorphanthera_robbinsii,19,13,6,Points-PointsKO-Adjacents,79
Dimorphanthera_womersleyi,8,0,8,Points-PointsKO-Adjacents,60
Dimorphocalyx_angustifolius,NA,NA,NA,NA,NA
Dimorphocalyx_australiensis,100,76,24,Alphahull-PointsKO-Adjacents,528
Dimorphocalyx_balakrishnanii,NA,NA,NA,NA,NA
Dimorphocalyx_beddomei,0,0,0,NA,0
Dimorphocalyx_denticulatus,13,2,11,Points-PointsKO-Adjacents,107
Dimorphocalyx_glabellus,2,2,0,Points-PointsKO-Adjacents,18
Dimorphocalyx_ixoroides,0,0,0,NA,0
Dimorphocalyx_malayanus,9,1,8,Points-PointsKO-Adjacents,74
Dimorphocalyx_muricatus,17,2,15,Points-PointsKO-Adjacents,146
Dimorphocalyx_pauciflorus,1,1,0,Points-PointsKO-Adjacents,9
Dimorphocalyx_poilanei,2,2,0,Points-PointsKO-Adjacents,18
Dinghoua_globularis,53,41,12,Alphahull-PointsKO-Adjacents,75
Dinizia_excelsa,141,97,44,Alphahull-PointsKO-Adjacents,20598
Dinoseris_salicifolia,59,0,59,Points-PointsKO-Adjacents,398
Dinosperma_erythrococca,216,0,216,Points-PointsKO-Adjacents,927
Dioclea_guianensis,441,288,153,Alphahull-PointsKO-Adjacents,28025
Dioclea_virgata,691,464,227,Alphahull-PointsKO-Adjacents,69506
Dioecrescis_erythroclada,4,4,0,Points-PointsKO-Adjacents,36
Diogenesia_vargasiana,5,5,0,Points-PointsKO-Adjacents,39
Diogoa_retivenia,5,3,2,Points-PointsKO-Adjacents,40
Diogoa_zenkeri,199,167,32,Alphahull-PointsKO-Adjacents,3772
Dioicodendron_dioicum,172,127,45,Alphahull-PointsKO-Adjacents,3492
Diospyros_abyssinica,247,168,79,Alphahull-PointsKO-Adjacents,6457
Diospyros_acapulcensis,456,389,67,Alphahull-PointsKO-Adjacents,6926
Diospyros_acocksii,10,0,10,Points-PointsKO-Adjacents,90
Diospyros_acris,0,0,0,NA,0
Diospyros_aculeata,42,25,17,Alphahull-PointsKO-Adjacents,166
Diospyros_acuminata,1,1,0,Points-PointsKO-Adjacents,9
Diospyros_acuta,0,0,0,NA,0
Diospyros_addita,0,0,0,NA,0
Diospyros_adenophora,0,0,0,NA,0
Diospyros_adiensis,0,0,0,NA,0
Diospyros_aequoris,68,37,31,Alphahull-PointsKO-Adjacents,501
Diospyros_affinis,0,0,0,NA,0
Diospyros_aifatensis,0,0,0,NA,0
Diospyros_alatella,0,0,0,NA,0
Diospyros_albiflora,0,0,0,NA,0
Diospyros_alboflavescens,4,3,1,Points-PointsKO-Adjacents,32
Diospyros_alisu,NA,NA,NA,NA,NA
Diospyros_alpina,3,3,0,Points-PointsKO-Adjacents,21
Diospyros_amabi,4,4,0,Points-PointsKO-Adjacents,24
Diospyros_amanap,1,1,0,Points-PointsKO-Adjacents,9
Diospyros_amaniensis,19,7,12,Points-PointsKO-Adjacents,74
Diospyros_amboinensis,1,1,0,Points-PointsKO-Adjacents,9
Diospyros_analamerensis,22,0,22,Points-PointsKO-Adjacents,85
Diospyros_andamanica,11,5,6,Points-PointsKO-Adjacents,64
Diospyros_angulata,0,0,0,NA,0
Diospyros_anisandra,188,0,188,Points-PointsKO-Adjacents,584
Diospyros_anisocalyx,14,1,13,Points-PointsKO-Adjacents,126
Diospyros_anitae,7,0,7,Points-PointsKO-Adjacents,45
Diospyros_ankifiensis,4,3,1,Points-PointsKO-Adjacents,24
Diospyros_anosivolensis,2,2,0,Points-PointsKO-Adjacents,9
Diospyros_apeibocarpos,4,4,0,Points-PointsKO-Adjacents,33
Diospyros_apiculata,4,1,3,Points-PointsKO-Adjacents,36
Diospyros_araripensis,0,0,0,NA,0
Diospyros_areolata,4,1,3,Points-PointsKO-Adjacents,36
Diospyros_areolifolia,5,5,0,Points-PointsKO-Adjacents,33
Diospyros_argentea,1,0,1,Points-PointsKO-Adjacents,9
Diospyros_armata,1,1,0,Points-PointsKO-Adjacents,9
Diospyros_artanthifolia,129,67,62,Alphahull-PointsKO-Adjacents,9892
Diospyros_arupaj,1,1,0,Points-PointsKO-Adjacents,9
Diospyros_atrata,0,0,0,NA,0
Diospyros_atrotricha,1,1,0,Points-PointsKO-Adjacents,9
Diospyros_attenuata,1,0,1,Points-PointsKO-Adjacents,9
Diospyros_aurea,1,0,1,Points-PointsKO-Adjacents,9
Diospyros_australis,1736,1641,95,Alphahull-PointsKO-Adjacents,3820
Diospyros_balansae,10,4,6,Points-PointsKO-Adjacents,62
Diospyros_balfouriana,1,1,0,Points-PointsKO-Adjacents,9
Diospyros_bambuseti,0,0,0,NA,0
Diospyros_bangkana,NA,NA,NA,NA,NA
Diospyros_bangoiensis,0,0,0,NA,0
Diospyros_baranensis,2,2,0,Points-PointsKO-Adjacents,10
Diospyros_barberi,0,0,0,NA,0
Diospyros_baroniana,5,2,3,Points-PointsKO-Adjacents,21
Diospyros_barteri,20,4,16,Points-PointsKO-Adjacents,158
Diospyros_batocana,16,4,12,Points-PointsKO-Adjacents,132
Diospyros_beccarioides,0,0,0,NA,0
Diospyros_bejaudii,6,0,6,Points-PointsKO-Adjacents,54
Diospyros_bemarivensis,9,1,8,Points-PointsKO-Adjacents,66
Diospyros_benstonei,3,3,0,Points-PointsKO-Adjacents,8
Diospyros_bernieriana,29,16,13,Points-PointsKO-Adjacents,121
Diospyros_bezofensis,7,2,5,Points-PointsKO-Adjacents,31
Diospyros_bibracteata,0,0,0,NA,0
Diospyros_bipindensis,126,93,33,Alphahull-PointsKO-Adjacents,3017
Diospyros_blepharophylla,1,1,0,Points-PointsKO-Adjacents,9
Diospyros_blumutensis,0,0,0,NA,0
Diospyros_boala,26,14,12,Points-PointsKO-Adjacents,198
Diospyros_boinensis,4,4,0,Points-PointsKO-Adjacents,36
Diospyros_boiviniana,2,2,0,Points-PointsKO-Adjacents,8
Diospyros_boivinii,28,16,12,Points-PointsKO-Adjacents,131
Diospyros_bonii,1,1,0,Points-PointsKO-Adjacents,9
Diospyros_borbonica,0,0,0,NA,0
Diospyros_borneensis,20,11,9,Points-PointsKO-Adjacents,144
Diospyros_bourdillonii,0,0,0,NA,0
Diospyros_boutoniana,6,1,5,Points-PointsKO-Adjacents,25
Diospyros_brainii,NA,NA,NA,NA,NA
Diospyros_brandisiana,6,0,6,Points-PointsKO-Adjacents,45
Diospyros_brasiliensis,18,3,15,Points-PointsKO-Adjacents,130
Diospyros_brassica,5,5,0,Points-PointsKO-Adjacents,20
Diospyros_brevicalyx,NA,NA,NA,NA,NA
Diospyros_brideliifolia,2,2,0,Points-PointsKO-Adjacents,16
Diospyros_britannoborneensis,4,3,1,Points-PointsKO-Adjacents,30
Diospyros_bullata,11,2,9,Points-PointsKO-Adjacents,91
Diospyros_bumelioides,58,48,10,Alphahull-PointsKO-Adjacents,542
Diospyros_burmanica,2,1,1,Points-PointsKO-Adjacents,18
Diospyros_bussei,23,8,15,Points-PointsKO-Adjacents,176
Diospyros_buxifolia,16,1,15,Points-PointsKO-Adjacents,129
Diospyros_cacharensis,0,0,0,NA,0
Diospyros_cachimboensis,0,0,0,NA,0
Diospyros_calcicola,0,0,0,NA,0
Diospyros_calciphila,20,15,5,Points-PointsKO-Adjacents,54
Diospyros_californica,16,8,8,Points-PointsKO-Adjacents,89
Diospyros_caloneura,1,1,0,Points-PointsKO-Adjacents,9
Diospyros_calophylla,32,18,14,Points-PointsKO-Adjacents,181
Diospyros_calycantha,524,489,35,Alphahull-PointsKO-Adjacents,2590
Diospyros_cambodiana,0,0,0,NA,0
Diospyros_campanulata,0,0,0,NA,0
Diospyros_canaliculata,102,61,41,Alphahull-PointsKO-Adjacents,2213
Diospyros_candolleana,1,0,1,Points-PointsKO-Adjacents,9
Diospyros_capreifolia,72,31,41,Alphahull-PointsKO-Adjacents,2780
Diospyros_capricornuta,4,4,0,Points-PointsKO-Adjacents,30
Diospyros_carbonaria,11,3,8,Points-PointsKO-Adjacents,87
Diospyros_caribaea,2,2,0,Points-PointsKO-Adjacents,18
Diospyros_carpinifolia,1,1,0,Points-PointsKO-Adjacents,9
Diospyros_castanea,6,0,6,Points-PointsKO-Adjacents,54
Diospyros_cathayensis,15,3,12,Points-PointsKO-Adjacents,135
Diospyros_caudisepala,1,1,0,Points-PointsKO-Adjacents,9
Diospyros_cauliflora,36,0,36,Points-PointsKO-Adjacents,274
Diospyros_cauligera,6,1,5,Points-PointsKO-Adjacents,30
Diospyros_cavalcantei,4,0,4,Points-PointsKO-Adjacents,33
Diospyros_cayennensis,21,6,15,Points-PointsKO-Adjacents,161
Diospyros_celebica,4,4,0,Points-PointsKO-Adjacents,30
Diospyros_chaetocarpa,1,1,0,Points-PointsKO-Adjacents,9
Diospyros_chamaethamnus,24,12,12,Points-PointsKO-Adjacents,212
Diospyros_chartacea,1,1,0,Points-PointsKO-Adjacents,9
Diospyros_cherrieri,4,4,0,Points-PointsKO-Adjacents,21
Diospyros_chevalieri,95,77,18,Alphahull-PointsKO-Adjacents,1131
Diospyros_chloroxylon,1,1,0,Points-PointsKO-Adjacents,9
Diospyros_choboensis,0,0,0,NA,0
Diospyros_christophersenii,1,1,0,Points-PointsKO-Adjacents,9
Diospyros_chrysocarpa,8,3,5,Points-PointsKO-Adjacents,45
Diospyros_chrysophyllos,3,3,0,Points-PointsKO-Adjacents,19
Diospyros_chunii,3,3,0,Points-PointsKO-Adjacents,18
Diospyros_cinnabarina,167,148,19,Alphahull-PointsKO-Adjacents,2854
Diospyros_cinnamomoides,70,51,19,Alphahull-PointsKO-Adjacents,1012
Diospyros_clementium,1,1,0,Points-PointsKO-Adjacents,9
Diospyros_clusiifolia,15,0,15,Points-PointsKO-Adjacents,83
Diospyros_coaetanca,0,0,0,NA,0
Diospyros_coccolobifolia,25,3,22,Points-PointsKO-Adjacents,221
Diospyros_collinsiae,0,0,0,NA,0
Diospyros_comorensis,22,13,9,Points-PointsKO-Adjacents,75
Diospyros_confertiflora,9,1,8,Points-PointsKO-Adjacents,58
Diospyros_conformis,1,1,0,Points-PointsKO-Adjacents,9
Diospyros_conifera,3,0,3,Points-PointsKO-Adjacents,27
Diospyros_conocarpa,140,116,24,Alphahull-PointsKO-Adjacents,3575
Diospyros_consanguinea,4,4,0,Points-PointsKO-Adjacents,36
Diospyros_consolatae,29,8,21,Points-PointsKO-Adjacents,184
Diospyros_conzattii,76,47,29,Alphahull-PointsKO-Adjacents,580
Diospyros_cooperi,41,24,17,Alphahull-PointsKO-Adjacents,947
Diospyros_corallina,1,1,0,Points-PointsKO-Adjacents,9
Diospyros_cordata,0,0,0,NA,0
Diospyros_cordato-oblonga,6,2,4,Points-PointsKO-Adjacents,37
Diospyros_coriacea,4,1,3,Points-PointsKO-Adjacents,27
Diospyros_coursiana,2,2,0,Points-PointsKO-Adjacents,9
Diospyros_crassiflora,87,63,24,Alphahull-PointsKO-Adjacents,4352
Diospyros_crassinervis,7,0,7,Points-PointsKO-Adjacents,42
Diospyros_crebripilis,2,2,0,Points-PointsKO-Adjacents,12
Diospyros_crockerensis,NA,NA,NA,NA,NA
Diospyros_crumenata,0,0,0,NA,0
Diospyros_cupulifera,46,30,16,Alphahull-PointsKO-Adjacents,429
Diospyros_curranii,8,0,8,Points-PointsKO-Adjacents,58
Diospyros_daemona,0,0,0,NA,0
Diospyros_dalyom,3,3,0,Points-PointsKO-Adjacents,27
Diospyros_danguyana,28,18,10,Points-PointsKO-Adjacents,163
Diospyros_dasyphylla,8,1,7,Points-PointsKO-Adjacents,61
Diospyros_decandra,6,0,6,Points-PointsKO-Adjacents,48
Diospyros_decaryana,9,1,8,Points-PointsKO-Adjacents,44
Diospyros_defectrix,8,0,8,Points-PointsKO-Adjacents,72
Diospyros_dendo,109,79,30,Alphahull-PointsKO-Adjacents,2247
Diospyros_densiflora,1,1,0,Points-PointsKO-Adjacents,9
Diospyros_dichroa,2,0,2,Points-PointsKO-Adjacents,18
Diospyros_dichrophylla,125,93,32,Alphahull-PointsKO-Adjacents,1500
Diospyros_dicorypheoides,5,0,5,Points-PointsKO-Adjacents,36
Diospyros_dictyoneura,2,0,2,Points-PointsKO-Adjacents,18
Diospyros_diepenhorstii,3,0,3,Points-PointsKO-Adjacents,27
Diospyros_dinhensis,0,0,0,NA,0
Diospyros_discocalyx,1,0,1,Points-PointsKO-Adjacents,9
Diospyros_discolor,45,29,16,Alphahull-PointsKO-Adjacents,130
Diospyros_diversifolia,0,0,0,NA,0
Diospyros_diversilimba,5,4,1,Points-PointsKO-Adjacents,32
Diospyros_dodecandra,0,0,0,NA,0
Diospyros_dolmen,6,0,6,Points-PointsKO-Adjacents,54
Diospyros_domarkind,0,0,0,NA,0
Diospyros_domingensis,1,0,1,Points-PointsKO-Adjacents,9
Diospyros_duartei,7,0,7,Points-PointsKO-Adjacents,54
Diospyros_dumetorum,36,17,19,Points-PointsKO-Adjacents,324
Diospyros_dussaudii,0,0,0,NA,0
Diospyros_ebenifera,4,4,0,Points-PointsKO-Adjacents,27
Diospyros_ebenoides,0,0,0,NA,0
Diospyros_ebenum,1,0,1,Points-PointsKO-Adjacents,9
Diospyros_eburnea,0,0,0,NA,0
Diospyros_egleri,7,1,6,Points-PointsKO-Adjacents,62
Diospyros_egrettarum,4,4,0,Points-PointsKO-Adjacents,13
Diospyros_ehretioides,8,0,8,Points-PointsKO-Adjacents,63
Diospyros_ekodul,4,4,0,Points-PointsKO-Adjacents,20
Diospyros_elegans,0,0,0,NA,0
Diospyros_elephasii,0,0,0,NA,0
Diospyros_elliotii,28,8,20,Points-PointsKO-Adjacents,193
Diospyros_ellipsoidea,0,0,0,NA,0
Diospyros_elliptifolia,10,0,10,Points-PointsKO-Adjacents,81
Diospyros_enervis,6,1,5,Points-PointsKO-Adjacents,44
Diospyros_eriantha,373,312,61,Alphahull-PointsKO-Adjacents,1775
Diospyros_erinacea,3,3,0,Points-PointsKO-Adjacents,26
Diospyros_erudita,3,3,0,Points-PointsKO-Adjacents,23
Diospyros_erythrosperma,31,21,10,Alphahull-PointsKO-Adjacents,777
Diospyros_esmereg,1,1,0,Points-PointsKO-Adjacents,9
Diospyros_eucalyptifolia,0,0,0,NA,0
Diospyros_euphlehia,0,0,0,NA,0
Diospyros_evena,2,0,2,Points-PointsKO-Adjacents,18
Diospyros_everettii,0,0,0,NA,0
Diospyros_fanjingshanica,NA,NA,NA,NA,NA
Diospyros_fasciculosa,257,197,60,Alphahull-PointsKO-Adjacents,1350
Diospyros_fastidiosa,3,3,0,Points-PointsKO-Adjacents,12
Diospyros_feliciana,2,2,0,Points-PointsKO-Adjacents,18
Diospyros_fenal,0,0,0,NA,0
Diospyros_fengchangensis,0,0,0,NA,0
Diospyros_fengii,0,0,0,NA,0
Diospyros_ferox,1,1,0,Points-PointsKO-Adjacents,9
Diospyros_ferrea,58,14,44,Points-PointsKO-Adjacents,414
Diospyros_ferruginescens,1,0,1,Points-PointsKO-Adjacents,9
Diospyros_filipendula,5,0,5,Points-PointsKO-Adjacents,36
Diospyros_filipes,8,2,6,Points-PointsKO-Adjacents,38
Diospyros_fischeri,23,13,10,Points-PointsKO-Adjacents,159
Diospyros_flavocarpa,25,15,10,Points-PointsKO-Adjacents,81
Diospyros_fleuryana,NA,NA,NA,NA,NA
Diospyros_foliolosa,1,0,1,Points-PointsKO-Adjacents,9
Diospyros_foliosa,32,12,20,Points-PointsKO-Adjacents,170
Diospyros_forbesii,0,0,0,NA,0
Diospyros_forrestii,2,2,0,Points-PointsKO-Adjacents,18
Diospyros_foxworthyi,3,3,0,Points-PointsKO-Adjacents,27
Diospyros_fragrans,104,88,16,Alphahull-PointsKO-Adjacents,1007
Diospyros_froesii,NA,NA,NA,NA,NA
Diospyros_frutescens,5,0,5,Points-PointsKO-Adjacents,42
Diospyros_fulvopilosa,0,0,0,NA,0
Diospyros_fuscovelutina,30,18,12,Points-PointsKO-Adjacents,157
Diospyros_fusicarpa,NA,NA,NA,NA,NA
Diospyros_fusiformis,1,1,0,Points-PointsKO-Adjacents,9
Diospyros_gabunensis,155,107,48,Alphahull-PointsKO-Adjacents,3190
Diospyros_gallo,6,1,5,Points-PointsKO-Adjacents,49
Diospyros_galpinii,21,0,21,Points-PointsKO-Adjacents,167
Diospyros_gambleana,NA,NA,NA,NA,NA
Diospyros_gaultheriifolia,54,33,21,Alphahull-PointsKO-Adjacents,263
Diospyros_geayana,3,3,0,Points-PointsKO-Adjacents,19
Diospyros_ghatensis,0,0,0,NA,0
Diospyros_gigantocarpa,0,0,0,NA,0
Diospyros_gillespiei,2,2,0,Points-PointsKO-Adjacents,14
Diospyros_gilletii,37,19,18,Points-PointsKO-Adjacents,227
Diospyros_gillisonii,7,1,6,Points-PointsKO-Adjacents,32
Diospyros_glabra,88,66,22,Alphahull-PointsKO-Adjacents,872
Diospyros_glabrata,1,1,0,Points-PointsKO-Adjacents,9
Diospyros_glandulifera,10,4,6,Points-PointsKO-Adjacents,70
Diospyros_glandulosa,13,2,11,Points-PointsKO-Adjacents,108
Diospyros_glans,11,3,8,Points-PointsKO-Adjacents,70
Diospyros_glaucifolia,17,9,8,Points-PointsKO-Adjacents,152
Diospyros_glaucophylla,0,0,0,NA,0
Diospyros_glomerata,23,0,23,Points-PointsKO-Adjacents,135
Diospyros_goudotii,1,1,0,Points-PointsKO-Adjacents,9
Diospyros_gracilescens,26,16,10,Points-PointsKO-Adjacents,177
Diospyros_gracilipes,103,83,20,Alphahull-PointsKO-Adjacents,1261
Diospyros_gracilis,0,0,0,NA,0
Diospyros_greenwayi,17,6,11,Points-PointsKO-Adjacents,96
Diospyros_greshoffiana,0,0,0,NA,0
Diospyros_greveana,9,2,7,Points-PointsKO-Adjacents,75
Diospyros_grex,4,4,0,Points-PointsKO-Adjacents,23
Diospyros_grisebachii,2,2,0,Points-PointsKO-Adjacents,18
Diospyros_guatterioides,4,4,0,Points-PointsKO-Adjacents,36
Diospyros_guianensis,83,37,46,Alphahull-PointsKO-Adjacents,4733
Diospyros_hackenbergii,NA,NA,NA,NA,NA
Diospyros_hainanensis,8,2,6,Points-PointsKO-Adjacents,51
Diospyros_haivanensis,0,0,0,NA,0
Diospyros_halesioides,1,1,0,Points-PointsKO-Adjacents,9
Diospyros_hallieri,2,2,0,Points-PointsKO-Adjacents,9
Diospyros_haplostylis,190,166,24,Alphahull-PointsKO-Adjacents,2125
Diospyros_hasseltii,1,1,0,Points-PointsKO-Adjacents,9
Diospyros_hassleri,4,4,0,Points-PointsKO-Adjacents,35
Diospyros_havilandii,1,0,1,Points-PointsKO-Adjacents,9
Diospyros_hayatae,0,0,0,NA,0
Diospyros_hazomainty,2,2,0,Points-PointsKO-Adjacents,18
Diospyros_hebecarpa,213,0,213,Points-PointsKO-Adjacents,570
Diospyros_hemiteles,1,1,0,Points-PointsKO-Adjacents,9
Diospyros_heterosepala,2,2,0,Points-PointsKO-Adjacents,8
Diospyros_heterotricha,23,0,23,Points-PointsKO-Adjacents,152
Diospyros_heudelotii,76,56,20,Alphahull-PointsKO-Adjacents,3500
Diospyros_hexamera,NA,NA,NA,NA,NA
Diospyros_hierniana,1,1,0,Points-PointsKO-Adjacents,9
Diospyros_hilairei,1,1,0,Points-PointsKO-Adjacents,9
Diospyros_hillebrandii,6,3,3,Points-PointsKO-Adjacents,25
Diospyros_hirsuta,1,1,0,Points-PointsKO-Adjacents,9
Diospyros_hispida,591,528,63,Alphahull-PointsKO-Adjacents,26664
Diospyros_holeana,NA,NA,NA,NA,NA
Diospyros_holttumii,NA,NA,NA,NA,NA
Diospyros_howii,5,0,5,Points-PointsKO-Adjacents,36
Diospyros_hoyleana,107,79,28,Alphahull-PointsKO-Adjacents,2492
Diospyros_humbertiana,49,37,12,Alphahull-PointsKO-Adjacents,673
Diospyros_implexicalyx,7,0,7,Points-PointsKO-Adjacents,54
Diospyros_impolita,6,0,6,Points-PointsKO-Adjacents,26
Diospyros_impressa,0,0,0,NA,0
Diospyros_inconstans,485,368,117,Alphahull-PointsKO-Adjacents,33504
Diospyros_inexplorata,0,0,0,NA,0
Diospyros_inflata,3,3,0,Points-PointsKO-Adjacents,18
Diospyros_inhacaensis,15,6,9,Points-PointsKO-Adjacents,103
Diospyros_insidiosa,0,0,0,NA,0
Diospyros_insignis,1,1,0,Points-PointsKO-Adjacents,9
Diospyros_insularis,17,0,17,Points-PointsKO-Adjacents,98
Diospyros_intricata,39,30,9,Alphahull-PointsKO-Adjacents,185
Diospyros_ismailii,1,1,0,Points-PointsKO-Adjacents,9
Diospyros_iturensis,233,191,42,Alphahull-PointsKO-Adjacents,4595
Diospyros_janowskyi,0,0,0,NA,0
Diospyros_japonica,122,71,51,Alphahull-PointsKO-Adjacents,1557
Diospyros_javanica,2,2,0,Points-PointsKO-Adjacents,12
Diospyros_johnstoniana,14,5,9,Points-PointsKO-Adjacents,84
Diospyros_johorensis,NA,NA,NA,NA,NA
Diospyros_juruensis,138,94,44,Alphahull-PointsKO-Adjacents,2168
Diospyros_kabuyeana,51,32,19,Alphahull-PointsKO-Adjacents,1170
Diospyros_kajangensis,NA,NA,NA,NA,NA
Diospyros_kaki,188,126,62,Alphahull-PointsKO-Adjacents,22271
Diospyros_kamerunensis,90,60,30,Alphahull-PointsKO-Adjacents,1628
Diospyros_kanizur,2,2,0,Points-PointsKO-Adjacents,18
Diospyros_kanurii,1,1,0,Points-PointsKO-Adjacents,9
Diospyros_katendei,2,2,0,Points-PointsKO-Adjacents,14
Diospyros_keningauensis,NA,NA,NA,NA,NA
Diospyros_kerrii,1,1,0,Points-PointsKO-Adjacents,9
Diospyros_ketsensis,2,2,0,Points-PointsKO-Adjacents,9
Diospyros_ketun,20,10,10,Points-PointsKO-Adjacents,152
Diospyros_kika,NA,NA,NA,NA,NA
Diospyros_kingii,NA,NA,NA,NA,NA
Diospyros_kintungensis,1,1,0,Points-PointsKO-Adjacents,9
Diospyros_kirkii,56,22,34,Alphahull-PointsKO-Adjacents,9636
Diospyros_kochummenii,0,0,0,NA,0
Diospyros_koeboeensis,0,0,0,NA,0
Diospyros_koenigii,0,0,0,NA,0
Diospyros_kolom,1,1,0,Points-PointsKO-Adjacents,9
Diospyros_kondor,8,0,8,Points-PointsKO-Adjacents,69
Diospyros_korthalsiana,5,1,4,Points-PointsKO-Adjacents,45
Diospyros_korupensis,7,5,2,Points-PointsKO-Adjacents,26
Diospyros_kostermansii,0,0,0,NA,0
Diospyros_kotoensis,8,5,3,Points-PointsKO-Adjacents,26
Diospyros_krukovii,1,1,0,Points-PointsKO-Adjacents,9
Diospyros_kupensis,8,5,3,Points-PointsKO-Adjacents,18
Diospyros_kurzii,1,0,1,Points-PointsKO-Adjacents,9
Diospyros_labillardierei,21,13,8,Points-PointsKO-Adjacents,79
Diospyros_lanceifolia,5,0,5,Points-PointsKO-Adjacents,45
Diospyros_lanceolata,34,21,13,Alphahull-PointsKO-Adjacents,130
Diospyros_landii,NA,NA,NA,NA,NA
Diospyros_lateralis,0,0,0,NA,0
Diospyros_latisepala,2,2,0,Points-PointsKO-Adjacents,18
Diospyros_latispathulata,24,14,10,Points-PointsKO-Adjacents,143
Diospyros_leucocalyx,26,15,11,Points-PointsKO-Adjacents,170
Diospyros_leucomelas,5,4,1,Points-PointsKO-Adjacents,32
Diospyros_liberiensis,11,4,7,Points-PointsKO-Adjacents,84
Diospyros_lobata,0,0,0,NA,0
Diospyros_lokohensis,35,19,16,Points-PointsKO-Adjacents,169
Diospyros_lolin,7,0,7,Points-PointsKO-Adjacents,52
Diospyros_lolinopsis,3,3,0,Points-PointsKO-Adjacents,15
Diospyros_longibracteata,7,1,6,Points-PointsKO-Adjacents,54
Diospyros_longiciliata,0,0,0,NA,0
Diospyros_longiflora,12,8,4,Points-PointsKO-Adjacents,73
Diospyros_longipedicellata,2,2,0,Points-PointsKO-Adjacents,15
Diospyros_longipilosa,1,1,0,Points-PointsKO-Adjacents,9
Diospyros_longistyla,4,4,0,Points-PointsKO-Adjacents,36
Diospyros_longshengensis,1,1,0,Points-PointsKO-Adjacents,9
Diospyros_lotus,328,182,146,Alphahull-PointsKO-Adjacents,20601
Diospyros_loureiroana,137,103,34,Alphahull-PointsKO-Adjacents,3795
Diospyros_louvelii,6,0,6,Points-PointsKO-Adjacents,35
Diospyros_lunduensis,NA,NA,NA,NA,NA
Diospyros_lycioides,635,549,86,Alphahull-PointsKO-Adjacents,24824
Diospyros_mabacea,36,29,7,Alphahull-PointsKO-Adjacents,51
Diospyros_maclurei,3,3,0,Points-PointsKO-Adjacents,27
Diospyros_macrocarpa,71,58,13,Alphahull-PointsKO-Adjacents,156
Diospyros_macrophylla,11,1,10,Points-PointsKO-Adjacents,98
Diospyros_madecassa,11,4,7,Points-PointsKO-Adjacents,66
Diospyros_mafiensis,15,6,9,Points-PointsKO-Adjacents,98
Diospyros_magogoana,1,1,0,Points-PointsKO-Adjacents,9
Diospyros_maingayi,1,0,1,Points-PointsKO-Adjacents,9
Diospyros_major,3,3,0,Points-PointsKO-Adjacents,18
Diospyros_malabarica,23,0,23,Points-PointsKO-Adjacents,198
Diospyros_malaccensis,0,0,0,NA,0
Diospyros_malacothrix,0,0,0,NA,0
Diospyros_manampetsae,21,13,8,Points-PointsKO-Adjacents,114
Diospyros_manausensis,2,2,0,Points-PointsKO-Adjacents,18
Diospyros_mangabensis,57,39,18,Alphahull-PointsKO-Adjacents,321
Diospyros_mangorensis,1,1,0,Points-PointsKO-Adjacents,8
Diospyros_mannii,204,161,43,Alphahull-PointsKO-Adjacents,6036
Diospyros_manu,7,2,5,Points-PointsKO-Adjacents,36
Diospyros_mapingo,24,14,10,Points-PointsKO-Adjacents,149
Diospyros_margaretae,4,4,0,Points-PointsKO-Adjacents,30
Diospyros_maritima,513,438,75,Alphahull-PointsKO-Adjacents,3253
Diospyros_marmorata,0,0,0,NA,0
Diospyros_martabanica,3,0,3,Points-PointsKO-Adjacents,27
Diospyros_martinii,1,0,1,Points-PointsKO-Adjacents,9
Diospyros_masoalensis,15,10,5,Points-PointsKO-Adjacents,86
Diospyros_matheriana,23,16,7,Points-PointsKO-Adjacents,129
Diospyros_meeusiana,5,5,0,Points-PointsKO-Adjacents,38
Diospyros_melanida,2,2,0,Points-PointsKO-Adjacents,17
Diospyros_melanoxylon,3,3,0,Points-PointsKO-Adjacents,27
Diospyros_melocarpa,32,16,16,Points-PointsKO-Adjacents,239
Diospyros_mespiliformis,941,817,124,Alphahull-PointsKO-Adjacents,21251
Diospyros_metcalfii,1,1,0,Points-PointsKO-Adjacents,9
Diospyros_mexiae,5,0,5,Points-PointsKO-Adjacents,35
Diospyros_miaoshanica,4,4,0,Points-PointsKO-Adjacents,36
Diospyros_micrantha,7,2,5,Points-PointsKO-Adjacents,50
Diospyros_micromera,NA,NA,NA,NA,NA
Diospyros_microrhombus,14,6,8,Points-PointsKO-Adjacents,65
Diospyros_miltonii,6,1,5,Points-PointsKO-Adjacents,28
Diospyros_minahassae,1,1,0,Points-PointsKO-Adjacents,8
Diospyros_mindanaensis,4,3,1,Points-PointsKO-Adjacents,36
Diospyros_minimifolia,6,0,6,Points-PointsKO-Adjacents,33
Diospyros_minutiflora,NA,NA,NA,NA,NA
Diospyros_minutiloba,NA,NA,NA,NA,NA
Diospyros_moi,0,0,0,NA,0
Diospyros_mollis,11,2,9,Points-PointsKO-Adjacents,93
Diospyros_mollissima,0,0,0,NA,0
Diospyros_monbuttensis,246,214,32,Alphahull-PointsKO-Adjacents,2538
Diospyros_montana,31,0,31,Points-PointsKO-Adjacents,231
Diospyros_moonii,1,0,1,Points-PointsKO-Adjacents,9
Diospyros_morrisiana,69,47,22,Alphahull-PointsKO-Adjacents,3174
Diospyros_multibracteata,0,0,0,NA,0
Diospyros_multiflora,0,0,0,NA,0
Diospyros_mun,0,0,0,NA,0
Diospyros_muricata,0,0,0,NA,0
Diospyros_mweroensis,20,8,12,Points-PointsKO-Adjacents,150
Diospyros_myriophylla,90,63,27,Alphahull-PointsKO-Adjacents,3187
Diospyros_myrmecocarpa,23,0,23,Points-PointsKO-Adjacents,166
Diospyros_myrtifolia,11,7,4,Points-PointsKO-Adjacents,64
Diospyros_myrtilloides,1,1,0,Points-PointsKO-Adjacents,9
Diospyros_nana,0,0,0,NA,0
Diospyros_nanay,8,0,8,Points-PointsKO-Adjacents,66
Diospyros_natalensis,74,32,42,Alphahull-PointsKO-Adjacents,2431
Diospyros_nebulosa,2,2,0,Points-PointsKO-Adjacents,10
Diospyros_neglecta,1,1,0,Points-PointsKO-Adjacents,9
Diospyros_neilgerrensis,0,0,0,NA,0
Diospyros_nemorosa,1,1,0,Points-PointsKO-Adjacents,9
Diospyros_neraudii,6,2,4,Points-PointsKO-Adjacents,18
Diospyros_neurosepala,0,0,0,NA,0
Diospyros_nhatrangensis,0,0,0,NA,0
Diospyros_nigra,308,249,59,Alphahull-PointsKO-Adjacents,6741
Diospyros_nigricans,0,0,0,NA,0
Diospyros_nigrocortex,2,2,0,Points-PointsKO-Adjacents,18
Diospyros_nilagirica,0,0,0,NA,0
Diospyros_nitida,0,0,0,NA,0
Diospyros_nodosa,4,4,0,Points-PointsKO-Adjacents,22
Diospyros_normanbyensis,2,2,0,Points-PointsKO-Adjacents,9
Diospyros_novoguineensis,18,4,14,Points-PointsKO-Adjacents,99
Diospyros_nummulariifolia,0,0,0,NA,0
Diospyros_nur,2,2,0,Points-PointsKO-Adjacents,9
Diospyros_nutans,0,0,0,NA,0
Diospyros_oaxacana,69,52,17,Alphahull-PointsKO-Adjacents,519
Diospyros_obducta,4,4,0,Points-PointsKO-Adjacents,36
Diospyros_obliquifolia,59,46,13,Alphahull-PointsKO-Adjacents,1004
Diospyros_oblonga,1,1,0,Points-PointsKO-Adjacents,9
Diospyros_occlusa,61,42,19,Alphahull-PointsKO-Adjacents,487
Diospyros_occulta,6,2,4,Points-PointsKO-Adjacents,43
Diospyros_okkesii,1,1,0,Points-PointsKO-Adjacents,9
Diospyros_olacinoides,43,31,12,Alphahull-PointsKO-Adjacents,140
Diospyros_oldhamii,63,46,17,Alphahull-PointsKO-Adjacents,322
Diospyros_oleifera,21,7,14,Points-PointsKO-Adjacents,183
Diospyros_olen,104,86,18,Alphahull-PointsKO-Adjacents,295
Diospyros_oligantha,1,0,1,Points-PointsKO-Adjacents,9
Diospyros_oliviformis,NA,NA,NA,NA,NA
Diospyros_onanae,3,3,0,Points-PointsKO-Adjacents,23
Diospyros_oocarpa,0,0,0,NA,0
Diospyros_opaca,0,0,0,NA,0
Diospyros_oppositifolia,0,0,0,NA,0
Diospyros_orthioneura,NA,NA,NA,NA,NA
Diospyros_ottohuberi,0,0,0,NA,0
Diospyros_oubatchensis,20,12,8,Points-PointsKO-Adjacents,54
Diospyros_ovalifolia,3,0,3,Points-PointsKO-Adjacents,27
Diospyros_ovalis,7,0,7,Points-PointsKO-Adjacents,57
Diospyros_pahangensis,0,0,0,NA,0
Diospyros_palauensis,NA,NA,NA,NA,NA
Diospyros_palembanica,0,0,0,NA,0
Diospyros_pallens,10,2,8,Points-PointsKO-Adjacents,87
Diospyros_palmeri,60,44,16,Alphahull-PointsKO-Adjacents,598
Diospyros_pancheri,13,7,6,Points-PointsKO-Adjacents,46
Diospyros_panguana,1,1,0,Points-PointsKO-Adjacents,9
Diospyros_paniculata,0,0,0,NA,0
Diospyros_papuana,34,17,17,Points-PointsKO-Adjacents,161
Diospyros_parabuxifolia,NA,NA,NA,NA,NA
Diospyros_paraensis,1,1,0,Points-PointsKO-Adjacents,9
Diospyros_parifolia,17,3,14,Points-PointsKO-Adjacents,111
Diospyros_parviflora,65,51,14,Alphahull-PointsKO-Adjacents,248
Diospyros_parvifolia,22,10,12,Points-PointsKO-Adjacents,128
Diospyros_pauciflora,0,0,0,NA,0
Diospyros_peekelii,42,31,11,Alphahull-PointsKO-Adjacents,308
Diospyros_pemadasae,NA,NA,NA,NA,NA
Diospyros_penangiana,1,1,0,Points-PointsKO-Adjacents,9
Diospyros_pendula,9,2,7,Points-PointsKO-Adjacents,72
Diospyros_penibukanensis,0,0,0,NA,0
Diospyros_pentamera,1008,0,1008,Points-PointsKO-Adjacents,1488
Diospyros_perakensis,0,0,0,NA,0
Diospyros_perfida,3,3,0,Points-PointsKO-Adjacents,25
Diospyros_perglauca,4,4,0,Points-PointsKO-Adjacents,36
Diospyros_perplexa,6,1,5,Points-PointsKO-Adjacents,25
Diospyros_perreticulata,9,3,6,Points-PointsKO-Adjacents,26
Diospyros_perrieri,18,5,13,Points-PointsKO-Adjacents,114
Diospyros_pervillei,9,2,7,Points-PointsKO-Adjacents,70
Diospyros_phanrangensis,0,0,0,NA,0
Diospyros_philippinensis,4,4,0,Points-PointsKO-Adjacents,35
Diospyros_phlebodes,1,1,0,Points-PointsKO-Adjacents,3
Diospyros_phuketensis,NA,NA,NA,NA,NA
Diospyros_physocalycina,53,40,13,Alphahull-PointsKO-Adjacents,899
Diospyros_pierrei,0,0,0,NA,0
Diospyros_pilosanthera,38,10,28,Points-PointsKO-Adjacents,316
Diospyros_pilosiuscula,7,0,7,Points-PointsKO-Adjacents,54
Diospyros_piresii,1,1,0,Points-PointsKO-Adjacents,9
Diospyros_piscatoria,132,99,33,Alphahull-PointsKO-Adjacents,2707
Diospyros_piscicapa,2,2,0,Points-PointsKO-Adjacents,18
Diospyros_platanoides,3,3,0,Points-PointsKO-Adjacents,27
Diospyros_platycalyx,14,3,11,Points-PointsKO-Adjacents,102
Diospyros_plectosepala,1,1,0,Points-PointsKO-Adjacents,9
Diospyros_poeppigiana,123,76,47,Alphahull-PointsKO-Adjacents,5284
Diospyros_polita,1,1,0,Points-PointsKO-Adjacents,9
Diospyros_polystemon,16,5,11,Points-PointsKO-Adjacents,111
Diospyros_poncei,0,0,0,NA,0
Diospyros_potamica,1,1,0,Points-PointsKO-Adjacents,9
Diospyros_potingensis,4,4,0,Points-PointsKO-Adjacents,36
Diospyros_preussii,86,70,16,Alphahull-PointsKO-Adjacents,680
Diospyros_pruinosa,25,16,9,Points-PointsKO-Adjacents,92
Diospyros_pruriens,0,0,0,NA,0
Diospyros_pseudoharmandii,NA,NA,NA,NA,NA
Diospyros_pseudomalabarica,0,0,0,NA,0
Diospyros_pseudomespilus,33,0,33,Points-PointsKO-Adjacents,206
Diospyros_pseudoxylopia,21,12,9,Points-PointsKO-Adjacents,137
Diospyros_pterocalyx,5,5,0,Points-PointsKO-Adjacents,19
Diospyros_pubescens,206,176,30,Alphahull-PointsKO-Adjacents,8729
Diospyros_pulchra,3,3,0,Points-PointsKO-Adjacents,26
Diospyros_puncticulosa,0,0,0,NA,0
Diospyros_punctilimba,NA,NA,NA,NA,NA
Diospyros_pustulata,7,1,6,Points-PointsKO-Adjacents,39
Diospyros_pyrrhocarpa,4,0,4,Points-PointsKO-Adjacents,36
Diospyros_quaesita,0,0,0,NA,0
Diospyros_quercina,18,4,14,Points-PointsKO-Adjacents,131
Diospyros_quiloensis,18,6,12,Points-PointsKO-Adjacents,125
Diospyros_rabiensis,20,16,4,Points-PointsKO-Adjacents,50
Diospyros_ramiflora,1,1,0,Points-PointsKO-Adjacents,9
Diospyros_ramulosa,45,30,15,Alphahull-PointsKO-Adjacents,967
Diospyros_ranongensis,NA,NA,NA,NA,NA
Diospyros_rekoi,12,4,8,Points-PointsKO-Adjacents,91
Diospyros_relit,0,0,0,NA,0
Diospyros_reticulinervis,4,3,1,Points-PointsKO-Adjacents,27
Diospyros_revaughanii,9,4,5,Points-PointsKO-Adjacents,34
Diospyros_revoluta,4,1,3,Points-PointsKO-Adjacents,20
Diospyros_revolutissima,29,17,12,Points-PointsKO-Adjacents,77
Diospyros_rheophytica,0,0,0,NA,0
Diospyros_rhodocalyx,5,3,2,Points-PointsKO-Adjacents,35
Diospyros_rhododendroides,3,3,0,Points-PointsKO-Adjacents,27
Diospyros_rhombifolia,22,9,13,Points-PointsKO-Adjacents,186
Diospyros_ridleyi,0,0,0,NA,0
Diospyros_ridsdalei,3,3,0,Points-PointsKO-Adjacents,12
Diospyros_riedelii,4,4,0,Points-PointsKO-Adjacents,27
Diospyros_rigida,3,1,2,Points-PointsKO-Adjacents,27
Diospyros_ropourea,9,6,3,Points-PointsKO-Adjacents,75
Diospyros_rosei,10,2,8,Points-PointsKO-Adjacents,82
Diospyros_rostrata,8,0,8,Points-PointsKO-Adjacents,25
Diospyros_rotok,0,0,0,NA,0
Diospyros_rotundifolia,28,9,19,Points-PointsKO-Adjacents,153
Diospyros_rubicunda,23,15,8,Points-PointsKO-Adjacents,84
Diospyros_rufa,3,3,0,Points-PointsKO-Adjacents,27
Diospyros_rufogemmata,0,0,0,NA,0
Diospyros_rumphii,2,2,0,Points-PointsKO-Adjacents,13
Diospyros_sahayadryensis,NA,NA,NA,NA,NA
Diospyros_sakalavarum,60,38,22,Alphahull-PointsKO-Adjacents,897
Diospyros_saldanhae,0,0,0,NA,0
Diospyros_salicifolia,173,148,25,Alphahull-PointsKO-Adjacents,3828
Diospyros_salletii,3,3,0,Points-PointsKO-Adjacents,16
Diospyros_samoensis,46,30,16,Alphahull-PointsKO-Adjacents,142
Diospyros_sankurensis,NA,NA,NA,NA,NA
Diospyros_santaremnensis,2,2,0,Points-PointsKO-Adjacents,12
Diospyros_sanza-minika,96,69,27,Alphahull-PointsKO-Adjacents,1999
Diospyros_savannarum,1,1,0,Points-PointsKO-Adjacents,9
Diospyros_saxatilis,7,2,5,Points-PointsKO-Adjacents,63
Diospyros_saxicola,NA,NA,NA,NA,NA
Diospyros_scabiosa,0,0,0,NA,0
Diospyros_scabra,5,2,3,Points-PointsKO-Adjacents,45
Diospyros_scabrida,61,37,24,Alphahull-PointsKO-Adjacents,1052
Diospyros_scalariformis,0,0,0,NA,0
Diospyros_schmutzii,0,0,0,NA,0
Diospyros_sclerophylla,16,2,14,Points-PointsKO-Adjacents,89
Diospyros_scortechinii,0,0,0,NA,0
Diospyros_scottmorii,1,1,0,Points-PointsKO-Adjacents,9
Diospyros_selangorensis,0,0,0,NA,0
Diospyros_senensis,27,13,14,Points-PointsKO-Adjacents,213
Diospyros_sericea,368,319,49,Alphahull-PointsKO-Adjacents,20989
Diospyros_serrana,1,1,0,Points-PointsKO-Adjacents,9
Diospyros_shimbaensis,12,4,8,Points-PointsKO-Adjacents,60
Diospyros_siamang,1,1,0,Points-PointsKO-Adjacents,9
Diospyros_sichourensis,4,3,1,Points-PointsKO-Adjacents,36
Diospyros_siderophylla,6,1,5,Points-PointsKO-Adjacents,54
Diospyros_simaloerensis,1,1,0,Points-PointsKO-Adjacents,9
Diospyros_simii,33,13,20,Points-PointsKO-Adjacents,274
Diospyros_singaporensis,1,1,0,Points-PointsKO-Adjacents,9
Diospyros_sintenisii,6,6,0,Points-PointsKO-Adjacents,34
Diospyros_sleumeri,0,0,0,NA,0
Diospyros_sogeriensis,17,3,14,Points-PointsKO-Adjacents,96
Diospyros_sonorae,19,6,13,Points-PointsKO-Adjacents,116
Diospyros_soporifera,NA,NA,NA,NA,NA
Diospyros_sororia,NA,NA,NA,NA,NA
Diospyros_soubreana,105,81,24,Alphahull-PointsKO-Adjacents,1733
Diospyros_soyauxii,11,6,5,Points-PointsKO-Adjacents,36
Diospyros_sparsirama,NA,NA,NA,NA,NA
Diospyros_sphaerosepala,32,26,6,Alphahull-PointsKO-Adjacents,267
Diospyros_sprucei,0,0,0,NA,0
Diospyros_squamifolia,0,0,0,NA,0
Diospyros_squamosa,93,69,24,Alphahull-PointsKO-Adjacents,808
Diospyros_squarrosa,58,38,20,Alphahull-PointsKO-Adjacents,2413
Diospyros_stenocarpa,10,3,7,Points-PointsKO-Adjacents,59
Diospyros_streptosepala,0,0,0,NA,0
Diospyros_stricta,0,0,0,NA,0
Diospyros_strigosa,9,3,6,Points-PointsKO-Adjacents,72
Diospyros_striicalyx,0,0,0,NA,0
Diospyros_styraciformis,1,0,1,Points-PointsKO-Adjacents,9
Diospyros_suaveolens,57,41,16,Alphahull-PointsKO-Adjacents,1227
Diospyros_subacuta,7,3,4,Points-PointsKO-Adjacents,45
Diospyros_subenervis,17,13,4,Points-PointsKO-Adjacents,25
Diospyros_subfalciformis,5,5,0,Points-PointsKO-Adjacents,27
Diospyros_subrhomboidea,2,2,0,Points-PointsKO-Adjacents,18
Diospyros_subrotata,17,0,17,Points-PointsKO-Adjacents,135
Diospyros_subsessilifolia,16,5,11,Points-PointsKO-Adjacents,96
Diospyros_subsessilis,1,1,0,Points-PointsKO-Adjacents,9
Diospyros_subtrinervis,7,0,7,Points-PointsKO-Adjacents,63
Diospyros_subtruncata,1,1,0,Points-PointsKO-Adjacents,9
Diospyros_sulcata,0,0,0,NA,0
Diospyros_sumatrana,34,14,20,Points-PointsKO-Adjacents,281
Diospyros_sundaica,0,0,0,NA,0
Diospyros_sunyiensis,2,2,0,Points-PointsKO-Adjacents,18
Diospyros_susarticulata,3,3,0,Points-PointsKO-Adjacents,18
Diospyros_sutchuensis,NA,NA,NA,NA,NA
Diospyros_sylvatica,1,0,1,Points-PointsKO-Adjacents,9
Diospyros_tampinensis,10,8,2,Points-PointsKO-Adjacents,26
Diospyros_tarim,6,0,6,Points-PointsKO-Adjacents,41
Diospyros_tenuiflora,10,0,10,Points-PointsKO-Adjacents,84
Diospyros_tenuipes,NA,NA,NA,NA,NA
Diospyros_tepu,0,0,0,NA,0
Diospyros_terminalis,0,0,0,NA,0
Diospyros_tero,1,1,0,Points-PointsKO-Adjacents,9
Diospyros_tessellaria,11,7,4,Points-PointsKO-Adjacents,34
Diospyros_tessmannii,9,0,9,Points-PointsKO-Adjacents,65
Diospyros_tetraceros,3,3,0,Points-PointsKO-Adjacents,25
Diospyros_tetrandra,10,0,10,Points-PointsKO-Adjacents,84
Diospyros_tetrapoda,2,2,0,Points-PointsKO-Adjacents,18
Diospyros_tetrasperma,219,179,40,Alphahull-PointsKO-Adjacents,2288
Diospyros_texana,319,274,45,Alphahull-PointsKO-Adjacents,4936
Diospyros_thaiensis,0,0,0,NA,0
Diospyros_thomasii,23,15,8,Points-PointsKO-Adjacents,188
Diospyros_thorelii,NA,NA,NA,NA,NA
Diospyros_thouarsii,2,2,0,Points-PointsKO-Adjacents,16
Diospyros_thwaitesii,0,0,0,NA,0
Diospyros_tireliae,8,0,8,Points-PointsKO-Adjacents,26
Diospyros_tonkinensis,NA,NA,NA,NA,NA
Diospyros_torquata,5,3,2,Points-PointsKO-Adjacents,37
Diospyros_touranensis,0,0,0,NA,0
Diospyros_toxicaria,43,27,16,Alphahull-PointsKO-Adjacents,201
Diospyros_transita,0,0,0,NA,0
Diospyros_transitoria,0,0,0,NA,0
Diospyros_trengganuensis,0,0,0,NA,0
Diospyros_trianthos,1,1,0,Points-PointsKO-Adjacents,9
Diospyros_trichophylla,NA,NA,NA,NA,NA
Diospyros_tricolor,35,13,22,Points-PointsKO-Adjacents,98
Diospyros_tridentata,7,2,5,Points-PointsKO-Adjacents,15
Diospyros_tristis,0,0,0,NA,0
Diospyros_trisulca,9,1,8,Points-PointsKO-Adjacents,63
Diospyros_trombetensis,0,0,0,NA,0
Diospyros_tropophylla,51,31,20,Alphahull-PointsKO-Adjacents,1197
Diospyros_troupinii,4,4,0,Points-PointsKO-Adjacents,34
Diospyros_truncata,1,1,0,Points-PointsKO-Adjacents,9
Diospyros_truncatifolia,9,1,8,Points-PointsKO-Adjacents,68
Diospyros_tsangii,19,10,9,Points-PointsKO-Adjacents,171
Diospyros_tuberculata,0,0,0,NA,0
Diospyros_turfosa,0,0,0,NA,0
Diospyros_tutcheri,10,1,9,Points-PointsKO-Adjacents,90
Diospyros_uaupensis,0,0,0,NA,0
Diospyros_ubaita,2,2,0,Points-PointsKO-Adjacents,9
Diospyros_ulo,11,6,5,Points-PointsKO-Adjacents,55
Diospyros_umbrosa,44,32,12,Alphahull-PointsKO-Adjacents,85
Diospyros_undulata,11,2,9,Points-PointsKO-Adjacents,80
Diospyros_unisemina,3,3,0,Points-PointsKO-Adjacents,27
Diospyros_urep,3,3,0,Points-PointsKO-Adjacents,27
Diospyros_urschii,11,6,5,Points-PointsKO-Adjacents,60
Diospyros_uzungwaensis,3,3,0,Points-PointsKO-Adjacents,9
Diospyros_vaccinioides,7,0,7,Points-PointsKO-Adjacents,53
Diospyros_variegata,3,3,0,Points-PointsKO-Adjacents,27
Diospyros_veillonii,1,1,0,Points-PointsKO-Adjacents,9
Diospyros_velutinosa,0,0,0,NA,0
Diospyros_velutipes,24,9,15,Points-PointsKO-Adjacents,132
Diospyros_venenosa,0,0,0,NA,0
Diospyros_venosa,15,1,14,Points-PointsKO-Adjacents,118
Diospyros_vermoesenii,18,10,8,Points-PointsKO-Adjacents,102
Diospyros_verrucosa,53,28,25,Alphahull-PointsKO-Adjacents,1184
Diospyros_vescoi,27,22,5,Alphahull-PointsKO-Adjacents,90
Diospyros_vestita,25,1,24,Points-PointsKO-Adjacents,198
Diospyros_vieillardii,74,56,18,Alphahull-PointsKO-Adjacents,213
Diospyros_vignei,77,59,18,Alphahull-PointsKO-Adjacents,938
Diospyros_villosa,59,24,35,Alphahull-PointsKO-Adjacents,787
Diospyros_villosiuscula,14,5,9,Points-PointsKO-Adjacents,96
Diospyros_virgata,9,1,8,Points-PointsKO-Adjacents,81
Diospyros_virginiana,916,665,251,Alphahull-PointsKO-Adjacents,29584
Diospyros_viridicans,35,12,23,Points-PointsKO-Adjacents,268
Diospyros_vitiensis,1,1,0,Points-PointsKO-Adjacents,3
Diospyros_wagemansii,0,0,0,NA,0
Diospyros_wajirensis,3,3,0,Points-PointsKO-Adjacents,18
Diospyros_walkeri,2,0,2,Points-PointsKO-Adjacents,9
Diospyros_wallichii,31,9,22,Points-PointsKO-Adjacents,234
Diospyros_weddellii,1,1,0,Points-PointsKO-Adjacents,9
Diospyros_whitei,0,0,0,NA,0
Diospyros_whitfordii,0,0,0,NA,0
Diospyros_whyteana,225,170,55,Alphahull-PointsKO-Adjacents,5666
Diospyros_winitii,6,0,6,Points-PointsKO-Adjacents,48
Diospyros_xavantina,4,4,0,Points-PointsKO-Adjacents,36
Diospyros_xiangguiensis,4,4,0,Points-PointsKO-Adjacents,34
Diospyros_xishuangbannaensis,0,0,0,NA,0
Diospyros_yaouhensis,21,9,12,Points-PointsKO-Adjacents,85
Diospyros_yatesiana,54,47,7,Alphahull-PointsKO-Adjacents,769
Diospyros_yeobi,0,0,0,NA,0
Diospyros_yomomo,7,2,5,Points-PointsKO-Adjacents,38
Diospyros_yucatanensis,84,66,18,Alphahull-PointsKO-Adjacents,1908
Diospyros_yunnanensis,6,1,5,Points-PointsKO-Adjacents,54
Diospyros_zenkeri,104,88,16,Alphahull-PointsKO-Adjacents,2286
Diospyros_zhenfengensis,NA,NA,NA,NA,NA
Diospyros_zombensis,52,29,23,Alphahull-PointsKO-Adjacents,2516
Dipelta_floribunda,23,1,22,Points-PointsKO-Adjacents,201
Dipentodon_sinicus,55,42,13,Alphahull-PointsKO-Adjacents,224
Diphasia_angolensis,11,5,6,Points-PointsKO-Adjacents,71
Diphysa_americana,364,282,82,Alphahull-PointsKO-Adjacents,8930
Diphysa_carthagenensis,509,417,92,Alphahull-PointsKO-Adjacents,8135
Diphysa_floribunda,178,126,52,Alphahull-PointsKO-Adjacents,3442
Diphysa_humilis,49,37,12,Alphahull-PointsKO-Adjacents,549
Diphysa_macrocarpa,5,4,1,Points-PointsKO-Adjacents,43
Diphysa_macrophylla,4,3,1,Points-PointsKO-Adjacents,36
Diphysa_occidentalis,75,0,75,Points-PointsKO-Adjacents,402
Diphysa_ormocarpoides,71,54,17,Alphahull-PointsKO-Adjacents,404
Diphysa_puberulenta,70,45,25,Alphahull-PointsKO-Adjacents,1523
Diphysa_punctata,3,3,0,Points-PointsKO-Adjacents,27
Diphysa_racemosa,96,62,34,Alphahull-PointsKO-Adjacents,1212
Diphysa_sennoides,14,7,7,Points-PointsKO-Adjacents,89
Diphysa_suberosa,135,98,37,Alphahull-PointsKO-Adjacents,3669
Diphysa_yucatanensis,48,34,14,Alphahull-PointsKO-Adjacents,1051
Diplodiscus_aureus,0,0,0,NA,0
Diplodiscus_decumbens,0,0,0,NA,0
Diplodiscus_hookerianus,0,0,0,NA,0
Diplodiscus_longifolius,1,1,0,Points-PointsKO-Adjacents,9
Diplodiscus_longipetiolatus,1,1,0,Points-PointsKO-Adjacents,9
Diplodiscus_microlepis,NA,NA,NA,NA,NA
Diplodiscus_paniculatus,6,0,6,Points-PointsKO-Adjacents,40
Diplodiscus_parviflorus,0,0,0,NA,0
Diplodiscus_scortechinii,0,0,0,NA,0
Diplodiscus_suluensis,6,0,6,Points-PointsKO-Adjacents,40
Diplodiscus_trichospermus,5,5,0,Points-PointsKO-Adjacents,36
Diploglottis_berniana,2,2,0,Points-PointsKO-Adjacents,11
Diploglottis_bracteata,49,43,6,Alphahull-PointsKO-Adjacents,59
Diploglottis_campbellii,41,0,41,Points-PointsKO-Adjacents,131
Diploglottis_cunninghamii,1344,1273,71,Alphahull-PointsKO-Adjacents,1520
Diploglottis_diphyllostegia,100,83,17,Alphahull-PointsKO-Adjacents,257
Diploglottis_harpullioides,24,14,10,Points-PointsKO-Adjacents,56
Diploglottis_macrantha,62,51,11,Alphahull-PointsKO-Adjacents,235
Diploglottis_obovata,37,32,5,Alphahull-PointsKO-Adjacents,114
Diploglottis_pedleyi,20,16,4,Points-PointsKO-Adjacents,41
Diploglottis_smithii,52,42,10,Alphahull-PointsKO-Adjacents,120
Diplokeleba_floribunda,161,131,30,Alphahull-PointsKO-Adjacents,6642
Diplokeleba_herzogii,16,11,5,Points-PointsKO-Adjacents,131
Diploknema_butyracea,2,0,2,Points-PointsKO-Adjacents,18
Diploknema_butyraceoides,NA,NA,NA,NA,NA
Diploknema_oligomera,2,2,0,Points-PointsKO-Adjacents,9
Diploknema_ramiflora,1,1,0,Points-PointsKO-Adjacents,9
Diploknema_sebifera,2,2,0,Points-PointsKO-Adjacents,18
Diploknema_siamensis,0,0,0,NA,0
Diploknema_yunnanensis,NA,NA,NA,NA,NA
Diploon_cuspidatum,237,135,102,Alphahull-PointsKO-Adjacents,2863
Diplopanax_stachyanthus,10,4,6,Points-PointsKO-Adjacents,90
Diplorhynchus_condylocarpon,234,158,76,Alphahull-PointsKO-Adjacents,19253
Diplospora_bilocularis,0,0,0,NA,0
Diplospora_dubia,458,389,69,Alphahull-PointsKO-Adjacents,7951
Diplospora_erythrospora,0,0,0,NA,0
Diplospora_kunstleri,0,0,0,NA,0
Diplospora_majumdarii,NA,NA,NA,NA,NA
Diplospora_malaccensis,32,16,16,Points-PointsKO-Adjacents,249
Diplospora_minahassae,3,3,0,Points-PointsKO-Adjacents,27
Diplospora_mollissima,6,2,4,Points-PointsKO-Adjacents,54
Diplospora_pubescens,0,0,0,NA,0
Diplospora_siamica,0,0,0,NA,0
Diplospora_tinagoensis,11,0,11,Points-PointsKO-Adjacents,93
Diplospora_velutina,0,0,0,NA,0
Diplospora_wrayi,0,0,0,NA,0
Diplostephium_antioquense,16,8,8,Points-PointsKO-Adjacents,90
Diplostephium_cinerascens,23,12,11,Points-PointsKO-Adjacents,159
Diplostephium_dentatum,8,3,5,Points-PointsKO-Adjacents,60
Diplostephium_ellipticum,1,1,0,Points-PointsKO-Adjacents,9
Diplostephium_fosbergii,3,3,0,Points-PointsKO-Adjacents,27
Diplostephium_grantii,8,1,7,Points-PointsKO-Adjacents,62
Diplostephium_oblongifolium,4,4,0,Points-PointsKO-Adjacents,36
Diplostephium_ochraceum,61,54,7,Alphahull-PointsKO-Adjacents,415
Diplostephium_perijaense,2,2,0,Points-PointsKO-Adjacents,18
Diplostephium_revolutum,18,1,17,Points-PointsKO-Adjacents,119
Diplostephium_romeroi,1,1,0,Points-PointsKO-Adjacents,9
Diplostephium_rosmarinifolium,167,148,19,Alphahull-PointsKO-Adjacents,1793
Diplostephium_rupestre,77,58,19,Alphahull-PointsKO-Adjacents,527
Diplostephium_santamartae,3,3,0,Points-PointsKO-Adjacents,27
Diplostephium_saxatile,3,3,0,Points-PointsKO-Adjacents,27
Diplostephium_tenuifolium,35,27,8,Alphahull-PointsKO-Adjacents,195
Diplotropis_brasiliensis,129,83,46,Alphahull-PointsKO-Adjacents,15189
Diplotropis_ferruginea,96,79,17,Alphahull-PointsKO-Adjacents,2431
Diplotropis_incexis,132,86,46,Alphahull-PointsKO-Adjacents,1776
Diplotropis_martiusii,237,178,59,Alphahull-PointsKO-Adjacents,11275
Diplotropis_peruviana,31,13,18,Points-PointsKO-Adjacents,221
Diplotropis_purpurea,468,0,468,Points-PointsKO-Adjacents,3512
Diplotropis_rigidocarpa,5,5,0,Points-PointsKO-Adjacents,23
Diplotropis_rodriguesii,13,7,6,Points-PointsKO-Adjacents,95
Diplotropis_strigulosa,5,5,0,Points-PointsKO-Adjacents,33
Diplusodon_virgatus,263,209,54,Alphahull-PointsKO-Adjacents,8039
Diplycosia_apiculifera,1,1,0,Points-PointsKO-Adjacents,9
Diplycosia_heterophylla,8,1,7,Points-PointsKO-Adjacents,72
Diplycosia_luzonica,11,3,8,Points-PointsKO-Adjacents,65
Diplycosia_pilosa,1,0,1,Points-PointsKO-Adjacents,9
Diplycosia_pseudorufescens,3,3,0,Points-PointsKO-Adjacents,27
Diplycosia_viridiflora,3,3,0,Points-PointsKO-Adjacents,27
Dipterocarpus_acutangulus,3,0,3,Points-PointsKO-Adjacents,27
Dipterocarpus_alatus,9,1,8,Points-PointsKO-Adjacents,81
Dipterocarpus_applanatus,0,0,0,NA,0
Dipterocarpus_baudii,3,3,0,Points-PointsKO-Adjacents,27
Dipterocarpus_borneensis,2,0,2,Points-PointsKO-Adjacents,18
Dipterocarpus_bourdillonii,0,0,0,NA,0
Dipterocarpus_caudatus,2,2,0,Points-PointsKO-Adjacents,18
Dipterocarpus_caudiferus,3,1,2,Points-PointsKO-Adjacents,27
Dipterocarpus_chartaceus,0,0,0,NA,0
Dipterocarpus_cinereus,0,0,0,NA,0
Dipterocarpus_concavus,0,0,0,NA,0
Dipterocarpus_condorensis,0,0,0,NA,0
Dipterocarpus_confertus,3,0,3,Points-PointsKO-Adjacents,27
Dipterocarpus_conformis,0,0,0,NA,0
Dipterocarpus_coriaceus,1,1,0,Points-PointsKO-Adjacents,9
Dipterocarpus_cornutus,1,0,1,Points-PointsKO-Adjacents,9
Dipterocarpus_costatus,6,0,6,Points-PointsKO-Adjacents,45
Dipterocarpus_costulatus,0,0,0,NA,0
Dipterocarpus_crinitus,9,1,8,Points-PointsKO-Adjacents,78
Dipterocarpus_cuspidatus,0,0,0,NA,0
Dipterocarpus_dyeri,3,3,0,Points-PointsKO-Adjacents,27
Dipterocarpus_elongatus,0,0,0,NA,0
Dipterocarpus_eurhynchus,1,0,1,Points-PointsKO-Adjacents,9
Dipterocarpus_fagineus,2,1,1,Points-PointsKO-Adjacents,18
Dipterocarpus_fusiformis,0,0,0,NA,0
Dipterocarpus_geniculatus,4,0,4,Points-PointsKO-Adjacents,36
Dipterocarpus_glabrigemmatus,0,0,0,NA,0
Dipterocarpus_glandulosus,0,0,0,NA,0
Dipterocarpus_globosus,2,0,2,Points-PointsKO-Adjacents,18
Dipterocarpus_gracilis,8,1,7,Points-PointsKO-Adjacents,72
Dipterocarpus_grandiflorus,5,1,4,Points-PointsKO-Adjacents,38
Dipterocarpus_hasseltii,9,0,9,Points-PointsKO-Adjacents,64
Dipterocarpus_hispidus,1,1,0,Points-PointsKO-Adjacents,9
Dipterocarpus_humeratus,4,4,0,Points-PointsKO-Adjacents,36
Dipterocarpus_indicus,2,0,2,Points-PointsKO-Adjacents,12
Dipterocarpus_insignis,0,0,0,NA,0
Dipterocarpus_intricatus,9,1,8,Points-PointsKO-Adjacents,81
Dipterocarpus_kerrii,4,0,4,Points-PointsKO-Adjacents,36
Dipterocarpus_kunstleri,6,0,6,Points-PointsKO-Adjacents,41
Dipterocarpus_lamellatus,0,0,0,NA,0
Dipterocarpus_littoralis,0,0,0,NA,0
Dipterocarpus_lowii,2,0,2,Points-PointsKO-Adjacents,18
Dipterocarpus_mundus,1,1,0,Points-PointsKO-Adjacents,9
Dipterocarpus_nudus,1,0,1,Points-PointsKO-Adjacents,9
Dipterocarpus_oblongifolius,7,2,5,Points-PointsKO-Adjacents,56
Dipterocarpus_obtusifolius,25,13,12,Points-PointsKO-Adjacents,141
Dipterocarpus_ochraceus,0,0,0,NA,0
Dipterocarpus_orbicularis,0,0,0,NA,0
Dipterocarpus_pachyphyllus,0,0,0,NA,0
Dipterocarpus_palembanicus,3,1,2,Points-PointsKO-Adjacents,27
Dipterocarpus_perakensis,0,0,0,NA,0
Dipterocarpus_retusus,4,0,4,Points-PointsKO-Adjacents,36
Dipterocarpus_rigidus,3,3,0,Points-PointsKO-Adjacents,25
Dipterocarpus_rotundifolius,0,0,0,NA,0
Dipterocarpus_sarawakensis,4,4,0,Points-PointsKO-Adjacents,18
Dipterocarpus_scaber,1,1,0,Points-PointsKO-Adjacents,9
Dipterocarpus_semivestitus,0,0,0,NA,0
Dipterocarpus_stellatus,5,0,5,Points-PointsKO-Adjacents,36
Dipterocarpus_sublamellatus,2,0,2,Points-PointsKO-Adjacents,18
Dipterocarpus_tempehes,2,2,0,Points-PointsKO-Adjacents,18
Dipterocarpus_tuberculatus,10,0,10,Points-PointsKO-Adjacents,75
Dipterocarpus_turbinatus,6,0,6,Points-PointsKO-Adjacents,54
Dipterocarpus_validus,2,2,0,Points-PointsKO-Adjacents,18
Dipterocarpus_verrucosus,1,0,1,Points-PointsKO-Adjacents,9
Dipterocarpus_zeylanicus,3,1,2,Points-PointsKO-Adjacents,18
Dipteronia_dyeriana,2,2,0,Points-PointsKO-Adjacents,18
Dipteronia_sinensis,31,15,16,Points-PointsKO-Adjacents,243
Dipteryx_alata,884,814,70,Alphahull-PointsKO-Adjacents,35364
Dipteryx_lacunifera,76,62,14,Alphahull-PointsKO-Adjacents,2269
Dipteryx_magnifica,126,86,40,Alphahull-PointsKO-Adjacents,5793
Dipteryx_micrantha,150,113,37,Alphahull-PointsKO-Adjacents,10137
Dipteryx_odorata,524,432,92,Alphahull-PointsKO-Adjacents,62947
Dipteryx_oleifera,180,150,30,Alphahull-PointsKO-Adjacents,1901
Dipteryx_polyphylla,50,0,50,Points-PointsKO-Adjacents,318
Dipteryx_punctata,161,111,50,Alphahull-PointsKO-Adjacents,18221
Dipteryx_rosea,49,26,23,Alphahull-PointsKO-Adjacents,543
Diptychandra_aurantiaca,530,483,47,Alphahull-PointsKO-Adjacents,32654
Dirachma_socotrana,5,1,4,Points-PointsKO-Adjacents,10
Dirachma_somalensis,3,3,0,Points-PointsKO-Adjacents,26
Dirichletia_obovata,7,4,3,Points-PointsKO-Adjacents,27
Dirichletia_pubescens,17,5,12,Points-PointsKO-Adjacents,130
Dirichletia_virgata,4,2,2,Points-PointsKO-Adjacents,17
Discaria_chacaye,58,27,31,Alphahull-PointsKO-Adjacents,850
Discaria_nitida,96,87,9,Alphahull-PointsKO-Adjacents,310
Discaria_toumatou,643,616,27,Alphahull-PointsKO-Adjacents,1957
Discocalyx_albiflora,2,2,0,Points-PointsKO-Adjacents,18
Discocalyx_amplifolia,NA,NA,NA,NA,NA
Discocalyx_angustifolia,0,0,0,NA,0
Discocalyx_angustissima,1,1,0,Points-PointsKO-Adjacents,9
Discocalyx_brachybotrya,0,0,0,NA,0
Discocalyx_brassii,3,3,0,Points-PointsKO-Adjacents,24
Discocalyx_crinita,NA,NA,NA,NA,NA
Discocalyx_cybianthoides,1,1,0,Points-PointsKO-Adjacents,9
Discocalyx_effusa,0,0,0,NA,0
Discocalyx_euphlebia,0,0,0,NA,0
Discocalyx_filipes,NA,NA,NA,NA,NA
Discocalyx_fusca,1,1,0,Points-PointsKO-Adjacents,9
Discocalyx_hymenandroides,NA,NA,NA,NA,NA
Discocalyx_insignis,1,1,0,Points-PointsKO-Adjacents,5
Discocalyx_ladronica,0,0,0,NA,0
Discocalyx_latepetiolata,17,9,8,Points-PointsKO-Adjacents,135
Discocalyx_leytensis,0,0,0,NA,0
Discocalyx_linearifolia,0,0,0,NA,0
Discocalyx_listeri,0,0,0,NA,0
Discocalyx_longifolia,NA,NA,NA,NA,NA
Discocalyx_longissima,1,1,0,Points-PointsKO-Adjacents,9
Discocalyx_luzoniensis,0,0,0,NA,0
Discocalyx_macrophylla,0,0,0,NA,0
Discocalyx_maculata,NA,NA,NA,NA,NA
Discocalyx_merrillii,0,0,0,NA,0
Discocalyx_mezii,0,0,0,NA,0
Discocalyx_micrantha,0,0,0,NA,0
Discocalyx_mindanaensis,1,1,0,Points-PointsKO-Adjacents,9
Discocalyx_minor,1,1,0,Points-PointsKO-Adjacents,8
Discocalyx_montana,2,2,0,Points-PointsKO-Adjacents,17
Discocalyx_pachyphylla,2,2,0,Points-PointsKO-Adjacents,16
Discocalyx_palauensis,0,0,0,NA,0
Discocalyx_palawanensis,0,0,0,NA,0
Discocalyx_phanerophlebia,0,0,0,NA,0
Discocalyx_philippinensis,0,0,0,NA,0
Discocalyx_ponapensis,5,5,0,Points-PointsKO-Adjacents,12
Discocalyx_psychotrioides,0,0,0,NA,0
Discocalyx_samarensis,NA,NA,NA,NA,NA
Discocalyx_sarcophylla,0,0,0,NA,0
Discocalyx_schlechteri,2,2,0,Points-PointsKO-Adjacents,12
Discocalyx_sessilifolia,0,0,0,NA,0
Discocalyx_silvestris,0,0,0,NA,0
Discocalyx_stenophylla,0,0,0,NA,0
Discocalyx_suluensis,0,0,0,NA,0
Discocalyx_tecsonii,0,0,0,NA,0
Discocalyx_vidalii,0,0,0,NA,0
Discocalyx_xiphophylla,NA,NA,NA,NA,NA
Discocarpus_essequeboensis,105,36,69,Alphahull-PointsKO-Adjacents,6244
Discocarpus_gentryi,17,0,17,Points-PointsKO-Adjacents,134
Discocarpus_pedicellatus,14,4,10,Points-PointsKO-Adjacents,96
Discocarpus_spruceanus,68,30,38,Alphahull-PointsKO-Adjacents,1324
Discoclaoxylon_hexandrum,88,55,33,Alphahull-PointsKO-Adjacents,1283
Discoclaoxylon_occidentale,7,3,4,Points-PointsKO-Adjacents,22
Discoclaoxylon_pedicellare,0,0,0,NA,0
Discoclaoxylon_pubescens,0,0,0,NA,0
Discocleidion_rufescens,60,37,23,Alphahull-PointsKO-Adjacents,3840
Discocnide_mexicana,72,44,28,Alphahull-PointsKO-Adjacents,1215
Discoglypremna_caloneura,145,97,48,Alphahull-PointsKO-Adjacents,5177
Discophora_guianensis,1066,929,137,Alphahull-PointsKO-Adjacents,65514
Discophora_montana,12,5,7,Points-PointsKO-Adjacents,101
Discopodium_penninervium,90,48,42,Alphahull-PointsKO-Adjacents,1473
Discospermum_abnorme,17,6,11,Points-PointsKO-Adjacents,91
Discospermum_apiocarpum,0,0,0,NA,0
Discospermum_beccarianum,1,1,0,Points-PointsKO-Adjacents,9
Discospermum_sphaerocarpum,0,0,0,NA,0
Diselma_archeri,199,188,11,Alphahull-PointsKO-Adjacents,281
Disepalum_aciculare,0,0,0,NA,0
Disepalum_acuminatissimum,NA,NA,NA,NA,NA
Disepalum_anomalum,7,2,5,Points-PointsKO-Adjacents,45
Disepalum_coronatum,5,5,0,Points-PointsKO-Adjacents,33
Disepalum_longipes,0,0,0,NA,0
Disepalum_petelotii,9,3,6,Points-PointsKO-Adjacents,81
Disepalum_plagioneurum,16,3,13,Points-PointsKO-Adjacents,118
Disepalum_platypetalum,8,1,7,Points-PointsKO-Adjacents,51
Disepalum_pulchrum,3,3,0,Points-PointsKO-Adjacents,24
Dissiliaria_baloghioides,82,0,82,Points-PointsKO-Adjacents,214
Dissiliaria_indistincta,18,12,6,Points-PointsKO-Adjacents,68
Dissiliaria_laxinervis,14,0,14,Points-PointsKO-Adjacents,46
Dissiliaria_muelleri,21,13,8,Points-PointsKO-Adjacents,55
Dissiliaria_surculosa,25,16,9,Points-PointsKO-Adjacents,75
Dissiliaria_tuckeri,16,11,5,Points-PointsKO-Adjacents,32
Dissomeria_crenata,42,27,15,Alphahull-PointsKO-Adjacents,2195
Dissomeria_glanduligera,3,3,0,Points-PointsKO-Adjacents,24
Distemonanthus_benthamianus,526,476,50,Alphahull-PointsKO-Adjacents,5301
Distephanus_garnierianus,97,78,19,Alphahull-PointsKO-Adjacents,761
Distephanus_trinervis,17,9,8,Points-PointsKO-Adjacents,108
Disterigma_humboldtii,337,258,79,Alphahull-PointsKO-Adjacents,2511
Distichirhops_megale,2,2,0,Points-PointsKO-Adjacents,9
Distichirhops_minor,NA,NA,NA,NA,NA
Distichirhops_mitsemosik,2,2,0,Points-PointsKO-Adjacents,9
Distyliopsis_dunnii,20,5,15,Points-PointsKO-Adjacents,180
Distyliopsis_lanata,3,3,0,Points-PointsKO-Adjacents,18
Distyliopsis_laurifolia,9,0,9,Points-PointsKO-Adjacents,81
Distyliopsis_salicifolia,0,0,0,NA,0
Distyliopsis_tutcheri,3,3,0,Points-PointsKO-Adjacents,27
Distyliopsis_yunnanensis,NA,NA,NA,NA,NA
Distylium_annamicum,1,1,0,Points-PointsKO-Adjacents,9
Distylium_chungii,4,3,1,Points-PointsKO-Adjacents,36
Distylium_cuspidatum,2,2,0,Points-PointsKO-Adjacents,18
Distylium_dunnianum,3,3,0,Points-PointsKO-Adjacents,27
Distylium_elaeagnoides,3,3,0,Points-PointsKO-Adjacents,27
Distylium_gracile,25,16,9,Points-PointsKO-Adjacents,117
Distylium_indicum,0,0,0,NA,0
Distylium_lepidotum,0,0,0,NA,0
Distylium_macrophyllum,1,1,0,Points-PointsKO-Adjacents,9
Distylium_myricoides,46,27,19,Alphahull-PointsKO-Adjacents,2427
Distylium_pingpienense,4,4,0,Points-PointsKO-Adjacents,36
Distylium_racemosum,141,87,54,Alphahull-PointsKO-Adjacents,1026
Distylium_stellare,1,1,0,Points-PointsKO-Adjacents,9
Distylium_tsiangii,2,2,0,Points-PointsKO-Adjacents,18
Ditaxis_dioica,15,0,15,Points-PointsKO-Adjacents,121
Ditta_maestrensis,0,0,0,NA,0
Ditta_myricoides,25,13,12,Points-PointsKO-Adjacents,115
Diyaminauclea_zeylanica,0,0,0,NA,0
Dobera_glabra,27,8,19,Points-PointsKO-Adjacents,219
Dobera_loranthifolia,11,1,10,Points-PointsKO-Adjacents,94
Docynia_delavayi,68,49,19,Alphahull-PointsKO-Adjacents,2923
Docynia_indica,21,6,15,Points-PointsKO-Adjacents,174
Dodecadenia_grandiflora,7,1,6,Points-PointsKO-Adjacents,63
Dodecastigma_amazonicum,128,86,42,Alphahull-PointsKO-Adjacents,9628
Dodecastigma_integrifolium,8,0,8,Points-PointsKO-Adjacents,72
Dodecastigma_uleanum,26,5,21,Points-PointsKO-Adjacents,196
Dodonaea_filifolia,194,163,31,Alphahull-PointsKO-Adjacents,4703
Dodonaea_hackettiana,6,2,4,Points-PointsKO-Adjacents,31
Dodonaea_inaequifolia,336,317,19,Alphahull-PointsKO-Adjacents,2975
Dodonaea_megazyga,157,139,18,Alphahull-PointsKO-Adjacents,829
Dodonaea_platyptera,251,200,51,Alphahull-PointsKO-Adjacents,7928
Dodonaea_polyandra,211,185,26,Alphahull-PointsKO-Adjacents,585
Dodonaea_stenophylla,214,172,42,Alphahull-PointsKO-Adjacents,7206
Doerpfeldia_cubensis,3,2,1,Points-PointsKO-Adjacents,24
Dolianthus_montiswilhelmii,2,2,0,Points-PointsKO-Adjacents,18
Dolichandrone_alba,7,0,7,Points-PointsKO-Adjacents,54
Dolichandrone_alternifolia,76,50,26,Alphahull-PointsKO-Adjacents,2546
Dolichandrone_arcuata,0,0,0,NA,0
Dolichandrone_atrovirens,1,1,0,Points-PointsKO-Adjacents,9
Dolichandrone_columnaris,1,1,0,Points-PointsKO-Adjacents,9
Dolichandrone_falcata,0,0,0,NA,0
Dolichandrone_filiformis,508,2,506,Points-PointsKO-Adjacents,1573
Dolichandrone_heterophylla,756,703,53,Alphahull-PointsKO-Adjacents,12904
Dolichandrone_serrulata,1,1,0,Points-PointsKO-Adjacents,9
Dolichandrone_spathacea,47,1,46,Points-PointsKO-Adjacents,285
Dolichodelphys_chlorocrater,60,31,29,Alphahull-PointsKO-Adjacents,690
Dolicholobium_acuminatum,1,1,0,Points-PointsKO-Adjacents,9
Dolicholobium_barbatum,1,1,0,Points-PointsKO-Adjacents,7
Dolicholobium_brassii,1,1,0,Points-PointsKO-Adjacents,9
Dolicholobium_cordatum,4,4,0,Points-PointsKO-Adjacents,30
Dolicholobium_crassicarpum,0,0,0,NA,0
Dolicholobium_forbesii,7,0,7,Points-PointsKO-Adjacents,38
Dolicholobium_gertrudis,12,0,12,Points-PointsKO-Adjacents,93
Dolicholobium_glabrum,0,0,0,NA,0
Dolicholobium_graciliflorum,0,0,0,NA,0
Dolicholobium_leptocarpum,1,1,0,Points-PointsKO-Adjacents,9
Dolicholobium_linearilobum,5,5,0,Points-PointsKO-Adjacents,18
Dolicholobium_longifructum,1,1,0,Points-PointsKO-Adjacents,6
Dolicholobium_macgregorii,0,0,0,NA,0
Dolicholobium_minutilobum,0,0,0,NA,0
Dolicholobium_moluccense,7,0,7,Points-PointsKO-Adjacents,51
Dolicholobium_nakiki,8,1,7,Points-PointsKO-Adjacents,46
Dolicholobium_oblongifolium,10,4,6,Points-PointsKO-Adjacents,45
Dolicholobium_oxylobum,9,1,8,Points-PointsKO-Adjacents,57
Dolicholobium_parviflorum,0,0,0,NA,0
Dolicholobium_peekelii,1,1,0,Points-PointsKO-Adjacents,9
Dolicholobium_philippinense,1,1,0,Points-PointsKO-Adjacents,8
Dolicholobium_rheophilum,2,2,0,Points-PointsKO-Adjacents,9
Dolicholobium_ridsdalei,0,0,0,NA,0
Dolicholobium_riuense,0,0,0,NA,0
Dolicholobium_rubrum,0,0,0,NA,0
Dolicholobium_rufiflorum,1,1,0,Points-PointsKO-Adjacents,9
Dolicholobium_seruiense,0,0,0,NA,0
Dolicholobium_solomonense,1,1,0,Points-PointsKO-Adjacents,9
Doliocarpus_gentryi,6,0,6,Points-PointsKO-Adjacents,45
Doliocarpus_leiophyllus,12,5,7,Points-PointsKO-Adjacents,100
Doliocarpus_olivaceus,42,26,16,Alphahull-PointsKO-Adjacents,216
Doliocarpus_pipolyi,2,2,0,Points-PointsKO-Adjacents,18
Doliocarpus_verruculosus,9,3,6,Points-PointsKO-Adjacents,42
Dombeya_acerifolia,15,5,10,Points-PointsKO-Adjacents,74
Dombeya_acuminatissima,0,0,0,NA,0
Dombeya_acutangula,3,2,1,Points-PointsKO-Adjacents,18
Dombeya_aethiopica,9,4,5,Points-PointsKO-Adjacents,75
Dombeya_albisquama,5,5,0,Points-PointsKO-Adjacents,45
Dombeya_albotomentosa,2,2,0,Points-PointsKO-Adjacents,12
Dombeya_alleizettei,2,2,0,Points-PointsKO-Adjacents,18
Dombeya_amaniensis,8,0,8,Points-PointsKO-Adjacents,45
Dombeya_ambalabeensis,11,6,5,Points-PointsKO-Adjacents,57
Dombeya_ambatosoratrensis,1,1,0,Points-PointsKO-Adjacents,9
Dombeya_ambohitrensis,2,2,0,Points-PointsKO-Adjacents,9
Dombeya_ambositrensis,18,0,18,Points-PointsKO-Adjacents,93
Dombeya_ameliae,1,1,0,Points-PointsKO-Adjacents,9
Dombeya_amplifolia,1,1,0,Points-PointsKO-Adjacents,9
Dombeya_anakaensis,6,0,6,Points-PointsKO-Adjacents,45
Dombeya_analavelonae,9,6,3,Points-PointsKO-Adjacents,54
Dombeya_andapensis,6,0,6,Points-PointsKO-Adjacents,49
Dombeya_andrahomanensis,1,1,0,Points-PointsKO-Adjacents,9
Dombeya_angustipetala,18,0,18,Points-PointsKO-Adjacents,93
Dombeya_ankaratrensis,3,3,0,Points-PointsKO-Adjacents,18
Dombeya_ankazobeensis,3,3,0,Points-PointsKO-Adjacents,27
Dombeya_anonyensis,14,0,14,Points-PointsKO-Adjacents,105
Dombeya_antsianakensis,11,5,6,Points-PointsKO-Adjacents,70
Dombeya_apikyensis,4,4,0,Points-PointsKO-Adjacents,27
Dombeya_asymmetrica,2,2,0,Points-PointsKO-Adjacents,13
Dombeya_australis,35,26,9,Alphahull-PointsKO-Adjacents,90
Dombeya_autumnalis,8,2,6,Points-PointsKO-Adjacents,72
Dombeya_befotakensis,7,0,7,Points-PointsKO-Adjacents,53
Dombeya_bemarivensis,8,3,5,Points-PointsKO-Adjacents,66
Dombeya_biumbellata,19,10,9,Points-PointsKO-Adjacents,82
Dombeya_blattiolens,7,3,4,Points-PointsKO-Adjacents,18
Dombeya_borraginea,8,4,4,Points-PointsKO-Adjacents,52
Dombeya_breonii,2,2,0,Points-PointsKO-Adjacents,16
Dombeya_brevistyla,4,4,0,Points-PointsKO-Adjacents,21
Dombeya_buettneri,52,21,31,Alphahull-PointsKO-Adjacents,657
Dombeya_cacuminum,4,4,0,Points-PointsKO-Adjacents,35
Dombeya_cannabina,8,3,5,Points-PointsKO-Adjacents,57
Dombeya_capuroniana,5,5,0,Points-PointsKO-Adjacents,28
Dombeya_capuronii,2,2,0,Points-PointsKO-Adjacents,18
Dombeya_catatii,0,0,0,NA,0
Dombeya_ciliata,7,3,4,Points-PointsKO-Adjacents,21
Dombeya_condensata,0,0,0,NA,0
Dombeya_coria,7,0,7,Points-PointsKO-Adjacents,52
Dombeya_coriopsis,1,1,0,Points-PointsKO-Adjacents,9
Dombeya_costulatinervia,0,0,0,NA,0
Dombeya_cymosa,58,36,22,Alphahull-PointsKO-Adjacents,965
Dombeya_decanthera,19,7,12,Points-PointsKO-Adjacents,90
Dombeya_decaryana,1,1,0,Points-PointsKO-Adjacents,9
Dombeya_decaryi,1,1,0,Points-PointsKO-Adjacents,9
Dombeya_de-lislei,4,4,0,Points-PointsKO-Adjacents,16
Dombeya_dichotoma,4,4,0,Points-PointsKO-Adjacents,32
Dombeya_dichotomopsis,18,0,18,Points-PointsKO-Adjacents,93
Dombeya_digyna,0,0,0,NA,0
Dombeya_dolichophylla,14,0,14,Points-PointsKO-Adjacents,105
Dombeya_dufournetii,1,1,0,Points-PointsKO-Adjacents,9
Dombeya_elegans,14,6,8,Points-PointsKO-Adjacents,33
Dombeya_elliptica,7,2,5,Points-PointsKO-Adjacents,50
Dombeya_erythroclada,1,1,0,Points-PointsKO-Adjacents,9
Dombeya_farafanganica,19,7,12,Points-PointsKO-Adjacents,90
Dombeya_ferruginea,9,7,2,Points-PointsKO-Adjacents,26
Dombeya_ficulnea,17,9,8,Points-PointsKO-Adjacents,39
Dombeya_flabellifolia,3,3,0,Points-PointsKO-Adjacents,18
Dombeya_floribunda,0,0,0,NA,0
Dombeya_glaberrima,14,0,14,Points-PointsKO-Adjacents,105
Dombeya_glabripes,0,0,0,NA,0
Dombeya_glandulosissima,2,2,0,Points-PointsKO-Adjacents,9
Dombeya_glechomifolia,0,0,0,NA,0
Dombeya_gracilicyma,2,2,0,Points-PointsKO-Adjacents,16
Dombeya_hafotsy,2,2,0,Points-PointsKO-Adjacents,18
Dombeya_halapo,0,0,0,NA,0
Dombeya_heimii,1,1,0,Points-PointsKO-Adjacents,9
Dombeya_hildebrandtii,8,4,4,Points-PointsKO-Adjacents,52
Dombeya_hilsenbergii,8,1,7,Points-PointsKO-Adjacents,59
Dombeya_humbertiana,0,0,0,NA,0
Dombeya_ianthotricha,2,2,0,Points-PointsKO-Adjacents,12
Dombeya_ivohibeensis,1,1,0,Points-PointsKO-Adjacents,9
Dombeya_kirkii,43,23,20,Alphahull-PointsKO-Adjacents,423
Dombeya_laevissima,1,1,0,Points-PointsKO-Adjacents,9
Dombeya_lastii,2,2,0,Points-PointsKO-Adjacents,17
Dombeya_laurifolia,26,15,11,Points-PointsKO-Adjacents,141
Dombeya_leachii,1,1,0,Points-PointsKO-Adjacents,9
Dombeya_leandrii,5,5,0,Points-PointsKO-Adjacents,27
Dombeya_lecomtei,11,3,8,Points-PointsKO-Adjacents,64
Dombeya_lecomteopsis,1,1,0,Points-PointsKO-Adjacents,9
Dombeya_ledermannii,9,0,9,Points-PointsKO-Adjacents,64
Dombeya_leuconeura,NA,NA,NA,NA,NA
Dombeya_longipedicellata,0,0,0,NA,0
Dombeya_longibracteolata,1,1,0,Points-PointsKO-Adjacents,9
Dombeya_longicuspidata,1,1,0,Points-PointsKO-Adjacents,9
Dombeya_longipes,5,5,0,Points-PointsKO-Adjacents,44
Dombeya_lucida,107,84,23,Alphahull-PointsKO-Adjacents,925
Dombeya_macrophylla,14,0,14,Points-PointsKO-Adjacents,105
Dombeya_macropoda,2,2,0,Points-PointsKO-Adjacents,18
Dombeya_magnifolia,2,2,0,Points-PointsKO-Adjacents,18
Dombeya_mananarensis,1,1,0,Points-PointsKO-Adjacents,9
Dombeya_mandenensis,7,3,4,Points-PointsKO-Adjacents,16
Dombeya_mandrakensis,NA,NA,NA,NA,NA
Dombeya_manongarivensis,1,1,0,Points-PointsKO-Adjacents,9
Dombeya_marojejyensis,4,4,0,Points-PointsKO-Adjacents,30
Dombeya_mauritiana,0,0,0,NA,0
Dombeya_megaphyllopsis,2,2,0,Points-PointsKO-Adjacents,17
Dombeya_menalohensis,0,0,0,NA,0
Dombeya_merika,3,3,0,Points-PointsKO-Adjacents,25
Dombeya_macrantha,28,21,7,Alphahull-PointsKO-Adjacents,103
Dombeya_mollis,19,7,12,Points-PointsKO-Adjacents,155
Dombeya_montana,4,4,0,Points-PointsKO-Adjacents,36
Dombeya_obovalis,0,0,0,NA,0
Dombeya_palmatisecta,5,5,0,Points-PointsKO-Adjacents,45
Dombeya_parvipetala,2,2,0,Points-PointsKO-Adjacents,18
Dombeya_pentagonalis,0,0,0,NA,0
Dombeya_perrieri,0,0,0,NA,0
Dombeya_pilosa,6,1,5,Points-PointsKO-Adjacents,23
Dombeya_platanifolia,1,1,0,Points-PointsKO-Adjacents,9
Dombeya_ploocarpa,0,0,0,NA,0
Dombeya_polyphylla,1,1,0,Points-PointsKO-Adjacents,7
Dombeya_populnea,3,3,0,Points-PointsKO-Adjacents,19
Dombeya_pubescens,8,0,8,Points-PointsKO-Adjacents,36
Dombeya_pulchra,34,26,8,Alphahull-PointsKO-Adjacents,329
Dombeya_punctata,17,12,5,Points-PointsKO-Adjacents,33
Dombeya_punctatopsis,2,2,0,Points-PointsKO-Adjacents,18
Dombeya_quinqueseta,104,63,41,Alphahull-PointsKO-Adjacents,920
Dombeya_ranofotsyensis,6,2,4,Points-PointsKO-Adjacents,23
Dombeya_rariflora,9,0,9,Points-PointsKO-Adjacents,22
Dombeya_reclinata,5,5,0,Points-PointsKO-Adjacents,30
Dombeya_repanda,0,0,0,NA,0
Dombeya_rienanensis,1,1,0,Points-PointsKO-Adjacents,9
Dombeya_rigida,27,4,23,Points-PointsKO-Adjacents,130
Dombeya_rodriguesiana,0,0,0,NA,0
Dombeya_rosacea,1,1,0,Points-PointsKO-Adjacents,9
Dombeya_roseiflora,1,1,0,Points-PointsKO-Adjacents,9
Dombeya_rottleroides,8,4,4,Points-PointsKO-Adjacents,50
Dombeya_rotunda,1,1,0,Points-PointsKO-Adjacents,9
Dombeya_rotundifolia,166,128,38,Alphahull-PointsKO-Adjacents,4019
Dombeya_rubricuspis,0,0,0,NA,0
Dombeya_sahatavyensis,6,1,5,Points-PointsKO-Adjacents,33
Dombeya_sakamaliensis,0,0,0,NA,0
Dombeya_selinala,7,1,6,Points-PointsKO-Adjacents,43
Dombeya_sely,1,1,0,Points-PointsKO-Adjacents,9
Dombeya_seyrigiana,0,0,0,NA,0
Dombeya_shupangae,36,15,21,Points-PointsKO-Adjacents,288
Dombeya_sofiensis,0,0,0,NA,0
Dombeya_somanga,4,4,0,Points-PointsKO-Adjacents,30
Dombeya_spectabilis,41,25,16,Alphahull-PointsKO-Adjacents,373
Dombeya_stipulacea,5,5,0,Points-PointsKO-Adjacents,36
Dombeya_suarezensis,0,0,0,NA,0
Dombeya_subsquamosa,0,0,0,NA,0
Dombeya_subviscosa,24,14,10,Points-PointsKO-Adjacents,153
Dombeya_superba,4,4,0,Points-PointsKO-Adjacents,21
Dombeya_tavia,1,1,0,Points-PointsKO-Adjacents,9
Dombeya_taylorii,9,1,8,Points-PointsKO-Adjacents,71
Dombeya_tiliacea,44,25,19,Alphahull-PointsKO-Adjacents,623
Dombeya_tomentosa,4,4,0,Points-PointsKO-Adjacents,28
Dombeya_torrida,74,40,34,Alphahull-PointsKO-Adjacents,2526
Dombeya_tremula,3,3,0,Points-PointsKO-Adjacents,27
Dombeya_tsaratananensis,1,1,0,Points-PointsKO-Adjacents,9
Dombeya_tsiandrensis,2,2,0,Points-PointsKO-Adjacents,18
Dombeya_tsiapetrokensis,0,0,0,NA,0
Dombeya_tulearensis,8,3,5,Points-PointsKO-Adjacents,43
Dombeya_umbellata,2,2,0,Points-PointsKO-Adjacents,17
Dombeya_urschiana,1,1,0,Points-PointsKO-Adjacents,9
Dombeya_valou,1,1,0,Points-PointsKO-Adjacents,9
Dombeya_venosa,1,1,0,Points-PointsKO-Adjacents,9
Dombeya_viburniflora,5,5,0,Points-PointsKO-Adjacents,31
Dombeya_viburnifloropsis,2,2,0,Points-PointsKO-Adjacents,18
Dombeya_wittei,5,4,1,Points-PointsKO-Adjacents,39
Dombeya_xiphosepalopsis,0,0,0,NA,0
Donella_ogoouensis,33,21,12,Alphahull-PointsKO-Adjacents,242
Donnellyanthus_deamii,78,56,22,Alphahull-PointsKO-Adjacents,1004
Doratoxylon_alatum,2,2,0,Points-PointsKO-Adjacents,18
Doratoxylon_apetalum,0,0,0,NA,0
Doratoxylon_littorale,5,5,0,Points-PointsKO-Adjacents,40
Dorobaea_callacallensis,9,3,6,Points-PointsKO-Adjacents,58
Dorstenia_gigas,2,2,0,Points-PointsKO-Adjacents,9
Dorstenia_oligogyna,11,5,6,Points-PointsKO-Adjacents,77
Doryphora_aromatica,185,0,185,Points-PointsKO-Adjacents,244
Doryphora_sassafras,1777,1683,94,Alphahull-PointsKO-Adjacents,1819
Doryxylon_spinosum,0,0,0,NA,0
Douradoa_consimilis,7,1,6,Points-PointsKO-Adjacents,63
Dovyalis_abyssinica,58,32,26,Alphahull-PointsKO-Adjacents,2448
Dovyalis_caffra,46,23,23,Alphahull-PointsKO-Adjacents,1373
Dovyalis_cameroonensis,1,1,0,Points-PointsKO-Adjacents,9
Dovyalis_hebecarpa,0,0,0,NA,0
Dovyalis_hispidula,15,0,15,Points-PointsKO-Adjacents,121
Dovyalis_longispina,19,8,11,Points-PointsKO-Adjacents,161
Dovyalis_lucida,36,17,19,Points-PointsKO-Adjacents,323
Dovyalis_macrocalyx,70,39,31,Alphahull-PointsKO-Adjacents,1555
Dovyalis_macrocarpa,0,0,0,NA,0
Dovyalis_mollis,2,2,0,Points-PointsKO-Adjacents,18
Dovyalis_rhamnoides,58,27,31,Alphahull-PointsKO-Adjacents,642
Dovyalis_rotundifolia,9,3,6,Points-PointsKO-Adjacents,66
Dovyalis_spinosissima,9,2,7,Points-PointsKO-Adjacents,55
Dovyalis_verrucosa,5,0,5,Points-PointsKO-Adjacents,45
Dovyalis_xanthocarpa,3,3,0,Points-PointsKO-Adjacents,26
Dovyalis_zenkeri,85,44,41,Alphahull-PointsKO-Adjacents,2961
Dovyalis_zeyheri,107,77,30,Alphahull-PointsKO-Adjacents,6775
Doyleanthus_arillata,3,3,0,Points-PointsKO-Adjacents,27
Dracaena_acutissima,36,18,18,Points-PointsKO-Adjacents,269
Dracaena_afromontana,217,165,52,Alphahull-PointsKO-Adjacents,13403
Dracaena_aletriformis,90,44,46,Alphahull-PointsKO-Adjacents,1367
Dracaena_americana,208,170,38,Alphahull-PointsKO-Adjacents,2122
Dracaena_arborea,242,167,75,Alphahull-PointsKO-Adjacents,5497
Dracaena_aurea,9,0,9,Points-PointsKO-Adjacents,29
Dracaena_bequaertii,NA,NA,NA,NA,NA
Dracaena_brachystachys,1,1,0,Points-PointsKO-Adjacents,9
Dracaena_bueana,4,3,1,Points-PointsKO-Adjacents,36
Dracaena_buettneri,NA,NA,NA,NA,NA
Dracaena_cambodiana,15,1,14,Points-PointsKO-Adjacents,129
Dracaena_cerasifera,81,55,26,Alphahull-PointsKO-Adjacents,1064
Dracaena_chiniana,13,2,11,Points-PointsKO-Adjacents,108
Dracaena_cinnabari,8,4,4,Points-PointsKO-Adjacents,28
Dracaena_cochinchinensis,9,0,9,Points-PointsKO-Adjacents,80
Dracaena_concinna,0,0,0,NA,0
Dracaena_conferta,3,3,0,Points-PointsKO-Adjacents,27
Dracaena_cubensis,14,8,6,Points-PointsKO-Adjacents,55
Dracaena_draco,125,89,36,Alphahull-PointsKO-Adjacents,327
Dracaena_ellenbeckiana,36,21,15,Alphahull-PointsKO-Adjacents,997
Dracaena_elliptica,160,85,75,Alphahull-PointsKO-Adjacents,6800
Dracaena_fernaldii,6,1,5,Points-PointsKO-Adjacents,43
Dracaena_floribunda,0,0,0,NA,0
Dracaena_forbesii,4,4,0,Points-PointsKO-Adjacents,19
Dracaena_fragrans,378,271,107,Alphahull-PointsKO-Adjacents,17476
Dracaena_glomerata,25,14,11,Points-PointsKO-Adjacents,157
Dracaena_granulata,1,1,0,Points-PointsKO-Adjacents,9
Dracaena_griffithii,2,2,0,Points-PointsKO-Adjacents,18
Dracaena_halaapepe,4,4,0,Points-PointsKO-Adjacents,22
Dracaena_hewittii,NA,NA,NA,NA,NA
Dracaena_hokouensis,NA,NA,NA,NA,NA
Dracaena_konaensis,5,1,4,Points-PointsKO-Adjacents,31
Dracaena_kupensis,7,7,0,Points-PointsKO-Adjacents,12
Dracaena_maingayi,3,1,2,Points-PointsKO-Adjacents,15
Dracaena_mannii,702,572,130,Alphahull-PointsKO-Adjacents,49890
Dracaena_multiflora,7,0,7,Points-PointsKO-Adjacents,55
Dracaena_ombet,27,7,20,Points-PointsKO-Adjacents,188
Dracaena_parviflora,0,0,0,NA,0
Dracaena_penangensis,0,0,0,NA,0
Dracaena_reflexa,476,412,64,Alphahull-PointsKO-Adjacents,6360
Dracaena_rockii,8,5,3,Points-PointsKO-Adjacents,32
Dracaena_rubroaurantiaca,1,1,0,Points-PointsKO-Adjacents,9
Dracaena_scabra,14,9,5,Points-PointsKO-Adjacents,89
Dracaena_serrulata,7,0,7,Points-PointsKO-Adjacents,60
Dracaena_steudneri,180,109,71,Alphahull-PointsKO-Adjacents,6232
Dracaena_tamaranae,22,16,6,Points-PointsKO-Adjacents,22
Dracaena_transvaalensis,9,4,5,Points-PointsKO-Adjacents,61
Dracaena_umbraculifera,6,1,5,Points-PointsKO-Adjacents,26
Dracaena_viridiflora,71,58,13,Alphahull-PointsKO-Adjacents,1122
Dracaena_xiphophylla,49,29,20,Alphahull-PointsKO-Adjacents,2675
Dracontomelon_costatum,6,0,6,Points-PointsKO-Adjacents,54
Dracontomelon_dao,138,63,75,Alphahull-PointsKO-Adjacents,4780
Dracontomelon_duperreanum,12,4,8,Points-PointsKO-Adjacents,108
Dracontomelon_laoticum,5,5,0,Points-PointsKO-Adjacents,34
Dracontomelon_lenticulatum,8,2,6,Points-PointsKO-Adjacents,57
Dracontomelon_macrocarpum,1,1,0,Points-PointsKO-Adjacents,9
Dracontomelon_petelotii,1,1,0,Points-PointsKO-Adjacents,9
Dracontomelon_schmidii,NA,NA,NA,NA,NA
Dracontomelon_vitiense,23,8,15,Points-PointsKO-Adjacents,142
Dracophyllum_arboreum,17,12,5,Points-PointsKO-Adjacents,44
Dracophyllum_elegantissimum,35,27,8,Alphahull-PointsKO-Adjacents,122
Dracophyllum_filifolium,497,461,36,Alphahull-PointsKO-Adjacents,1616
Dracophyllum_fitzgeraldii,13,0,13,Points-PointsKO-Adjacents,5
Dracophyllum_latifolium,892,860,32,Alphahull-PointsKO-Adjacents,1078
Dracophyllum_lessonianum,176,149,27,Alphahull-PointsKO-Adjacents,430
Dracophyllum_longifolium,2538,2475,63,Alphahull-PointsKO-Adjacents,3646
Dracophyllum_matthewsii,24,18,6,Points-PointsKO-Adjacents,84
Dracophyllum_pyramidale,20,9,11,Points-PointsKO-Adjacents,108
Dracophyllum_scoparium,35,19,16,Points-PointsKO-Adjacents,95
Dracophyllum_sinclairii,144,112,32,Alphahull-PointsKO-Adjacents,556
Dracophyllum_townsonii,83,61,22,Alphahull-PointsKO-Adjacents,120
Dracophyllum_traversii,1175,1135,40,Alphahull-PointsKO-Adjacents,1659
Dracophyllum_verticillatum,98,80,18,Alphahull-PointsKO-Adjacents,202
Dracophyllum_viride,22,14,8,Points-PointsKO-Adjacents,45
Dransfieldia_micrantha,3,3,0,Points-PointsKO-Adjacents,21
Cyathocalyx_acuminatus,5,0,5,Points-PointsKO-Adjacents,41
Drepananthus_angustipetalus,0,0,0,NA,0
Drepananthus_biovulatus,7,1,6,Points-PointsKO-Adjacents,62
Drepananthus_carinatus,4,0,4,Points-PointsKO-Adjacents,34
Cyathocalyx_crassipetalus,0,0,0,NA,0
Drepananthus_deltoideus,2,2,0,Points-PointsKO-Adjacents,18
Drepananthus_filiformis,1,1,0,Points-PointsKO-Adjacents,9
Drepananthus_havilandii,3,0,3,Points-PointsKO-Adjacents,27
Cyathocalyx_hexagynus,2,2,0,Points-PointsKO-Adjacents,18
Cyathocalyx_kingii,3,3,0,Points-PointsKO-Adjacents,27
Cyathocalyx_lucidus,3,3,0,Points-PointsKO-Adjacents,26
Drepananthus_magnificus,15,1,14,Points-PointsKO-Adjacents,132
Cyathocalyx_minahassae,0,0,0,NA,0
Cyathocalyx_obtusifolius,22,7,15,Points-PointsKO-Adjacents,145
Drepananthus_pahangensis,0,0,0,NA,0
Cyathocalyx_petiolatus,20,0,20,Points-PointsKO-Adjacents,148
Drepananthus_pruniferus,1,1,0,Points-PointsKO-Adjacents,9
Cyathocalyx_pubescens,1,1,0,Points-PointsKO-Adjacents,9
Drepananthus_ramuliflorus,0,0,0,NA,0
Drepananthus_ridleyi,2,1,1,Points-PointsKO-Adjacents,18
Cyathocalyx_vitiensis,0,0,0,NA,0
Drimycarpus_anacardifolius,NA,NA,NA,NA,NA
Drimycarpus_luridus,8,0,8,Points-PointsKO-Adjacents,66
Drimycarpus_maximus,0,0,0,NA,0
Drimycarpus_racemosus,8,0,8,Points-PointsKO-Adjacents,63
Drimys_angustifolia,189,0,189,Points-PointsKO-Adjacents,879
Drimys_brasiliensis,820,736,84,Alphahull-PointsKO-Adjacents,13916
Drimys_confertifolia,10,5,5,Points-PointsKO-Adjacents,9
Drimys_granadensis,317,282,35,Alphahull-PointsKO-Adjacents,3077
Drimys_roraimensis,53,31,22,Alphahull-PointsKO-Adjacents,1076
Drimys_winteri,127,93,34,Alphahull-PointsKO-Adjacents,3706
Droceloncia_rigidifolia,33,18,15,Points-PointsKO-Adjacents,172
Dryadodaphne_crassa,28,17,11,Points-PointsKO-Adjacents,182
Dryadodaphne_novoguineensis,29,16,13,Points-PointsKO-Adjacents,184
Dryadodaphne_trachyphloia,34,29,5,Alphahull-PointsKO-Adjacents,40
Drymophloeus_litigiosus,12,4,8,Points-PointsKO-Adjacents,86
Drymophloeus_oliviformis,13,5,8,Points-PointsKO-Adjacents,85
Drymophloeus_whitmeeanus,1,1,0,Points-PointsKO-Adjacents,9
Dryobalanops_aromatica,2,2,0,Points-PointsKO-Adjacents,18
Dryobalanops_beccarii,9,1,8,Points-PointsKO-Adjacents,81
Dryobalanops_fusca,0,0,0,NA,0
Dryobalanops_keithii,0,0,0,NA,0
Dryobalanops_lanceolata,5,3,2,Points-PointsKO-Adjacents,42
Dryobalanops_oblongifolia,8,3,5,Points-PointsKO-Adjacents,72
Dryobalanops_rappa,1,1,0,Points-PointsKO-Adjacents,9
Dryobalanops_sumatrensis,0,0,0,NA,0
Drypetes_acuminata,33,23,10,Alphahull-PointsKO-Adjacents,93
Drypetes_aetoxyloides,NA,NA,NA,NA,NA
Drypetes_aframensis,9,1,8,Points-PointsKO-Adjacents,75
Drypetes_alba,75,40,35,Alphahull-PointsKO-Adjacents,932
Drypetes_amazonica,162,114,48,Alphahull-PointsKO-Adjacents,6774
Drypetes_ambigua,15,5,10,Points-PointsKO-Adjacents,114
Drypetes_andamanica,0,0,0,NA,0
Drypetes_angustifolia,8,1,7,Points-PointsKO-Adjacents,45
Drypetes_arcuatinervia,7,0,7,Points-PointsKO-Adjacents,63
Drypetes_arguta,50,25,25,Alphahull-PointsKO-Adjacents,363
Drypetes_assamica,3,0,3,Points-PointsKO-Adjacents,27
Drypetes_aubrevillei,24,14,10,Points-PointsKO-Adjacents,134
Drypetes_australis,NA,NA,NA,NA,NA
Drypetes_aylmeri,33,16,17,Points-PointsKO-Adjacents,213
Drypetes_bakembei,11,8,3,Points-PointsKO-Adjacents,49
Drypetes_balakrishnanii,NA,NA,NA,NA,NA
Drypetes_bathiei,5,5,0,Points-PointsKO-Adjacents,41
Drypetes_bipindensis,24,10,14,Points-PointsKO-Adjacents,173
Drypetes_brownii,91,67,24,Alphahull-PointsKO-Adjacents,1393
Drypetes_caesia,0,0,0,NA,0
Drypetes_calvescens,12,3,9,Points-PointsKO-Adjacents,72
Drypetes_calyptosepala,1,1,0,Points-PointsKO-Adjacents,9
Drypetes_cambodica,0,0,0,NA,0
Drypetes_capillipes,66,41,25,Alphahull-PointsKO-Adjacents,2084
Drypetes_capuronii,71,47,24,Alphahull-PointsKO-Adjacents,1653
Drypetes_carolinensis,1,1,0,Points-PointsKO-Adjacents,7
Drypetes_castilloi,1,1,0,Points-PointsKO-Adjacents,9
Drypetes_caustica,1,0,1,Points-PointsKO-Adjacents,9
Drypetes_celastrinea,NA,NA,NA,NA,NA
Drypetes_celebica,0,0,0,NA,0
Drypetes_chevalieri,89,58,31,Alphahull-PointsKO-Adjacents,1885
Drypetes_cinnabarina,31,10,21,Points-PointsKO-Adjacents,192
Drypetes_cockburnii,0,0,0,NA,0
Drypetes_comorensis,3,3,0,Points-PointsKO-Adjacents,11
Drypetes_confertiflora,0,0,0,NA,0
Drypetes_congestiflora,5,5,0,Points-PointsKO-Adjacents,45
Drypetes_convoluta,1,1,0,Points-PointsKO-Adjacents,9
Drypetes_crassipes,8,3,5,Points-PointsKO-Adjacents,57
Drypetes_cumingii,8,1,7,Points-PointsKO-Adjacents,72
Drypetes_curtisii,2,2,0,Points-PointsKO-Adjacents,18
Drypetes_darimontiana,5,5,0,Points-PointsKO-Adjacents,43
Drypetes_dasycarpa,4,4,0,Points-PointsKO-Adjacents,30
Drypetes_dasyneura,1,1,0,Points-PointsKO-Adjacents,9
Drypetes_deplanchei,1870,1748,122,Alphahull-PointsKO-Adjacents,10410
Drypetes_detersibilis,NA,NA,NA,NA,NA
Drypetes_dewildei,0,0,0,NA,0
Drypetes_dinklagei,21,6,15,Points-PointsKO-Adjacents,160
Drypetes_diopa,5,5,0,Points-PointsKO-Adjacents,30
Drypetes_diversifolia,7,0,7,Points-PointsKO-Adjacents,41
Drypetes_dolichocarpa,0,0,0,NA,0
Drypetes_dussii,1,0,1,Points-PointsKO-Adjacents,9
Drypetes_eglandulosa,0,0,0,NA,0
Drypetes_ellipsoidea,0,0,0,NA,0
Drypetes_elliptica,0,0,0,NA,0
Drypetes_eriocarpa,0,0,0,NA,0
Drypetes_euryodes,4,4,0,Points-PointsKO-Adjacents,30
Drypetes_falcata,0,0,0,NA,0
Drypetes_fallax,3,3,0,Points-PointsKO-Adjacents,21
Drypetes_fanshawei,20,10,10,Points-PointsKO-Adjacents,155
Drypetes_floribunda,139,0,139,Points-PointsKO-Adjacents,426
Drypetes_forbesii,1,1,0,Points-PointsKO-Adjacents,9
Drypetes_fusiformis,1,1,0,Points-PointsKO-Adjacents,9
Drypetes_gabonensis,30,22,8,Alphahull-PointsKO-Adjacents,466
Drypetes_gardneri,0,0,0,NA,0
Drypetes_gentryi,30,0,30,Points-PointsKO-Adjacents,127
Drypetes_gerrardii,130,75,55,Alphahull-PointsKO-Adjacents,8742
Drypetes_gerrardinoides,9,1,8,Points-PointsKO-Adjacents,50
Drypetes_gilgiana,146,108,38,Alphahull-PointsKO-Adjacents,6010
Drypetes_gitingensis,2,2,0,Points-PointsKO-Adjacents,8
Drypetes_glaberrima,0,0,0,NA,0
Drypetes_glabra,5,5,0,Points-PointsKO-Adjacents,17
Drypetes_glauca,69,39,30,Alphahull-PointsKO-Adjacents,537
Drypetes_globosa,0,0,0,NA,0
Drypetes_gossweileri,64,43,21,Alphahull-PointsKO-Adjacents,3104
Drypetes_gracilis,1,1,0,Points-PointsKO-Adjacents,9
Drypetes_grandifolia,0,0,0,NA,0
Drypetes_hainanensis,4,4,0,Points-PointsKO-Adjacents,27
Drypetes_harmandii,1,1,0,Points-PointsKO-Adjacents,9
Drypetes_helferi,0,0,0,NA,0
Drypetes_henriquesii,1,1,0,Points-PointsKO-Adjacents,9
Drypetes_heptandra,0,0,0,NA,0
Drypetes_hoaensis,4,4,0,Points-PointsKO-Adjacents,36
Drypetes_iliae,0,0,0,NA,0
Drypetes_ilicifolia,11,1,10,Points-PointsKO-Adjacents,42
Drypetes_impressinervis,0,0,0,NA,0
Drypetes_inaequalis,50,31,19,Alphahull-PointsKO-Adjacents,919
Drypetes_indica,98,84,14,Alphahull-PointsKO-Adjacents,209
Drypetes_integerrima,0,0,0,NA,0
Drypetes_iodoformis,32,24,8,Alphahull-PointsKO-Adjacents,77
Drypetes_ituriensis,25,6,19,Points-PointsKO-Adjacents,162
Drypetes_ivorensis,46,25,21,Alphahull-PointsKO-Adjacents,535
Drypetes_jaintensis,1,1,0,Points-PointsKO-Adjacents,9
Drypetes_kikir,9,0,9,Points-PointsKO-Adjacents,75
Drypetes_klainei,10,3,7,Points-PointsKO-Adjacents,78
Drypetes_laciniata,62,42,20,Alphahull-PointsKO-Adjacents,2183
Drypetes_laevis,2,2,0,Points-PointsKO-Adjacents,14
Drypetes_lasiogynoides,17,8,9,Points-PointsKO-Adjacents,92
Drypetes_lateriflora,376,301,75,Alphahull-PointsKO-Adjacents,7300
Drypetes_leiocarpa,0,0,0,NA,0
Drypetes_leonensis,63,27,36,Alphahull-PointsKO-Adjacents,3028
Drypetes_littoralis,21,0,21,Points-PointsKO-Adjacents,47
Drypetes_longifolia,49,11,38,Points-PointsKO-Adjacents,363
Drypetes_longistipitata,NA,NA,NA,NA,NA
Drypetes_macrostigma,0,0,0,NA,0
Drypetes_madagascariensis,253,222,31,Alphahull-PointsKO-Adjacents,3633
Drypetes_magnistipula,18,10,8,Points-PointsKO-Adjacents,99
Drypetes_malabarica,0,0,0,NA,0
Drypetes_maquilingensis,1,1,0,Points-PointsKO-Adjacents,9
Drypetes_microphylla,2,0,2,Points-PointsKO-Adjacents,18
Drypetes_microphylloides,0,0,0,NA,0
Drypetes_mildbraedii,9,1,8,Points-PointsKO-Adjacents,70
Drypetes_minahassae,1,1,0,Points-PointsKO-Adjacents,9
Drypetes_moliwensis,NA,NA,NA,NA,NA
Drypetes_molunduana,62,43,19,Alphahull-PointsKO-Adjacents,2769
Drypetes_monachinoi,2,2,0,Points-PointsKO-Adjacents,18
Drypetes_monosperma,1,1,0,Points-PointsKO-Adjacents,9
Drypetes_mossambicensis,9,0,9,Points-PointsKO-Adjacents,78
Drypetes_mucronata,16,3,13,Points-PointsKO-Adjacents,110
Drypetes_natalensis,85,44,41,Alphahull-PointsKO-Adjacents,2881
Drypetes_neglecta,1,1,0,Points-PointsKO-Adjacents,9
Drypetes_nervosa,0,0,0,NA,0
Drypetes_nitida,0,0,0,NA,0
Drypetes_obanensis,1,1,0,Points-PointsKO-Adjacents,9
Drypetes_oblongifolia,0,0,0,NA,0
Drypetes_obtusa,4,4,0,Points-PointsKO-Adjacents,36
Drypetes_occidentalis,19,0,19,Points-PointsKO-Adjacents,127
Drypetes_ochrodasya,0,0,0,NA,0
Drypetes_ochrothrix,0,0,0,NA,0
Drypetes_oppositifolia,1,1,0,Points-PointsKO-Adjacents,9
Drypetes_ovalis,0,0,0,NA,0
Drypetes_oxyodonta,1,1,0,Points-PointsKO-Adjacents,9
Drypetes_pachycarpa,0,0,0,NA,0
Drypetes_pacifica,0,0,0,NA,0
Drypetes_parvifolia,25,7,18,Points-PointsKO-Adjacents,171
Drypetes_paxii,27,7,20,Points-PointsKO-Adjacents,186
Drypetes_pellegrinii,27,16,11,Points-PointsKO-Adjacents,184
Drypetes_pendula,7,2,5,Points-PointsKO-Adjacents,48
Drypetes_perakensis,NA,NA,NA,NA,NA
Drypetes_perreticulata,13,2,11,Points-PointsKO-Adjacents,80
Drypetes_perrieri,77,53,24,Alphahull-PointsKO-Adjacents,3692
Drypetes_picardae,1,1,0,Points-PointsKO-Adjacents,8
Drypetes_pierreana,7,1,6,Points-PointsKO-Adjacents,59
Drypetes_polyalthioides,1,1,0,Points-PointsKO-Adjacents,9
Drypetes_polyantha,18,14,4,Points-PointsKO-Adjacents,59
Drypetes_polyneura,3,0,3,Points-PointsKO-Adjacents,27
Drypetes_porteri,0,0,0,NA,0
Drypetes_preussii,22,0,22,Points-PointsKO-Adjacents,126
Drypetes_principum,71,44,27,Alphahull-PointsKO-Adjacents,2043
Drypetes_prunifera,1,1,0,Points-PointsKO-Adjacents,9
Drypetes_reticulata,19,4,15,Points-PointsKO-Adjacents,162
Drypetes_rhakodiskos,4,4,0,Points-PointsKO-Adjacents,36
Drypetes_riparia,NA,NA,NA,NA,NA
Drypetes_riseleyi,0,0,0,NA,0
Drypetes_rotensis,0,0,0,NA,0
Drypetes_rubriflora,0,0,0,NA,0
Drypetes_salicifolia,0,0,0,NA,0
Drypetes_sclerophylla,5,5,0,Points-PointsKO-Adjacents,37
Drypetes_sepiaria,0,0,0,NA,0
Drypetes_sessiliflora,49,27,22,Alphahull-PointsKO-Adjacents,606
Drypetes_sibuyanensis,0,0,0,NA,0
Drypetes_simalurensis,0,0,0,NA,0
Drypetes_singroboensis,18,12,6,Points-PointsKO-Adjacents,98
Drypetes_spinosodentata,18,13,5,Points-PointsKO-Adjacents,108
Drypetes_standleyi,101,76,25,Alphahull-PointsKO-Adjacents,1095
Drypetes_staudtii,24,16,8,Points-PointsKO-Adjacents,144
Drypetes_stipulacea,2,2,0,Points-PointsKO-Adjacents,18
Drypetes_stipularis,4,4,0,Points-PointsKO-Adjacents,36
Drypetes_stylosa,0,0,0,NA,0
Drypetes_subcrenata,0,0,0,NA,0
Drypetes_subcubica,6,2,4,Points-PointsKO-Adjacents,33
Drypetes_subsessilis,0,0,0,NA,0
Drypetes_subsymmetrica,0,0,0,NA,0
Drypetes_sumatrana,1,1,0,Points-PointsKO-Adjacents,9
Drypetes_taylorii,NA,NA,NA,NA,NA
Drypetes_tessmanniana,4,4,0,Points-PointsKO-Adjacents,36
Drypetes_teysmannii,2,2,0,Points-PointsKO-Adjacents,18
Drypetes_thouarsii,13,3,10,Points-PointsKO-Adjacents,106
Drypetes_tomentella,NA,NA,NA,NA,NA
Drypetes_ugandensis,22,8,14,Points-PointsKO-Adjacents,114
Drypetes_usambarica,44,30,14,Alphahull-PointsKO-Adjacents,343
Drypetes_variabilis,282,209,73,Alphahull-PointsKO-Adjacents,34798
Drypetes_venusta,0,0,0,NA,0
Drypetes_vernicosa,40,30,10,Alphahull-PointsKO-Adjacents,94
Drypetes_verrucosa,12,6,6,Points-PointsKO-Adjacents,80
Drypetes_vilhenae,1,1,0,Points-PointsKO-Adjacents,9
Drypetes_viridis,2,2,0,Points-PointsKO-Adjacents,18
Drypetes_vitiensis,1,0,1,Points-PointsKO-Adjacents,7
Drypetes_wightii,0,0,0,NA,0
Drypetes_xanthophylloides,1,1,0,Points-PointsKO-Adjacents,9
Drypetes_yapensis,2,2,0,Points-PointsKO-Adjacents,7
Duabanga_grandiflora,32,11,21,Points-PointsKO-Adjacents,288
Duabanga_moluccana,53,26,27,Alphahull-PointsKO-Adjacents,1003
Dubautia_arborea,6,2,4,Points-PointsKO-Adjacents,21
Dubautia_knudsenii,9,4,5,Points-PointsKO-Adjacents,26
Dubautia_microcephala,2,2,0,Points-PointsKO-Adjacents,9
Dubautia_plantaginea,15,7,8,Points-PointsKO-Adjacents,87
Dubautia_reticulata,7,3,4,Points-PointsKO-Adjacents,37
Duboisia_leichhardtii,100,0,100,Points-PointsKO-Adjacents,406
Duboisia_myoporoides,1185,1032,153,Alphahull-PointsKO-Adjacents,4339
Duboscia_macrocarpa,110,86,24,Alphahull-PointsKO-Adjacents,4221
Duboscia_viridiflora,71,38,33,Alphahull-PointsKO-Adjacents,1330
Dubouzetia_acuminata,7,0,7,Points-PointsKO-Adjacents,44
Dubouzetia_campanulata,70,54,16,Alphahull-PointsKO-Adjacents,116
Dubouzetia_caudiculata,34,23,11,Alphahull-PointsKO-Adjacents,67
Dubouzetia_confusa,43,32,11,Alphahull-PointsKO-Adjacents,76
Dubouzetia_dentata,3,3,0,Points-PointsKO-Adjacents,27
Dubouzetia_elegans,37,25,12,Alphahull-PointsKO-Adjacents,128
Dubouzetia_galorei,15,6,9,Points-PointsKO-Adjacents,83
Dubouzetia_kairoi,13,9,4,Points-PointsKO-Adjacents,54
Dubouzetia_saxatilis,4,4,0,Points-PointsKO-Adjacents,12
Duckeanthus_grandiflorus,8,2,6,Points-PointsKO-Adjacents,72
Duckeodendron_cestroides,49,33,16,Alphahull-PointsKO-Adjacents,887
Duckesia_verrucosa,49,32,17,Alphahull-PointsKO-Adjacents,1886
Duguetia_aberrans,6,1,5,Points-PointsKO-Adjacents,43
Duguetia_amplexifolia,1,1,0,Points-PointsKO-Adjacents,9
Duguetia_antioquensis,55,45,10,Alphahull-PointsKO-Adjacents,586
Duguetia_argentea,80,50,30,Alphahull-PointsKO-Adjacents,5341
Duguetia_aripuanae,3,3,0,Points-PointsKO-Adjacents,27
Duguetia_asterotricha,28,11,17,Points-PointsKO-Adjacents,172
Duguetia_bahiensis,58,41,17,Alphahull-PointsKO-Adjacents,595
Duguetia_barteri,20,11,9,Points-PointsKO-Adjacents,116
Duguetia_cadaverica,80,46,34,Alphahull-PointsKO-Adjacents,3569
Duguetia_calycina,290,231,59,Alphahull-PointsKO-Adjacents,18638
Duguetia_caniflora,6,2,4,Points-PointsKO-Adjacents,41
Duguetia_cauliflora,163,114,49,Alphahull-PointsKO-Adjacents,14205
Duguetia_chrysea,38,24,14,Alphahull-PointsKO-Adjacents,366
Duguetia_chrysocarpa,78,55,23,Alphahull-PointsKO-Adjacents,2343
Duguetia_colombiana,7,6,1,Points-PointsKO-Adjacents,12
Duguetia_confinis,37,25,12,Alphahull-PointsKO-Adjacents,1075
Duguetia_confusa,133,107,26,Alphahull-PointsKO-Adjacents,990
Duguetia_decurrens,12,7,5,Points-PointsKO-Adjacents,88
Duguetia_dicholepidota,7,1,6,Points-PointsKO-Adjacents,33
Duguetia_dilabens,3,3,0,Points-PointsKO-Adjacents,27
Duguetia_dimorphopetala,33,24,9,Alphahull-PointsKO-Adjacents,425
Duguetia_duckei,2,2,0,Points-PointsKO-Adjacents,18
Duguetia_echinophora,179,130,49,Alphahull-PointsKO-Adjacents,14651
Duguetia_elliptica,3,3,0,Points-PointsKO-Adjacents,15
Duguetia_eximia,53,37,16,Alphahull-PointsKO-Adjacents,712
Duguetia_flagellaris,179,107,72,Alphahull-PointsKO-Adjacents,14540
Duguetia_furfuracea,743,653,90,Alphahull-PointsKO-Adjacents,26922
Duguetia_gardneriana,133,89,44,Alphahull-PointsKO-Adjacents,1386
Duguetia_gentryi,11,5,6,Points-PointsKO-Adjacents,80
Duguetia_granvilleana,8,6,2,Points-PointsKO-Adjacents,64
Duguetia_guianensis,15,7,8,Points-PointsKO-Adjacents,69
Duguetia_hadrantha,103,67,36,Alphahull-PointsKO-Adjacents,5485
Duguetia_inconspicua,82,55,27,Alphahull-PointsKO-Adjacents,3781
Duguetia_lanceolata,507,438,69,Alphahull-PointsKO-Adjacents,11563
Duguetia_latifolia,141,91,50,Alphahull-PointsKO-Adjacents,15795
Duguetia_lepidota,77,39,38,Alphahull-PointsKO-Adjacents,3626
Duguetia_longicuspis,16,5,11,Points-PointsKO-Adjacents,141
Duguetia_lucida,132,88,44,Alphahull-PointsKO-Adjacents,7376
Duguetia_macrocalyx,18,9,9,Points-PointsKO-Adjacents,95
Duguetia_macrophylla,207,164,43,Alphahull-PointsKO-Adjacents,15224
Duguetia_magnolioidea,7,3,4,Points-PointsKO-Adjacents,32
Duguetia_manausensis,20,13,7,Points-PointsKO-Adjacents,101
Duguetia_marcgraviana,342,295,47,Alphahull-PointsKO-Adjacents,25386
Duguetia_megalophylla,15,6,9,Points-PointsKO-Adjacents,114
Duguetia_microphylla,4,4,0,Points-PointsKO-Adjacents,36
Duguetia_moricandiana,59,29,30,Alphahull-PointsKO-Adjacents,416
Duguetia_neglecta,67,53,14,Alphahull-PointsKO-Adjacents,877
Duguetia_nitida,7,2,5,Points-PointsKO-Adjacents,51
Duguetia_oblanceolata,2,2,0,Points-PointsKO-Adjacents,18
Duguetia_oblongifolia,1,1,0,Points-PointsKO-Adjacents,9
Duguetia_odorata,148,116,32,Alphahull-PointsKO-Adjacents,8513
Duguetia_oligocarpa,5,2,3,Points-PointsKO-Adjacents,37
Duguetia_panamensis,42,27,15,Alphahull-PointsKO-Adjacents,650
Duguetia_paraensis,34,15,19,Points-PointsKO-Adjacents,249
Duguetia_pauciflora,27,19,8,Points-PointsKO-Adjacents,170
Duguetia_peruviana,8,4,4,Points-PointsKO-Adjacents,56
Duguetia_pohliana,8,0,8,Points-PointsKO-Adjacents,58
Duguetia_pycnastera,163,129,34,Alphahull-PointsKO-Adjacents,14183
Duguetia_quitarensis,374,295,79,Alphahull-PointsKO-Adjacents,35935
Duguetia_restingae,7,0,7,Points-PointsKO-Adjacents,48
Duguetia_reticulata,7,2,5,Points-PointsKO-Adjacents,51
Duguetia_riberensis,18,10,8,Points-PointsKO-Adjacents,149
Duguetia_riedeliana,18,0,18,Points-PointsKO-Adjacents,141
Duguetia_rigida,83,65,18,Alphahull-PointsKO-Adjacents,2862
Duguetia_rionegrensis,9,0,9,Points-PointsKO-Adjacents,81
Duguetia_riparia,154,87,67,Alphahull-PointsKO-Adjacents,16501
Duguetia_rotundifolia,4,4,0,Points-PointsKO-Adjacents,34
Duguetia_salicifolia,39,26,13,Alphahull-PointsKO-Adjacents,478
Duguetia_sancticaroli,9,5,4,Points-PointsKO-Adjacents,50
Duguetia_schulzii,3,3,0,Points-PointsKO-Adjacents,25
Duguetia_scottmorii,8,1,7,Points-PointsKO-Adjacents,36
Duguetia_sessilis,17,3,14,Points-PointsKO-Adjacents,120
Duguetia_sooretamae,14,0,14,Points-PointsKO-Adjacents,83
Duguetia_spixiana,469,408,61,Alphahull-PointsKO-Adjacents,29052
Duguetia_staudtii,98,70,28,Alphahull-PointsKO-Adjacents,3469
Duguetia_stelechantha,156,126,30,Alphahull-PointsKO-Adjacents,16585
Duguetia_stenantha,38,18,20,Points-PointsKO-Adjacents,287
Duguetia_subcordata,7,1,6,Points-PointsKO-Adjacents,63
Duguetia_surinamensis,168,103,65,Alphahull-PointsKO-Adjacents,15292
Duguetia_tenuis,7,0,7,Points-PointsKO-Adjacents,57
Duguetia_tobagensis,1,1,0,Points-PointsKO-Adjacents,8
Duguetia_trunciflora,101,41,60,Alphahull-PointsKO-Adjacents,1391
Duguetia_tuberculata,9,4,5,Points-PointsKO-Adjacents,42
Duguetia_ulei,26,10,16,Points-PointsKO-Adjacents,180
Duguetia_uniflora,70,49,21,Alphahull-PointsKO-Adjacents,2772
Duguetia_vallicola,23,10,13,Points-PointsKO-Adjacents,195
Duguetia_venezuelana,5,5,0,Points-PointsKO-Adjacents,27
Duguetia_yeshidan,148,112,36,Alphahull-PointsKO-Adjacents,11409
Duidania_montana,16,11,5,Points-PointsKO-Adjacents,68
Dulacia_candida,513,437,76,Alphahull-PointsKO-Adjacents,57843
Dulacia_crassa,1,1,0,Points-PointsKO-Adjacents,9
Dulacia_egleri,30,14,16,Points-PointsKO-Adjacents,246
Dulacia_gardneriana,21,6,15,Points-PointsKO-Adjacents,152
Dulacia_guianensis,105,54,51,Alphahull-PointsKO-Adjacents,11290
Dulacia_inopiflora,95,36,59,Alphahull-PointsKO-Adjacents,3656
Dulacia_macrophylla,76,43,33,Alphahull-PointsKO-Adjacents,4444
Dulacia_papillosa,37,13,24,Points-PointsKO-Adjacents,218
Dulacia_pauciflora,41,19,22,Points-PointsKO-Adjacents,318
Dulacia_redmondii,37,25,12,Alphahull-PointsKO-Adjacents,295
Dulacia_singularis,11,1,10,Points-PointsKO-Adjacents,79
Dulacia_tepuiensis,14,8,6,Points-PointsKO-Adjacents,84
Dunalia_brachyacantha,88,55,33,Alphahull-PointsKO-Adjacents,1413
Dunalia_solanacea,186,164,22,Alphahull-PointsKO-Adjacents,2149
Dunalia_spinosa,51,26,25,Alphahull-PointsKO-Adjacents,596
Dunalia_trianaei,84,66,18,Alphahull-PointsKO-Adjacents,813
Duparquetia_orchidacea,180,143,37,Alphahull-PointsKO-Adjacents,3426
Duperrea_pavettifolia,37,13,24,Points-PointsKO-Adjacents,324
Dupuya_haraka,37,22,15,Alphahull-PointsKO-Adjacents,250
Dupuya_madagascariensis,116,93,23,Alphahull-PointsKO-Adjacents,1258
Duranta_armata,3,3,0,Points-PointsKO-Adjacents,17
Duranta_costaricensis,67,49,18,Alphahull-PointsKO-Adjacents,149
Duranta_dombeyana,27,7,20,Points-PointsKO-Adjacents,198
Duranta_erecta,824,527,297,Alphahull-PointsKO-Adjacents,16636
Duranta_mutisii,151,101,50,Alphahull-PointsKO-Adjacents,2002
Duranta_obtusifolia,37,17,20,Points-PointsKO-Adjacents,268
Duranta_serratifolia,154,0,154,Points-PointsKO-Adjacents,803
Duranta_steyermarkii,1,1,0,Points-PointsKO-Adjacents,9
Duranta_triacantha,58,31,27,Alphahull-PointsKO-Adjacents,293
Duranta_vestita,114,0,114,Points-PointsKO-Adjacents,661
Durio_acutifolius,30,15,15,Points-PointsKO-Adjacents,227
Durio_affinis,1,1,0,Points-PointsKO-Adjacents,9
Durio_beccarianus,2,2,0,Points-PointsKO-Adjacents,18
Durio_bruneiensis,NA,NA,NA,NA,NA
Durio_bukitrayaensis,NA,NA,NA,NA,NA
Durio_burmanicus,NA,NA,NA,NA,NA
Durio_carinatus,0,0,0,NA,0
Durio_ceylanicus,5,5,0,Points-PointsKO-Adjacents,31
Durio_crassipes,1,1,0,Points-PointsKO-Adjacents,9
Durio_dulcis,10,0,10,Points-PointsKO-Adjacents,85
Durio_grandiflorus,10,1,9,Points-PointsKO-Adjacents,75
Durio_graveolens,17,5,12,Points-PointsKO-Adjacents,140
Durio_kinabaluensis,2,2,0,Points-PointsKO-Adjacents,18
Durio_kutejensis,18,8,10,Points-PointsKO-Adjacents,162
Durio_lanceolatus,9,0,9,Points-PointsKO-Adjacents,70
Durio_lissocarpus,0,0,0,NA,0
Durio_lowianus,2,2,0,Points-PointsKO-Adjacents,18
Durio_macrantha,0,0,0,NA,0
Durio_macrolepis,NA,NA,NA,NA,NA
Durio_macrophyllus,0,0,0,NA,0
Durio_malaccensis,2,0,2,Points-PointsKO-Adjacents,18
Durio_oblongus,3,0,3,Points-PointsKO-Adjacents,27
Durio_oxleyanus,8,0,8,Points-PointsKO-Adjacents,62
Durio_pinangianus,0,0,0,NA,0
Durio_purpureus,1,1,0,Points-PointsKO-Adjacents,9
Durio_rosayroanus,0,0,0,NA,0
Durio_singaporensis,3,1,2,Points-PointsKO-Adjacents,12
Durio_testudinarius,11,0,11,Points-PointsKO-Adjacents,89
Durio_wyatt-smithii,0,0,0,NA,0
Duroia_amapana,4,4,0,Points-PointsKO-Adjacents,36
Duroia_aquatica,43,39,4,Alphahull-PointsKO-Adjacents,1384
Duroia_bolivarensis,30,14,16,Points-PointsKO-Adjacents,235
Duroia_costaricensis,70,61,9,Alphahull-PointsKO-Adjacents,77
Duroia_duckei,95,41,54,Alphahull-PointsKO-Adjacents,6677
Duroia_eriopila,282,238,44,Alphahull-PointsKO-Adjacents,13239
Duroia_fusifera,134,97,37,Alphahull-PointsKO-Adjacents,6935
Duroia_genipoides,131,62,69,Alphahull-PointsKO-Adjacents,14622
Duroia_gransabanensis,4,4,0,Points-PointsKO-Adjacents,30
Duroia_hirsuta,508,457,51,Alphahull-PointsKO-Adjacents,23421
Duroia_hirsutissima,3,3,0,Points-PointsKO-Adjacents,26
Duroia_kotchubioides,0,0,0,NA,0
Duroia_laevis,5,2,3,Points-PointsKO-Adjacents,45
Duroia_longiflora,15,3,12,Points-PointsKO-Adjacents,135
Duroia_longifolia,8,0,8,Points-PointsKO-Adjacents,72
Duroia_macrophylla,148,106,42,Alphahull-PointsKO-Adjacents,16089
Duroia_maguirei,45,26,19,Alphahull-PointsKO-Adjacents,2095
Duroia_martiniana,0,0,0,NA,0
Duroia_melinonii,1,1,0,Points-PointsKO-Adjacents,9
Duroia_merumensis,1,1,0,Points-PointsKO-Adjacents,9
Duroia_micrantha,273,192,81,Alphahull-PointsKO-Adjacents,14952
Duroia_nitida,21,7,14,Points-PointsKO-Adjacents,161
Duroia_palustris,2,2,0,Points-PointsKO-Adjacents,18
Duroia_paraensis,23,3,20,Points-PointsKO-Adjacents,207
Duroia_paruensis,13,5,8,Points-PointsKO-Adjacents,108
Duroia_petiolaris,33,9,24,Points-PointsKO-Adjacents,295
Duroia_plicata,0,0,0,NA,0
Duroia_prancei,14,6,8,Points-PointsKO-Adjacents,122
Duroia_retrorsipila,6,3,3,Points-PointsKO-Adjacents,52
Duroia_saccifera,191,132,59,Alphahull-PointsKO-Adjacents,13933
Duroia_sancti-ciprianii,3,3,0,Points-PointsKO-Adjacents,24
Duroia_soejartoi,8,3,5,Points-PointsKO-Adjacents,54
Duroia_steinbachii,3,3,0,Points-PointsKO-Adjacents,23
Duroia_strigosa,2,2,0,Points-PointsKO-Adjacents,18
Duroia_trichocarpa,1,1,0,Points-PointsKO-Adjacents,9
Duroia_triflora,9,2,7,Points-PointsKO-Adjacents,81
Duroia_valesca,24,14,10,Points-PointsKO-Adjacents,179
Duroia_velutina,58,38,20,Alphahull-PointsKO-Adjacents,2468
Dussia_atropurpurea,37,21,16,Alphahull-PointsKO-Adjacents,326
Dussia_coriacea,8,1,7,Points-PointsKO-Adjacents,63
Dussia_cuscatlanica,48,32,16,Alphahull-PointsKO-Adjacents,1045
Dussia_discolor,44,17,27,Points-PointsKO-Adjacents,339
Dussia_foxii,1,1,0,Points-PointsKO-Adjacents,9
Dussia_lehmannii,121,101,20,Alphahull-PointsKO-Adjacents,2537
Dussia_macroprophyllata,105,83,22,Alphahull-PointsKO-Adjacents,1316
Dussia_martinicensis,17,2,15,Points-PointsKO-Adjacents,104
Dussia_mexicana,46,31,15,Alphahull-PointsKO-Adjacents,215
Dussia_sanguinea,2,2,0,Points-PointsKO-Adjacents,16
Dussia_tessmannii,190,149,41,Alphahull-PointsKO-Adjacents,10530
Dutailliopsis_gordonii,1,1,0,Points-PointsKO-Adjacents,9
Dutaillyea_amosensis,7,2,5,Points-PointsKO-Adjacents,28
Dutaillyea_comptonii,1,1,0,Points-PointsKO-Adjacents,9
Dutaillyea_trifoliolata,8,4,4,Points-PointsKO-Adjacents,22
Duvaua_dependens,71,0,71,Points-PointsKO-Adjacents,547
Dyera_costulata,0,0,0,NA,0
Dyera_polyphylla,1,1,0,Points-PointsKO-Adjacents,9
Dyerophytum_pendulum,4,4,0,Points-PointsKO-Adjacents,10
Dypsis_acuminum,7,1,6,Points-PointsKO-Adjacents,52
Dypsis_albofarinosa,0,0,0,NA,0
Dypsis_ambanjae,5,5,0,Points-PointsKO-Adjacents,27
Dypsis_ambositrae,11,6,5,Points-PointsKO-Adjacents,50
Dypsis_andrianatonga,17,10,7,Points-PointsKO-Adjacents,52
Dypsis_ankaizinensis,2,2,0,Points-PointsKO-Adjacents,18
Dypsis_ankirindro,3,3,0,Points-PointsKO-Adjacents,23
Dypsis_antanambensis,1,1,0,Points-PointsKO-Adjacents,8
Dypsis_arenarum,4,4,0,Points-PointsKO-Adjacents,34
Dypsis_baronii,65,47,18,Alphahull-PointsKO-Adjacents,1085
Dypsis_basilonga,2,2,0,Points-PointsKO-Adjacents,18
Dypsis_bejofo,12,5,7,Points-PointsKO-Adjacents,49
Dypsis_boiviniana,5,0,5,Points-PointsKO-Adjacents,32
Dypsis_brittiana,1,1,0,Points-PointsKO-Adjacents,9
Dypsis_cabadae,0,0,0,NA,0
Dypsis_canaliculata,5,5,0,Points-PointsKO-Adjacents,36
Dypsis_canescens,2,2,0,Points-PointsKO-Adjacents,17
Dypsis_carlsmithii,2,2,0,Points-PointsKO-Adjacents,14
Dypsis_ceracea,12,5,7,Points-PointsKO-Adjacents,74
Dypsis_commersoniana,2,2,0,Points-PointsKO-Adjacents,18
Dypsis_confusa,25,17,8,Points-PointsKO-Adjacents,136
Dypsis_corniculata,10,4,6,Points-PointsKO-Adjacents,54
Dypsis_coursii,10,0,10,Points-PointsKO-Adjacents,57
Dypsis_crinita,22,13,9,Points-PointsKO-Adjacents,128
Dypsis_curtisii,6,0,6,Points-PointsKO-Adjacents,38
Dypsis_decaryi,9,0,9,Points-PointsKO-Adjacents,34
Dypsis_decipiens,24,15,9,Points-PointsKO-Adjacents,124
Dypsis_delicatula,5,5,0,Points-PointsKO-Adjacents,12
Dypsis_dransfieldii,4,4,0,Points-PointsKO-Adjacents,25
Dypsis_faneva,7,1,6,Points-PointsKO-Adjacents,51
Dypsis_fanjana,9,2,7,Points-PointsKO-Adjacents,44
Dypsis_fasciculata,16,4,12,Points-PointsKO-Adjacents,112
Dypsis_fibrosa,74,48,26,Alphahull-PointsKO-Adjacents,785
Dypsis_forficifolia,44,32,12,Alphahull-PointsKO-Adjacents,310
Dypsis_gautieri,3,3,0,Points-PointsKO-Adjacents,12
Dypsis_henrici,2,2,0,Points-PointsKO-Adjacents,18
Dypsis_heteromorpha,9,4,5,Points-PointsKO-Adjacents,59
Dypsis_hiarakae,12,4,8,Points-PointsKO-Adjacents,87
Dypsis_hovomantsina,10,4,6,Points-PointsKO-Adjacents,43
Dypsis_humbertii,15,8,7,Points-PointsKO-Adjacents,91
Dypsis_humblotiana,0,0,0,NA,0
Dypsis_humilis,3,3,0,Points-PointsKO-Adjacents,27
Dypsis_ifanadianae,2,2,0,Points-PointsKO-Adjacents,14
Dypsis_intermedia,2,2,0,Points-PointsKO-Adjacents,9
Dypsis_interrupta,3,3,0,Points-PointsKO-Adjacents,18
Dypsis_jumelleana,21,14,7,Points-PointsKO-Adjacents,80
Dypsis_lanceolata,6,2,4,Points-PointsKO-Adjacents,20
Dypsis_lantzeana,18,11,7,Points-PointsKO-Adjacents,108
Dypsis_lanuginosa,4,4,0,Points-PointsKO-Adjacents,29
Dypsis_lastelliana,38,25,13,Alphahull-PointsKO-Adjacents,525
Dypsis_leptocheilos,7,0,7,Points-PointsKO-Adjacents,33
Dypsis_ligulata,2,2,0,Points-PointsKO-Adjacents,12
Dypsis_linearis,30,18,12,Points-PointsKO-Adjacents,191
Dypsis_lokohoensis,12,8,4,Points-PointsKO-Adjacents,66
Dypsis_lutea,6,3,3,Points-PointsKO-Adjacents,42
Dypsis_lutescens,24,9,15,Points-PointsKO-Adjacents,157
Dypsis_madagascariensis,67,50,17,Alphahull-PointsKO-Adjacents,1197
Dypsis_makirae,2,2,0,Points-PointsKO-Adjacents,12
Dypsis_malcomberi,8,3,5,Points-PointsKO-Adjacents,35
Dypsis_mananjarensis,20,6,14,Points-PointsKO-Adjacents,126
Dypsis_mangorensis,6,0,6,Points-PointsKO-Adjacents,44
Dypsis_marojejyi,8,3,5,Points-PointsKO-Adjacents,35
Dypsis_mcdonaldiana,5,5,0,Points-PointsKO-Adjacents,32
Dypsis_moorei,3,3,0,Points-PointsKO-Adjacents,21
Dypsis_nauseosa,6,2,4,Points-PointsKO-Adjacents,45
Dypsis_nodifera,117,93,24,Alphahull-PointsKO-Adjacents,900
Dypsis_nossibensis,3,3,0,Points-PointsKO-Adjacents,11
Dypsis_onilahensis,33,17,16,Points-PointsKO-Adjacents,225
Dypsis_oreophila,18,11,7,Points-PointsKO-Adjacents,102
Dypsis_oropedionis,5,5,0,Points-PointsKO-Adjacents,33
Dypsis_ovobontsira,1,1,0,Points-PointsKO-Adjacents,8
Dypsis_paludosa,15,9,6,Points-PointsKO-Adjacents,83
Dypsis_pembana,2,2,0,Points-PointsKO-Adjacents,8
Dypsis_perrieri,23,1,22,Points-PointsKO-Adjacents,138
Dypsis_pervillei,4,4,0,Points-PointsKO-Adjacents,24
Dypsis_pilulifera,20,9,11,Points-PointsKO-Adjacents,132
Dypsis_pinnatifrons,99,72,27,Alphahull-PointsKO-Adjacents,1124
Dypsis_plumosa,0,0,0,NA,0
Dypsis_prestoniana,4,4,0,Points-PointsKO-Adjacents,26
Dypsis_procera,20,13,7,Points-PointsKO-Adjacents,88
Dypsis_procumbens,44,25,19,Alphahull-PointsKO-Adjacents,320
Dypsis_psammophila,10,0,10,Points-PointsKO-Adjacents,52
Dypsis_rakotonasoloi,1,1,0,Points-PointsKO-Adjacents,9
Dypsis_rivularis,12,5,7,Points-PointsKO-Adjacents,57
Dypsis_robusta,NA,NA,NA,NA,NA
Dypsis_sahanofensis,9,1,8,Points-PointsKO-Adjacents,60
Dypsis_saintelucei,5,0,5,Points-PointsKO-Adjacents,43
Dypsis_sancta,1,1,0,Points-PointsKO-Adjacents,9
Dypsis_scottiana,31,19,12,Points-PointsKO-Adjacents,70
Dypsis_serpentina,9,1,8,Points-PointsKO-Adjacents,60
Dypsis_singularis,2,2,0,Points-PointsKO-Adjacents,18
Dypsis_soanieranae,4,4,0,Points-PointsKO-Adjacents,26
Dypsis_tanalensis,2,2,0,Points-PointsKO-Adjacents,12
Dypsis_thouarsiana,0,0,0,NA,0
Dypsis_tokoravina,9,1,8,Points-PointsKO-Adjacents,50
Dypsis_tsaratananensis,3,3,0,Points-PointsKO-Adjacents,12
Dypsis_tsaravoasira,22,13,9,Points-PointsKO-Adjacents,123
Dypsis_utilis,12,5,7,Points-PointsKO-Adjacents,69
Dypsis_vonitrandambo,1,1,0,Points-PointsKO-Adjacents,9
Dysosma_versipellis,45,11,34,Points-PointsKO-Adjacents,369
Dysoxylum_acutangulum,409,359,50,Alphahull-PointsKO-Adjacents,2067
Dysoxylum_alatum,3,3,0,Points-PointsKO-Adjacents,21
Dysoxylum_aliquantulum,0,0,0,NA,0
Dysoxylum_alliaceum,126,58,68,Alphahull-PointsKO-Adjacents,700
Dysoxylum_aneityense,11,0,11,Points-PointsKO-Adjacents,71
Dysoxylum_angustifolium,0,0,0,NA,0
Dysoxylum_annae,0,0,0,NA,0
Dysoxylum_arborescens,267,163,104,Alphahull-PointsKO-Adjacents,3514
Dysoxylum_beddomei,0,0,0,NA,0
Dysoxylum_bijugum,30,8,22,Points-PointsKO-Adjacents,151
Dysoxylum_boridianum,2,2,0,Points-PointsKO-Adjacents,12
Dysoxylum_brachybotrys,4,4,0,Points-PointsKO-Adjacents,18
Dysoxylum_brassii,8,0,8,Points-PointsKO-Adjacents,66
Dysoxylum_brevipaniculum,9,0,9,Points-PointsKO-Adjacents,81
Dysoxylum_canalense,8,3,5,Points-PointsKO-Adjacents,51
Dysoxylum_carolinae,5,5,0,Points-PointsKO-Adjacents,39
Dysoxylum_cauliflorum,36,13,23,Points-PointsKO-Adjacents,291
Dysoxylum_championii,1,1,0,Points-PointsKO-Adjacents,9
Dysoxylum_crassum,0,0,0,NA,0
Dysoxylum_cumingianum,8,1,7,Points-PointsKO-Adjacents,24
Dysoxylum_cupuliforme,1,1,0,Points-PointsKO-Adjacents,9
Dysoxylum_cyrtobotryum,30,3,27,Points-PointsKO-Adjacents,266
Dysoxylum_densiflorum,18,3,15,Points-PointsKO-Adjacents,155
Dysoxylum_dolichobotrys,0,0,0,NA,0
Dysoxylum_dumosum,0,0,0,NA,0
Dysoxylum_enantiophyllum,3,3,0,Points-PointsKO-Adjacents,27
Dysoxylum_excelsum,53,16,37,Points-PointsKO-Adjacents,369
Dysoxylum_flavescens,1,1,0,Points-PointsKO-Adjacents,9
Dysoxylum_fraserianum,946,909,37,Alphahull-PointsKO-Adjacents,1400
Dysoxylum_gaudichaudianum,226,135,91,Alphahull-PointsKO-Adjacents,2453
Dysoxylum_gillespieanum,0,0,0,NA,0
Dysoxylum_glandulosum,NA,NA,NA,NA,NA
Dysoxylum_gotadhora,2,0,2,Points-PointsKO-Adjacents,18
Dysoxylum_grande,18,3,15,Points-PointsKO-Adjacents,162
Dysoxylum_hapalanthum,17,6,11,Points-PointsKO-Adjacents,100
Dysoxylum_hoaense,0,0,0,NA,0
Dysoxylum_hongkongense,68,50,18,Alphahull-PointsKO-Adjacents,177
Dysoxylum_hornei,0,0,0,NA,0
Dysoxylum_huntii,22,15,7,Points-PointsKO-Adjacents,46
Dysoxylum_inopinatum,13,4,9,Points-PointsKO-Adjacents,93
Dysoxylum_juglans,0,0,0,NA,0
Dysoxylum_kaniense,0,0,0,NA,0
Dysoxylum_klanderi,105,87,18,Alphahull-PointsKO-Adjacents,191
Dysoxylum_kouiriense,2,2,0,Points-PointsKO-Adjacents,18
Dysoxylum_latifolium,145,111,34,Alphahull-PointsKO-Adjacents,747
Dysoxylum_laxiracemosum,0,0,0,NA,0
Dysoxylum_lenticellare,2,2,0,Points-PointsKO-Adjacents,15
Dysoxylum_lenticellatum,4,0,4,Points-PointsKO-Adjacents,36
Dysoxylum_loureirii,0,0,0,NA,0
Dysoxylum_macranthum,4,4,0,Points-PointsKO-Adjacents,27
Dysoxylum_macrocarpum,6,0,6,Points-PointsKO-Adjacents,48
Dysoxylum_macrostachyum,2,2,0,Points-PointsKO-Adjacents,18
Dysoxylum_magnificum,1,1,0,Points-PointsKO-Adjacents,9
Dysoxylum_malabaricum,0,0,0,NA,0
Dysoxylum_medogense,NA,NA,NA,NA,NA
Dysoxylum_middletonianum,NA,NA,NA,NA,NA
Dysoxylum_minutiflorum,4,4,0,Points-PointsKO-Adjacents,25
Dysoxylum_mollissimum,35,9,26,Points-PointsKO-Adjacents,252
Dysoxylum_myriandrum,0,0,0,NA,0
Dysoxylum_nutans,16,6,10,Points-PointsKO-Adjacents,122
Dysoxylum_oliveri,0,0,0,NA,0
Dysoxylum_oppositifolium,138,111,27,Alphahull-PointsKO-Adjacents,509
Dysoxylum_pachyphyllum,15,0,15,Points-PointsKO-Adjacents,5
Dysoxylum_pachypodum,0,0,0,NA,0
Dysoxylum_pachyrhache,2,2,0,Points-PointsKO-Adjacents,18
Dysoxylum_pallens,0,0,0,NA,0
Dysoxylum_papillosum,1,1,0,Points-PointsKO-Adjacents,9
Dysoxylum_papuanum,86,68,18,Alphahull-PointsKO-Adjacents,214
Dysoxylum_parasiticum,207,140,67,Alphahull-PointsKO-Adjacents,2533
Dysoxylum_pauciflorum,1,1,0,Points-PointsKO-Adjacents,8
Dysoxylum_perryanum,NA,NA,NA,NA,NA
Dysoxylum_pettigrewianum,157,0,157,Points-PointsKO-Adjacents,561
Dysoxylum_phaeotrichum,3,3,0,Points-PointsKO-Adjacents,27
Dysoxylum_poilanei,1,1,0,Points-PointsKO-Adjacents,9
Dysoxylum_pumilum,15,11,4,Points-PointsKO-Adjacents,30
Dysoxylum_purpureum,0,0,0,NA,0
Dysoxylum_quadrangulatum,3,3,0,Points-PointsKO-Adjacents,9
Dysoxylum_randianum,0,0,0,NA,0
Dysoxylum_rigidum,1,1,0,Points-PointsKO-Adjacents,9
Dysoxylum_roseum,118,103,15,Alphahull-PointsKO-Adjacents,199
Dysoxylum_rubrocostatum,0,0,0,NA,0
Dysoxylum_rufescens,42,28,14,Alphahull-PointsKO-Adjacents,137
Dysoxylum_rufum,615,573,42,Alphahull-PointsKO-Adjacents,1072
Dysoxylum_rugulosum,9,0,9,Points-PointsKO-Adjacents,73
Dysoxylum_seemannii,1,1,0,Points-PointsKO-Adjacents,3
Dysoxylum_sessile,5,5,0,Points-PointsKO-Adjacents,42
Dysoxylum_setosum,69,42,27,Alphahull-PointsKO-Adjacents,771
Dysoxylum_sparsiflorum,0,0,0,NA,0
Dysoxylum_spectabile,1833,1770,63,Alphahull-PointsKO-Adjacents,1831
Dysoxylum_spicatum,0,0,0,NA,0
Dysoxylum_stellatopuberulum,2,2,0,Points-PointsKO-Adjacents,16
Dysoxylum_swaminathanianum,NA,NA,NA,NA,NA
Dysoxylum_tenuiflorum,0,0,0,NA,0
Dysoxylum_tongense,0,0,0,NA,0
Dysoxylum_tonkinense,0,0,0,NA,0
Dysoxylum_variabile,53,30,23,Alphahull-PointsKO-Adjacents,1322
Dysoxylum_yunzaingense,4,4,0,Points-PointsKO-Adjacents,36
Dystovomita_brasiliensis,23,0,23,Points-PointsKO-Adjacents,155
Dystovomita_clusiifolia,35,13,22,Points-PointsKO-Adjacents,244
Dystovomita_paniculata,169,134,35,Alphahull-PointsKO-Adjacents,2306
Ebenopsis_caesalpinioides,5,5,0,Points-PointsKO-Adjacents,26
Ebenopsis_confinis,67,54,13,Alphahull-PointsKO-Adjacents,720
Ebenopsis_ebano,279,201,78,Alphahull-PointsKO-Adjacents,2760
Eberhardtia_aurata,15,4,11,Points-PointsKO-Adjacents,128
Eberhardtia_krempfii,1,1,0,Points-PointsKO-Adjacents,9
Eberhardtia_tonkinensis,10,4,6,Points-PointsKO-Adjacents,75
Ecclinusa_bullata,22,0,22,Points-PointsKO-Adjacents,127
Ecclinusa_dumetorum,4,4,0,Points-PointsKO-Adjacents,30
Ecclinusa_guianensis,266,169,97,Alphahull-PointsKO-Adjacents,30477
Ecclinusa_lanceolata,330,251,79,Alphahull-PointsKO-Adjacents,46016
Ecclinusa_lancifolia,8,0,8,Points-PointsKO-Adjacents,72
Ecclinusa_orinocoensis,6,2,4,Points-PointsKO-Adjacents,24
Ecclinusa_parviflora,2,1,1,Points-PointsKO-Adjacents,18
Ecclinusa_psilophylla,9,1,8,Points-PointsKO-Adjacents,72
Ecclinusa_ramiflora,592,437,155,Alphahull-PointsKO-Adjacents,48988
Ecclinusa_ulei,29,22,7,Alphahull-PointsKO-Adjacents,588
Echinocactus_platyacanthus,458,434,24,Alphahull-PointsKO-Adjacents,1580
Echinopsis_cuzcoensis,1,1,0,Points-PointsKO-Adjacents,9
Echinopsis_lageniformis,4,4,0,Points-PointsKO-Adjacents,23
Echinopsis_tacaquirensis,0,0,0,NA,0
Echinopsis_tarijensis,14,8,6,Points-PointsKO-Adjacents,126
Echinopsis_terscheckii,27,15,12,Points-PointsKO-Adjacents,199
Echinopsis_uyupampensis,0,0,0,NA,0
Echinopsis_volliana,2,2,0,Points-PointsKO-Adjacents,18
Ecuadendron_acosta-solisianum,7,4,3,Points-PointsKO-Adjacents,30
Edgeworthia_gardneri,39,22,17,Alphahull-PointsKO-Adjacents,220
Ehretia_acuminata,1169,1027,142,Alphahull-PointsKO-Adjacents,15720
Ehretia_amoena,111,84,27,Alphahull-PointsKO-Adjacents,2451
Ehretia_anacua,356,283,73,Alphahull-PointsKO-Adjacents,5915
Ehretia_bakeri,56,40,16,Alphahull-PointsKO-Adjacents,967
Ehretia_coerulea,14,3,11,Points-PointsKO-Adjacents,118
Ehretia_confinis,6,0,6,Points-PointsKO-Adjacents,45
Ehretia_corylifolia,20,9,11,Points-PointsKO-Adjacents,171
Ehretia_cymosa,343,240,103,Alphahull-PointsKO-Adjacents,14346
Ehretia_decaryi,9,6,3,Points-PointsKO-Adjacents,56
Ehretia_densiflora,1,1,0,Points-PointsKO-Adjacents,9
Ehretia_dichotoma,2,2,0,Points-PointsKO-Adjacents,18
Ehretia_dicksonii,121,68,53,Alphahull-PointsKO-Adjacents,5801
Ehretia_dunniana,4,4,0,Points-PointsKO-Adjacents,34
Ehretia_glandulosissima,1,1,0,Points-PointsKO-Adjacents,9
Ehretia_hainanensis,1,1,0,Points-PointsKO-Adjacents,9
Ehretia_javanica,5,5,0,Points-PointsKO-Adjacents,44
Ehretia_keyensis,0,0,0,NA,0
Ehretia_laevis,31,0,31,Points-PointsKO-Adjacents,259
Ehretia_latifolia,195,144,51,Alphahull-PointsKO-Adjacents,2684
Ehretia_longiflora,107,69,38,Alphahull-PointsKO-Adjacents,2185
Ehretia_meyersii,5,5,0,Points-PointsKO-Adjacents,22
Ehretia_microcalyx,NA,NA,NA,NA,NA
Ehretia_microphylla,0,0,0,NA,0
Ehretia_moluccana,NA,NA,NA,NA,NA
Ehretia_obtusifolia,101,49,52,Alphahull-PointsKO-Adjacents,2347
Ehretia_parallela,0,0,0,NA,0
Ehretia_philippinensis,12,3,9,Points-PointsKO-Adjacents,58
Ehretia_phillipsonii,10,5,5,Points-PointsKO-Adjacents,41
Ehretia_pingbianensis,2,2,0,Points-PointsKO-Adjacents,18
Ehretia_resinosa,42,27,15,Alphahull-PointsKO-Adjacents,157
Ehretia_retusa,NA,NA,NA,NA,NA
Ehretia_rigida,NA,NA,NA,NA,NA
Ehretia_saligna,1108,1031,77,Alphahull-PointsKO-Adjacents,27128
Ehretia_setosa,NA,NA,NA,NA,NA
Ehretia_seyrigii,13,4,9,Points-PointsKO-Adjacents,66
Ehretia_siamensis,0,0,0,NA,0
Ehretia_silvana,1,0,1,Points-PointsKO-Adjacents,9
Ehretia_timorensis,0,0,0,NA,0
Ehretia_tinifolia,651,524,127,Alphahull-PointsKO-Adjacents,9504
Ehretia_trachyphylla,23,13,10,Points-PointsKO-Adjacents,141
Ehretia_tsangii,8,1,7,Points-PointsKO-Adjacents,72
Ehretia_wallichiana,2,2,0,Points-PointsKO-Adjacents,18
Ehretia_wightiana,0,0,0,NA,0
Eirmocephala_megaphylla,107,67,40,Alphahull-PointsKO-Adjacents,1165
Ekebergia_benguelensis,37,12,25,Points-PointsKO-Adjacents,287
Ekebergia_capensis,632,475,157,Alphahull-PointsKO-Adjacents,31284
Ekebergia_pterophylla,60,40,20,Alphahull-PointsKO-Adjacents,945
Ekmanianthe_actinophylla,5,5,0,Points-PointsKO-Adjacents,29
Ekmanianthe_longiflora,9,1,8,Points-PointsKO-Adjacents,59
Elachyptera_floribunda,74,22,52,Alphahull-PointsKO-Adjacents,631
Elachyptera_parvifolia,42,11,31,Points-PointsKO-Adjacents,345
Elaeagia_alterniramosa,9,3,6,Points-PointsKO-Adjacents,64
Elaeagia_arborea,4,4,0,Points-PointsKO-Adjacents,36
Elaeagia_asperula,6,2,4,Points-PointsKO-Adjacents,48
Elaeagia_auriculata,81,65,16,Alphahull-PointsKO-Adjacents,297
Elaeagia_barbata,4,4,0,Points-PointsKO-Adjacents,30
Elaeagia_chiriquina,4,4,0,Points-PointsKO-Adjacents,25
Elaeagia_cuatrecasasii,2,2,0,Points-PointsKO-Adjacents,18
Elaeagia_cubensis,1,1,0,Points-PointsKO-Adjacents,8
Elaeagia_ecuadorensis,13,6,7,Points-PointsKO-Adjacents,64
Elaeagia_glossostipula,26,16,10,Points-PointsKO-Adjacents,164
Elaeagia_grandis,4,4,0,Points-PointsKO-Adjacents,36
Elaeagia_karstenii,128,68,60,Alphahull-PointsKO-Adjacents,3570
Elaeagia_laxiflora,8,3,5,Points-PointsKO-Adjacents,42
Elaeagia_magniflora,8,0,8,Points-PointsKO-Adjacents,63
Elaeagia_maguirei,36,17,19,Points-PointsKO-Adjacents,245
Elaeagia_mariae,142,106,36,Alphahull-PointsKO-Adjacents,933
Elaeagia_microcarpa,14,9,5,Points-PointsKO-Adjacents,107
Elaeagia_mollis,2,2,0,Points-PointsKO-Adjacents,18
Elaeagia_multinervia,2,2,0,Points-PointsKO-Adjacents,18
Elaeagia_myriantha,149,97,52,Alphahull-PointsKO-Adjacents,2242
Elaeagia_nitidifolia,33,18,15,Points-PointsKO-Adjacents,217
Elaeagia_obovata,26,13,13,Points-PointsKO-Adjacents,196
Elaeagia_pastoensis,68,56,12,Alphahull-PointsKO-Adjacents,2032
Elaeagia_ruizteranii,6,2,4,Points-PointsKO-Adjacents,46
Elaeagia_utilis,180,144,36,Alphahull-PointsKO-Adjacents,3948
Elaeagnus_angustifolia,1162,883,279,Alphahull-PointsKO-Adjacents,71997
Elaeagnus_annamensis,1,1,0,Points-PointsKO-Adjacents,9
Elaeagnus_bambusetorum,0,0,0,NA,0
Elaeagnus_bockii,42,26,16,Alphahull-PointsKO-Adjacents,2840
Elaeagnus_bonii,2,2,0,Points-PointsKO-Adjacents,18
Elaeagnus_calcarea,NA,NA,NA,NA,NA
Elaeagnus_caudata,1,1,0,Points-PointsKO-Adjacents,9
Elaeagnus_cinnamomifolia,2,2,0,Points-PointsKO-Adjacents,18
Elaeagnus_commutata,479,332,147,Alphahull-PointsKO-Adjacents,27919
Elaeagnus_conferta,35,0,35,Points-PointsKO-Adjacents,305
Elaeagnus_courtoisii,NA,NA,NA,NA,NA
Elaeagnus_davidii,0,0,0,NA,0
Elaeagnus_delavayi,4,4,0,Points-PointsKO-Adjacents,36
Elaeagnus_difficilis,27,5,22,Points-PointsKO-Adjacents,243
Elaeagnus_fasciculata,NA,NA,NA,NA,NA
Elaeagnus_gonyanthes,28,0,28,Points-PointsKO-Adjacents,243
Elaeagnus_griffithii,5,5,0,Points-PointsKO-Adjacents,45
Elaeagnus_grijsii,1,1,0,Points-PointsKO-Adjacents,9
Elaeagnus_guizhouensis,NA,NA,NA,NA,NA
Elaeagnus_henryi,49,17,32,Points-PointsKO-Adjacents,431
Elaeagnus_infundibularis,2,2,0,Points-PointsKO-Adjacents,18
Elaeagnus_jiangxiensis,1,1,0,Points-PointsKO-Adjacents,9
Elaeagnus_jingdonensis,1,1,0,Points-PointsKO-Adjacents,9
Elaeagnus_kanaii,0,0,0,NA,0
Elaeagnus_lanceolata,75,44,31,Alphahull-PointsKO-Adjacents,9432
Elaeagnus_lanpingensis,8,4,4,Points-PointsKO-Adjacents,46
Elaeagnus_laosensis,NA,NA,NA,NA,NA
Elaeagnus_latifolia,4,4,0,Points-PointsKO-Adjacents,36
Elaeagnus_lipoensis,NA,NA,NA,NA,NA
Elaeagnus_liuzhouensis,NA,NA,NA,NA,NA
Elaeagnus_longiloba,1,1,0,Points-PointsKO-Adjacents,9
Elaeagnus_loureiroi,17,4,13,Points-PointsKO-Adjacents,147
Elaeagnus_luoxiangensis,NA,NA,NA,NA,NA
Elaeagnus_luxiensis,6,0,6,Points-PointsKO-Adjacents,52
Elaeagnus_macrantha,3,3,0,Points-PointsKO-Adjacents,27
Elaeagnus_magna,39,22,17,Alphahull-PointsKO-Adjacents,1949
Elaeagnus_maximowiczii,0,0,0,NA,0
Elaeagnus_micrantha,3,3,0,Points-PointsKO-Adjacents,27
Elaeagnus_mollis,0,0,0,NA,0
Elaeagnus_multiflora,423,235,188,Alphahull-PointsKO-Adjacents,3886
Elaeagnus_oldhamii,73,44,29,Alphahull-PointsKO-Adjacents,370
Elaeagnus_ovata,0,0,0,NA,0
Elaeagnus_pallidiflora,3,3,0,Points-PointsKO-Adjacents,27
Elaeagnus_parvifolia,5,5,0,Points-PointsKO-Adjacents,45
Elaeagnus_pilostyla,2,2,0,Points-PointsKO-Adjacents,18
Elaeagnus_pungens,387,232,155,Alphahull-PointsKO-Adjacents,16913
Elaeagnus_pyriformis,0,0,0,NA,0
Elaeagnus_retrostyla,NA,NA,NA,NA,NA
Elaeagnus_rhamnoides,1294,969,325,Alphahull-PointsKO-Adjacents,18061
Elaeagnus_sarmentosa,5,5,0,Points-PointsKO-Adjacents,45
Elaeagnus_schlechtendalii,0,0,0,NA,0
Elaeagnus_songarica,2,2,0,Points-PointsKO-Adjacents,18
Elaeagnus_s-stylata,NA,NA,NA,NA,NA
Elaeagnus_stellipila,20,0,20,Points-PointsKO-Adjacents,179
Elaeagnus_taliensis,1,1,0,Points-PointsKO-Adjacents,9
Elaeagnus_tarokoensis,6,2,4,Points-PointsKO-Adjacents,21
Elaeagnus_tonkinensis,5,5,0,Points-PointsKO-Adjacents,45
Elaeagnus_tubiflora,2,2,0,Points-PointsKO-Adjacents,18
Elaeagnus_tutcheri,0,0,0,NA,0
Elaeagnus_viridis,32,17,15,Points-PointsKO-Adjacents,286
Elaeagnus_wenshanensis,8,3,5,Points-PointsKO-Adjacents,63
Elaeagnus_xichouensis,1,1,0,Points-PointsKO-Adjacents,9
Elaeagnus_xingwenensis,NA,NA,NA,NA,NA
Elaeagnus_xizangensis,NA,NA,NA,NA,NA
Elaeagnus_yunnanensis,0,0,0,NA,0
Elaeis_guineensis,102,33,69,Alphahull-PointsKO-Adjacents,671
Elaeis_oleifera,204,126,78,Alphahull-PointsKO-Adjacents,4429
Elaeocarpus_acmocarpus,4,4,0,Points-PointsKO-Adjacents,35
Elaeocarpus_acmosepalus,0,0,0,NA,0
Elaeocarpus_acrantherus,4,4,0,Points-PointsKO-Adjacents,36
Elaeocarpus_acronodia,4,4,0,Points-PointsKO-Adjacents,36
Elaeocarpus_acuminatus,0,0,0,NA,0
Elaeocarpus_adenopus,0,0,0,NA,0
Elaeocarpus_affinis,0,0,0,NA,0
Elaeocarpus_alaternoides,108,93,15,Alphahull-PointsKO-Adjacents,186
Elaeocarpus_albiflorus,1,1,0,Points-PointsKO-Adjacents,9
Elaeocarpus_alnifolius,50,27,23,Alphahull-PointsKO-Adjacents,519
Elaeocarpus_altigenus,33,21,12,Alphahull-PointsKO-Adjacents,550
Elaeocarpus_altisectus,11,3,8,Points-PointsKO-Adjacents,72
Elaeocarpus_amboinensis,0,0,0,NA,0
Elaeocarpus_amoenus,1,1,0,Points-PointsKO-Adjacents,9
Elaeocarpus_ampliflorus,0,0,0,NA,0
Elaeocarpus_amplifolius,19,7,12,Points-PointsKO-Adjacents,99
Elaeocarpus_angustifolius,40,5,35,Points-PointsKO-Adjacents,330
Elaeocarpus_angustipes,10,3,7,Points-PointsKO-Adjacents,53
Elaeocarpus_apoensis,0,0,0,NA,0
Elaeocarpus_arfakensis,16,0,16,Points-PointsKO-Adjacents,87
Elaeocarpus_argenteus,9,0,9,Points-PointsKO-Adjacents,36
Elaeocarpus_arnhemicus,608,547,61,Alphahull-PointsKO-Adjacents,4035
Elaeocarpus_atropunctatus,NA,NA,NA,NA,NA
Elaeocarpus_auricomus,2,2,0,Points-PointsKO-Adjacents,18
Elaeocarpus_austroyunnanensis,6,1,5,Points-PointsKO-Adjacents,54
Elaeocarpus_azaleifolius,1,1,0,Points-PointsKO-Adjacents,9
Elaeocarpus_bachmaensis,2,2,0,Points-PointsKO-Adjacents,18
Elaeocarpus_badius,0,0,0,NA,0
Elaeocarpus_bakaianus,8,0,8,Points-PointsKO-Adjacents,42
Elaeocarpus_balabanii,0,0,0,NA,0
Elaeocarpus_balansae,3,3,0,Points-PointsKO-Adjacents,27
Elaeocarpus_balgooyi,4,4,0,Points-PointsKO-Adjacents,29
Elaeocarpus_bancroftii,100,0,100,Points-PointsKO-Adjacents,182
Elaeocarpus_baramii,1,1,0,Points-PointsKO-Adjacents,9
Elaeocarpus_barbulatus,4,4,0,Points-PointsKO-Adjacents,36
Elaeocarpus_bataanensis,3,3,0,Points-PointsKO-Adjacents,27
Elaeocarpus_batjanicus,NA,NA,NA,NA,NA
Elaeocarpus_batudulangii,0,0,0,NA,0
Elaeocarpus_batui,2,2,0,Points-PointsKO-Adjacents,18
Elaeocarpus_baudouini,21,17,4,Points-PointsKO-Adjacents,65
Elaeocarpus_beccarii,4,4,0,Points-PointsKO-Adjacents,36
Elaeocarpus_bellus,NA,NA,NA,NA,NA
Elaeocarpus_bidupensis,0,0,0,NA,0
Elaeocarpus_bifidus,9,4,5,Points-PointsKO-Adjacents,39
Elaeocarpus_biflorus,1,1,0,Points-PointsKO-Adjacents,9
Elaeocarpus_bilobatus,6,0,6,Points-PointsKO-Adjacents,41
Elaeocarpus_bilongvinas,2,2,0,Points-PointsKO-Adjacents,14
Elaeocarpus_blascoi,0,0,0,NA,0
Elaeocarpus_blepharoceras,20,15,5,Points-PointsKO-Adjacents,88
Elaeocarpus_bojeri,1,1,0,Points-PointsKO-Adjacents,9
Elaeocarpus_bonii,1,1,0,Points-PointsKO-Adjacents,9
Elaeocarpus_bontocensis,NA,NA,NA,NA,NA
Elaeocarpus_braceanus,24,13,11,Points-PointsKO-Adjacents,202
Elaeocarpus_brachypodus,13,4,9,Points-PointsKO-Adjacents,82
Elaeocarpus_brachystachyus,3,3,0,Points-PointsKO-Adjacents,18
Elaeocarpus_bracteatus,0,0,0,NA,0
Elaeocarpus_branderhorsti,7,3,4,Points-PointsKO-Adjacents,41
Elaeocarpus_brigittae,0,0,0,NA,0
Elaeocarpus_brunneotomentosus,2,2,0,Points-PointsKO-Adjacents,12
Elaeocarpus_brunnescens,13,7,6,Points-PointsKO-Adjacents,105
Elaeocarpus_buderi,7,1,6,Points-PointsKO-Adjacents,51
Elaeocarpus_bullatus,15,8,7,Points-PointsKO-Adjacents,53
Elaeocarpus_burebidensis,0,0,0,NA,0
Elaeocarpus_burkii,0,0,0,NA,0
Elaeocarpus_calomala,3,3,0,Points-PointsKO-Adjacents,27
Elaeocarpus_candollei,0,0,0,NA,0
Elaeocarpus_capuronii,15,7,8,Points-PointsKO-Adjacents,100
Elaeocarpus_carolinae,50,0,50,Points-PointsKO-Adjacents,94
Elaeocarpus_carolinensis,3,3,0,Points-PointsKO-Adjacents,11
Elaeocarpus_cassinoides,1,1,0,Points-PointsKO-Adjacents,9
Elaeocarpus_castaneifolius,7,3,4,Points-PointsKO-Adjacents,21
Elaeocarpus_celebesianus,0,0,0,NA,0
Elaeocarpus_celebicus,2,2,0,Points-PointsKO-Adjacents,18
Elaeocarpus_cheirophorus,NA,NA,NA,NA,NA
Elaeocarpus_chelonimorphus,1,1,0,Points-PointsKO-Adjacents,8
Elaeocarpus_chewii,1,1,0,Points-PointsKO-Adjacents,9
Elaeocarpus_chinensis,59,36,23,Alphahull-PointsKO-Adjacents,3531
Elaeocarpus_chionanthus,0,0,0,NA,0
Elaeocarpus_christophersenii,1,1,0,Points-PointsKO-Adjacents,5
Elaeocarpus_chrysophyllus,1,1,0,Points-PointsKO-Adjacents,9
Elaeocarpus_clementis,58,38,20,Alphahull-PointsKO-Adjacents,2676
Elaeocarpus_clethroides,1,1,0,Points-PointsKO-Adjacents,9
Elaeocarpus_coactilus,0,0,0,NA,0
Elaeocarpus_colnettianus,5,5,0,Points-PointsKO-Adjacents,18
Elaeocarpus_coloides,16,3,13,Points-PointsKO-Adjacents,94
Elaeocarpus_compactus,0,0,0,NA,0
Elaeocarpus_comptonii,9,4,5,Points-PointsKO-Adjacents,50
Elaeocarpus_conoideus,2,2,0,Points-PointsKO-Adjacents,9
Elaeocarpus_coodei,0,0,0,NA,0
Elaeocarpus_coorangooloo,32,24,8,Alphahull-PointsKO-Adjacents,72
Elaeocarpus_corallococcus,7,1,6,Points-PointsKO-Adjacents,41
Elaeocarpus_cordifolius,1,1,0,Points-PointsKO-Adjacents,9
Elaeocarpus_coriaceus,0,0,0,NA,0
Elaeocarpus_corneri,1,1,0,Points-PointsKO-Adjacents,9
Elaeocarpus_corsonianus,NA,NA,NA,NA,NA
Elaeocarpus_costatus,10,7,3,Points-PointsKO-Adjacents,5
Elaeocarpus_coumbouiensis,7,2,5,Points-PointsKO-Adjacents,51
Elaeocarpus_crassinervatus,3,3,0,Points-PointsKO-Adjacents,25
Elaeocarpus_crassus,0,0,0,NA,0
Elaeocarpus_cristatus,4,4,0,Points-PointsKO-Adjacents,30
Elaeocarpus_cruciatus,1,1,0,Points-PointsKO-Adjacents,9
Elaeocarpus_cuernosensis,6,0,6,Points-PointsKO-Adjacents,43
Elaeocarpus_culminicola,79,46,33,Alphahull-PointsKO-Adjacents,2962
Elaeocarpus_cumingii,20,4,16,Points-PointsKO-Adjacents,167
Elaeocarpus_cupreus,8,1,7,Points-PointsKO-Adjacents,70
Elaeocarpus_curranii,1,1,0,Points-PointsKO-Adjacents,9
Elaeocarpus_cyanocarpus,1,1,0,Points-PointsKO-Adjacents,7
Elaeocarpus_dallmannensis,0,0,0,NA,0
Elaeocarpus_darlacensis,NA,NA,NA,NA,NA
Elaeocarpus_dasycarpus,10,2,8,Points-PointsKO-Adjacents,60
Elaeocarpus_de-bruynii,2,2,0,Points-PointsKO-Adjacents,9
Elaeocarpus_degenerianus,0,0,0,NA,0
Elaeocarpus_densiflorus,35,18,17,Points-PointsKO-Adjacents,193
Elaeocarpus_dentatus,5047,4987,60,Alphahull-PointsKO-Adjacents,2754
Elaeocarpus_dewildei,0,0,0,NA,0
Elaeocarpus_dictyophlebius,2,2,0,Points-PointsKO-Adjacents,12
Elaeocarpus_dinagatensis,0,0,0,NA,0
Elaeocarpus_divaricativenus,NA,NA,NA,NA,NA
Elaeocarpus_dognyensis,50,33,17,Alphahull-PointsKO-Adjacents,128
Elaeocarpus_dolichobotrys,3,3,0,Points-PointsKO-Adjacents,21
Elaeocarpus_dolichodactylus,45,22,23,Alphahull-PointsKO-Adjacents,759
Elaeocarpus_dolichostylus,70,36,34,Alphahull-PointsKO-Adjacents,1555
Elaeocarpus_dubius,25,8,17,Points-PointsKO-Adjacents,216
Elaeocarpus_duclouxii,63,44,19,Alphahull-PointsKO-Adjacents,4758
Elaeocarpus_elaeagnoides,NA,NA,NA,NA,NA
Elaeocarpus_elatus,8,4,4,Points-PointsKO-Adjacents,52
Elaeocarpus_elliffii,97,84,13,Alphahull-PointsKO-Adjacents,193
Elaeocarpus_elmeri,6,0,6,Points-PointsKO-Adjacents,43
Elaeocarpus_erdinii,3,3,0,Points-PointsKO-Adjacents,24
Elaeocarpus_eriobotryoides,0,0,0,NA,0
Elaeocarpus_eumundi,236,195,41,Alphahull-PointsKO-Adjacents,983
Elaeocarpus_euneurus,5,4,1,Points-PointsKO-Adjacents,45
Elaeocarpus_eymae,1,1,0,Points-PointsKO-Adjacents,9
Elaeocarpus_fairchildii,3,3,0,Points-PointsKO-Adjacents,26
Elaeocarpus_ferrugineus,35,9,26,Points-PointsKO-Adjacents,226
Elaeocarpus_ferruginiflorus,111,102,9,Alphahull-PointsKO-Adjacents,264
Elaeocarpus_filiformidentatus,9,0,9,Points-PointsKO-Adjacents,68
Elaeocarpus_finisterrae,4,4,0,Points-PointsKO-Adjacents,21
Elaeocarpus_firmus,0,0,0,NA,0
Elaeocarpus_flavescens,NA,NA,NA,NA,NA
Elaeocarpus_fleuryi,1,1,0,Points-PointsKO-Adjacents,9
Elaeocarpus_floresii,0,0,0,NA,0
Elaeocarpus_floribundus,21,4,17,Points-PointsKO-Adjacents,163
Elaeocarpus_floridanus,11,2,9,Points-PointsKO-Adjacents,71
Elaeocarpus_forbesii,0,0,0,NA,0
Elaeocarpus_foveolatus,161,140,21,Alphahull-PointsKO-Adjacents,248
Elaeocarpus_foxworthyi,0,0,0,NA,0
Elaeocarpus_fraseri,0,0,0,NA,0
Elaeocarpus_fruticosus,NA,NA,NA,NA,NA
Elaeocarpus_fulgens,1,1,0,Points-PointsKO-Adjacents,9
Elaeocarpus_fulvus,0,0,0,NA,0
Elaeocarpus_fuscoides,37,19,18,Points-PointsKO-Adjacents,219
Elaeocarpus_fuscus,NA,NA,NA,NA,NA
Elaeocarpus_gagnepainii,0,0,0,NA,0
Elaeocarpus_gambutanus,2,2,0,Points-PointsKO-Adjacents,18
Elaeocarpus_gammillii,0,0,0,NA,0
Elaeocarpus_gaussenii,0,0,0,NA,0
Elaeocarpus_geminiflorus,38,25,13,Alphahull-PointsKO-Adjacents,77
Elaeocarpus_gibbonii,4,4,0,Points-PointsKO-Adjacents,12
Elaeocarpus_gigantifolius,1,1,0,Points-PointsKO-Adjacents,9
Elaeocarpus_gillespieanus,0,0,0,NA,0
Elaeocarpus_gitingensis,6,0,6,Points-PointsKO-Adjacents,43
Elaeocarpus_glaber,19,7,12,Points-PointsKO-Adjacents,141
Elaeocarpus_glaberrimus,1,1,0,Points-PointsKO-Adjacents,9
Elaeocarpus_glabripetalus,80,55,25,Alphahull-PointsKO-Adjacents,3415
Elaeocarpus_glandulifer,0,0,0,NA,0
Elaeocarpus_gordonii,4,4,0,Points-PointsKO-Adjacents,10
Elaeocarpus_graeffei,0,0,0,NA,0
Elaeocarpus_grahamii,59,46,13,Alphahull-PointsKO-Adjacents,112
Elaeocarpus_grandiflorus,15,4,11,Points-PointsKO-Adjacents,123
Elaeocarpus_griffithii,41,13,28,Points-PointsKO-Adjacents,300
Elaeocarpus_griseopuberulus,0,0,0,NA,0
Elaeocarpus_grumosus,1,1,0,Points-PointsKO-Adjacents,9
Elaeocarpus_guillaumii,9,0,9,Points-PointsKO-Adjacents,50
Elaeocarpus_gummatus,23,16,7,Points-PointsKO-Adjacents,84
Elaeocarpus_gustaviifolius,4,4,0,Points-PointsKO-Adjacents,32
Elaeocarpus_gymnogynus,7,2,5,Points-PointsKO-Adjacents,63
Elaeocarpus_habbemensis,33,17,16,Points-PointsKO-Adjacents,178
Elaeocarpus_hainanensis,14,0,14,Points-PointsKO-Adjacents,126
Elaeocarpus_halconensis,1,1,0,Points-PointsKO-Adjacents,9
Elaeocarpus_hallieri,0,0,0,NA,0
Elaeocarpus_harmandii,5,5,0,Points-PointsKO-Adjacents,45
Elaeocarpus_hartleyi,4,4,0,Points-PointsKO-Adjacents,18
Elaeocarpus_harunii,1,1,0,Points-PointsKO-Adjacents,9
Elaeocarpus_hayatae,6,2,4,Points-PointsKO-Adjacents,24
Elaeocarpus_hebecarpus,0,0,0,NA,0
Elaeocarpus_hedyosmus,0,0,0,NA,0
Elaeocarpus_heinrichii,NA,NA,NA,NA,NA
Elaeocarpus_heptadactyloides,1,1,0,Points-PointsKO-Adjacents,9
Elaeocarpus_heptadactylus,NA,NA,NA,NA,NA
Elaeocarpus_hildebrandtii,54,34,20,Alphahull-PointsKO-Adjacents,574
Elaeocarpus_hochreutineri,11,3,8,Points-PointsKO-Adjacents,78
Elaeocarpus_holopetalus,693,667,26,Alphahull-PointsKO-Adjacents,1316
Elaeocarpus_homalioides,4,4,0,Points-PointsKO-Adjacents,21
Elaeocarpus_hookerianus,4778,4707,71,Alphahull-PointsKO-Adjacents,4485
Elaeocarpus_hortensis,8,1,7,Points-PointsKO-Adjacents,39
Elaeocarpus_hosei,1,1,0,Points-PointsKO-Adjacents,9
Elaeocarpus_howii,3,3,0,Points-PointsKO-Adjacents,27
Elaeocarpus_hygrophilus,4,0,4,Points-PointsKO-Adjacents,35
Elaeocarpus_hypadenus,NA,NA,NA,NA,NA
Elaeocarpus_ilocanus,0,0,0,NA,0
Elaeocarpus_indochinensis,1,1,0,Points-PointsKO-Adjacents,9
Elaeocarpus_inopinatus,1,1,0,Points-PointsKO-Adjacents,9
Elaeocarpus_inopportunus,0,0,0,NA,0
Elaeocarpus_insignis,0,0,0,NA,0
Elaeocarpus_integrifolius,0,0,0,NA,0
Elaeocarpus_integripetalus,0,0,0,NA,0
Elaeocarpus_isotrichus,3,3,0,Points-PointsKO-Adjacents,27
Elaeocarpus_jacobsii,1,1,0,Points-PointsKO-Adjacents,9
Elaeocarpus_japonicus,547,454,93,Alphahull-PointsKO-Adjacents,15549
Elaeocarpus_joga,2,2,0,Points-PointsKO-Adjacents,8
Elaeocarpus_johnsonii,50,43,7,Alphahull-PointsKO-Adjacents,43
Elaeocarpus_jugahanus,4,4,0,Points-PointsKO-Adjacents,34
Elaeocarpus_kaalensis,7,0,7,Points-PointsKO-Adjacents,40
Elaeocarpus_kajewskii,0,0,0,NA,0
Elaeocarpus_kalabitii,4,4,0,Points-PointsKO-Adjacents,25
Elaeocarpus_kambi,1,1,0,Points-PointsKO-Adjacents,9
Elaeocarpus_kaniensis,10,0,10,Points-PointsKO-Adjacents,45
Elaeocarpus_kerstingianus,1,1,0,Points-PointsKO-Adjacents,9
Elaeocarpus_kinabaluensis,3,3,0,Points-PointsKO-Adjacents,27
Elaeocarpus_kirtonii,290,238,52,Alphahull-PointsKO-Adjacents,1367
Elaeocarpus_kjellbergii,0,0,0,NA,0
Elaeocarpus_knuthii,9,1,8,Points-PointsKO-Adjacents,55
Elaeocarpus_kontumensis,2,2,0,Points-PointsKO-Adjacents,18
Elaeocarpus_kostermansii,5,5,0,Points-PointsKO-Adjacents,45
Elaeocarpus_kraengensis,0,0,0,NA,0
Elaeocarpus_kusaiensis,1,1,0,Points-PointsKO-Adjacents,5
Elaeocarpus_kusanoi,2,2,0,Points-PointsKO-Adjacents,12
Elaeocarpus_lacunosus,34,0,34,Points-PointsKO-Adjacents,163
Elaeocarpus_lagunensis,2,2,0,Points-PointsKO-Adjacents,8
Elaeocarpus_lanceifolius,32,0,32,Points-PointsKO-Adjacents,185
Elaeocarpus_lancistipulatus,1,1,0,Points-PointsKO-Adjacents,9
Elaeocarpus_lanipae,NA,NA,NA,NA,NA
Elaeocarpus_laoticus,1,1,0,Points-PointsKO-Adjacents,9
Elaeocarpus_largiflorens,184,164,20,Alphahull-PointsKO-Adjacents,374
Elaeocarpus_latescens,1,1,0,Points-PointsKO-Adjacents,9
Elaeocarpus_laurifolius,0,0,0,NA,0
Elaeocarpus_lawasii,0,0,0,NA,0
Elaeocarpus_laxirameus,6,0,6,Points-PointsKO-Adjacents,43
Elaeocarpus_ledermannii,73,42,31,Alphahull-PointsKO-Adjacents,2042
Elaeocarpus_leopoldii,0,0,0,NA,0
Elaeocarpus_lepidus,0,0,0,NA,0
Elaeocarpus_le-ratii,17,6,11,Points-PointsKO-Adjacents,75
Elaeocarpus_leucanthus,4,4,0,Points-PointsKO-Adjacents,27
Elaeocarpus_leytensis,4,4,0,Points-PointsKO-Adjacents,34
Elaeocarpus_limitaneioides,NA,NA,NA,NA,NA
Elaeocarpus_limitaneus,13,1,12,Points-PointsKO-Adjacents,111
Elaeocarpus_linearifolius,0,0,0,NA,0
Elaeocarpus_lingualis,10,0,10,Points-PointsKO-Adjacents,54
Elaeocarpus_linnaei,1,1,0,Points-PointsKO-Adjacents,9
Elaeocarpus_linsmithii,25,19,6,Points-PointsKO-Adjacents,34
Elaeocarpus_longifolius,1,1,0,Points-PointsKO-Adjacents,9
Elaeocarpus_longlingensis,1,1,0,Points-PointsKO-Adjacents,9
Elaeocarpus_luteolignum,1,1,0,Points-PointsKO-Adjacents,9
Elaeocarpus_luteolus,9,2,7,Points-PointsKO-Adjacents,62
Elaeocarpus_luzonicus,0,0,0,NA,0
Elaeocarpus_macranthus,0,0,0,NA,0
Elaeocarpus_macrocarpus,0,0,0,NA,0
Elaeocarpus_macrocerus,11,2,9,Points-PointsKO-Adjacents,87
Elaeocarpus_macrophyllus,0,0,0,NA,0
Elaeocarpus_macropus,7,2,5,Points-PointsKO-Adjacents,61
Elaeocarpus_magnifolius,0,0,0,NA,0
Elaeocarpus_mallotoides,NA,NA,NA,NA,NA
Elaeocarpus_mamasii,0,0,0,NA,0
Elaeocarpus_mandiae,1,1,0,Points-PointsKO-Adjacents,9
Elaeocarpus_maquilingensis,0,0,0,NA,0
Elaeocarpus_marafunganus,12,4,8,Points-PointsKO-Adjacents,68
Elaeocarpus_marginatus,10,3,7,Points-PointsKO-Adjacents,59
Elaeocarpus_mastersii,45,24,21,Alphahull-PointsKO-Adjacents,660
Elaeocarpus_medioglaber,0,0,0,NA,0
Elaeocarpus_megacarpus,0,0,0,NA,0
Elaeocarpus_melochioides,0,0,0,NA,0
Elaeocarpus_merrittii,0,0,0,NA,0
Elaeocarpus_micranthus,0,0,0,NA,0
Elaeocarpus_microphyllus,0,0,0,NA,0
Elaeocarpus_miegei,30,10,20,Points-PointsKO-Adjacents,157
Elaeocarpus_millarii,9,4,5,Points-PointsKO-Adjacents,52
Elaeocarpus_milnei,0,0,0,NA,0
Elaeocarpus_mindanaensis,0,0,0,NA,0
Elaeocarpus_mindoroensis,0,0,0,NA,0
Elaeocarpus_mingendensis,NA,NA,NA,NA,NA
Elaeocarpus_miquelii,0,0,0,NA,0
Elaeocarpus_miriensis,1,1,0,Points-PointsKO-Adjacents,9
Elaeocarpus_mollis,1,1,0,Points-PointsKO-Adjacents,9
Elaeocarpus_monocera,0,0,0,NA,0
Elaeocarpus_montanus,1,1,0,Points-PointsKO-Adjacents,9
Elaeocarpus_moratii,2,2,0,Points-PointsKO-Adjacents,17
Elaeocarpus_multiflorus,20,3,17,Points-PointsKO-Adjacents,141
Elaeocarpus_multinervosus,8,0,8,Points-PointsKO-Adjacents,72
Elaeocarpus_multisectus,27,6,21,Points-PointsKO-Adjacents,123
Elaeocarpus_muluensis,0,0,0,NA,0
Elaeocarpus_munroii,0,0,0,NA,0
Elaeocarpus_murudensis,10,4,6,Points-PointsKO-Adjacents,80
Elaeocarpus_murukkai,19,11,8,Points-PointsKO-Adjacents,83
Elaeocarpus_musseri,4,4,0,Points-PointsKO-Adjacents,36
Elaeocarpus_mutabilis,6,2,4,Points-PointsKO-Adjacents,26
Elaeocarpus_myrmecophilus,2,2,0,Points-PointsKO-Adjacents,18
Elaeocarpus_myrtoides,2,2,0,Points-PointsKO-Adjacents,18
Elaeocarpus_nanus,9,2,7,Points-PointsKO-Adjacents,42
Elaeocarpus_neobritannicus,11,5,6,Points-PointsKO-Adjacents,79
Elaeocarpus_nervosus,1,1,0,Points-PointsKO-Adjacents,9
Elaeocarpus_nitentifolius,21,0,21,Points-PointsKO-Adjacents,174
Elaeocarpus_nitidulus,2,2,0,Points-PointsKO-Adjacents,16
Elaeocarpus_nitidus,27,7,20,Points-PointsKO-Adjacents,219
Elaeocarpus_nodosus,11,5,6,Points-PointsKO-Adjacents,29
Elaeocarpus_nooteboomii,1,1,0,Points-PointsKO-Adjacents,9
Elaeocarpus_nouhuysii,19,0,19,Points-PointsKO-Adjacents,88
Elaeocarpus_nubigenus,2,2,0,Points-PointsKO-Adjacents,18
Elaeocarpus_oblongilimbus,NA,NA,NA,NA,NA
Elaeocarpus_obovatus,996,913,83,Alphahull-PointsKO-Adjacents,2286
Elaeocarpus_obtusus,4,0,4,Points-PointsKO-Adjacents,36
Elaeocarpus_occidentalis,0,0,0,NA,0
Elaeocarpus_octantherus,0,0,0,NA,0
Elaeocarpus_octopetalus,15,9,6,Points-PointsKO-Adjacents,91
Elaeocarpus_oriomensis,8,1,7,Points-PointsKO-Adjacents,64
Elaeocarpus_orohensis,1,1,0,Points-PointsKO-Adjacents,9
Elaeocarpus_ovalis,19,3,16,Points-PointsKO-Adjacents,163
Elaeocarpus_ovigerus,25,16,9,Points-PointsKO-Adjacents,89
Elaeocarpus_pachyanthus,9,2,7,Points-PointsKO-Adjacents,55
Elaeocarpus_pachydactylus,NA,NA,NA,NA,NA
Elaeocarpus_pachyophrys,5,5,0,Points-PointsKO-Adjacents,36
Elaeocarpus_pagonensis,1,1,0,Points-PointsKO-Adjacents,9
Elaeocarpus_palembanicus,14,4,10,Points-PointsKO-Adjacents,125
Elaeocarpus_parviflorus,NA,NA,NA,NA,NA
Elaeocarpus_parvilimbus,6,0,6,Points-PointsKO-Adjacents,43
Elaeocarpus_pedunculatus,30,0,30,Points-PointsKO-Adjacents,178
Elaeocarpus_pendulus,0,0,0,NA,0
Elaeocarpus_pentadactylus,NA,NA,NA,NA,NA
Elaeocarpus_perrieri,8,4,4,Points-PointsKO-Adjacents,42
Elaeocarpus_petelotii,0,0,0,NA,0
Elaeocarpus_petiolatus,52,10,42,Points-PointsKO-Adjacents,424
Elaeocarpus_philippinensis,3,3,0,Points-PointsKO-Adjacents,27
Elaeocarpus_photiniifolia,43,15,28,Points-PointsKO-Adjacents,198
Elaeocarpus_pierrei,3,3,0,Points-PointsKO-Adjacents,27
Elaeocarpus_piestocarpus,9,1,8,Points-PointsKO-Adjacents,38
Elaeocarpus_pinosukii,0,0,0,NA,0
Elaeocarpus_pittosporoides,1,1,0,Points-PointsKO-Adjacents,9
Elaeocarpus_poculifer,4,4,0,Points-PointsKO-Adjacents,24
Elaeocarpus_poilanei,7,0,7,Points-PointsKO-Adjacents,54
Elaeocarpus_polyandrus,0,0,0,NA,0
Elaeocarpus_polyanthus,1,1,0,Points-PointsKO-Adjacents,9
Elaeocarpus_polycarpus,NA,NA,NA,NA,NA
Elaeocarpus_polydactylus,109,82,27,Alphahull-PointsKO-Adjacents,1293
Elaeocarpus_polystachyus,5,5,0,Points-PointsKO-Adjacents,34
Elaeocarpus_praeclarus,NA,NA,NA,NA,NA
Elaeocarpus_prafiensis,0,0,0,NA,0
Elaeocarpus_prunifolioides,5,0,5,Points-PointsKO-Adjacents,45
Elaeocarpus_prunifolius,0,0,0,NA,0
Elaeocarpus_pseudopaniculatus,5,5,0,Points-PointsKO-Adjacents,42
Elaeocarpus_ptilanthus,63,45,18,Alphahull-PointsKO-Adjacents,488
Elaeocarpus_pullenii,9,2,7,Points-PointsKO-Adjacents,60
Elaeocarpus_punctatus,0,0,0,NA,0
Elaeocarpus_purus,1,1,0,Points-PointsKO-Adjacents,9
Elaeocarpus_pycnanthus,28,16,12,Points-PointsKO-Adjacents,172
Elaeocarpus_pyriformis,0,0,0,NA,0
Elaeocarpus_quadratus,0,0,0,NA,0
Elaeocarpus_ramiflorus,0,0,0,NA,0
Elaeocarpus_recurvatus,1,1,0,Points-PointsKO-Adjacents,9
Elaeocarpus_renae,0,0,0,NA,0
Elaeocarpus_retakensis,0,0,0,NA,0
Elaeocarpus_reticosus,0,0,0,NA,0
Elaeocarpus_reticulatus,4440,0,4440,Points-PointsKO-Adjacents,2157
Elaeocarpus_rivularis,0,0,0,NA,0
Elaeocarpus_roseiflorus,0,0,0,NA,0
Elaeocarpus_roseoalbus,NA,NA,NA,NA,NA
Elaeocarpus_roslii,0,0,0,NA,0
Elaeocarpus_rotundifolius,51,34,17,Alphahull-PointsKO-Adjacents,264
Elaeocarpus_royenii,1,1,0,Points-PointsKO-Adjacents,9
Elaeocarpus_rubescens,3,3,0,Points-PointsKO-Adjacents,8
Elaeocarpus_rubidus,0,0,0,NA,0
Elaeocarpus_rufovestitus,9,4,5,Points-PointsKO-Adjacents,66
Elaeocarpus_rugosus,4,3,1,Points-PointsKO-Adjacents,30
Elaeocarpus_ruminatus,95,77,18,Alphahull-PointsKO-Adjacents,198
Elaeocarpus_rumphii,10,0,10,Points-PointsKO-Adjacents,50
Elaeocarpus_rutengii,0,0,0,NA,0
Elaeocarpus_sadikanensis,4,4,0,Points-PointsKO-Adjacents,19
Elaeocarpus_salicifolius,24,6,18,Points-PointsKO-Adjacents,192
Elaeocarpus_sallehianus,0,0,0,NA,0
Elaeocarpus_samari,0,0,0,NA,0
Elaeocarpus_sarcanthus,33,18,15,Points-PointsKO-Adjacents,201
Elaeocarpus_sayeri,32,17,15,Points-PointsKO-Adjacents,209
Elaeocarpus_schlechterianus,12,1,11,Points-PointsKO-Adjacents,87
Elaeocarpus_schmutzii,0,0,0,NA,0
Elaeocarpus_schoddei,6,0,6,Points-PointsKO-Adjacents,33
Elaeocarpus_sebastianii,0,0,0,NA,0
Elaeocarpus_sepikanus,57,24,33,Alphahull-PointsKO-Adjacents,2645
Elaeocarpus_seramicus,NA,NA,NA,NA,NA
Elaeocarpus_sericoloides,6,0,6,Points-PointsKO-Adjacents,54
Elaeocarpus_sericopetalus,103,88,15,Alphahull-PointsKO-Adjacents,249
Elaeocarpus_seringii,33,22,11,Alphahull-PointsKO-Adjacents,91
Elaeocarpus_serratus,4,3,1,Points-PointsKO-Adjacents,29
Elaeocarpus_sikkimensis,2,2,0,Points-PointsKO-Adjacents,18
Elaeocarpus_simaluensis,0,0,0,NA,0
Elaeocarpus_simplex,0,0,0,NA,0
Elaeocarpus_speciosus,30,18,12,Points-PointsKO-Adjacents,132
Elaeocarpus_sphaerocarpus,2,2,0,Points-PointsKO-Adjacents,18
Elaeocarpus_stapfianus,0,0,0,NA,0
Elaeocarpus_stellaris,40,31,9,Alphahull-PointsKO-Adjacents,133
Elaeocarpus_sterrophyilus,NA,NA,NA,NA,NA
Elaeocarpus_steupii,1,1,0,Points-PointsKO-Adjacents,9
Elaeocarpus_stipularis,143,94,49,Alphahull-PointsKO-Adjacents,4723
Elaeocarpus_storckii,1,1,0,Points-PointsKO-Adjacents,9
Elaeocarpus_subcapitatus,0,0,0,NA,0
Elaeocarpus_subisensis,0,0,0,NA,0
Elaeocarpus_sublucidus,NA,NA,NA,NA,NA
Elaeocarpus_submonoceras,17,3,14,Points-PointsKO-Adjacents,123
Elaeocarpus_subpetiolatus,NA,NA,NA,NA,NA
Elaeocarpus_subpuberus,0,0,0,NA,0
Elaeocarpus_subserratus,141,115,26,Alphahull-PointsKO-Adjacents,1994
Elaeocarpus_subvillosus,2,2,0,Points-PointsKO-Adjacents,16
Elaeocarpus_surigaensis,0,0,0,NA,0
Elaeocarpus_sylvestris,87,57,30,Alphahull-PointsKO-Adjacents,4851
Elaeocarpus_symingtonii,0,0,0,NA,0
Elaeocarpus_takolensis,1,1,0,Points-PointsKO-Adjacents,9
Elaeocarpus_taprobanicus,0,0,0,NA,0
Elaeocarpus_tariensis,32,22,10,Alphahull-PointsKO-Adjacents,295
Elaeocarpus_tectonifolius,0,0,0,NA,0
Elaeocarpus_tectorius,15,0,15,Points-PointsKO-Adjacents,117
Elaeocarpus_terminalioides,1,1,0,Points-PointsKO-Adjacents,9
Elaeocarpus_teysmannii,21,7,14,Points-PointsKO-Adjacents,154
Elaeocarpus_thelmae,16,12,4,Points-PointsKO-Adjacents,25
Elaeocarpus_thorelii,1,1,0,Points-PointsKO-Adjacents,9
Elaeocarpus_timikensis,2,2,0,Points-PointsKO-Adjacents,9
Elaeocarpus_timorensis,0,0,0,NA,0
Elaeocarpus_tjerengii,0,0,0,NA,0
Elaeocarpus_tonganus,2,2,0,Points-PointsKO-Adjacents,11
Elaeocarpus_toninensis,9,1,8,Points-PointsKO-Adjacents,56
Elaeocarpus_tonkinensis,0,0,0,NA,0
Elaeocarpus_tremulus,4,4,0,Points-PointsKO-Adjacents,24
Elaeocarpus_treubii,NA,NA,NA,NA,NA
Elaeocarpus_trichopetalus,0,0,0,NA,0
Elaeocarpus_trichophyllus,47,27,20,Alphahull-PointsKO-Adjacents,326
Elaeocarpus_triflorus,1,1,0,Points-PointsKO-Adjacents,9
Elaeocarpus_truncatus,2,2,0,Points-PointsKO-Adjacents,18
Elaeocarpus_tuasivicus,1,1,0,Points-PointsKO-Adjacents,9
Elaeocarpus_tuberculatus,3,0,3,Points-PointsKO-Adjacents,27
Elaeocarpus_ulianus,6,1,5,Points-PointsKO-Adjacents,28
Elaeocarpus_undulatus,7,2,5,Points-PointsKO-Adjacents,51
Elaeocarpus_urophyllus,0,0,0,NA,0
Elaeocarpus_valetonii,10,2,8,Points-PointsKO-Adjacents,72
Elaeocarpus_validus,1,1,0,Points-PointsKO-Adjacents,9
Elaeocarpus_variabilis,2,0,2,Points-PointsKO-Adjacents,18
Elaeocarpus_varunua,16,3,13,Points-PointsKO-Adjacents,144
Elaeocarpus_venosus,1,1,0,Points-PointsKO-Adjacents,9
Elaeocarpus_verheijenii,0,0,0,NA,0
Elaeocarpus_verruculosus,0,0,0,NA,0
Elaeocarpus_versicolor,7,1,6,Points-PointsKO-Adjacents,55
Elaeocarpus_verticillatus,2,2,0,Points-PointsKO-Adjacents,8
Elaeocarpus_vieillardii,9,3,6,Points-PointsKO-Adjacents,63
Elaeocarpus_viguieri,0,0,0,NA,0
Elaeocarpus_vitiensis,NA,NA,NA,NA,NA
Elaeocarpus_weibeliana,18,11,7,Points-PointsKO-Adjacents,54
Elaeocarpus_whartonensis,5,5,0,Points-PointsKO-Adjacents,34
Elaeocarpus_williamsianus,25,22,3,Alphahull-PointsKO-Adjacents,31
Elaeocarpus_womersleyi,39,19,20,Points-PointsKO-Adjacents,228
Elaeocarpus_wrayi,16,4,12,Points-PointsKO-Adjacents,124
Elaeocarpus_xanthodactylus,0,0,0,NA,0
Elaeocarpus_yateensis,59,44,15,Alphahull-PointsKO-Adjacents,153
Elaeocarpus_zambalensis,6,0,6,Points-PointsKO-Adjacents,43
Elaeocarpus_zeylanicus,2,2,0,Points-PointsKO-Adjacents,9
Elaeodendron_aquifolium,5,5,0,Points-PointsKO-Adjacents,44
Elaeoluma_crispa,9,4,5,Points-PointsKO-Adjacents,67
Elaeoluma_glabrescens,473,376,97,Alphahull-PointsKO-Adjacents,39313
Elaeoluma_nuda,56,30,26,Alphahull-PointsKO-Adjacents,1788
Elaeoluma_schomburgkiana,115,87,28,Alphahull-PointsKO-Adjacents,7110
Elateriospermum_tapos,28,0,28,Points-PointsKO-Adjacents,208
Elattostachys_aiyurensis,1,1,0,Points-PointsKO-Adjacents,9
Elattostachys_angulosa,6,0,6,Points-PointsKO-Adjacents,40
Elattostachys_apetala,143,121,22,Alphahull-PointsKO-Adjacents,439
Elattostachys_dzumacensis,9,5,4,Points-PointsKO-Adjacents,15
Elattostachys_erythrocarpa,0,0,0,NA,0
Elattostachys_falcata,13,3,10,Points-PointsKO-Adjacents,87
Elattostachys_globosa,7,1,6,Points-PointsKO-Adjacents,60
Elattostachys_goropuensis,3,3,0,Points-PointsKO-Adjacents,21
Elattostachys_incisa,24,12,12,Points-PointsKO-Adjacents,80
Elattostachys_megalantha,24,13,11,Points-PointsKO-Adjacents,120
Elattostachys_microcarpa,71,52,19,Alphahull-PointsKO-Adjacents,241
Elattostachys_nervosa,567,538,29,Alphahull-PointsKO-Adjacents,1117
Elattostachys_obliquinervis,1,1,0,Points-PointsKO-Adjacents,9
Elattostachys_palauensis,0,0,0,NA,0
Elattostachys_rubrofructus,3,3,0,Points-PointsKO-Adjacents,26
Elattostachys_solomonensis,0,0,0,NA,0
Elattostachys_tetraporandra,4,4,0,Points-PointsKO-Adjacents,30
Elattostachys_venosus,0,0,0,NA,0
Elattostachys_verrucosa,8,0,8,Points-PointsKO-Adjacents,53
Elattostachys_xylocarpa,401,365,36,Alphahull-PointsKO-Adjacents,2407
Elattostachys_zippeliana,12,3,9,Points-PointsKO-Adjacents,90
Elephantorrhiza_burkei,54,40,14,Alphahull-PointsKO-Adjacents,1657
Elephantorrhiza_goetzei,60,32,28,Alphahull-PointsKO-Adjacents,6464
Elephantorrhiza_rangei,1,1,0,Points-PointsKO-Adjacents,9
Elephantorrhiza_schinziana,4,4,0,Points-PointsKO-Adjacents,36
Elephantorrhiza_suffruticosa,20,9,11,Points-PointsKO-Adjacents,144
Eleutherandra_pes-cervi,2,2,0,Points-PointsKO-Adjacents,18
Eleutherococcus_lasiogyne,11,3,8,Points-PointsKO-Adjacents,88
Eleutherococcus_sessiliflorus,7,2,5,Points-PointsKO-Adjacents,63
Eleutherostylis_renistipulata,1,1,0,Points-PointsKO-Adjacents,9
Eliea_articulata,82,54,28,Alphahull-PointsKO-Adjacents,378
Eligmocarpus_cynometroides,11,5,6,Points-PointsKO-Adjacents,26
Elingamita_johnsonii,12,0,12,Points-PointsKO-Adjacents,45
Elizabetha_bicolor,19,0,19,Points-PointsKO-Adjacents,150
Elizabetha_coccinea,81,66,15,Alphahull-PointsKO-Adjacents,1360
Elizabetha_duckei,16,5,11,Points-PointsKO-Adjacents,141
Elizabetha_durissima,7,1,6,Points-PointsKO-Adjacents,63
Elizabetha_fanshawei,12,8,4,Points-PointsKO-Adjacents,63
Elizabetha_grahamiae,4,4,0,Points-PointsKO-Adjacents,30
Elizabetha_leiogyne,20,9,11,Points-PointsKO-Adjacents,174
Elizabetha_macrostachya,19,4,15,Points-PointsKO-Adjacents,156
Elizabetha_paraensis,16,1,15,Points-PointsKO-Adjacents,144
Elizabetha_princeps,91,69,22,Alphahull-PointsKO-Adjacents,4058
Elizabetha_speciosa,21,14,7,Points-PointsKO-Adjacents,114
Elliottia_racemosa,5,2,3,Points-PointsKO-Adjacents,39
Ellipanthus_beccarii,20,11,9,Points-PointsKO-Adjacents,144
Ellipanthus_calophyllus,1,1,0,Points-PointsKO-Adjacents,9
Ellipanthus_glabrifolius,3,3,0,Points-PointsKO-Adjacents,18
Ellipanthus_hemandradenioides,18,6,12,Points-PointsKO-Adjacents,97
Ellipanthus_madagascariensis,23,10,13,Points-PointsKO-Adjacents,153
Ellipanthus_razanatsimae,2,2,0,Points-PointsKO-Adjacents,16
Ellipanthus_tomentosus,18,1,17,Points-PointsKO-Adjacents,134
Ellipanthus_unifoliolatus,0,0,0,NA,0
Ellipeiopsis_cherrevensis,3,3,0,Points-PointsKO-Adjacents,27
Ellipeiopsis_ferruginea,0,0,0,NA,0
Elvasia_bisepala,8,2,6,Points-PointsKO-Adjacents,56
Elvasia_brevipedicellata,4,4,0,Points-PointsKO-Adjacents,36
Elvasia_calophyllea,64,33,31,Alphahull-PointsKO-Adjacents,983
Elvasia_canescens,55,28,27,Alphahull-PointsKO-Adjacents,969
Elvasia_capixaba,3,3,0,Points-PointsKO-Adjacents,21
Elvasia_elvasioides,60,30,30,Alphahull-PointsKO-Adjacents,898
Elvasia_essequibensis,7,2,5,Points-PointsKO-Adjacents,57
Elvasia_gigantifolia,10,6,4,Points-PointsKO-Adjacents,34
Elvasia_kollmannii,2,2,0,Points-PointsKO-Adjacents,12
Elvasia_macrostipularis,12,3,9,Points-PointsKO-Adjacents,93
Elvasia_oligandra,2,2,0,Points-PointsKO-Adjacents,18
Elvasia_quinqueloba,34,8,26,Points-PointsKO-Adjacents,254
Elvasia_sphaerocarpa,0,0,0,NA,0
Elvasia_tricarpellata,37,18,19,Points-PointsKO-Adjacents,253
Embelia_clarkei,1,1,0,Points-PointsKO-Adjacents,9
Embelia_henryi,7,1,6,Points-PointsKO-Adjacents,63
Embelia_libeniana,10,8,2,Points-PointsKO-Adjacents,53
Embelia_palauensis,1,1,0,Points-PointsKO-Adjacents,5
Embelia_ruminata,18,4,14,Points-PointsKO-Adjacents,158
Embelia_scandens,22,0,22,Points-PointsKO-Adjacents,189
Embelia_schimperi,136,70,66,Alphahull-PointsKO-Adjacents,6348
Embelia_sessiliflora,32,16,16,Points-PointsKO-Adjacents,279
Embelia_sootepensis,0,0,0,NA,0
Embelia_subcoriacea,64,33,31,Alphahull-PointsKO-Adjacents,3504
Embelia_tropophylla,8,2,6,Points-PointsKO-Adjacents,70
Embelia_tsjeriam-cottam,15,1,14,Points-PointsKO-Adjacents,129
Embelia_upembensis,3,3,0,Points-PointsKO-Adjacents,27
Embelia_vestita,229,190,39,Alphahull-PointsKO-Adjacents,13734
Embelia_xylocarpa,9,0,9,Points-PointsKO-Adjacents,75
Embolanthera_spicata,0,0,0,NA,0
Embothrium_coccineum,132,95,37,Alphahull-PointsKO-Adjacents,3059
Emmenopterys_henryi,46,21,25,Alphahull-PointsKO-Adjacents,2165
Emmenopterys_rehderi,0,0,0,NA,0
Emmenosperma_alphitonoides,61,35,26,Alphahull-PointsKO-Adjacents,642
Emmenosperma_cunninghamii,196,142,54,Alphahull-PointsKO-Adjacents,1168
Emmenosperma_micropetalum,0,0,0,NA,0
Emmenosperma_pancherianum,2,1,1,Points-PointsKO-Adjacents,16
Emmenosperma_papuanum,24,10,14,Points-PointsKO-Adjacents,136
Emmotum_acuminatum,74,38,36,Alphahull-PointsKO-Adjacents,2932
Emmotum_affine,173,0,173,Points-PointsKO-Adjacents,836
Emmotum_celiae,8,5,3,Points-PointsKO-Adjacents,39
Emmotum_conjunctum,48,38,10,Alphahull-PointsKO-Adjacents,680
Emmotum_fagifolium,110,0,110,Points-PointsKO-Adjacents,840
Emmotum_floribundum,26,3,23,Points-PointsKO-Adjacents,215
Emmotum_fulvum,14,8,6,Points-PointsKO-Adjacents,101
Emmotum_glabrum,150,100,50,Alphahull-PointsKO-Adjacents,6134
Emmotum_harleyi,56,46,10,Alphahull-PointsKO-Adjacents,136
Emmotum_nitens,1346,1254,92,Alphahull-PointsKO-Adjacents,44362
Emmotum_orbiculatum,106,82,24,Alphahull-PointsKO-Adjacents,3949
Emmotum_yapacanum,2,2,0,Points-PointsKO-Adjacents,14
Empleurum_fragrans,3,3,0,Points-PointsKO-Adjacents,27
Empleurum_unicapsulare,64,46,18,Alphahull-PointsKO-Adjacents,641
Empogona_acidophylla,24,19,5,Points-PointsKO-Adjacents,94
Empogona_aequatoria,17,9,8,Points-PointsKO-Adjacents,93
Empogona_africana,2,2,0,Points-PointsKO-Adjacents,17
Empogona_bequaertii,10,0,10,Points-PointsKO-Adjacents,90
Empogona_bracteata,21,15,6,Points-PointsKO-Adjacents,109
Empogona_concolor,12,7,5,Points-PointsKO-Adjacents,66
Empogona_coriacea,210,112,98,Alphahull-PointsKO-Adjacents,23181
Empogona_crepiniana,108,67,41,Alphahull-PointsKO-Adjacents,6754
Empogona_glabra,18,0,18,Points-PointsKO-Adjacents,153
Empogona_gossweileri,112,90,22,Alphahull-PointsKO-Adjacents,2154
Empogona_kirkii,70,38,32,Alphahull-PointsKO-Adjacents,1319
Empogona_lanceolata,NA,NA,NA,NA,NA
Empogona_macrophylla,33,15,18,Points-PointsKO-Adjacents,264
Empogona_reflexa,53,28,25,Alphahull-PointsKO-Adjacents,832
Empogona_talbotii,18,12,6,Points-PointsKO-Adjacents,119
Endertia_spectabilis,2,2,0,Points-PointsKO-Adjacents,18
Endiandra_acuminata,120,107,13,Alphahull-PointsKO-Adjacents,224
Endiandra_aggregata,1,1,0,Points-PointsKO-Adjacents,9
Endiandra_albiramea,0,0,0,NA,0
Endiandra_aneityensis,2,2,0,Points-PointsKO-Adjacents,14
Endiandra_anthropophagorum,24,17,7,Points-PointsKO-Adjacents,38
Endiandra_archboldiana,1,1,0,Points-PointsKO-Adjacents,9
Endiandra_arfakensis,NA,NA,NA,NA,NA
Endiandra_asymmerrica,NA,NA,NA,NA,NA
Endiandra_baillonii,19,13,6,Points-PointsKO-Adjacents,70
Endiandra_beccariana,2,2,0,Points-PointsKO-Adjacents,16
Endiandra_bellendenkerana,21,17,4,Points-PointsKO-Adjacents,34
Endiandra_bessaphila,111,96,15,Alphahull-PointsKO-Adjacents,238
Endiandra_brassii,11,4,7,Points-PointsKO-Adjacents,84
Endiandra_bullata,0,0,0,NA,0
Endiandra_carrii,2,2,0,Points-PointsKO-Adjacents,18
Endiandra_chartacea,NA,NA,NA,NA,NA
Endiandra_clavigera,1,0,1,Points-PointsKO-Adjacents,8
Endiandra_clemensii,5,5,0,Points-PointsKO-Adjacents,32
Endiandra_collinsii,29,18,11,Points-PointsKO-Adjacents,66
Endiandra_compressa,117,83,34,Alphahull-PointsKO-Adjacents,365
Endiandra_cooperana,7,2,5,Points-PointsKO-Adjacents,13
Endiandra_coriacea,5,4,1,Points-PointsKO-Adjacents,15
Endiandra_cowleyana,140,110,30,Alphahull-PointsKO-Adjacents,547
Endiandra_crassiflora,175,158,17,Alphahull-PointsKO-Adjacents,379
Endiandra_cuneata,NA,NA,NA,NA,NA
Endiandra_cyphellophora,3,3,0,Points-PointsKO-Adjacents,9
Endiandra_dichrophylla,68,61,7,Alphahull-PointsKO-Adjacents,70
Endiandra_dielsiana,92,1,91,Points-PointsKO-Adjacents,271
Endiandra_discolor,531,461,70,Alphahull-PointsKO-Adjacents,1540
Endiandra_djamuensis,0,0,0,NA,0
Endiandra_dolichocarpa,1,1,0,Points-PointsKO-Adjacents,9
Endiandra_elaeocarpa,7,4,3,Points-PointsKO-Adjacents,22
Endiandra_elongata,2,1,1,Points-PointsKO-Adjacents,18
Endiandra_engleriana,2,2,0,Points-PointsKO-Adjacents,17
Endiandra_euadenia,2,2,0,Points-PointsKO-Adjacents,18
Endiandra_eusideroxylocarpa,0,0,0,NA,0
Endiandra_faceta,1,1,0,Points-PointsKO-Adjacents,9
Endiandra_ferruginea,1,1,0,Points-PointsKO-Adjacents,9
Endiandra_firma,1,1,0,Points-PointsKO-Adjacents,9
Endiandra_flavinervis,7,3,4,Points-PointsKO-Adjacents,34
Endiandra_floydii,73,66,7,Alphahull-PointsKO-Adjacents,61
Endiandra_forbesii,7,4,3,Points-PointsKO-Adjacents,45
Endiandra_formicaria,0,0,0,NA,0
Endiandra_fulva,1,1,0,Points-PointsKO-Adjacents,9
Endiandra_gem,NA,NA,NA,NA,NA
Endiandra_gemopsis,NA,NA,NA,NA,NA
Endiandra_gillespiei,0,0,0,NA,0
Endiandra_glauca,212,193,19,Alphahull-PointsKO-Adjacents,726
Endiandra_globosa,253,239,14,Alphahull-PointsKO-Adjacents,106
Endiandra_grandifolia,9,3,6,Points-PointsKO-Adjacents,46
Endiandra_grayi,19,15,4,Points-PointsKO-Adjacents,21
Endiandra_hainanensis,3,3,0,Points-PointsKO-Adjacents,27
Endiandra_havelii,1,1,0,Points-PointsKO-Adjacents,9
Endiandra_hayesii,178,168,10,Alphahull-PointsKO-Adjacents,95
Endiandra_holttumii,1,1,0,Points-PointsKO-Adjacents,9
Endiandra_hypotephra,184,156,28,Alphahull-PointsKO-Adjacents,501
Endiandra_immersa,0,0,0,NA,0
Endiandra_impressicosta,58,45,13,Alphahull-PointsKO-Adjacents,137
Endiandra_inaequitepala,0,0,0,NA,0
Endiandra_insignis,106,91,15,Alphahull-PointsKO-Adjacents,136
Endiandra_introrsa,57,49,8,Alphahull-PointsKO-Adjacents,85
Endiandra_invasiorum,2,2,0,Points-PointsKO-Adjacents,14
Endiandra_jonesii,21,17,4,Points-PointsKO-Adjacents,21
Endiandra_kingiana,4,1,3,Points-PointsKO-Adjacents,36
Endiandra_latifolia,3,3,0,Points-PointsKO-Adjacents,22
Endiandra_laxiflora,1,1,0,Points-PointsKO-Adjacents,9
Endiandra_lecardii,23,14,9,Points-PointsKO-Adjacents,115
Endiandra_ledermannii,2,2,0,Points-PointsKO-Adjacents,18
Endiandra_leptodendron,61,48,13,Alphahull-PointsKO-Adjacents,176
Endiandra_limnophila,56,40,16,Alphahull-PointsKO-Adjacents,94
Endiandra_longipedicellata,95,75,20,Alphahull-PointsKO-Adjacents,242
Endiandra_luteola,0,0,0,NA,0
Endiandra_macrophylla,7,0,7,Points-PointsKO-Adjacents,63
Endiandra_macrostemon,2,2,0,Points-PointsKO-Adjacents,14
Endiandra_magnilimba,3,3,0,Points-PointsKO-Adjacents,21
Endiandra_maingayi,2,2,0,Points-PointsKO-Adjacents,18
Endiandra_microneura,33,29,4,Alphahull-PointsKO-Adjacents,34
Endiandra_microphylla,0,0,0,NA,0
Endiandra_minutiflora,1,1,0,Points-PointsKO-Adjacents,9
Endiandra_monothyra,140,127,13,Alphahull-PointsKO-Adjacents,286
Endiandra_montana,147,132,15,Alphahull-PointsKO-Adjacents,247
Endiandra_monticola,0,0,0,NA,0
Endiandra_muelleri,904,857,47,Alphahull-PointsKO-Adjacents,1120
Endiandra_multiflora,NA,NA,NA,NA,NA
Endiandra_neocaledonica,6,0,6,Points-PointsKO-Adjacents,46
Endiandra_oblonga,0,0,0,NA,0
Endiandra_ochracea,1,1,0,Points-PointsKO-Adjacents,9
Endiandra_oviformis,1,1,0,Points-PointsKO-Adjacents,9
Endiandra_palmerstonii,107,96,11,Alphahull-PointsKO-Adjacents,168
Endiandra_papuana,2,2,0,Points-PointsKO-Adjacents,18
Endiandra_phaeocarpa,12,8,4,Points-PointsKO-Adjacents,18
Endiandra_pilosa,4,4,0,Points-PointsKO-Adjacents,27
Endiandra_polyneura,8,2,6,Points-PointsKO-Adjacents,46
Endiandra_praeclara,3,3,0,Points-PointsKO-Adjacents,21
Endiandra_pubens,311,282,29,Alphahull-PointsKO-Adjacents,519
Endiandra_recurva,0,0,0,NA,0
Endiandra_reticulata,0,0,0,NA,0
Endiandra_rhizophoretum,1,1,0,Points-PointsKO-Adjacents,7
Endiandra_rigidior,0,0,0,NA,0
Endiandra_rubescens,8,1,7,Points-PointsKO-Adjacents,70
Endiandra_sankeyana,130,120,10,Alphahull-PointsKO-Adjacents,198
Endiandra_schlechteri,0,0,0,NA,0
Endiandra_scrobiculata,1,1,0,Points-PointsKO-Adjacents,9
Endiandra_sebertii,23,10,13,Points-PointsKO-Adjacents,111
Endiandra_sericea,2,2,0,Points-PointsKO-Adjacents,14
Endiandra_sideroxylon,57,54,3,Alphahull-PointsKO-Adjacents,61
Endiandra_sieberi,977,0,977,Points-PointsKO-Adjacents,1187
Endiandra_sleumeri,0,0,0,NA,0
Endiandra_solomonensis,1,1,0,Points-PointsKO-Adjacents,9
Endiandra_spathulata,0,0,0,NA,0
Endiandra_sphaerica,1,1,0,Points-PointsKO-Adjacents,9
Endiandra_sulavesiana,1,1,0,Points-PointsKO-Adjacents,9
Endiandra_sumatrana,NA,NA,NA,NA,NA
Endiandra_teschneriana,0,0,0,NA,0
Endiandra_trichotosa,0,0,0,NA,0
Endiandra_tryphera,0,0,0,NA,0
Endiandra_versteeghii,0,0,0,NA,0
Endiandra_virens,108,0,108,Points-PointsKO-Adjacents,286
Endiandra_whitmorei,0,0,0,NA,0
Endiandra_wolfei,177,162,15,Alphahull-PointsKO-Adjacents,348
Endiandra_wrayi,0,0,0,NA,0
Endiandra_xanthocarpa,34,28,6,Alphahull-PointsKO-Adjacents,38
Endiandra_xylophylla,3,3,0,Points-PointsKO-Adjacents,25
Endlicheria_acuminata,61,27,34,Alphahull-PointsKO-Adjacents,2325
Endlicheria_anomala,450,381,69,Alphahull-PointsKO-Adjacents,41550
Endlicheria_arachnocome,16,6,10,Points-PointsKO-Adjacents,132
Endlicheria_argentea,5,5,0,Points-PointsKO-Adjacents,43
Endlicheria_arunciflora,49,22,27,Alphahull-PointsKO-Adjacents,1931
Endlicheria_aurea,19,13,6,Points-PointsKO-Adjacents,84
Endlicheria_balsamea,1,1,0,Points-PointsKO-Adjacents,9
Endlicheria_bracteata,131,92,39,Alphahull-PointsKO-Adjacents,8756
Endlicheria_bracteolata,133,85,48,Alphahull-PointsKO-Adjacents,10608
Endlicheria_browniana,50,30,20,Alphahull-PointsKO-Adjacents,721
Endlicheria_canescens,107,64,43,Alphahull-PointsKO-Adjacents,1473
Endlicheria_chalisea,73,29,44,Alphahull-PointsKO-Adjacents,1082
Endlicheria_chrysovelutina,7,3,4,Points-PointsKO-Adjacents,56
Endlicheria_citriodora,26,18,8,Points-PointsKO-Adjacents,143
Endlicheria_cocuirey,8,0,8,Points-PointsKO-Adjacents,72
Endlicheria_colombiana,14,7,7,Points-PointsKO-Adjacents,95
Endlicheria_coriacea,9,0,9,Points-PointsKO-Adjacents,60
Endlicheria_dictifarinosa,37,28,9,Alphahull-PointsKO-Adjacents,1120
Endlicheria_directonervia,19,5,14,Points-PointsKO-Adjacents,145
Endlicheria_duotincta,8,2,6,Points-PointsKO-Adjacents,66
Endlicheria_dysodantha,158,120,38,Alphahull-PointsKO-Adjacents,10541
Endlicheria_ferruginosa,2,2,0,Points-PointsKO-Adjacents,16
Endlicheria_formosa,329,271,58,Alphahull-PointsKO-Adjacents,24659
Endlicheria_glomerata,125,90,35,Alphahull-PointsKO-Adjacents,2032
Endlicheria_goeldiana,1,1,0,Points-PointsKO-Adjacents,9
Endlicheria_gracilis,96,34,62,Alphahull-PointsKO-Adjacents,2679
Endlicheria_griseosericea,75,51,24,Alphahull-PointsKO-Adjacents,734
Endlicheria_jefensis,2,2,0,Points-PointsKO-Adjacents,18
Endlicheria_klugii,81,42,39,Alphahull-PointsKO-Adjacents,6311
Endlicheria_krukovii,42,0,42,Points-PointsKO-Adjacents,352
Endlicheria_lhotzkyi,55,32,23,Alphahull-PointsKO-Adjacents,3837
Endlicheria_longicaudata,62,28,34,Alphahull-PointsKO-Adjacents,779
Endlicheria_macrophylla,134,94,40,Alphahull-PointsKO-Adjacents,13554
Endlicheria_melinonii,19,5,14,Points-PointsKO-Adjacents,156
Endlicheria_metallica,135,78,57,Alphahull-PointsKO-Adjacents,11381
Endlicheria_mishuyacensis,36,17,19,Points-PointsKO-Adjacents,244
Endlicheria_multiflora,100,60,40,Alphahull-PointsKO-Adjacents,4548
Endlicheria_nilssonii,2,2,0,Points-PointsKO-Adjacents,18
Endlicheria_oreocola,6,0,6,Points-PointsKO-Adjacents,49
Endlicheria_paniculata,1790,1595,195,Alphahull-PointsKO-Adjacents,54027
Endlicheria_paradoxa,3,3,0,Points-PointsKO-Adjacents,21
Endlicheria_punctulata,16,9,7,Points-PointsKO-Adjacents,114
Endlicheria_pyriformis,210,146,64,Alphahull-PointsKO-Adjacents,14308
Endlicheria_reflectens,57,41,16,Alphahull-PointsKO-Adjacents,457
Endlicheria_robusta,9,1,8,Points-PointsKO-Adjacents,68
Endlicheria_rubra,5,5,0,Points-PointsKO-Adjacents,36
Endlicheria_rubriflora,60,27,33,Alphahull-PointsKO-Adjacents,1610
Endlicheria_ruforamula,93,64,29,Alphahull-PointsKO-Adjacents,5593
Endlicheria_sericea,34,18,16,Points-PointsKO-Adjacents,135
Endlicheria_sprucei,95,55,40,Alphahull-PointsKO-Adjacents,4582
Endlicheria_szyszylowiczii,125,53,72,Alphahull-PointsKO-Adjacents,4438
Endlicheria_tessmannii,70,51,19,Alphahull-PointsKO-Adjacents,2606
Endlicheria_tomentosa,3,3,0,Points-PointsKO-Adjacents,27
Endlicheria_tschudyana,37,0,37,Points-PointsKO-Adjacents,258
Endlicheria_verticillata,66,29,37,Alphahull-PointsKO-Adjacents,3787
Endlicheria_williamsii,29,11,18,Points-PointsKO-Adjacents,212
Endlicheria_xerampela,9,2,7,Points-PointsKO-Adjacents,74
Endocomia_canarioides,8,1,7,Points-PointsKO-Adjacents,70
Endocomia_macrocoma,21,2,19,Points-PointsKO-Adjacents,168
Endocomia_rufirachis,4,4,0,Points-PointsKO-Adjacents,36
Endocomia_virella,0,0,0,NA,0
Endodesmia_calophylloides,100,78,22,Alphahull-PointsKO-Adjacents,2763
Endopleura_uchi,146,92,54,Alphahull-PointsKO-Adjacents,17248
Endospermum_chinense,13,2,11,Points-PointsKO-Adjacents,117
Endospermum_diadenum,28,11,17,Points-PointsKO-Adjacents,208
Endospermum_domatiophorum,10,1,9,Points-PointsKO-Adjacents,75
Endospermum_macrophyllum,2,2,0,Points-PointsKO-Adjacents,12
Endospermum_medullosum,36,14,22,Points-PointsKO-Adjacents,220
Endospermum_moluccanum,62,28,34,Alphahull-PointsKO-Adjacents,912
Endospermum_myrmecophilum,91,61,30,Alphahull-PointsKO-Adjacents,321
Endospermum_ovatum,1,1,0,Points-PointsKO-Adjacents,9
Endospermum_peltatum,4,0,4,Points-PointsKO-Adjacents,35
Endospermum_quadriloculare,2,2,0,Points-PointsKO-Adjacents,18
Endospermum_robbieanum,0,0,0,NA,0
Engelhardtia_apoensis,0,0,0,NA,0
Engelhardtia_danumensis,NA,NA,NA,NA,NA
Engelhardtia_hainanensis,NA,NA,NA,NA,NA
Engelhardtia_kinabaluensis,NA,NA,NA,NA,NA
Engelhardtia_mendalomensis,1,1,0,Points-PointsKO-Adjacents,9
Engelhardtia_mersingensis,0,0,0,NA,0
Engelhardtia_mollis,NA,NA,NA,NA,NA
Engelhardtia_rigida,47,0,47,Points-PointsKO-Adjacents,302
Engelhardtia_roxburghiana,219,177,42,Alphahull-PointsKO-Adjacents,12198
Engelhardtia_serrata,12,0,12,Points-PointsKO-Adjacents,99
Engelhardtia_spicata,64,0,64,Points-PointsKO-Adjacents,534
Engelhardtia_unijuga,NA,NA,NA,NA,NA
Englerodaphne_ovalifolia,10,0,10,Points-PointsKO-Adjacents,85
Englerodaphne_pilosa,14,3,11,Points-PointsKO-Adjacents,99
Englerodendron_gabunense,13,11,2,Points-PointsKO-Adjacents,83
Englerodendron_usambarense,5,5,0,Points-PointsKO-Adjacents,15
Englerophytum_congolense,14,7,7,Points-PointsKO-Adjacents,118
Englerophytum_iturense,6,1,5,Points-PointsKO-Adjacents,42
Englerophytum_magalismontanum,143,88,55,Alphahull-PointsKO-Adjacents,2521
Englerophytum_natalense,80,35,45,Alphahull-PointsKO-Adjacents,1360
Englerophytum_oblanceolatum,71,41,30,Alphahull-PointsKO-Adjacents,3404
Englerophytum_oubanguiense,11,0,11,Points-PointsKO-Adjacents,90
Englerophytum_somiferanum,1,1,0,Points-PointsKO-Adjacents,9
Englerophytum_stelechantha,32,22,10,Alphahull-PointsKO-Adjacents,178
Engomegoma_gordonii,55,42,13,Alphahull-PointsKO-Adjacents,676
Enicosanthum_macranthum,3,3,0,Points-PointsKO-Adjacents,27
Enicosanthum_nitidum,2,2,0,Points-PointsKO-Adjacents,18
Enkianthus_campanulatus,205,176,29,Alphahull-PointsKO-Adjacents,963
Enkianthus_chinensis,79,46,33,Alphahull-PointsKO-Adjacents,6813
Enkianthus_deflexus,96,82,14,Alphahull-PointsKO-Adjacents,2837
Enkianthus_pauciflorus,5,5,0,Points-PointsKO-Adjacents,45
Enkianthus_quinqueflorus,40,17,23,Points-PointsKO-Adjacents,345
Enkianthus_serrulatus,58,35,23,Alphahull-PointsKO-Adjacents,3741
Enkianthus_sikokianus,45,29,16,Alphahull-PointsKO-Adjacents,259
Enneatypus_ramiflorus,25,9,16,Points-PointsKO-Adjacents,196
Enneatypus_tenuiflorus,58,34,24,Alphahull-PointsKO-Adjacents,2061
Entada_abyssinica,574,448,126,Alphahull-PointsKO-Adjacents,10052
Entada_africana,555,506,49,Alphahull-PointsKO-Adjacents,7294
Entada_chrysostachys,102,66,36,Alphahull-PointsKO-Adjacents,4119
Entada_leptostachya,58,26,32,Alphahull-PointsKO-Adjacents,562
Entada_louvelii,51,33,18,Alphahull-PointsKO-Adjacents,619
Entada_pervillei,33,21,12,Alphahull-PointsKO-Adjacents,426
Entada_polystachya,534,331,203,Alphahull-PointsKO-Adjacents,21529
Entandrophragma_angolense,221,152,69,Alphahull-PointsKO-Adjacents,17040
Entandrophragma_bussei,1,1,0,Points-PointsKO-Adjacents,9
Entandrophragma_candollei,142,101,41,Alphahull-PointsKO-Adjacents,7754
Entandrophragma_caudatum,0,0,0,NA,0
Entandrophragma_congoense,35,13,22,Points-PointsKO-Adjacents,283
Entandrophragma_cylindricum,209,154,55,Alphahull-PointsKO-Adjacents,7929
Entandrophragma_delevoyi,10,2,8,Points-PointsKO-Adjacents,60
Entandrophragma_excelsum,31,0,31,Points-PointsKO-Adjacents,219
Entandrophragma_palustre,14,3,11,Points-PointsKO-Adjacents,99
Entandrophragma_spicatum,16,4,12,Points-PointsKO-Adjacents,128
Entandrophragma_utile,131,74,57,Alphahull-PointsKO-Adjacents,4282
Entelea_arborescens,250,191,59,Alphahull-PointsKO-Adjacents,1891
Enterolobium_barinense,25,9,16,Points-PointsKO-Adjacents,205
Enterolobium_barnebianum,87,51,36,Alphahull-PointsKO-Adjacents,4771
Enterolobium_contortisiliquum,1612,1478,134,Alphahull-PointsKO-Adjacents,65893
Enterolobium_cyclocarpum,938,745,193,Alphahull-PointsKO-Adjacents,22785
Enterolobium_glaziovii,29,9,20,Points-PointsKO-Adjacents,187
Enterolobium_gummiferum,503,443,60,Alphahull-PointsKO-Adjacents,25127
Enterolobium_maximum,109,62,47,Alphahull-PointsKO-Adjacents,7435
Enterolobium_monjollo,46,27,19,Alphahull-PointsKO-Adjacents,1174
Enterolobium_oldemanii,3,0,3,Points-PointsKO-Adjacents,27
Enterolobium_schomburgkii,654,540,114,Alphahull-PointsKO-Adjacents,68811
Enterolobium_timbouva,94,48,46,Alphahull-PointsKO-Adjacents,4814
Eosanthe_cubensis,1,1,0,Points-PointsKO-Adjacents,9
Epacris_heteronema,198,177,21,Alphahull-PointsKO-Adjacents,993
Eperua_bijuga,47,28,19,Alphahull-PointsKO-Adjacents,1270
Eperua_duckeana,62,0,62,Points-PointsKO-Adjacents,348
Eperua_falcata,216,181,35,Alphahull-PointsKO-Adjacents,6826
Eperua_glabra,7,0,7,Points-PointsKO-Adjacents,36
Eperua_glabriflora,64,58,6,Alphahull-PointsKO-Adjacents,537
Eperua_grandiflora,73,48,25,Alphahull-PointsKO-Adjacents,1814
Eperua_jenmanii,59,45,14,Alphahull-PointsKO-Adjacents,1385
Eperua_leucantha,106,82,24,Alphahull-PointsKO-Adjacents,2873
Eperua_obtusata,5,5,0,Points-PointsKO-Adjacents,42
Eperua_oleifera,32,16,16,Points-PointsKO-Adjacents,270
Eperua_praesagata,6,0,6,Points-PointsKO-Adjacents,42
Eperua_purpurea,109,0,109,Points-PointsKO-Adjacents,681
Eperua_rubiginosa,129,102,27,Alphahull-PointsKO-Adjacents,4974
Eperua_schomburgkiana,73,46,27,Alphahull-PointsKO-Adjacents,3977
Eperua_venosa,2,2,0,Points-PointsKO-Adjacents,15
Ephedranthus_amazonicus,89,51,38,Alphahull-PointsKO-Adjacents,1303
Ephedranthus_boliviensis,35,22,13,Alphahull-PointsKO-Adjacents,1162
Ephedranthus_columbianus,19,13,6,Points-PointsKO-Adjacents,125
Ephedranthus_guianensis,42,27,15,Alphahull-PointsKO-Adjacents,1441
Ephedranthus_parviflorus,140,87,53,Alphahull-PointsKO-Adjacents,7543
Ephedranthus_pisocarpus,57,42,15,Alphahull-PointsKO-Adjacents,1970
Ephippiandra_madagascariensis,44,23,21,Alphahull-PointsKO-Adjacents,253
Ephippiandra_masoalensis,1,1,0,Points-PointsKO-Adjacents,8
Ephippiandra_perrieri,13,0,13,Points-PointsKO-Adjacents,53
Ephippiandra_tsaratanensis,5,5,0,Points-PointsKO-Adjacents,35
Ephippiocarpa_orientalis,9,2,7,Points-PointsKO-Adjacents,75
Epiprinus_balansae,3,3,0,Points-PointsKO-Adjacents,25
Epiprinus_lanceifolius,0,0,0,NA,0
Epiprinus_malayanus,7,0,7,Points-PointsKO-Adjacents,57
Epiprinus_mallotiformis,0,0,0,NA,0
Epiprinus_poilanei,0,0,0,NA,0
Epiprinus_siletianus,18,3,15,Points-PointsKO-Adjacents,130
Erblichia_odorata,206,166,40,Alphahull-PointsKO-Adjacents,2394
Eremaea_dendroidea,27,23,4,Alphahull-PointsKO-Adjacents,103
Eremanthus_arboreus,26,16,10,Points-PointsKO-Adjacents,149
Eremanthus_argenteus,11,0,11,Points-PointsKO-Adjacents,48
Eremanthus_auriculatus,3,3,0,Points-PointsKO-Adjacents,21
Eremanthus_brasiliensis,11,3,8,Points-PointsKO-Adjacents,99
Eremanthus_brevifolius,2,2,0,Points-PointsKO-Adjacents,18
Eremanthus_capitatus,325,286,39,Alphahull-PointsKO-Adjacents,8110
Eremanthus_cinctus,31,13,18,Points-PointsKO-Adjacents,267
Eremanthus_crotonoides,146,125,21,Alphahull-PointsKO-Adjacents,1726
Eremanthus_elaeagnus,103,88,15,Alphahull-PointsKO-Adjacents,1724
Eremanthus_erythropappus,421,377,44,Alphahull-PointsKO-Adjacents,6066
Eremanthus_glomerulatus,436,390,46,Alphahull-PointsKO-Adjacents,11904
Eremanthus_goyazensis,173,149,24,Alphahull-PointsKO-Adjacents,3781
Eremanthus_hatschbachii,6,3,3,Points-PointsKO-Adjacents,35
Eremanthus_incanus,345,316,29,Alphahull-PointsKO-Adjacents,4978
Eremanthus_leucodendron,18,0,18,Points-PointsKO-Adjacents,49
Eremanthus_mattogrossensis,132,105,27,Alphahull-PointsKO-Adjacents,9623
Eremanthus_polycephalus,75,62,13,Alphahull-PointsKO-Adjacents,877
Eremanthus_rondoniensis,26,13,13,Points-PointsKO-Adjacents,195
Eremanthus_veadeiroensis,9,7,2,Points-PointsKO-Adjacents,42
Eremogeton_grandiflorus,33,26,7,Alphahull-PointsKO-Adjacents,147
Eremolaena_humblotiana,19,13,6,Points-PointsKO-Adjacents,78
Eremolaena_rotundifolia,61,61,0,Alphahull,6066
Eremophila_bignoniflora,1200,1148,52,Alphahull-PointsKO-Adjacents,23451
Eremophila_dalyana,94,0,94,Points-PointsKO-Adjacents,483
Eremophila_interstans,153,136,17,Alphahull-PointsKO-Adjacents,1345
Eremophila_linearis,111,99,12,Alphahull-PointsKO-Adjacents,1018
Eremophila_longifolia,4964,4838,126,Alphahull-PointsKO-Adjacents,70851
Eremophila_micrantha,16,10,6,Points-PointsKO-Adjacents,82
Eremophila_miniata,162,142,20,Alphahull-PointsKO-Adjacents,4759
Eremophila_mitchellii,2259,2218,41,Alphahull-PointsKO-Adjacents,16556
Eremophila_muelleriana,13,1,12,Points-PointsKO-Adjacents,91
Eremophila_oldfieldii,471,0,471,Points-PointsKO-Adjacents,1923
Eremophila_oppositifolia,1383,0,1383,Points-PointsKO-Adjacents,5344
Eremophila_pterocarpa,110,92,18,Alphahull-PointsKO-Adjacents,3180
Eremophila_rigens,7,3,4,Points-PointsKO-Adjacents,45
Eremophila_santalina,78,71,7,Alphahull-PointsKO-Adjacents,149
Eremophila_tetraptera,20,13,7,Points-PointsKO-Adjacents,77
Eremophila_virens,16,12,4,Points-PointsKO-Adjacents,71
Eremophila_youngii,158,0,158,Points-PointsKO-Adjacents,911
Eremosis_leiocarpa,66,51,15,Alphahull-PointsKO-Adjacents,674
Eremosis_shannonii,5,5,0,Points-PointsKO-Adjacents,28
Eremosis_triflosculosa,63,39,24,Alphahull-PointsKO-Adjacents,1169
Eremosparton_aphyllum,2,2,0,Points-PointsKO-Adjacents,18
Eremosparton_flaccidum,0,0,0,NA,0
Eremospatha_haullevilleana,131,92,39,Alphahull-PointsKO-Adjacents,16217
Eriandra_fragrans,0,0,0,NA,0
Erica_arborea,14446,13822,624,Alphahull-PointsKO-Adjacents,18837
Erica_benguelensis,174,116,58,Alphahull-PointsKO-Adjacents,4590
Erica_caffra,131,0,131,Points-PointsKO-Adjacents,929
Erica_evansii,14,0,14,Points-PointsKO-Adjacents,126
Erica_hexandra,14,0,14,Points-PointsKO-Adjacents,99
Erica_kingaensis,96,78,18,Alphahull-PointsKO-Adjacents,405
Erica_mafiensis,4,4,0,Points-PointsKO-Adjacents,24
Erica_mannii,145,91,54,Alphahull-PointsKO-Adjacents,1531
Erica_nyassana,8,3,5,Points-PointsKO-Adjacents,18
Erica_racemosa,23,12,11,Points-PointsKO-Adjacents,180
Erica_trimera,10,7,3,Points-PointsKO-Adjacents,54
Erinocarpus_nimmonii,0,0,0,NA,0
Eriobotrya_bengalensis,35,0,35,Points-PointsKO-Adjacents,294
Eriobotrya_cavaleriei,58,40,18,Alphahull-PointsKO-Adjacents,2972
Eriobotrya_deflexa,285,256,29,Alphahull-PointsKO-Adjacents,518
Eriobotrya_fragrans,21,10,11,Points-PointsKO-Adjacents,189
Eriobotrya_henryi,9,0,9,Points-PointsKO-Adjacents,81
Eriobotrya_japonica,97,54,43,Alphahull-PointsKO-Adjacents,10585
Eriobotrya_malipoensis,4,4,0,Points-PointsKO-Adjacents,36
Eriobotrya_obovata,5,5,0,Points-PointsKO-Adjacents,45
Eriobotrya_prinoides,16,5,11,Points-PointsKO-Adjacents,120
Eriobotrya_salwinensis,17,11,6,Points-PointsKO-Adjacents,104
Eriobotrya_serrata,10,4,6,Points-PointsKO-Adjacents,90
Eriobotrya_tengyuehensis,19,0,19,Points-PointsKO-Adjacents,142
Eriocoelum_dzangensis,7,4,3,Points-PointsKO-Adjacents,36
Eriocoelum_kerstingii,81,43,38,Alphahull-PointsKO-Adjacents,941
Eriocoelum_lawtonii,3,3,0,Points-PointsKO-Adjacents,27
Eriocoelum_macrocarpum,85,71,14,Alphahull-PointsKO-Adjacents,2371
Eriocoelum_microspermum,37,11,26,Points-PointsKO-Adjacents,275
Eriocoelum_oblongum,11,6,5,Points-PointsKO-Adjacents,65
Eriocoelum_paniculatum,19,8,11,Points-PointsKO-Adjacents,155
Eriocoelum_petiolare,52,36,16,Alphahull-PointsKO-Adjacents,1118
Eriocoelum_pungens,32,21,11,Alphahull-PointsKO-Adjacents,509
Eriocoelum_racemosum,40,16,24,Points-PointsKO-Adjacents,284
Eriocoelum_rivulare,0,0,0,NA,0
Eriolaena_affinis,0,0,0,NA,0
Eriolaena_candollei,6,1,5,Points-PointsKO-Adjacents,50
Eriolaena_glabrescens,7,1,6,Points-PointsKO-Adjacents,63
Eriolaena_hookeriana,0,0,0,NA,0
Eriolaena_kwangsiensis,6,0,6,Points-PointsKO-Adjacents,54
Eriolaena_lushingtonii,0,0,0,NA,0
Eriolaena_quinquelocularis,1,1,0,Points-PointsKO-Adjacents,9
Eriolaena_spectabilis,21,11,10,Points-PointsKO-Adjacents,185
Eriolaena_wallichii,1,1,0,Points-PointsKO-Adjacents,9
Eriolarynx_iochromoides,3,3,0,Points-PointsKO-Adjacents,27
Eriolarynx_lorentzii,15,9,6,Points-PointsKO-Adjacents,100
Eriope_exaltata,70,62,8,Alphahull-PointsKO-Adjacents,275
Eriope_latifolia,173,147,26,Alphahull-PointsKO-Adjacents,1014
Eriope_salviifolia,56,0,56,Points-PointsKO-Adjacents,303
Eriosema_violaceum,80,30,50,Alphahull-PointsKO-Adjacents,955
Eriosolena_composita,38,0,38,Points-PointsKO-Adjacents,297
Eriostemon_trachyphyllus,176,155,21,Alphahull-PointsKO-Adjacents,869
Eriotheca_candolleana,351,301,50,Alphahull-PointsKO-Adjacents,11635
Eriotheca_crassa,8,5,3,Points-PointsKO-Adjacents,37
Eriotheca_crenulaticalyx,18,6,12,Points-PointsKO-Adjacents,123
Eriotheca_discolor,39,22,17,Alphahull-PointsKO-Adjacents,485
Eriotheca_dolichopoda,21,11,10,Points-PointsKO-Adjacents,130
Eriotheca_gentryi,15,9,6,Points-PointsKO-Adjacents,76
Eriotheca_globosa,432,323,109,Alphahull-PointsKO-Adjacents,47916
Eriotheca_gracilipes,592,532,60,Alphahull-PointsKO-Adjacents,24846
Eriotheca_hassleri,0,0,0,NA,0
Eriotheca_longipedicellata,28,8,20,Points-PointsKO-Adjacents,227
Eriotheca_longipes,2,2,0,Points-PointsKO-Adjacents,18
Eriotheca_longitubulosa,15,0,15,Points-PointsKO-Adjacents,88
Eriotheca_loretensis,11,6,5,Points-PointsKO-Adjacents,87
Eriotheca_macrophylla,252,204,48,Alphahull-PointsKO-Adjacents,5121
Eriotheca_obcordata,57,34,23,Alphahull-PointsKO-Adjacents,764
Eriotheca_parvifolia,25,12,13,Points-PointsKO-Adjacents,164
Eriotheca_pentaphylla,109,83,26,Alphahull-PointsKO-Adjacents,965
Eriotheca_peruviana,5,5,0,Points-PointsKO-Adjacents,41
Eriotheca_platyandra,1,1,0,Points-PointsKO-Adjacents,9
Eriotheca_pubescens,294,255,39,Alphahull-PointsKO-Adjacents,11413
Eriotheca_roseorum,56,37,19,Alphahull-PointsKO-Adjacents,2980
Eriotheca_ruizii,94,70,24,Alphahull-PointsKO-Adjacents,558
Eriotheca_sclerophylla,35,12,23,Points-PointsKO-Adjacents,293
Eriotheca_squamigera,26,16,10,Points-PointsKO-Adjacents,162
Eriotheca_surinamensis,31,19,12,Points-PointsKO-Adjacents,223
Eriotheca_vargasii,5,5,0,Points-PointsKO-Adjacents,43
Erioxylum_palmeri,63,33,30,Alphahull-PointsKO-Adjacents,921
Erisma_arietinum,4,0,4,Points-PointsKO-Adjacents,30
Erisma_bicolor,58,27,31,Alphahull-PointsKO-Adjacents,4552
Erisma_blancoa,14,5,9,Points-PointsKO-Adjacents,78
Erisma_calcaratum,141,94,47,Alphahull-PointsKO-Adjacents,6704
Erisma_costatum,19,7,12,Points-PointsKO-Adjacents,144
Erisma_djalma-batistae,8,0,8,Points-PointsKO-Adjacents,61
Erisma_floribundum,41,12,29,Points-PointsKO-Adjacents,310
Erisma_fuscum,21,4,17,Points-PointsKO-Adjacents,147
Erisma_gracile,31,10,21,Points-PointsKO-Adjacents,226
Erisma_japura,46,27,19,Alphahull-PointsKO-Adjacents,1569
Erisma_lanceolatum,2,2,0,Points-PointsKO-Adjacents,18
Erisma_laurifolium,20,2,18,Points-PointsKO-Adjacents,155
Erisma_maliforme,NA,NA,NA,NA,NA
Erisma_megalophyllum,1,1,0,Points-PointsKO-Adjacents,9
Erisma_micranthum,22,11,11,Points-PointsKO-Adjacents,155
Erisma_nitidum,12,4,8,Points-PointsKO-Adjacents,78
Erisma_niveum,NA,NA,NA,NA,NA
Erisma_silvae,1,1,0,Points-PointsKO-Adjacents,9
Erisma_splendens,22,9,13,Points-PointsKO-Adjacents,145
Erisma_tessmannii,3,3,0,Points-PointsKO-Adjacents,21
Erisma_uncinatum,370,267,103,Alphahull-PointsKO-Adjacents,60564
Erismadelphus_exsul,111,84,27,Alphahull-PointsKO-Adjacents,3133
Erismadelphus_sessilis,5,5,0,Points-PointsKO-Adjacents,40
Erismanthus_obliquus,4,0,4,Points-PointsKO-Adjacents,36
Erismanthus_sinensis,9,0,9,Points-PointsKO-Adjacents,69
Erithalis_fruticosa,216,146,70,Alphahull-PointsKO-Adjacents,3079
Erithalis_harrisii,4,4,0,Points-PointsKO-Adjacents,24
Erithalis_odorifera,42,17,25,Points-PointsKO-Adjacents,240
Erithalis_quadrangularis,4,4,0,Points-PointsKO-Adjacents,24
Ernodea_angusta,2,1,1,Points-PointsKO-Adjacents,17
Ernodea_littoralis,157,91,66,Alphahull-PointsKO-Adjacents,1700
Erythrina_abyssinica,168,115,53,Alphahull-PointsKO-Adjacents,16523
Erythrina_addisoniae,14,1,13,Points-PointsKO-Adjacents,123
Erythrina_amazonica,150,91,59,Alphahull-PointsKO-Adjacents,9215
Erythrina_americana,296,221,75,Alphahull-PointsKO-Adjacents,6177
Erythrina_ankaranensis,6,2,4,Points-PointsKO-Adjacents,21
Erythrina_arborescens,29,9,20,Points-PointsKO-Adjacents,227
Erythrina_atitlanensis,6,2,4,Points-PointsKO-Adjacents,35
Erythrina_barqueroana,5,5,0,Points-PointsKO-Adjacents,30
Erythrina_batolobium,8,3,5,Points-PointsKO-Adjacents,38
Erythrina_berenices,8,3,5,Points-PointsKO-Adjacents,58
Erythrina_berteroana,228,142,86,Alphahull-PointsKO-Adjacents,6458
Erythrina_breviflora,150,126,24,Alphahull-PointsKO-Adjacents,1991
Erythrina_brucei,14,9,5,Points-PointsKO-Adjacents,101
Erythrina_buchii,5,5,0,Points-PointsKO-Adjacents,34
Erythrina_burana,13,11,2,Points-PointsKO-Adjacents,18
Erythrina_burttii,1,1,0,Points-PointsKO-Adjacents,9
Erythrina_caffra,39,13,26,Points-PointsKO-Adjacents,297
Erythrina_caribaea,23,11,12,Points-PointsKO-Adjacents,136
Erythrina_castillejiflora,2,2,0,Points-PointsKO-Adjacents,18
Erythrina_chiapasana,77,65,12,Alphahull-PointsKO-Adjacents,284
Erythrina_chiriquensis,29,0,29,Points-PointsKO-Adjacents,106
Erythrina_cobanensis,1,1,0,Points-PointsKO-Adjacents,9
Erythrina_cochleata,21,5,16,Points-PointsKO-Adjacents,138
Erythrina_corallodendron,28,3,25,Points-PointsKO-Adjacents,201
Erythrina_coralloides,112,88,24,Alphahull-PointsKO-Adjacents,2224
Erythrina_costaricensis,227,189,38,Alphahull-PointsKO-Adjacents,2724
Erythrina_crista-galli,432,344,88,Alphahull-PointsKO-Adjacents,22083
Erythrina_cubensis,10,2,8,Points-PointsKO-Adjacents,52
Erythrina_decora,20,10,10,Points-PointsKO-Adjacents,159
Erythrina_dominguezii,194,120,74,Alphahull-PointsKO-Adjacents,20682
Erythrina_droogmansiana,6,0,6,Points-PointsKO-Adjacents,54
Erythrina_edulis,324,267,57,Alphahull-PointsKO-Adjacents,3952
Erythrina_eggersii,8,2,6,Points-PointsKO-Adjacents,39
Erythrina_elenae,3,3,0,Points-PointsKO-Adjacents,21
Erythrina_euodiphylla,1,1,0,Points-PointsKO-Adjacents,9
Erythrina_excelsa,12,4,8,Points-PointsKO-Adjacents,73
Erythrina_flabelliformis,255,222,33,Alphahull-PointsKO-Adjacents,5016
Erythrina_florenciae,9,1,8,Points-PointsKO-Adjacents,53
Erythrina_folkersii,121,101,20,Alphahull-PointsKO-Adjacents,2501
Erythrina_fusca,642,409,233,Alphahull-PointsKO-Adjacents,44990
Erythrina_gibbosa,150,133,17,Alphahull-PointsKO-Adjacents,820
Erythrina_globocalyx,16,12,4,Points-PointsKO-Adjacents,50
Erythrina_goldmanii,93,74,19,Alphahull-PointsKO-Adjacents,407
Erythrina_greenwayi,0,0,0,NA,0
Erythrina_grisebachii,4,3,1,Points-PointsKO-Adjacents,36
Erythrina_guatemalensis,6,3,3,Points-PointsKO-Adjacents,39
Erythrina_haerdii,8,3,5,Points-PointsKO-Adjacents,55
Erythrina_hazomboay,8,2,6,Points-PointsKO-Adjacents,66
Erythrina_herbacea,580,433,147,Alphahull-PointsKO-Adjacents,9862
Erythrina_hondurensis,14,6,8,Points-PointsKO-Adjacents,114
Erythrina_huehuetenangensis,3,3,0,Points-PointsKO-Adjacents,23
Erythrina_humeana,101,65,36,Alphahull-PointsKO-Adjacents,2685
Erythrina_insularis,12,6,6,Points-PointsKO-Adjacents,56
Erythrina_lanata,168,134,34,Alphahull-PointsKO-Adjacents,3213
Erythrina_lanceolata,123,100,23,Alphahull-PointsKO-Adjacents,1355
Erythrina_latissima,71,38,33,Alphahull-PointsKO-Adjacents,1545
Erythrina_leptopoda,5,5,0,Points-PointsKO-Adjacents,43
Erythrina_livingstoniana,18,7,11,Points-PointsKO-Adjacents,140
Erythrina_lysistemon,121,1,120,Points-PointsKO-Adjacents,951
Erythrina_macrophylla,16,8,8,Points-PointsKO-Adjacents,108
Erythrina_madagascariensis,34,17,17,Points-PointsKO-Adjacents,217
Erythrina_melanacantha,6,1,5,Points-PointsKO-Adjacents,54
Erythrina_merrilliana,6,1,5,Points-PointsKO-Adjacents,29
Erythrina_mexicana,38,22,16,Alphahull-PointsKO-Adjacents,1898
Erythrina_microcarpa,0,0,0,NA,0
Erythrina_mildbraedii,35,14,21,Points-PointsKO-Adjacents,298
Erythrina_mitis,46,25,21,Alphahull-PointsKO-Adjacents,1019
Erythrina_oaxacana,14,8,6,Points-PointsKO-Adjacents,60
Erythrina_oliviae,9,1,8,Points-PointsKO-Adjacents,63
Erythrina_orophila,10,4,6,Points-PointsKO-Adjacents,71
Erythrina_pallida,7,0,7,Points-PointsKO-Adjacents,46
Erythrina_perrieri,3,3,0,Points-PointsKO-Adjacents,23
Erythrina_peruviana,40,27,13,Alphahull-PointsKO-Adjacents,676
Erythrina_poeppigiana,365,274,91,Alphahull-PointsKO-Adjacents,26831
Erythrina_polychaeta,9,4,5,Points-PointsKO-Adjacents,72
Erythrina_rubrinervia,171,117,54,Alphahull-PointsKO-Adjacents,5371
Erythrina_sacleuxii,24,17,7,Points-PointsKO-Adjacents,168
Erythrina_salviiflora,3,3,0,Points-PointsKO-Adjacents,27
Erythrina_sandwicensis,10,1,9,Points-PointsKO-Adjacents,62
Erythrina_santamartensis,4,4,0,Points-PointsKO-Adjacents,28
Erythrina_schimpffii,47,32,15,Alphahull-PointsKO-Adjacents,551
Erythrina_schliebenii,5,4,1,Points-PointsKO-Adjacents,36
Erythrina_senegalensis,377,323,54,Alphahull-PointsKO-Adjacents,10560
Erythrina_sigmoidea,29,1,28,Points-PointsKO-Adjacents,230
Erythrina_similis,16,4,12,Points-PointsKO-Adjacents,112
Erythrina_smithiana,58,41,17,Alphahull-PointsKO-Adjacents,718
Erythrina_sousae,4,4,0,Points-PointsKO-Adjacents,30
Erythrina_speciosa,203,127,76,Alphahull-PointsKO-Adjacents,6167
Erythrina_standleyana,220,185,35,Alphahull-PointsKO-Adjacents,3100
Erythrina_steyermarkii,68,53,15,Alphahull-PointsKO-Adjacents,738
Erythrina_stricta,11,1,10,Points-PointsKO-Adjacents,90
Erythrina_suberosa,4,3,1,Points-PointsKO-Adjacents,27
Erythrina_subumbrans,14,0,14,Points-PointsKO-Adjacents,123
Erythrina_tahitensis,1,1,0,Points-PointsKO-Adjacents,9
Erythrina_tajumulcensis,5,5,0,Points-PointsKO-Adjacents,41
Erythrina_tholloniana,2,2,0,Points-PointsKO-Adjacents,18
Erythrina_thyrsiflora,36,27,9,Alphahull-PointsKO-Adjacents,184
Erythrina_tuxtlana,16,10,6,Points-PointsKO-Adjacents,66
Erythrina_ulei,186,109,77,Alphahull-PointsKO-Adjacents,8690
Erythrina_variegata,161,80,81,Alphahull-PointsKO-Adjacents,1749
Erythrina_velutina,593,499,94,Alphahull-PointsKO-Adjacents,15386
Erythrina_verna,250,175,75,Alphahull-PointsKO-Adjacents,15780
Erythrina_vespertilio,888,788,100,Alphahull-PointsKO-Adjacents,39824
Erythrina_vogelii,25,8,17,Points-PointsKO-Adjacents,191
Erythrina_warneckei,NA,NA,NA,NA,NA
Erythrina_williamsii,4,4,0,Points-PointsKO-Adjacents,36
Erythrochiton_brasiliensis,186,94,92,Alphahull-PointsKO-Adjacents,4372
Erythrochiton_fallax,74,52,22,Alphahull-PointsKO-Adjacents,790
Erythrochiton_giganteus,12,6,6,Points-PointsKO-Adjacents,81
Erythrochiton_gymnanthus,31,21,10,Alphahull-PointsKO-Adjacents,47
Erythrochiton_hypophyllanthus,2,2,0,Points-PointsKO-Adjacents,18
Erythrochiton_odontoglossus,9,4,5,Points-PointsKO-Adjacents,72
Erythrochiton_trichanthus,4,4,0,Points-PointsKO-Adjacents,36
Erythrococca_atrovirens,44,13,31,Points-PointsKO-Adjacents,321
Erythrococca_berberidea,23,5,18,Points-PointsKO-Adjacents,173
Erythrococca_bongensis,47,26,21,Alphahull-PointsKO-Adjacents,1449
Erythrococca_columnaris,1,1,0,Points-PointsKO-Adjacents,6
Erythrococca_fischeri,21,12,9,Points-PointsKO-Adjacents,132
Erythrococca_kirkii,22,13,9,Points-PointsKO-Adjacents,143
Erythrococca_menyharthii,52,25,27,Alphahull-PointsKO-Adjacents,2356
Erythrococca_molleri,6,2,4,Points-PointsKO-Adjacents,14
Erythrococca_patula,2,2,0,Points-PointsKO-Adjacents,18
Erythrococca_polyandra,9,1,8,Points-PointsKO-Adjacents,72
Erythrococca_trichogyne,44,14,30,Points-PointsKO-Adjacents,315
Erythrococca_welwitschiana,16,0,16,Points-PointsKO-Adjacents,116
Erythrococca_zambesiaca,4,4,0,Points-PointsKO-Adjacents,30
Erythropalum_scandens,51,0,51,Points-PointsKO-Adjacents,402
Erythrophleum_africanum,247,154,93,Alphahull-PointsKO-Adjacents,6914
Erythrophleum_chlorostachys,5418,5354,64,Alphahull-PointsKO-Adjacents,13165
Erythrophleum_couminga,18,10,8,Points-PointsKO-Adjacents,84
Erythrophleum_fordii,12,0,12,Points-PointsKO-Adjacents,108
Erythrophleum_ivorense,335,295,40,Alphahull-PointsKO-Adjacents,7789
Erythrophleum_letestui,0,0,0,NA,0
Erythrophleum_suaveolens,664,548,116,Alphahull-PointsKO-Adjacents,28447
Erythrophleum_succirubrum,1,1,0,Points-PointsKO-Adjacents,9
Erythrophleum_teysmannii,2,2,0,Points-PointsKO-Adjacents,18
Erythrophysa_aesculina,19,14,5,Points-PointsKO-Adjacents,65
Erythrophysa_alata,11,4,7,Points-PointsKO-Adjacents,88
Erythrophysa_belinii,13,8,5,Points-PointsKO-Adjacents,60
Erythrophysa_humbertii,11,7,4,Points-PointsKO-Adjacents,45
Erythrophysa_lapiazicola,4,4,0,Points-PointsKO-Adjacents,16
Erythrophysa_paniculata,3,3,0,Points-PointsKO-Adjacents,27
Erythrophysa_sakalava,3,3,0,Points-PointsKO-Adjacents,27
Erythrophysa_septentrionalis,0,0,0,NA,0
Erythrophysa_transvaalensis,17,14,3,Points-PointsKO-Adjacents,118
Erythrospermum_acuminatissimum,6,0,6,Points-PointsKO-Adjacents,39
Erythrospermum_ampullaceum,2,2,0,Points-PointsKO-Adjacents,18
Erythrospermum_boivinianum,2,2,0,Points-PointsKO-Adjacents,18
Erythrospermum_candidum,58,33,25,Alphahull-PointsKO-Adjacents,540
Erythrospermum_capitatum,2,2,0,Points-PointsKO-Adjacents,18
Erythrospermum_coffeaefolium,NA,NA,NA,NA,NA
Erythrospermum_corymbosum,2,2,0,Points-PointsKO-Adjacents,18
Erythrospermum_crassipes,2,2,0,Points-PointsKO-Adjacents,18
Erythrospermum_elegans,2,2,0,Points-PointsKO-Adjacents,18
Erythrospermum_laurei,2,2,0,Points-PointsKO-Adjacents,18
Erythrospermum_monticolum,3,3,0,Points-PointsKO-Adjacents,23
Erythrospermum_nossibeense,2,2,0,Points-PointsKO-Adjacents,18
Erythrospermum_pervillei,2,2,0,Points-PointsKO-Adjacents,18
Erythrospermum_recurvifolium,NA,NA,NA,NA,NA
Erythrospermum_richardianum,2,2,0,Points-PointsKO-Adjacents,18
Erythrospermum_rignyanum,2,2,0,Points-PointsKO-Adjacents,18
Erythrospermum_sifarii,2,2,0,Points-PointsKO-Adjacents,10
Erythrospermum_sparsiflorum,2,2,0,Points-PointsKO-Adjacents,18
Erythrospermum_zeylanicum,0,0,0,NA,0
Erythrostemon_gilliesii,220,0,220,Points-PointsKO-Adjacents,1723
Erythroxylum_acuminatum,41,23,18,Alphahull-PointsKO-Adjacents,637
Erythroxylum_affine,105,61,44,Alphahull-PointsKO-Adjacents,2325
Erythroxylum_alaternifolium,16,4,12,Points-PointsKO-Adjacents,96
Erythroxylum_amazonicum,247,147,100,Alphahull-PointsKO-Adjacents,23838
Erythroxylum_ambiguum,87,57,30,Alphahull-PointsKO-Adjacents,2068
Erythroxylum_amplifolium,13,4,9,Points-PointsKO-Adjacents,81
Erythroxylum_amplum,16,0,16,Points-PointsKO-Adjacents,144
Erythroxylum_andrei,33,13,20,Points-PointsKO-Adjacents,198
Erythroxylum_anguifugum,382,319,63,Alphahull-PointsKO-Adjacents,25571
Erythroxylum_areolatum,158,92,66,Alphahull-PointsKO-Adjacents,3958
Erythroxylum_argentinum,279,0,279,Points-PointsKO-Adjacents,1795
Erythroxylum_badium,81,58,23,Alphahull-PointsKO-Adjacents,2973
Erythroxylum_barbatum,129,97,32,Alphahull-PointsKO-Adjacents,10199
Erythroxylum_bequaertii,45,29,16,Alphahull-PointsKO-Adjacents,625
Erythroxylum_betulaceum,155,130,25,Alphahull-PointsKO-Adjacents,5442
Erythroxylum_brevipes,64,1,63,Points-PointsKO-Adjacents,274
Erythroxylum_buxus,63,30,33,Alphahull-PointsKO-Adjacents,4239
Erythroxylum_caatingae,290,269,21,Alphahull-PointsKO-Adjacents,7389
Erythroxylum_cambodianum,3,2,1,Points-PointsKO-Adjacents,18
Erythroxylum_campestre,462,375,87,Alphahull-PointsKO-Adjacents,24067
Erythroxylum_capitatum,6,0,6,Points-PointsKO-Adjacents,33
Erythroxylum_carthagenense,20,10,10,Points-PointsKO-Adjacents,119
Erythroxylum_cassinoides,8,5,3,Points-PointsKO-Adjacents,50
Erythroxylum_cataractarum,104,75,29,Alphahull-PointsKO-Adjacents,7227
Erythroxylum_citrifolium,1952,1761,191,Alphahull-PointsKO-Adjacents,125147
Erythroxylum_clarense,1,1,0,Points-PointsKO-Adjacents,9
Erythroxylum_coelophlebium,49,0,49,Points-PointsKO-Adjacents,307
Erythroxylum_columbinum,99,62,37,Alphahull-PointsKO-Adjacents,893
Erythroxylum_confusum,155,119,36,Alphahull-PointsKO-Adjacents,2567
Erythroxylum_coriaceum,5,5,0,Points-PointsKO-Adjacents,36
Erythroxylum_cuneatum,5,0,5,Points-PointsKO-Adjacents,41
Erythroxylum_cuneifolium,731,648,83,Alphahull-PointsKO-Adjacents,33897
Erythroxylum_cuspidifolium,278,212,66,Alphahull-PointsKO-Adjacents,2214
Erythroxylum_daphnites,616,540,76,Alphahull-PointsKO-Adjacents,28835
Erythroxylum_davidii,1,1,0,Points-PointsKO-Adjacents,7
Erythroxylum_deciduum,1605,1480,125,Alphahull-PointsKO-Adjacents,45585
Erythroxylum_delagoense,14,5,9,Points-PointsKO-Adjacents,91
Erythroxylum_divaricatum,77,45,32,Alphahull-PointsKO-Adjacents,5715
Erythroxylum_ecarinatum,26,6,20,Points-PointsKO-Adjacents,153
Erythroxylum_eligulatum,3,3,0,Points-PointsKO-Adjacents,27
Erythroxylum_ellipticum,842,812,30,Alphahull-PointsKO-Adjacents,7353
Erythroxylum_emarginatum,144,68,76,Alphahull-PointsKO-Adjacents,3847
Erythroxylum_engleri,150,120,30,Alphahull-PointsKO-Adjacents,14278
Erythroxylum_ferrugineum,110,83,27,Alphahull-PointsKO-Adjacents,1371
Erythroxylum_fimbriatum,128,85,43,Alphahull-PointsKO-Adjacents,9992
Erythroxylum_fischeri,13,3,10,Points-PointsKO-Adjacents,103
Erythroxylum_foetidum,49,33,16,Alphahull-PointsKO-Adjacents,483
Erythroxylum_frangulifolium,38,23,15,Alphahull-PointsKO-Adjacents,300
Erythroxylum_glaucum,34,23,11,Alphahull-PointsKO-Adjacents,545
Erythroxylum_glaziovii,NA,NA,NA,NA,NA
Erythroxylum_gonoclados,44,0,44,Points-PointsKO-Adjacents,272
Erythroxylum_gracilipes,512,426,86,Alphahull-PointsKO-Adjacents,35052
Erythroxylum_grandifolium,19,7,12,Points-PointsKO-Adjacents,98
Erythroxylum_grisebachii,1,1,0,Points-PointsKO-Adjacents,9
Erythroxylum_guanchezii,9,6,3,Points-PointsKO-Adjacents,69
Erythroxylum_guatemalense,90,71,19,Alphahull-PointsKO-Adjacents,1135
Erythroxylum_hamigerum,55,35,20,Alphahull-PointsKO-Adjacents,1006
Erythroxylum_haughtii,9,2,7,Points-PointsKO-Adjacents,71
Erythroxylum_havanense,415,301,114,Alphahull-PointsKO-Adjacents,11560
Erythroxylum_hildebrandtii,75,51,24,Alphahull-PointsKO-Adjacents,2524
Erythroxylum_hondense,61,37,24,Alphahull-PointsKO-Adjacents,2143
Erythroxylum_hypericifolium,3,3,0,Points-PointsKO-Adjacents,25
Erythroxylum_hypoleucum,12,6,6,Points-PointsKO-Adjacents,67
Erythroxylum_impressum,90,69,21,Alphahull-PointsKO-Adjacents,4237
Erythroxylum_incrassatum,5,3,2,Points-PointsKO-Adjacents,35
Erythroxylum_jamaicense,3,3,0,Points-PointsKO-Adjacents,17
Erythroxylum_kapplerianum,172,133,39,Alphahull-PointsKO-Adjacents,24250
Erythroxylum_kochummenii,NA,NA,NA,NA,NA
Erythroxylum_lanceolatum,0,0,0,NA,0
Erythroxylum_laurel,75,50,25,Alphahull-PointsKO-Adjacents,2525
Erythroxylum_leal-costae,8,1,7,Points-PointsKO-Adjacents,47
Erythroxylum_leptoneurum,104,64,40,Alphahull-PointsKO-Adjacents,4016
Erythroxylum_ligustrinum,67,34,33,Alphahull-PointsKO-Adjacents,2037
Erythroxylum_loretense,11,2,9,Points-PointsKO-Adjacents,86
Erythroxylum_lygoides,1,1,0,Points-PointsKO-Adjacents,9
Erythroxylum_macrocalyx,126,100,26,Alphahull-PointsKO-Adjacents,1884
Erythroxylum_macrophyllum,1914,1777,137,Alphahull-PointsKO-Adjacents,92666
Erythroxylum_mangorense,2,2,0,Points-PointsKO-Adjacents,17
Erythroxylum_mannii,59,33,26,Alphahull-PointsKO-Adjacents,1729
Erythroxylum_maracasense,45,22,23,Alphahull-PointsKO-Adjacents,1228
Erythroxylum_mattos-silvae,32,24,8,Alphahull-PointsKO-Adjacents,113
Erythroxylum_mexicanum,134,91,43,Alphahull-PointsKO-Adjacents,2806
Erythroxylum_microphyllum,65,32,33,Alphahull-PointsKO-Adjacents,2237
Erythroxylum_minutifolium,23,4,19,Points-PointsKO-Adjacents,159
Erythroxylum_monogynum,0,0,0,NA,0
Erythroxylum_moonii,0,0,0,NA,0
Erythroxylum_mucronatum,622,486,136,Alphahull-PointsKO-Adjacents,58130
Erythroxylum_myrsinites,189,145,44,Alphahull-PointsKO-Adjacents,8347
Erythroxylum_nobile,163,124,39,Alphahull-PointsKO-Adjacents,1194
Erythroxylum_nossibeense,5,5,0,Points-PointsKO-Adjacents,41
Erythroxylum_novocaledonicum,7,1,6,Points-PointsKO-Adjacents,60
Erythroxylum_novogranatense,85,55,30,Alphahull-PointsKO-Adjacents,2830
Erythroxylum_oblanceolatum,0,0,0,NA,0
Erythroxylum_obtusifolium,1,0,1,Points-PointsKO-Adjacents,9
Erythroxylum_occultum,3,2,1,Points-PointsKO-Adjacents,14
Erythroxylum_ochranthum,38,18,20,Points-PointsKO-Adjacents,258
Erythroxylum_oreophilum,44,28,16,Alphahull-PointsKO-Adjacents,1355
Erythroxylum_orinocense,48,36,12,Alphahull-PointsKO-Adjacents,1932
Erythroxylum_oxycarpum,30,8,22,Points-PointsKO-Adjacents,229
Erythroxylum_oxypetalum,12,2,10,Points-PointsKO-Adjacents,108
Erythroxylum_pacificum,2,2,0,Points-PointsKO-Adjacents,17
Erythroxylum_panamense,174,137,37,Alphahull-PointsKO-Adjacents,2065
Erythroxylum_passerinum,371,283,88,Alphahull-PointsKO-Adjacents,5597
Erythroxylum_patentissimum,23,9,14,Points-PointsKO-Adjacents,196
Erythroxylum_pauferrense,23,0,23,Points-PointsKO-Adjacents,126
Erythroxylum_pelleterianum,573,500,73,Alphahull-PointsKO-Adjacents,30603
Erythroxylum_petrae-caballi,20,12,8,Points-PointsKO-Adjacents,98
Erythroxylum_pictum,21,9,12,Points-PointsKO-Adjacents,159
Erythroxylum_platycladum,7,0,7,Points-PointsKO-Adjacents,55
Erythroxylum_plowmanianum,12,10,2,Points-PointsKO-Adjacents,33
Erythroxylum_plowmanii,10,2,8,Points-PointsKO-Adjacents,75
Erythroxylum_polygonoides,121,105,16,Alphahull-PointsKO-Adjacents,2729
Erythroxylum_pulchrum,307,250,57,Alphahull-PointsKO-Adjacents,5746
Erythroxylum_pungens,239,209,30,Alphahull-PointsKO-Adjacents,7097
Erythroxylum_raimondii,22,9,13,Points-PointsKO-Adjacents,149
Erythroxylum_revolutum,356,0,356,Points-PointsKO-Adjacents,2219
Erythroxylum_riverae,2,2,0,Points-PointsKO-Adjacents,18
Erythroxylum_roraimae,25,9,16,Points-PointsKO-Adjacents,207
Erythroxylum_rotundifolium,534,451,83,Alphahull-PointsKO-Adjacents,10178
Erythroxylum_rufum,224,128,96,Alphahull-PointsKO-Adjacents,13272
Erythroxylum_ruizii,9,3,6,Points-PointsKO-Adjacents,62
Erythroxylum_sarawakanum,NA,NA,NA,NA,NA
Erythroxylum_schliebenii,NA,NA,NA,NA,NA
Erythroxylum_schomburgkii,13,4,9,Points-PointsKO-Adjacents,112
Erythroxylum_schunkei,1,1,0,Points-PointsKO-Adjacents,9
Erythroxylum_sechellarum,0,0,0,NA,0
Erythroxylum_shatona,17,0,17,Points-PointsKO-Adjacents,112
Erythroxylum_sinense,41,16,25,Points-PointsKO-Adjacents,366
Erythroxylum_sphaeranthum,54,35,19,Alphahull-PointsKO-Adjacents,451
Erythroxylum_splendidum,20,0,20,Points-PointsKO-Adjacents,76
Erythroxylum_spruceanum,70,37,33,Alphahull-PointsKO-Adjacents,3360
Erythroxylum_squamatum,624,467,157,Alphahull-PointsKO-Adjacents,63377
Erythroxylum_suberosum,1503,1364,139,Alphahull-PointsKO-Adjacents,53068
Erythroxylum_subglaucescens,2,2,0,Points-PointsKO-Adjacents,18
Erythroxylum_subracemosum,230,165,65,Alphahull-PointsKO-Adjacents,16537
Erythroxylum_subrotundum,450,376,74,Alphahull-PointsKO-Adjacents,13914
Erythroxylum_substriatum,1,1,0,Points-PointsKO-Adjacents,9
Erythroxylum_subumbellatum,1,1,0,Points-PointsKO-Adjacents,5
Erythroxylum_timothei,4,4,0,Points-PointsKO-Adjacents,36
Erythroxylum_tortuosum,494,422,72,Alphahull-PointsKO-Adjacents,18518
Erythroxylum_tucuruiense,17,12,5,Points-PointsKO-Adjacents,73
Erythroxylum_ulei,215,168,47,Alphahull-PointsKO-Adjacents,9187
Erythroxylum_urbanii,21,14,7,Points-PointsKO-Adjacents,109
Erythroxylum_vasquezii,7,1,6,Points-PointsKO-Adjacents,63
Erythroxylum_vernicosum,43,28,15,Alphahull-PointsKO-Adjacents,992
Erythroxylum_williamsii,29,24,5,Alphahull-PointsKO-Adjacents,167
Erythroxylum_zambesiacum,4,4,0,Points-PointsKO-Adjacents,36
Erythroxylum_zeylanicum,NA,NA,NA,NA,NA
Escallonia_angustifolia,27,7,20,Points-PointsKO-Adjacents,156
Escallonia_bifida,314,0,314,Points-PointsKO-Adjacents,2052
Escallonia_callcottiae,7,0,7,Points-PointsKO-Adjacents,14
Escallonia_discolor,28,10,18,Points-PointsKO-Adjacents,163
Escallonia_herrerae,8,0,8,Points-PointsKO-Adjacents,48
Escallonia_hypoglauca,53,36,17,Alphahull-PointsKO-Adjacents,586
Escallonia_micrantha,20,9,11,Points-PointsKO-Adjacents,127
Escallonia_millegrana,57,43,14,Alphahull-PointsKO-Adjacents,1348
Escallonia_myrtilloides,625,561,64,Alphahull-PointsKO-Adjacents,8178
Escallonia_myrtoidea,42,31,11,Alphahull-PointsKO-Adjacents,435
Escallonia_paniculata,437,361,76,Alphahull-PointsKO-Adjacents,6476
Escallonia_pendula,119,78,41,Alphahull-PointsKO-Adjacents,2028
Escallonia_piurensis,5,5,0,Points-PointsKO-Adjacents,36
Escallonia_pulverulenta,41,26,15,Alphahull-PointsKO-Adjacents,668
Escallonia_resinosa,93,61,32,Alphahull-PointsKO-Adjacents,1366
Escallonia_reticulata,34,27,7,Alphahull-PointsKO-Adjacents,144
Escallonia_revoluta,38,23,15,Alphahull-PointsKO-Adjacents,557
Escallonia_rosea,53,36,17,Alphahull-PointsKO-Adjacents,1069
Escallonia_rubra,381,193,188,Alphahull-PointsKO-Adjacents,5879
Escallonia_schreiteri,34,21,13,Alphahull-PointsKO-Adjacents,724
Escallonia_tucumanensis,27,0,27,Points-PointsKO-Adjacents,201
Eschweilera_aguilarii,28,22,6,Alphahull-PointsKO-Adjacents,53
Eschweilera_alata,17,9,8,Points-PointsKO-Adjacents,128
Eschweilera_albiflora,463,399,64,Alphahull-PointsKO-Adjacents,35680
Eschweilera_alvimii,50,26,24,Alphahull-PointsKO-Adjacents,352
Eschweilera_amazonica,122,85,37,Alphahull-PointsKO-Adjacents,11055
Eschweilera_amazoniciformis,28,22,6,Alphahull-PointsKO-Adjacents,102
Eschweilera_amplexifolia,31,26,5,Alphahull-PointsKO-Adjacents,76
Eschweilera_andina,166,130,36,Alphahull-PointsKO-Adjacents,5365
Eschweilera_antioquensis,132,102,30,Alphahull-PointsKO-Adjacents,2393
Eschweilera_apiculata,112,0,112,Points-PointsKO-Adjacents,642
Eschweilera_atropetiolata,93,69,24,Alphahull-PointsKO-Adjacents,4656
Eschweilera_baguensis,3,3,0,Points-PointsKO-Adjacents,27
Eschweilera_beebei,2,2,0,Points-PointsKO-Adjacents,12
Eschweilera_biflava,27,17,10,Points-PointsKO-Adjacents,73
Eschweilera_bogotensis,6,5,1,Points-PointsKO-Adjacents,48
Eschweilera_boltenii,6,3,3,Points-PointsKO-Adjacents,48
Eschweilera_bracteosa,170,133,37,Alphahull-PointsKO-Adjacents,14900
Eschweilera_cabrerana,8,4,4,Points-PointsKO-Adjacents,60
Eschweilera_calyculata,86,67,19,Alphahull-PointsKO-Adjacents,722
Eschweilera_carinata,29,9,20,Points-PointsKO-Adjacents,216
Eschweilera_caudiculata,179,144,35,Alphahull-PointsKO-Adjacents,3200
Eschweilera_collina,162,0,162,Points-PointsKO-Adjacents,922
Eschweilera_collinsii,64,47,17,Alphahull-PointsKO-Adjacents,418
Eschweilera_complanata,26,0,26,Points-PointsKO-Adjacents,158
Eschweilera_compressa,19,7,12,Points-PointsKO-Adjacents,105
Eschweilera_congestiflora,26,18,8,Points-PointsKO-Adjacents,124
Eschweilera_coriacea,1343,1255,88,Alphahull-PointsKO-Adjacents,78490
Eschweilera_costaricensis,40,35,5,Alphahull-PointsKO-Adjacents,110
Eschweilera_cyathiformis,38,29,9,Alphahull-PointsKO-Adjacents,197
Eschweilera_decolorans,174,109,65,Alphahull-PointsKO-Adjacents,15678
Eschweilera_eperuetorum,10,5,5,Points-PointsKO-Adjacents,53
Eschweilera_fanshawei,2,2,0,Points-PointsKO-Adjacents,18
Eschweilera_gigantea,138,109,29,Alphahull-PointsKO-Adjacents,5653
Eschweilera_grandiflora,172,130,42,Alphahull-PointsKO-Adjacents,12272
Eschweilera_harmonii,2,2,0,Points-PointsKO-Adjacents,9
Eschweilera_hondurensis,32,16,16,Points-PointsKO-Adjacents,144
Eschweilera_integricalyx,10,3,7,Points-PointsKO-Adjacents,55
Eschweilera_integrifolia,103,80,23,Alphahull-PointsKO-Adjacents,1603
Eschweilera_itayensis,67,53,14,Alphahull-PointsKO-Adjacents,2469
Eschweilera_jacquelyniae,16,11,5,Points-PointsKO-Adjacents,61
Eschweilera_juruensis,115,83,32,Alphahull-PointsKO-Adjacents,12586
Eschweilera_klugii,5,5,0,Points-PointsKO-Adjacents,45
Eschweilera_laevicarpa,103,49,54,Alphahull-PointsKO-Adjacents,1480
Eschweilera_longipedicellata,9,0,9,Points-PointsKO-Adjacents,27
Eschweilera_macrocarpa,6,1,5,Points-PointsKO-Adjacents,48
Eschweilera_mattos-silvae,19,8,11,Points-PointsKO-Adjacents,94
Eschweilera_mexicana,6,2,4,Points-PointsKO-Adjacents,30
Eschweilera_micrantha,294,242,52,Alphahull-PointsKO-Adjacents,26408
Eschweilera_microcalyx,15,7,8,Points-PointsKO-Adjacents,108
Eschweilera_nana,282,226,56,Alphahull-PointsKO-Adjacents,11539
Eschweilera_neblinensis,7,0,7,Points-PointsKO-Adjacents,42
Eschweilera_neei,22,14,8,Points-PointsKO-Adjacents,101
Eschweilera_obversa,56,29,27,Alphahull-PointsKO-Adjacents,3232
Eschweilera_ovalifolia,167,119,48,Alphahull-PointsKO-Adjacents,15985
Eschweilera_ovata,835,682,153,Alphahull-PointsKO-Adjacents,19641
Eschweilera_pachyderma,22,8,14,Points-PointsKO-Adjacents,180
Eschweilera_panamensis,43,21,22,Alphahull-PointsKO-Adjacents,1095
Eschweilera_paniculata,7,1,6,Points-PointsKO-Adjacents,60
Eschweilera_parviflora,303,248,55,Alphahull-PointsKO-Adjacents,22778
Eschweilera_parvifolia,506,428,78,Alphahull-PointsKO-Adjacents,57351
Eschweilera_pedicellata,652,593,59,Alphahull-PointsKO-Adjacents,37741
Eschweilera_perumbonata,22,7,15,Points-PointsKO-Adjacents,160
Eschweilera_piresii,20,6,14,Points-PointsKO-Adjacents,129
Eschweilera_potaroensis,4,4,0,Points-PointsKO-Adjacents,36
Eschweilera_praealta,5,5,0,Points-PointsKO-Adjacents,45
Eschweilera_pseudodecolorans,60,0,60,Points-PointsKO-Adjacents,247
Eschweilera_punctata,39,29,10,Alphahull-PointsKO-Adjacents,313
Eschweilera_rabeliana,6,0,6,Points-PointsKO-Adjacents,50
Eschweilera_rankiniae,15,14,1,Points-PointsKO-Adjacents,46
Eschweilera_reversa,146,119,27,Alphahull-PointsKO-Adjacents,2775
Eschweilera_revoluta,8,1,7,Points-PointsKO-Adjacents,42
Eschweilera_rhododendrifolia,23,14,9,Points-PointsKO-Adjacents,145
Eschweilera_rimbachii,69,54,15,Alphahull-PointsKO-Adjacents,927
Eschweilera_rionegrense,19,9,10,Points-PointsKO-Adjacents,142
Eschweilera_rodriguesiana,12,7,5,Points-PointsKO-Adjacents,50
Eschweilera_roraimensis,15,0,15,Points-PointsKO-Adjacents,97
Eschweilera_rufifolia,44,36,8,Alphahull-PointsKO-Adjacents,372
Eschweilera_sagotiana,168,124,44,Alphahull-PointsKO-Adjacents,7890
Eschweilera_sclerophylla,29,0,29,Points-PointsKO-Adjacents,155
Eschweilera_sessilis,100,76,24,Alphahull-PointsKO-Adjacents,2378
Eschweilera_simiorum,66,0,66,Points-PointsKO-Adjacents,378
Eschweilera_squamata,4,4,0,Points-PointsKO-Adjacents,18
Eschweilera_subcordata,1,1,0,Points-PointsKO-Adjacents,6
Eschweilera_subglandulosa,340,294,46,Alphahull-PointsKO-Adjacents,15902
Eschweilera_tenax,28,8,20,Points-PointsKO-Adjacents,189
Eschweilera_tenuifolia,316,265,51,Alphahull-PointsKO-Adjacents,14317
Eschweilera_tessmannii,216,172,44,Alphahull-PointsKO-Adjacents,14535
Eschweilera_tetrapetala,31,0,31,Points-PointsKO-Adjacents,151
Eschweilera_truncata,128,99,29,Alphahull-PointsKO-Adjacents,6526
Eschweilera_venezuelica,4,4,0,Points-PointsKO-Adjacents,36
Eschweilera_wachenheimii,126,95,31,Alphahull-PointsKO-Adjacents,4309
Escontria_chiotilla,152,141,11,Alphahull-PointsKO-Adjacents,537
Esenbeckia_alata,11,5,6,Points-PointsKO-Adjacents,61
Esenbeckia_almawillia,143,80,63,Alphahull-PointsKO-Adjacents,3271
Esenbeckia_amazonica,76,46,30,Alphahull-PointsKO-Adjacents,7102
Esenbeckia_berlandieri,327,275,52,Alphahull-PointsKO-Adjacents,4451
Esenbeckia_bicolor,4,4,0,Points-PointsKO-Adjacents,36
Esenbeckia_collina,14,0,14,Points-PointsKO-Adjacents,65
Esenbeckia_cornuta,4,4,0,Points-PointsKO-Adjacents,30
Esenbeckia_cowanii,40,8,32,Points-PointsKO-Adjacents,299
Esenbeckia_decidua,11,0,11,Points-PointsKO-Adjacents,75
Esenbeckia_densiflora,40,25,15,Alphahull-PointsKO-Adjacents,586
Esenbeckia_echinoidea,2,2,0,Points-PointsKO-Adjacents,18
Esenbeckia_febrifuga,537,451,86,Alphahull-PointsKO-Adjacents,15587
Esenbeckia_feddemae,2,2,0,Points-PointsKO-Adjacents,14
Esenbeckia_flava,50,32,18,Alphahull-PointsKO-Adjacents,243
Esenbeckia_grandiflora,1532,1316,216,Alphahull-PointsKO-Adjacents,32841
Esenbeckia_hartmanii,50,0,50,Points-PointsKO-Adjacents,271
Esenbeckia_hieronymi,39,19,20,Points-PointsKO-Adjacents,238
Esenbeckia_kallunkiae,14,5,9,Points-PointsKO-Adjacents,99
Esenbeckia_leiocarpa,180,122,58,Alphahull-PointsKO-Adjacents,3079
Esenbeckia_macrantha,45,31,14,Alphahull-PointsKO-Adjacents,228
Esenbeckia_nesiotica,7,0,7,Points-PointsKO-Adjacents,47
Esenbeckia_oligantha,39,22,17,Alphahull-PointsKO-Adjacents,1571
Esenbeckia_panamensis,34,22,12,Alphahull-PointsKO-Adjacents,378
Esenbeckia_pentaphylla,3,3,0,Points-PointsKO-Adjacents,27
Esenbeckia_pilocarpoides,288,195,93,Alphahull-PointsKO-Adjacents,28309
Esenbeckia_pumila,145,111,34,Alphahull-PointsKO-Adjacents,3773
Esenbeckia_runyonii,51,26,25,Alphahull-PointsKO-Adjacents,616
Esenbeckia_scrotiformis,22,7,15,Points-PointsKO-Adjacents,167
Esenbeckia_warscewiczii,10,0,10,Points-PointsKO-Adjacents,90
Espadaea_amoena,6,1,5,Points-PointsKO-Adjacents,51
Espeletia_brachyaxiantha,19,15,4,Points-PointsKO-Adjacents,76
Espostoa_calva,0,0,0,NA,0
Espostoa_guentheri,7,4,3,Points-PointsKO-Adjacents,18
Espostoa_lanata,19,15,4,Points-PointsKO-Adjacents,64
Espostoa_senilis,0,0,0,NA,0
Espostoa_utcubambensis,1,0,1,Points-PointsKO-Adjacents,9
Etaballia_dubia,53,22,31,Alphahull-PointsKO-Adjacents,1915
Euadenia_brevipetala,NA,NA,NA,NA,NA
Euadenia_eminens,64,24,40,Alphahull-PointsKO-Adjacents,1516
Eucalyptopsis_alauda,0,0,0,NA,0
Eucalyptopsis_papuana,28,6,22,Points-PointsKO-Adjacents,153
Eucalyptus_abdita,19,12,7,Points-PointsKO-Adjacents,84
Eucalyptus_absita,15,9,6,Points-PointsKO-Adjacents,51
Eucalyptus_acaciiformis,289,273,16,Alphahull-PointsKO-Adjacents,369
Eucalyptus_accedens,250,235,15,Alphahull-PointsKO-Adjacents,632
Eucalyptus_acies,41,34,7,Alphahull-PointsKO-Adjacents,39
Eucalyptus_acmenoides,2666,2469,197,Alphahull-PointsKO-Adjacents,5913
Eucalyptus_acroleuca,37,28,9,Alphahull-PointsKO-Adjacents,78
Eucalyptus_aenea,12,10,2,Points-PointsKO-Adjacents,34
Eucalyptus_aequioperta,83,78,5,Alphahull-PointsKO-Adjacents,991
Eucalyptus_agglomerata,1799,1740,59,Alphahull-PointsKO-Adjacents,1822
Eucalyptus_aggregata,336,0,336,Points-PointsKO-Adjacents,540
Eucalyptus_alaticaulis,88,80,8,Alphahull-PointsKO-Adjacents,106
Eucalyptus_alba,501,439,62,Alphahull-PointsKO-Adjacents,3794
Eucalyptus_albens,4863,3622,1241,Alphahull-PointsKO-Adjacents,4161
Eucalyptus_albida,256,245,11,Alphahull-PointsKO-Adjacents,1234
Eucalyptus_albopurpurea,283,264,19,Alphahull-PointsKO-Adjacents,335
Eucalyptus_alipes,172,160,12,Alphahull-PointsKO-Adjacents,590
Eucalyptus_alligatrix,134,122,12,Alphahull-PointsKO-Adjacents,132
Eucalyptus_ambigua,42,31,11,Alphahull-PointsKO-Adjacents,152
Eucalyptus_ammophila,77,53,24,Alphahull-PointsKO-Adjacents,296
Eucalyptus_amplifolia,1244,1063,181,Alphahull-PointsKO-Adjacents,2248
Eucalyptus_amygdalina,4967,0,4967,Points-PointsKO-Adjacents,1041
Eucalyptus_anceps,6,1,5,Points-PointsKO-Adjacents,54
Eucalyptus_ancophila,51,42,9,Alphahull-PointsKO-Adjacents,75
Eucalyptus_andrewsii,2229,0,2229,Points-PointsKO-Adjacents,1424
Eucalyptus_angophoroides,584,560,24,Alphahull-PointsKO-Adjacents,826
Eucalyptus_angularis,4,4,0,Points-PointsKO-Adjacents,15
Eucalyptus_angulosa,440,393,47,Alphahull-PointsKO-Adjacents,2367
Eucalyptus_angustissima,96,82,14,Alphahull-PointsKO-Adjacents,419
Eucalyptus_annulata,157,0,157,Points-PointsKO-Adjacents,467
Eucalyptus_annuliformis,7,3,4,Points-PointsKO-Adjacents,23
Eucalyptus_apiculata,194,186,8,Alphahull-PointsKO-Adjacents,305
Eucalyptus_apodophylla,282,263,19,Alphahull-PointsKO-Adjacents,2053
Eucalyptus_apothalassica,144,127,17,Alphahull-PointsKO-Adjacents,1623
Eucalyptus_approximans,126,0,126,Points-PointsKO-Adjacents,197
Eucalyptus_aquilina,12,8,4,Points-PointsKO-Adjacents,28
Eucalyptus_arachnaea,264,247,17,Alphahull-PointsKO-Adjacents,1013
Eucalyptus_arborella,23,0,23,Points-PointsKO-Adjacents,72
Eucalyptus_arcana,8,1,7,Points-PointsKO-Adjacents,25
Eucalyptus_archeri,178,169,9,Alphahull-PointsKO-Adjacents,237
Eucalyptus_arenacea,1218,1192,26,Alphahull-PointsKO-Adjacents,1033
Eucalyptus_arenicola,137,128,9,Alphahull-PointsKO-Adjacents,93
Eucalyptus_argillacea,167,137,30,Alphahull-PointsKO-Adjacents,934
Eucalyptus_argophloia,73,59,14,Alphahull-PointsKO-Adjacents,114
Eucalyptus_argutifolia,13,9,4,Points-PointsKO-Adjacents,53
Eucalyptus_aromaphloia,1288,1258,30,Alphahull-PointsKO-Adjacents,1074
Eucalyptus_articulata,4,4,0,Points-PointsKO-Adjacents,21
Eucalyptus_aspersa,132,118,14,Alphahull-PointsKO-Adjacents,492
Eucalyptus_aspratilis,104,87,17,Alphahull-PointsKO-Adjacents,1175
Eucalyptus_assimilans,20,15,5,Points-PointsKO-Adjacents,68
Eucalyptus_astringens,299,277,22,Alphahull-PointsKO-Adjacents,1127
Eucalyptus_atrata,103,90,13,Alphahull-PointsKO-Adjacents,126
Eucalyptus_badjensis,77,69,8,Alphahull-PointsKO-Adjacents,81
Eucalyptus_baeuerlenii,66,58,8,Alphahull-PointsKO-Adjacents,103
Eucalyptus_baileyana,285,0,285,Points-PointsKO-Adjacents,486
Eucalyptus_baiophylla,31,26,5,Alphahull-PointsKO-Adjacents,85
Eucalyptus_bakeri,221,194,27,Alphahull-PointsKO-Adjacents,3256
Eucalyptus_balladoniensis,68,58,10,Alphahull-PointsKO-Adjacents,303
Eucalyptus_bancroftii,272,0,272,Points-PointsKO-Adjacents,475
Eucalyptus_banksii,289,274,15,Alphahull-PointsKO-Adjacents,768
Eucalyptus_barberi,200,186,14,Alphahull-PointsKO-Adjacents,161
Eucalyptus_barklyensis,70,56,14,Alphahull-PointsKO-Adjacents,870
Eucalyptus_baueriana,714,633,81,Alphahull-PointsKO-Adjacents,1110
Eucalyptus_baxteri,1464,1421,43,Alphahull-PointsKO-Adjacents,2556
Eucalyptus_beaniana,27,18,9,Points-PointsKO-Adjacents,79
Eucalyptus_beardiana,33,26,7,Alphahull-PointsKO-Adjacents,134
Eucalyptus_behriana,697,672,25,Alphahull-PointsKO-Adjacents,2681
Eucalyptus_bensonii,36,30,6,Alphahull-PointsKO-Adjacents,42
Eucalyptus_benthamii,88,75,13,Alphahull-PointsKO-Adjacents,118
Eucalyptus_beyeri,67,51,16,Alphahull-PointsKO-Adjacents,861
Eucalyptus_beyeriana,344,313,31,Alphahull-PointsKO-Adjacents,1110
Eucalyptus_bicolor,3,0,3,Points-PointsKO-Adjacents,14
Eucalyptus_bigalerita,647,612,35,Alphahull-PointsKO-Adjacents,5124
Eucalyptus_biterranea,17,8,9,Points-PointsKO-Adjacents,72
Eucalyptus_biturbinata,706,680,26,Alphahull-PointsKO-Adjacents,1821
Eucalyptus_blakelyi,5246,5069,177,Alphahull-PointsKO-Adjacents,5810
Eucalyptus_blaxellii,19,12,7,Points-PointsKO-Adjacents,73
Eucalyptus_blaxlandi,356,338,18,Alphahull-PointsKO-Adjacents,574
Eucalyptus_boliviana,11,6,5,Points-PointsKO-Adjacents,19
Eucalyptus_bosistoana,845,793,52,Alphahull-PointsKO-Adjacents,845
Eucalyptus_botryoides,1737,1444,293,Alphahull-PointsKO-Adjacents,2795
Eucalyptus_brachyandra,235,217,18,Alphahull-PointsKO-Adjacents,2562
Eucalyptus_brachycalyx,2667,2613,54,Alphahull-PointsKO-Adjacents,3979
Eucalyptus_brachycorys,236,219,17,Alphahull-PointsKO-Adjacents,2412
Eucalyptus_brachyphylla,18,10,8,Points-PointsKO-Adjacents,75
Eucalyptus_brandiana,6,0,6,Points-PointsKO-Adjacents,42
Eucalyptus_brassiana,293,266,27,Alphahull-PointsKO-Adjacents,1728
Eucalyptus_brevifolia,1036,0,1036,Points-PointsKO-Adjacents,2209
Eucalyptus_brevistylis,22,13,9,Points-PointsKO-Adjacents,40
Eucalyptus_bridgesiana,2954,2826,128,Alphahull-PointsKO-Adjacents,4474
Eucalyptus_brockwayi,44,34,10,Alphahull-PointsKO-Adjacents,77
Eucalyptus_brookeriana,609,585,24,Alphahull-PointsKO-Adjacents,2467
Eucalyptus_broviniensis,5,5,0,Points-PointsKO-Adjacents,17
Eucalyptus_brownii,283,263,20,Alphahull-PointsKO-Adjacents,2568
Eucalyptus_brunnea,341,333,8,Alphahull-PointsKO-Adjacents,216
Eucalyptus_buprestium,160,12,148,Points-PointsKO-Adjacents,256
Eucalyptus_burdettiana,17,5,12,Points-PointsKO-Adjacents,123
Eucalyptus_burgessiana,187,156,31,Alphahull-PointsKO-Adjacents,340
Eucalyptus_burracoppinensis,204,188,16,Alphahull-PointsKO-Adjacents,812
Eucalyptus_cadens,75,65,10,Alphahull-PointsKO-Adjacents,48
Eucalyptus_caesia,91,65,26,Alphahull-PointsKO-Adjacents,833
Eucalyptus_calcareana,590,554,36,Alphahull-PointsKO-Adjacents,1204
Eucalyptus_calcicola,46,0,46,Points-PointsKO-Adjacents,105
Eucalyptus_caleyi,617,604,13,Alphahull-PointsKO-Adjacents,1109
Eucalyptus_caliginosa,1056,0,1056,Points-PointsKO-Adjacents,804
Eucalyptus_calycogona,2351,2301,50,Alphahull-PointsKO-Adjacents,4524
Eucalyptus_calyerup,8,5,3,Points-PointsKO-Adjacents,33
Eucalyptus_camaldulensis,15359,14689,670,Alphahull-PointsKO-Adjacents,77560
Eucalyptus_cambageana,296,271,25,Alphahull-PointsKO-Adjacents,3600
Eucalyptus_cameronii,772,747,25,Alphahull-PointsKO-Adjacents,939
Eucalyptus_camfieldii,138,83,55,Alphahull-PointsKO-Adjacents,160
Eucalyptus_campaspe,111,84,27,Alphahull-PointsKO-Adjacents,406
Eucalyptus_camphora,859,832,27,Alphahull-PointsKO-Adjacents,2058
Eucalyptus_canaliculata,315,0,315,Points-PointsKO-Adjacents,337
Eucalyptus_canescens,120,110,10,Alphahull-PointsKO-Adjacents,610
Eucalyptus_canobolensis,32,28,4,Alphahull-PointsKO-Adjacents,21
Eucalyptus_capillosa,342,326,16,Alphahull-PointsKO-Adjacents,2154
Eucalyptus_capitanea,39,31,8,Alphahull-PointsKO-Adjacents,93
Eucalyptus_capitellata,579,449,130,Alphahull-PointsKO-Adjacents,419
Eucalyptus_captiosa,189,175,14,Alphahull-PointsKO-Adjacents,1283
Eucalyptus_carnea,1201,0,1201,Points-PointsKO-Adjacents,1232
Eucalyptus_carnei,115,101,14,Alphahull-PointsKO-Adjacents,1977
Eucalyptus_castrensis,4,4,0,Points-PointsKO-Adjacents,12
Eucalyptus_celastroides,766,736,30,Alphahull-PointsKO-Adjacents,4064
Eucalyptus_cephalocarpa,229,172,57,Alphahull-PointsKO-Adjacents,580
Eucalyptus_ceracea,11,0,11,Points-PointsKO-Adjacents,43
Eucalyptus_cerasiformis,13,12,1,Points-PointsKO-Adjacents,49
Eucalyptus_ceratocorys,144,118,26,Alphahull-PointsKO-Adjacents,1570
Eucalyptus_cernua,78,0,78,Points-PointsKO-Adjacents,129
Eucalyptus_chapmaniana,168,160,8,Alphahull-PointsKO-Adjacents,369
Eucalyptus_chartaboma,106,97,9,Alphahull-PointsKO-Adjacents,1273
Eucalyptus_chloroclada,1221,1201,20,Alphahull-PointsKO-Adjacents,5876
Eucalyptus_chlorophylla,803,751,52,Alphahull-PointsKO-Adjacents,9880
Eucalyptus_cinerea,531,476,55,Alphahull-PointsKO-Adjacents,2021
Eucalyptus_cladocalyx,1088,932,156,Alphahull-PointsKO-Adjacents,5169
Eucalyptus_clelandii,206,190,16,Alphahull-PointsKO-Adjacents,2242
Eucalyptus_clivicola,81,74,7,Alphahull-PointsKO-Adjacents,298
Eucalyptus_cloeziana,386,0,386,Points-PointsKO-Adjacents,908
Eucalyptus_cneorifolia,218,205,13,Alphahull-PointsKO-Adjacents,121
Eucalyptus_coccifera,756,746,10,Alphahull-PointsKO-Adjacents,714
Eucalyptus_comitae-vallis,206,178,28,Alphahull-PointsKO-Adjacents,3638
Eucalyptus_concinna,848,803,45,Alphahull-PointsKO-Adjacents,8869
Eucalyptus_conferruminata,62,33,29,Alphahull-PointsKO-Adjacents,280
Eucalyptus_confluens,108,98,10,Alphahull-PointsKO-Adjacents,438
Eucalyptus_conglobata,429,401,28,Alphahull-PointsKO-Adjacents,1902
Eucalyptus_conglomerata,61,0,61,Points-PointsKO-Adjacents,97
Eucalyptus_conica,738,718,20,Alphahull-PointsKO-Adjacents,4526
Eucalyptus_conjuncta,11,9,2,Points-PointsKO-Adjacents,33
Eucalyptus_consideniana,1571,1541,30,Alphahull-PointsKO-Adjacents,2120
Eucalyptus_conspicua,243,226,17,Alphahull-PointsKO-Adjacents,565
Eucalyptus_contracta,17,14,3,Points-PointsKO-Adjacents,32
Eucalyptus_conveniens,44,0,44,Points-PointsKO-Adjacents,122
Eucalyptus_coolabah,3393,3324,69,Alphahull-PointsKO-Adjacents,34688
Eucalyptus_cooperiana,133,120,13,Alphahull-PointsKO-Adjacents,454
Eucalyptus_copulans,8,3,5,Points-PointsKO-Adjacents,16
Eucalyptus_cordata,164,0,164,Points-PointsKO-Adjacents,381
Eucalyptus_cornuta,212,1,211,Points-PointsKO-Adjacents,562
Eucalyptus_corrugata,104,98,6,Alphahull-PointsKO-Adjacents,429
Eucalyptus_corynodes,53,44,9,Alphahull-PointsKO-Adjacents,418
Eucalyptus_cosmophylla,771,0,771,Points-PointsKO-Adjacents,230
Eucalyptus_costuligera,16,13,3,Points-PointsKO-Adjacents,61
Eucalyptus_crebra,6677,0,6677,Points-PointsKO-Adjacents,7944
Eucalyptus_crenulata,73,56,17,Alphahull-PointsKO-Adjacents,274
Eucalyptus_creta,21,15,6,Points-PointsKO-Adjacents,81
Eucalyptus_cretata,99,94,5,Alphahull-PointsKO-Adjacents,132
Eucalyptus_crispata,18,13,5,Points-PointsKO-Adjacents,94
Eucalyptus_croajingolensis,884,861,23,Alphahull-PointsKO-Adjacents,549
Eucalyptus_crucis,133,0,133,Points-PointsKO-Adjacents,334
Eucalyptus_cullenii,415,401,14,Alphahull-PointsKO-Adjacents,1649
Eucalyptus_cuprea,29,0,29,Points-PointsKO-Adjacents,127
Eucalyptus_cupularis,97,0,97,Points-PointsKO-Adjacents,318
Eucalyptus_curtisii,165,0,165,Points-PointsKO-Adjacents,429
Eucalyptus_cyanoclada,66,1,65,Points-PointsKO-Adjacents,318
Eucalyptus_cyanophylla,459,0,459,Points-PointsKO-Adjacents,462
Eucalyptus_cyclostoma,63,58,5,Alphahull-PointsKO-Adjacents,179
Eucalyptus_cylindriflora,187,173,14,Alphahull-PointsKO-Adjacents,1638
Eucalyptus_cylindrocarpa,230,216,14,Alphahull-PointsKO-Adjacents,2243
Eucalyptus_cypellocarpa,5296,5234,62,Alphahull-PointsKO-Adjacents,3554
Eucalyptus_dalrympleana,4367,4302,65,Alphahull-PointsKO-Adjacents,4386
Eucalyptus_dawsonii,307,298,9,Alphahull-PointsKO-Adjacents,514
Eucalyptus_dealbata,1977,1933,44,Alphahull-PointsKO-Adjacents,5434
Eucalyptus_deanei,623,570,53,Alphahull-PointsKO-Adjacents,977
Eucalyptus_decipiens,474,0,474,Points-PointsKO-Adjacents,1126
Eucalyptus_decolor,38,0,38,Points-PointsKO-Adjacents,91
Eucalyptus_decorticans,229,0,229,Points-PointsKO-Adjacents,881
Eucalyptus_decurva,231,212,19,Alphahull-PointsKO-Adjacents,1257
Eucalyptus_deflexa,51,42,9,Alphahull-PointsKO-Adjacents,138
Eucalyptus_deglupta,46,18,28,Points-PointsKO-Adjacents,259
Eucalyptus_delegatensis,4759,4733,26,Alphahull-PointsKO-Adjacents,2356
Eucalyptus_delicata,47,39,8,Alphahull-PointsKO-Adjacents,319
Eucalyptus_dendromorpha,159,145,14,Alphahull-PointsKO-Adjacents,222
Eucalyptus_densa,242,0,242,Points-PointsKO-Adjacents,701
Eucalyptus_denticulata,252,242,10,Alphahull-PointsKO-Adjacents,257
Eucalyptus_depauperata,103,0,103,Points-PointsKO-Adjacents,363
Eucalyptus_desmondensis,27,19,8,Points-PointsKO-Adjacents,76
Eucalyptus_deuaensis,12,8,4,Points-PointsKO-Adjacents,31
Eucalyptus_dielsii,89,77,12,Alphahull-PointsKO-Adjacents,292
Eucalyptus_diminuta,103,84,19,Alphahull-PointsKO-Adjacents,311
Eucalyptus_diptera,128,0,128,Points-PointsKO-Adjacents,282
Eucalyptus_disclusa,9,3,6,Points-PointsKO-Adjacents,35
Eucalyptus_discreta,124,104,20,Alphahull-PointsKO-Adjacents,446
Eucalyptus_dissimulata,200,0,200,Points-PointsKO-Adjacents,568
Eucalyptus_dissita,9,7,2,Points-PointsKO-Adjacents,18
Eucalyptus_distans,155,1,154,Points-PointsKO-Adjacents,418
Eucalyptus_distuberosa,35,30,5,Alphahull-PointsKO-Adjacents,444
Eucalyptus_diversicolor,135,1,134,Points-PointsKO-Adjacents,301
Eucalyptus_diversifolia,2546,2499,47,Alphahull-PointsKO-Adjacents,1914
Eucalyptus_dives,2702,2620,82,Alphahull-PointsKO-Adjacents,3369
Eucalyptus_dolichocera,156,140,16,Alphahull-PointsKO-Adjacents,580
Eucalyptus_dolichorhyncha,56,42,14,Alphahull-PointsKO-Adjacents,198
Eucalyptus_dolorosa,2,2,0,Points-PointsKO-Adjacents,12
Eucalyptus_doratoxylon,121,105,16,Alphahull-PointsKO-Adjacents,278
Eucalyptus_dorrigoensis,153,142,11,Alphahull-PointsKO-Adjacents,185
Eucalyptus_drepanophylla,408,1,407,Points-PointsKO-Adjacents,1695
Eucalyptus_drummondii,334,320,14,Alphahull-PointsKO-Adjacents,1103
Eucalyptus_dumosa,4849,4784,65,Alphahull-PointsKO-Adjacents,8678
Eucalyptus_dundasii,116,0,116,Points-PointsKO-Adjacents,288
Eucalyptus_dunnii,166,159,7,Alphahull-PointsKO-Adjacents,413
Eucalyptus_dura,177,157,20,Alphahull-PointsKO-Adjacents,856
Eucalyptus_dwyeri,1509,1474,35,Alphahull-PointsKO-Adjacents,3343
Eucalyptus_ebbanoensis,246,222,24,Alphahull-PointsKO-Adjacents,1210
Eucalyptus_educta,16,9,7,Points-PointsKO-Adjacents,86
Eucalyptus_effusa,88,71,17,Alphahull-PointsKO-Adjacents,712
Eucalyptus_elaeophloia,13,10,3,Points-PointsKO-Adjacents,18
Eucalyptus_elata,1662,1610,52,Alphahull-PointsKO-Adjacents,1724
Eucalyptus_elliptica,190,178,12,Alphahull-PointsKO-Adjacents,577
Eucalyptus_epruinata,3,3,0,Points-PointsKO-Adjacents,21
Eucalyptus_erectifolia,45,39,6,Alphahull-PointsKO-Adjacents,67
Eucalyptus_eremicola,414,388,26,Alphahull-PointsKO-Adjacents,6515
Eucalyptus_eremophila,479,460,19,Alphahull-PointsKO-Adjacents,3172
Eucalyptus_erosa,9,4,5,Points-PointsKO-Adjacents,35
Eucalyptus_erythrocorys,80,57,23,Alphahull-PointsKO-Adjacents,250
Eucalyptus_erythronema,287,268,19,Alphahull-PointsKO-Adjacents,1077
Eucalyptus_eudesmioides,388,0,388,Points-PointsKO-Adjacents,831
Eucalyptus_eugenioides,2238,2030,208,Alphahull-PointsKO-Adjacents,4864
Eucalyptus_ewartiana,278,255,23,Alphahull-PointsKO-Adjacents,5153
Eucalyptus_exigua,42,35,7,Alphahull-PointsKO-Adjacents,282
Eucalyptus_exilipes,66,55,11,Alphahull-PointsKO-Adjacents,402
Eucalyptus_exilis,42,35,7,Alphahull-PointsKO-Adjacents,133
Eucalyptus_exserta,953,900,53,Alphahull-PointsKO-Adjacents,8953
Eucalyptus_extensa,140,133,7,Alphahull-PointsKO-Adjacents,1124
Eucalyptus_extrica,92,80,12,Alphahull-PointsKO-Adjacents,121
Eucalyptus_falcata,493,1,492,Points-PointsKO-Adjacents,1236
Eucalyptus_falciformis,565,546,19,Alphahull-PointsKO-Adjacents,756
Eucalyptus_famelica,31,21,10,Alphahull-PointsKO-Adjacents,322
Eucalyptus_farinosa,6,1,5,Points-PointsKO-Adjacents,27
Eucalyptus_fasciculosa,2533,0,2533,Points-PointsKO-Adjacents,725
Eucalyptus_fastigata,1935,1904,31,Alphahull-PointsKO-Adjacents,1832
Eucalyptus_fergusonii,209,187,22,Alphahull-PointsKO-Adjacents,327
Eucalyptus_fibrosa,3208,0,3208,Points-PointsKO-Adjacents,3045
Eucalyptus_fitzgeraldii,28,23,5,Alphahull-PointsKO-Adjacents,179
Eucalyptus_flavida,39,24,15,Alphahull-PointsKO-Adjacents,194
Eucalyptus_flindersii,179,169,10,Alphahull-PointsKO-Adjacents,446
Eucalyptus_flocktoniae,741,714,27,Alphahull-PointsKO-Adjacents,3458
Eucalyptus_foecunda,4414,0,4414,Points-PointsKO-Adjacents,5105
Eucalyptus_foliosa,15,14,1,Points-PointsKO-Adjacents,40
Eucalyptus_formanii,59,45,14,Alphahull-PointsKO-Adjacents,143
Eucalyptus_forresterae,9,3,6,Points-PointsKO-Adjacents,34
Eucalyptus_forrestiana,114,105,9,Alphahull-PointsKO-Adjacents,282
Eucalyptus_fracta,13,11,2,Points-PointsKO-Adjacents,19
Eucalyptus_fraseri,127,122,5,Alphahull-PointsKO-Adjacents,536
Eucalyptus_fraxinoides,321,310,11,Alphahull-PointsKO-Adjacents,318
Eucalyptus_frenchiana,21,15,6,Points-PointsKO-Adjacents,104
Eucalyptus_froggattii,128,116,12,Alphahull-PointsKO-Adjacents,331
Eucalyptus_fruticosa,87,68,19,Alphahull-PointsKO-Adjacents,406
Eucalyptus_fulgens,237,222,15,Alphahull-PointsKO-Adjacents,221
Eucalyptus_fusiformis,118,96,22,Alphahull-PointsKO-Adjacents,427
Eucalyptus_gamophylla,984,946,38,Alphahull-PointsKO-Adjacents,16907
Eucalyptus_gardneri,150,138,12,Alphahull-PointsKO-Adjacents,879
Eucalyptus_georgei,56,47,9,Alphahull-PointsKO-Adjacents,193
Eucalyptus_gigantangion,43,0,43,Points-PointsKO-Adjacents,130
Eucalyptus_gillenii,211,174,37,Alphahull-PointsKO-Adjacents,1144
Eucalyptus_gillii,299,278,21,Alphahull-PointsKO-Adjacents,1062
Eucalyptus_gittinsii,193,175,18,Alphahull-PointsKO-Adjacents,552
Eucalyptus_glaucescens,176,158,18,Alphahull-PointsKO-Adjacents,910
Eucalyptus_glaucina,290,153,137,Alphahull-PointsKO-Adjacents,557
Eucalyptus_globoidea,5587,5323,264,Alphahull-PointsKO-Adjacents,3033
Eucalyptus_globulus,4549,4391,158,Alphahull-PointsKO-Adjacents,5714
Eucalyptus_glomericassis,61,53,8,Alphahull-PointsKO-Adjacents,134
Eucalyptus_glomerosa,173,157,16,Alphahull-PointsKO-Adjacents,2628
Eucalyptus_gomphocephala,131,69,62,Alphahull-PointsKO-Adjacents,367
Eucalyptus_gongylocarpa,306,275,31,Alphahull-PointsKO-Adjacents,6362
Eucalyptus_goniantha,177,161,16,Alphahull-PointsKO-Adjacents,611
Eucalyptus_goniocalyx,1441,1376,65,Alphahull-PointsKO-Adjacents,5756
Eucalyptus_goniocarpa,35,30,5,Alphahull-PointsKO-Adjacents,68
Eucalyptus_gracilis,6386,6308,78,Alphahull-PointsKO-Adjacents,13708
Eucalyptus_grandis,1158,1044,114,Alphahull-PointsKO-Adjacents,1425
Eucalyptus_granitica,195,181,14,Alphahull-PointsKO-Adjacents,534
Eucalyptus_gratiae,143,127,16,Alphahull-PointsKO-Adjacents,452
Eucalyptus_gregoriensis,14,6,8,Points-PointsKO-Adjacents,88
Eucalyptus_gregsoniana,105,93,12,Alphahull-PointsKO-Adjacents,278
Eucalyptus_griffithsii,261,0,261,Points-PointsKO-Adjacents,660
Eucalyptus_grisea,46,40,6,Alphahull-PointsKO-Adjacents,112
Eucalyptus_grossa,145,124,21,Alphahull-PointsKO-Adjacents,838
Eucalyptus_grossifolia,12,8,4,Points-PointsKO-Adjacents,62
Eucalyptus_guilfoylei,71,61,10,Alphahull-PointsKO-Adjacents,95
Eucalyptus_gunnii,338,0,338,Points-PointsKO-Adjacents,465
Eucalyptus_gymnoteles,28,19,9,Points-PointsKO-Adjacents,162
Eucalyptus_gypsophila,250,227,23,Alphahull-PointsKO-Adjacents,8325
Eucalyptus_haemastoma,1024,771,253,Alphahull-PointsKO-Adjacents,502
Eucalyptus_hallii,86,78,8,Alphahull-PointsKO-Adjacents,56
Eucalyptus_halophila,79,71,8,Alphahull-PointsKO-Adjacents,74
Eucalyptus_hebetifolia,107,100,7,Alphahull-PointsKO-Adjacents,375
Eucalyptus_helenae,18,12,6,Points-PointsKO-Adjacents,77
Eucalyptus_helidonica,59,45,14,Alphahull-PointsKO-Adjacents,178
Eucalyptus_herbertiana,353,320,33,Alphahull-PointsKO-Adjacents,4396
Eucalyptus_histophylla,44,37,7,Alphahull-PointsKO-Adjacents,466
Eucalyptus_horistes,897,868,29,Alphahull-PointsKO-Adjacents,6280
Eucalyptus_houseana,123,0,123,Points-PointsKO-Adjacents,500
Eucalyptus_howittiana,96,0,96,Points-PointsKO-Adjacents,230
Eucalyptus_hypolaena,101,87,14,Alphahull-PointsKO-Adjacents,916
Eucalyptus_hypostomatica,74,65,9,Alphahull-PointsKO-Adjacents,140
Eucalyptus_ignorabilis,101,87,14,Alphahull-PointsKO-Adjacents,341
Eucalyptus_imitans,69,0,69,Points-PointsKO-Adjacents,102
Eucalyptus_imlayensis,7,1,6,Points-PointsKO-Adjacents,33
Eucalyptus_impensa,6,2,4,Points-PointsKO-Adjacents,38
Eucalyptus_incerata,47,42,5,Alphahull-PointsKO-Adjacents,279
Eucalyptus_incrassata,4649,4568,81,Alphahull-PointsKO-Adjacents,7158
Eucalyptus_indurata,126,114,12,Alphahull-PointsKO-Adjacents,368
Eucalyptus_infera,22,18,4,Points-PointsKO-Adjacents,51
Eucalyptus_infracorticata,3,3,0,Points-PointsKO-Adjacents,26
Eucalyptus_insularis,17,0,17,Points-PointsKO-Adjacents,42
Eucalyptus_interstans,123,0,123,Points-PointsKO-Adjacents,295
Eucalyptus_intertexta,1867,1818,49,Alphahull-PointsKO-Adjacents,14303
Eucalyptus_irritans,74,61,13,Alphahull-PointsKO-Adjacents,628
Eucalyptus_jacksonii,48,40,8,Alphahull-PointsKO-Adjacents,65
Eucalyptus_jensenii,311,281,30,Alphahull-PointsKO-Adjacents,5021
Eucalyptus_jimberlanica,11,6,5,Points-PointsKO-Adjacents,33
Eucalyptus_johnstonii,239,228,11,Alphahull-PointsKO-Adjacents,478
Eucalyptus_jucunda,165,0,165,Points-PointsKO-Adjacents,419
Eucalyptus_jutsonii,38,30,8,Alphahull-PointsKO-Adjacents,175
Eucalyptus_kabiana,13,6,7,Points-PointsKO-Adjacents,19
Eucalyptus_kartzoffiana,60,55,5,Alphahull-PointsKO-Adjacents,59
Eucalyptus_kenneallyi,0,0,0,NA,0
Eucalyptus_kessellii,207,194,13,Alphahull-PointsKO-Adjacents,436
Eucalyptus_kingsmillii,412,0,412,Points-PointsKO-Adjacents,1737
Eucalyptus_kitsoniana,222,199,23,Alphahull-PointsKO-Adjacents,516
Eucalyptus_kochii,1020,990,30,Alphahull-PointsKO-Adjacents,6459
Eucalyptus_kondininensis,174,161,13,Alphahull-PointsKO-Adjacents,832
Eucalyptus_koolpinensis,16,12,4,Points-PointsKO-Adjacents,34
Eucalyptus_kruseana,40,31,9,Alphahull-PointsKO-Adjacents,124
Eucalyptus_kumarlensis,73,64,9,Alphahull-PointsKO-Adjacents,164
Eucalyptus_kybeanensis,140,127,13,Alphahull-PointsKO-Adjacents,398
Eucalyptus_lacrimans,68,56,12,Alphahull-PointsKO-Adjacents,128
Eucalyptus_laeliae,86,76,10,Alphahull-PointsKO-Adjacents,103
Eucalyptus_laevis,78,72,6,Alphahull-PointsKO-Adjacents,318
Eucalyptus_laevopinea,1523,0,1523,Points-PointsKO-Adjacents,1253
Eucalyptus_lane-poolei,92,0,92,Points-PointsKO-Adjacents,211
Eucalyptus_langleyi,49,42,7,Alphahull-PointsKO-Adjacents,39
Eucalyptus_lansdowneana,86,67,19,Alphahull-PointsKO-Adjacents,644
Eucalyptus_laophila,70,63,7,Alphahull-PointsKO-Adjacents,82
Eucalyptus_largeana,78,71,7,Alphahull-PointsKO-Adjacents,274
Eucalyptus_latens,193,183,10,Alphahull-PointsKO-Adjacents,865
Eucalyptus_lateritica,12,5,7,Points-PointsKO-Adjacents,39
Eucalyptus_latisinensis,118,101,17,Alphahull-PointsKO-Adjacents,236
Eucalyptus_lehmannii,216,182,34,Alphahull-PointsKO-Adjacents,686
Eucalyptus_leprophloia,15,10,5,Points-PointsKO-Adjacents,66
Eucalyptus_leptocalyx,378,366,12,Alphahull-PointsKO-Adjacents,950
Eucalyptus_leptophleba,453,0,453,Points-PointsKO-Adjacents,1287
Eucalyptus_leptopoda,780,751,29,Alphahull-PointsKO-Adjacents,6714
Eucalyptus_lesouefii,256,231,25,Alphahull-PointsKO-Adjacents,2301
Eucalyptus_leucophloia,974,931,43,Alphahull-PointsKO-Adjacents,8074
Eucalyptus_leucoxylon,6838,6595,243,Alphahull-PointsKO-Adjacents,5854
Eucalyptus_ligulata,60,48,12,Alphahull-PointsKO-Adjacents,111
Eucalyptus_ligustrina,183,158,25,Alphahull-PointsKO-Adjacents,604
Eucalyptus_limitaris,102,89,13,Alphahull-PointsKO-Adjacents,1058
Eucalyptus_lirata,99,0,99,Points-PointsKO-Adjacents,233
Eucalyptus_litorea,19,0,19,Points-PointsKO-Adjacents,97
Eucalyptus_livida,91,86,5,Alphahull-PointsKO-Adjacents,553
Eucalyptus_lockyeri,129,117,12,Alphahull-PointsKO-Adjacents,208
Eucalyptus_longicornis,349,0,349,Points-PointsKO-Adjacents,1491
Eucalyptus_longifolia,825,711,114,Alphahull-PointsKO-Adjacents,896
Eucalyptus_longirostrata,223,11,212,Points-PointsKO-Adjacents,669
Eucalyptus_longissima,184,173,11,Alphahull-PointsKO-Adjacents,2330
Eucalyptus_loxophleba,1365,1336,29,Alphahull-PointsKO-Adjacents,5433
Eucalyptus_lucasii,296,279,17,Alphahull-PointsKO-Adjacents,6527
Eucalyptus_lucens,50,42,8,Alphahull-PointsKO-Adjacents,142
Eucalyptus_luculenta,27,27,0,Alphahull,896
Eucalyptus_luehmanniana,193,138,55,Alphahull-PointsKO-Adjacents,155
Eucalyptus_luteola,36,28,8,Alphahull-PointsKO-Adjacents,241
Eucalyptus_macarthurii,179,1,178,Points-PointsKO-Adjacents,194
Eucalyptus_mackintyi,73,60,13,Alphahull-PointsKO-Adjacents,211
Eucalyptus_macmahonii,2,2,0,Points-PointsKO-Adjacents,18
Eucalyptus_macrandra,102,0,102,Points-PointsKO-Adjacents,326
Eucalyptus_macrocarpa,181,158,23,Alphahull-PointsKO-Adjacents,929
Eucalyptus_macrorhyncha,1273,1196,77,Alphahull-PointsKO-Adjacents,5149
Eucalyptus_magnificata,55,49,6,Alphahull-PointsKO-Adjacents,132
Eucalyptus_major,241,190,51,Alphahull-PointsKO-Adjacents,2035
Eucalyptus_malacoxylon,164,153,11,Alphahull-PointsKO-Adjacents,301
Eucalyptus_mannensis,544,497,47,Alphahull-PointsKO-Adjacents,8180
Eucalyptus_mannifera,2869,2787,82,Alphahull-PointsKO-Adjacents,3451
Eucalyptus_marginata,810,731,79,Alphahull-PointsKO-Adjacents,2046
Eucalyptus_mckieana,170,0,170,Points-PointsKO-Adjacents,209
Eucalyptus_mcquoidii,8,3,5,Points-PointsKO-Adjacents,23
Eucalyptus_medialis,49,44,5,Alphahull-PointsKO-Adjacents,93
Eucalyptus_mediocris,232,208,24,Alphahull-PointsKO-Adjacents,2353
Eucalyptus_megacarpa,158,130,28,Alphahull-PointsKO-Adjacents,871
Eucalyptus_megacornuta,48,35,13,Alphahull-PointsKO-Adjacents,135
Eucalyptus_megasepala,69,53,16,Alphahull-PointsKO-Adjacents,589
Eucalyptus_melanoleuca,111,98,13,Alphahull-PointsKO-Adjacents,1539
Eucalyptus_melanophitra,30,25,5,Alphahull-PointsKO-Adjacents,54
Eucalyptus_melanophloia,2077,2003,74,Alphahull-PointsKO-Adjacents,14467
Eucalyptus_melanoxylon,239,228,11,Alphahull-PointsKO-Adjacents,2348
Eucalyptus_melliodora,9434,0,9434,Points-PointsKO-Adjacents,6870
Eucalyptus_mensalis,18,15,3,Points-PointsKO-Adjacents,36
Eucalyptus_merrickiae,34,30,4,Alphahull-PointsKO-Adjacents,97
Eucalyptus_michaeliana,184,170,14,Alphahull-PointsKO-Adjacents,288
Eucalyptus_micranthera,186,168,18,Alphahull-PointsKO-Adjacents,505
Eucalyptus_microcarpa,6623,0,6623,Points-PointsKO-Adjacents,4991
Eucalyptus_microcodon,21,18,3,Points-PointsKO-Adjacents,58
Eucalyptus_microcorys,3608,3387,221,Alphahull-PointsKO-Adjacents,1585
Eucalyptus_microneura,190,183,7,Alphahull-PointsKO-Adjacents,946
Eucalyptus_microschema,27,21,6,Alphahull-PointsKO-Adjacents,127
Eucalyptus_microtheca,1253,1190,63,Alphahull-PointsKO-Adjacents,23070
Eucalyptus_mimica,65,60,5,Alphahull-PointsKO-Adjacents,158
Eucalyptus_miniata,3241,3174,67,Alphahull-PointsKO-Adjacents,8699
Eucalyptus_minniritchi,64,55,9,Alphahull-PointsKO-Adjacents,671
Eucalyptus_misella,17,11,6,Points-PointsKO-Adjacents,66
Eucalyptus_mitchelliana,23,21,2,Alphahull-PointsKO-Adjacents,22
Eucalyptus_moderata,273,258,15,Alphahull-PointsKO-Adjacents,2506
Eucalyptus_moluccana,2683,2428,255,Alphahull-PointsKO-Adjacents,7969
Eucalyptus_molyneuxii,3,3,0,Points-PointsKO-Adjacents,21
Eucalyptus_montivaga,45,29,16,Alphahull-PointsKO-Adjacents,355
Eucalyptus_mooreana,22,15,7,Points-PointsKO-Adjacents,95
Eucalyptus_moorei,203,188,15,Alphahull-PointsKO-Adjacents,783
Eucalyptus_morrisbyi,26,0,26,Points-PointsKO-Adjacents,42
Eucalyptus_morrisii,174,1,173,Points-PointsKO-Adjacents,524
Eucalyptus_muelleriana,2052,2010,42,Alphahull-PointsKO-Adjacents,1899
Eucalyptus_multicaulis,207,172,35,Alphahull-PointsKO-Adjacents,445
Eucalyptus_myriadena,322,303,19,Alphahull-PointsKO-Adjacents,1876
Eucalyptus_nandewarica,31,27,4,Alphahull-PointsKO-Adjacents,53
Eucalyptus_nebulosa,7,5,2,Points-PointsKO-Adjacents,21
Eucalyptus_neglecta,123,116,7,Alphahull-PointsKO-Adjacents,261
Eucalyptus_newbeyi,15,10,5,Points-PointsKO-Adjacents,47
Eucalyptus_nicholii,250,0,250,Points-PointsKO-Adjacents,504
Eucalyptus_nigra,13,5,8,Points-PointsKO-Adjacents,107
Eucalyptus_nigrifunda,22,13,9,Points-PointsKO-Adjacents,103
Eucalyptus_nitens,410,389,21,Alphahull-PointsKO-Adjacents,954
Eucalyptus_nitida,1392,1366,26,Alphahull-PointsKO-Adjacents,1287
Eucalyptus_nobilis,775,752,23,Alphahull-PointsKO-Adjacents,1658
Eucalyptus_normantonensis,356,318,38,Alphahull-PointsKO-Adjacents,8836
Eucalyptus_nortonii,1088,1024,64,Alphahull-PointsKO-Adjacents,2617
Eucalyptus_notabilis,331,312,19,Alphahull-PointsKO-Adjacents,943
Eucalyptus_nova-anglica,457,443,14,Alphahull-PointsKO-Adjacents,720
Eucalyptus_nudicaulis,11,7,4,Points-PointsKO-Adjacents,39
Eucalyptus_nutans,11,4,7,Points-PointsKO-Adjacents,72
Eucalyptus_obconica,100,0,100,Points-PointsKO-Adjacents,462
Eucalyptus_obesa,327,235,92,Alphahull-PointsKO-Adjacents,26238
Eucalyptus_obliqua,3547,3437,110,Alphahull-PointsKO-Adjacents,5630
Eucalyptus_oblonga,1692,1559,133,Alphahull-PointsKO-Adjacents,1355
Eucalyptus_obstans,172,141,31,Alphahull-PointsKO-Adjacents,279
Eucalyptus_obtusiflora,447,413,34,Alphahull-PointsKO-Adjacents,1693
Eucalyptus_occidentalis,351,325,26,Alphahull-PointsKO-Adjacents,2154
Eucalyptus_ochrophloia,233,215,18,Alphahull-PointsKO-Adjacents,1937
Eucalyptus_odontocarpa,456,0,456,Points-PointsKO-Adjacents,1696
Eucalyptus_odorata,2573,2454,119,Alphahull-PointsKO-Adjacents,2976
Eucalyptus_oldfieldii,430,404,26,Alphahull-PointsKO-Adjacents,7174
Eucalyptus_oleosa,6539,6430,109,Alphahull-PointsKO-Adjacents,13956
Eucalyptus_olida,67,61,6,Alphahull-PointsKO-Adjacents,61
Eucalyptus_oligantha,335,307,28,Alphahull-PointsKO-Adjacents,1902
Eucalyptus_olivina,232,0,232,Points-PointsKO-Adjacents,827
Eucalyptus_olsenii,48,0,48,Points-PointsKO-Adjacents,111
Eucalyptus_ophitica,15,11,4,Points-PointsKO-Adjacents,27
Eucalyptus_optima,128,112,16,Alphahull-PointsKO-Adjacents,998
Eucalyptus_oraria,141,0,141,Points-PointsKO-Adjacents,349
Eucalyptus_orbifolia,135,0,135,Points-PointsKO-Adjacents,586
Eucalyptus_ordiana,26,21,5,Alphahull-PointsKO-Adjacents,67
Eucalyptus_oreades,298,286,12,Alphahull-PointsKO-Adjacents,946
Eucalyptus_oresbia,20,16,4,Points-PointsKO-Adjacents,42
Eucalyptus_orgadophila,399,371,28,Alphahull-PointsKO-Adjacents,4579
Eucalyptus_ornans,3,3,0,Points-PointsKO-Adjacents,9
Eucalyptus_ornata,35,29,6,Alphahull-PointsKO-Adjacents,109
Eucalyptus_orophila,3,3,0,Points-PointsKO-Adjacents,21
Eucalyptus_orthostemon,151,140,11,Alphahull-PointsKO-Adjacents,797
Eucalyptus_ovata,7214,6904,310,Alphahull-PointsKO-Adjacents,4752
Eucalyptus_ovularis,102,90,12,Alphahull-PointsKO-Adjacents,798
Eucalyptus_oxymitra,534,514,20,Alphahull-PointsKO-Adjacents,4423
Eucalyptus_pachycalyx,123,99,24,Alphahull-PointsKO-Adjacents,256
Eucalyptus_pachyloma,180,0,180,Points-PointsKO-Adjacents,294
Eucalyptus_pachyphylla,527,493,34,Alphahull-PointsKO-Adjacents,10444
Eucalyptus_paedoglauca,30,0,30,Points-PointsKO-Adjacents,89
Eucalyptus_pallida,53,0,53,Points-PointsKO-Adjacents,205
Eucalyptus_paludicola,72,66,6,Alphahull-PointsKO-Adjacents,48
Eucalyptus_panda,149,138,11,Alphahull-PointsKO-Adjacents,1453
Eucalyptus_paniculata,1404,1162,242,Alphahull-PointsKO-Adjacents,1385
Eucalyptus_pantoleuca,117,110,7,Alphahull-PointsKO-Adjacents,697
Eucalyptus_paralimnetica,7,6,1,Points-PointsKO-Adjacents,38
Eucalyptus_parramattensis,465,412,53,Alphahull-PointsKO-Adjacents,431
Eucalyptus_parvula,113,107,6,Alphahull-PointsKO-Adjacents,131
Eucalyptus_patellaris,420,399,21,Alphahull-PointsKO-Adjacents,2688
Eucalyptus_patens,241,219,22,Alphahull-PointsKO-Adjacents,791
Eucalyptus_pauciflora,5995,5866,129,Alphahull-PointsKO-Adjacents,5680
Eucalyptus_pellita,128,108,20,Alphahull-PointsKO-Adjacents,401
Eucalyptus_pendens,41,36,5,Alphahull-PointsKO-Adjacents,72
Eucalyptus_perangusta,173,165,8,Alphahull-PointsKO-Adjacents,595
Eucalyptus_percostata,43,0,43,Points-PointsKO-Adjacents,134
Eucalyptus_perriniana,181,158,23,Alphahull-PointsKO-Adjacents,994
Eucalyptus_persistens,386,360,26,Alphahull-PointsKO-Adjacents,2514
Eucalyptus_petraea,175,160,15,Alphahull-PointsKO-Adjacents,2067
Eucalyptus_petrensis,46,27,19,Alphahull-PointsKO-Adjacents,152
Eucalyptus_phaenophylla,558,546,12,Alphahull-PointsKO-Adjacents,1360
Eucalyptus_phenax,2949,2888,61,Alphahull-PointsKO-Adjacents,4972
Eucalyptus_phoenicea,870,0,870,Points-PointsKO-Adjacents,1744
Eucalyptus_pilbarensis,46,33,13,Alphahull-PointsKO-Adjacents,287
Eucalyptus_pileata,596,560,36,Alphahull-PointsKO-Adjacents,2997
Eucalyptus_pilularis,3515,3078,437,Alphahull-PointsKO-Adjacents,2244
Eucalyptus_pimpiniana,116,100,16,Alphahull-PointsKO-Adjacents,624
Eucalyptus_piperita,2936,0,2936,Points-PointsKO-Adjacents,869
Eucalyptus_placita,89,77,12,Alphahull-PointsKO-Adjacents,250
Eucalyptus_planchoniana,392,346,46,Alphahull-PointsKO-Adjacents,663
Eucalyptus_planipes,69,60,9,Alphahull-PointsKO-Adjacents,559
Eucalyptus_platycorys,296,283,13,Alphahull-PointsKO-Adjacents,2500
Eucalyptus_platydisca,26,0,26,Points-PointsKO-Adjacents,55
Eucalyptus_platyphylla,479,432,47,Alphahull-PointsKO-Adjacents,3938
Eucalyptus_platypus,274,251,23,Alphahull-PointsKO-Adjacents,824
Eucalyptus_plenissima,260,246,14,Alphahull-PointsKO-Adjacents,1815
Eucalyptus_pleurocorys,48,0,48,Points-PointsKO-Adjacents,154
Eucalyptus_pluricaulis,312,0,312,Points-PointsKO-Adjacents,912
Eucalyptus_polita,102,0,102,Points-PointsKO-Adjacents,401
Eucalyptus_polyanthemos,4165,4012,153,Alphahull-PointsKO-Adjacents,3794
Eucalyptus_polybractea,359,330,29,Alphahull-PointsKO-Adjacents,2704
Eucalyptus_populnea,3396,3351,45,Alphahull-PointsKO-Adjacents,15214
Eucalyptus_porosa,3591,3430,161,Alphahull-PointsKO-Adjacents,6769
Eucalyptus_portuensis,162,137,25,Alphahull-PointsKO-Adjacents,1410
Eucalyptus_praetermissa,11,0,11,Points-PointsKO-Adjacents,44
Eucalyptus_prava,652,641,11,Alphahull-PointsKO-Adjacents,761
Eucalyptus_preissiana,212,192,20,Alphahull-PointsKO-Adjacents,439
Eucalyptus_prolixa,109,0,109,Points-PointsKO-Adjacents,426
Eucalyptus_prominens,72,0,72,Points-PointsKO-Adjacents,141
Eucalyptus_prominula,84,74,10,Alphahull-PointsKO-Adjacents,93
Eucalyptus_propinqua,2150,2059,91,Alphahull-PointsKO-Adjacents,2156
Eucalyptus_protensa,67,59,8,Alphahull-PointsKO-Adjacents,473
Eucalyptus_provecta,55,43,12,Alphahull-PointsKO-Adjacents,289
Eucalyptus_proxima,93,1,92,Points-PointsKO-Adjacents,104
Eucalyptus_pruiniramis,14,10,4,Points-PointsKO-Adjacents,71
Eucalyptus_pruinosa,1647,1592,55,Alphahull-PointsKO-Adjacents,14479
Eucalyptus_psammitica,91,0,91,Points-PointsKO-Adjacents,135
Eucalyptus_pterocarpa,30,19,11,Points-PointsKO-Adjacents,100
Eucalyptus_pulchella,1035,1005,30,Alphahull-PointsKO-Adjacents,516
Eucalyptus_pulverulenta,129,111,18,Alphahull-PointsKO-Adjacents,450
Eucalyptus_pumila,19,0,19,Points-PointsKO-Adjacents,42
Eucalyptus_punctata,3582,0,3582,Points-PointsKO-Adjacents,1615
Eucalyptus_purpurata,4,4,0,Points-PointsKO-Adjacents,21
Eucalyptus_pyriformis,191,165,26,Alphahull-PointsKO-Adjacents,843
Eucalyptus_pyrocarpa,216,197,19,Alphahull-PointsKO-Adjacents,400
Eucalyptus_quadrangulata,460,402,58,Alphahull-PointsKO-Adjacents,1086
Eucalyptus_quadrans,160,0,160,Points-PointsKO-Adjacents,568
Eucalyptus_quadricostata,66,56,10,Alphahull-PointsKO-Adjacents,87
Eucalyptus_quaerenda,39,29,10,Alphahull-PointsKO-Adjacents,142
Eucalyptus_quinniorum,59,53,6,Alphahull-PointsKO-Adjacents,62
Eucalyptus_racemosa,2787,0,2787,Points-PointsKO-Adjacents,2443
Eucalyptus_radiata,4355,4220,135,Alphahull-PointsKO-Adjacents,4190
Eucalyptus_ralla,35,27,8,Alphahull-PointsKO-Adjacents,71
Eucalyptus_rameliana,55,48,7,Alphahull-PointsKO-Adjacents,139
Eucalyptus_raveretiana,185,156,29,Alphahull-PointsKO-Adjacents,594
Eucalyptus_ravida,234,0,234,Points-PointsKO-Adjacents,721
Eucalyptus_recta,18,0,18,Points-PointsKO-Adjacents,53
Eucalyptus_recurva,7,6,1,Points-PointsKO-Adjacents,25
Eucalyptus_redimiculifera,5,5,0,Points-PointsKO-Adjacents,12
Eucalyptus_reducta,195,173,22,Alphahull-PointsKO-Adjacents,535
Eucalyptus_redunca,108,92,16,Alphahull-PointsKO-Adjacents,660
Eucalyptus_regnans,2624,2590,34,Alphahull-PointsKO-Adjacents,1810
Eucalyptus_relicta,14,8,6,Points-PointsKO-Adjacents,68
Eucalyptus_remota,128,0,128,Points-PointsKO-Adjacents,61
Eucalyptus_repullulans,65,0,65,Points-PointsKO-Adjacents,267
Eucalyptus_resinifera,1845,1505,340,Alphahull-PointsKO-Adjacents,2217
Eucalyptus_retinens,138,128,10,Alphahull-PointsKO-Adjacents,645
Eucalyptus_retusa,1,1,0,Points-PointsKO-Adjacents,5
Eucalyptus_rhodantha,40,32,8,Alphahull-PointsKO-Adjacents,102
Eucalyptus_rhombica,40,25,15,Alphahull-PointsKO-Adjacents,384
Eucalyptus_rhomboidea,11,7,4,Points-PointsKO-Adjacents,47
Eucalyptus_rigens,48,0,48,Points-PointsKO-Adjacents,103
Eucalyptus_rigidula,379,359,20,Alphahull-PointsKO-Adjacents,5531
Eucalyptus_risdonii,106,0,106,Points-PointsKO-Adjacents,154
Eucalyptus_robertsonii,796,780,16,Alphahull-PointsKO-Adjacents,1404
Eucalyptus_robusta,1557,1,1556,Points-PointsKO-Adjacents,1044
Eucalyptus_rodwayi,621,0,621,Points-PointsKO-Adjacents,587
Eucalyptus_rosacea,45,36,9,Alphahull-PointsKO-Adjacents,858
Eucalyptus_roycei,68,0,68,Points-PointsKO-Adjacents,158
Eucalyptus_rubida,3960,0,3960,Points-PointsKO-Adjacents,2945
Eucalyptus_rubiginosa,65,0,65,Points-PointsKO-Adjacents,195
Eucalyptus_rudderi,33,24,9,Alphahull-PointsKO-Adjacents,83
Eucalyptus_rudis,553,0,553,Points-PointsKO-Adjacents,1360
Eucalyptus_rugosa,604,564,40,Alphahull-PointsKO-Adjacents,2142
Eucalyptus_rugulata,9,4,5,Points-PointsKO-Adjacents,33
Eucalyptus_rummeryi,94,85,9,Alphahull-PointsKO-Adjacents,131
Eucalyptus_rupestris,50,40,10,Alphahull-PointsKO-Adjacents,356
Eucalyptus_sabulosa,109,101,8,Alphahull-PointsKO-Adjacents,207
Eucalyptus_salicola,239,214,25,Alphahull-PointsKO-Adjacents,2424
Eucalyptus_saligna,2849,2468,381,Alphahull-PointsKO-Adjacents,2598
Eucalyptus_salmonophloia,460,437,23,Alphahull-PointsKO-Adjacents,3805
Eucalyptus_salubris,484,463,21,Alphahull-PointsKO-Adjacents,4508
Eucalyptus_sargentii,194,173,21,Alphahull-PointsKO-Adjacents,877
Eucalyptus_saxatilis,42,35,7,Alphahull-PointsKO-Adjacents,75
Eucalyptus_saxicola,7,3,4,Points-PointsKO-Adjacents,26
Eucalyptus_scias,469,0,469,Points-PointsKO-Adjacents,459
Eucalyptus_scoparia,63,0,63,Points-PointsKO-Adjacents,209
Eucalyptus_scopulorum,4,4,0,Points-PointsKO-Adjacents,33
Eucalyptus_scyphocalyx,240,227,13,Alphahull-PointsKO-Adjacents,1632
Eucalyptus_seeana,304,242,62,Alphahull-PointsKO-Adjacents,1000
Eucalyptus_selachiana,48,0,48,Points-PointsKO-Adjacents,151
Eucalyptus_semiglobosa,36,27,9,Alphahull-PointsKO-Adjacents,159
Eucalyptus_semota,16,0,16,Points-PointsKO-Adjacents,76
Eucalyptus_sepulcralis,48,40,8,Alphahull-PointsKO-Adjacents,81
Eucalyptus_serpentinicola,20,17,3,Points-PointsKO-Adjacents,36
Eucalyptus_serraensis,59,0,59,Points-PointsKO-Adjacents,95
Eucalyptus_sessilis,269,0,269,Points-PointsKO-Adjacents,590
Eucalyptus_sheathiana,368,351,17,Alphahull-PointsKO-Adjacents,2403
Eucalyptus_shirleyi,302,0,302,Points-PointsKO-Adjacents,987
Eucalyptus_sicilifolia,14,8,6,Points-PointsKO-Adjacents,26
Eucalyptus_siderophloia,2578,2399,179,Alphahull-PointsKO-Adjacents,3157
Eucalyptus_sideroxylon,1861,1720,141,Alphahull-PointsKO-Adjacents,9715
Eucalyptus_sieberi,5887,5719,168,Alphahull-PointsKO-Adjacents,2958
Eucalyptus_silvestris,43,37,6,Alphahull-PointsKO-Adjacents,106
Eucalyptus_similis,184,0,184,Points-PointsKO-Adjacents,621
Eucalyptus_singularis,35,31,4,Alphahull-PointsKO-Adjacents,109
Eucalyptus_sinuosa,10,6,4,Points-PointsKO-Adjacents,51
Eucalyptus_smithii,801,776,25,Alphahull-PointsKO-Adjacents,953
Eucalyptus_socialis,9144,9001,143,Alphahull-PointsKO-Adjacents,26978
Eucalyptus_sparsa,133,117,16,Alphahull-PointsKO-Adjacents,1100
Eucalyptus_sparsicoma,10,5,5,Points-PointsKO-Adjacents,33
Eucalyptus_spathulata,189,0,189,Points-PointsKO-Adjacents,656
Eucalyptus_spectatrix,38,30,8,Alphahull-PointsKO-Adjacents,112
Eucalyptus_sphaerocarpa,38,31,7,Alphahull-PointsKO-Adjacents,61
Eucalyptus_splendens,19,0,19,Points-PointsKO-Adjacents,56
Eucalyptus_sporadica,314,297,17,Alphahull-PointsKO-Adjacents,1282
Eucalyptus_spreta,120,112,8,Alphahull-PointsKO-Adjacents,469
Eucalyptus_squamosa,283,229,54,Alphahull-PointsKO-Adjacents,263
Eucalyptus_staeri,165,152,13,Alphahull-PointsKO-Adjacents,350
Eucalyptus_staigeriana,62,49,13,Alphahull-PointsKO-Adjacents,259
Eucalyptus_stannicola,NA,NA,NA,NA,NA
Eucalyptus_steedmanii,19,1,18,Points-PointsKO-Adjacents,80
Eucalyptus_stellulata,1475,1440,35,Alphahull-PointsKO-Adjacents,2816
Eucalyptus_stenostoma,85,81,4,Alphahull-PointsKO-Adjacents,51
Eucalyptus_stoatei,58,45,13,Alphahull-PointsKO-Adjacents,146
Eucalyptus_stowardii,113,111,2,Alphahull-PointsKO-Adjacents,526
Eucalyptus_striaticalyx,291,252,39,Alphahull-PointsKO-Adjacents,5604
Eucalyptus_stricklandii,111,87,24,Alphahull-PointsKO-Adjacents,547
Eucalyptus_stricta,584,545,39,Alphahull-PointsKO-Adjacents,1052
Eucalyptus_strzeleckii,398,344,54,Alphahull-PointsKO-Adjacents,155
Eucalyptus_sturgissiana,80,75,5,Alphahull-PointsKO-Adjacents,46
Eucalyptus_subangusta,529,508,21,Alphahull-PointsKO-Adjacents,2138
Eucalyptus_subcaerulea,10,4,6,Points-PointsKO-Adjacents,42
Eucalyptus_subcrenulata,306,289,17,Alphahull-PointsKO-Adjacents,548
Eucalyptus_sublucida,41,23,18,Alphahull-PointsKO-Adjacents,849
Eucalyptus_subtilior,284,273,11,Alphahull-PointsKO-Adjacents,424
Eucalyptus_subtilis,54,46,8,Alphahull-PointsKO-Adjacents,160
Eucalyptus_suffulgens,176,163,13,Alphahull-PointsKO-Adjacents,1078
Eucalyptus_suggrandis,414,0,414,Points-PointsKO-Adjacents,816
Eucalyptus_surgens,7,2,5,Points-PointsKO-Adjacents,23
Eucalyptus_sweedmaniana,5,5,0,Points-PointsKO-Adjacents,39
Eucalyptus_synandra,34,25,9,Alphahull-PointsKO-Adjacents,295
Eucalyptus_talyuberlup,83,74,9,Alphahull-PointsKO-Adjacents,133
Eucalyptus_tardecidens,129,113,16,Alphahull-PointsKO-Adjacents,541
Eucalyptus_taurina,30,24,6,Alphahull-PointsKO-Adjacents,59
Eucalyptus_tectifica,2248,0,2248,Points-PointsKO-Adjacents,3694
Eucalyptus_tenella,134,122,12,Alphahull-PointsKO-Adjacents,381
Eucalyptus_tenera,176,165,11,Alphahull-PointsKO-Adjacents,1905
Eucalyptus_tenuipes,261,238,23,Alphahull-PointsKO-Adjacents,1396
Eucalyptus_tenuiramis,932,901,31,Alphahull-PointsKO-Adjacents,578
Eucalyptus_tenuis,71,64,7,Alphahull-PointsKO-Adjacents,458
Eucalyptus_tephroclada,105,94,11,Alphahull-PointsKO-Adjacents,531
Eucalyptus_tephrodes,113,100,13,Alphahull-PointsKO-Adjacents,432
Eucalyptus_terebra,81,71,10,Alphahull-PointsKO-Adjacents,342
Eucalyptus_tereticornis,5839,5334,505,Alphahull-PointsKO-Adjacents,11963
Eucalyptus_terrica,95,87,8,Alphahull-PointsKO-Adjacents,193
Eucalyptus_tetrapleura,161,1,160,Points-PointsKO-Adjacents,108
Eucalyptus_tetraptera,172,0,172,Points-PointsKO-Adjacents,521
Eucalyptus_tetrodonta,917,883,34,Alphahull-PointsKO-Adjacents,7196
Eucalyptus_thamnoides,205,192,13,Alphahull-PointsKO-Adjacents,800
Eucalyptus_tholiformis,107,92,15,Alphahull-PointsKO-Adjacents,1305
Eucalyptus_thozetiana,390,360,30,Alphahull-PointsKO-Adjacents,6667
Eucalyptus_tindaliae,599,531,68,Alphahull-PointsKO-Adjacents,1718
Eucalyptus_tintinnans,577,561,16,Alphahull-PointsKO-Adjacents,1831
Eucalyptus_todtiana,265,220,45,Alphahull-PointsKO-Adjacents,389
Eucalyptus_torquata,166,131,35,Alphahull-PointsKO-Adjacents,1708
Eucalyptus_tortilis,54,46,8,Alphahull-PointsKO-Adjacents,262
Eucalyptus_trachybasis,122,99,23,Alphahull-PointsKO-Adjacents,1171
Eucalyptus_transcontinentalis,350,328,22,Alphahull-PointsKO-Adjacents,3873
Eucalyptus_tricarpa,1332,1293,39,Alphahull-PointsKO-Adjacents,1766
Eucalyptus_triflora,83,75,8,Alphahull-PointsKO-Adjacents,77
Eucalyptus_trivalvis,416,380,36,Alphahull-PointsKO-Adjacents,11063
Eucalyptus_tumida,169,157,12,Alphahull-PointsKO-Adjacents,454
Eucalyptus_umbra,1128,0,1128,Points-PointsKO-Adjacents,1175
Eucalyptus_umbrawarrensis,151,139,12,Alphahull-PointsKO-Adjacents,985
Eucalyptus_uncinata,568,538,30,Alphahull-PointsKO-Adjacents,1814
Eucalyptus_urna,259,240,19,Alphahull-PointsKO-Adjacents,1680
Eucalyptus_urnigera,154,141,13,Alphahull-PointsKO-Adjacents,302
Eucalyptus_urophylla,29,18,11,Points-PointsKO-Adjacents,105
Eucalyptus_utilis,76,47,29,Alphahull-PointsKO-Adjacents,458
Eucalyptus_uvida,21,12,9,Points-PointsKO-Adjacents,105
Eucalyptus_valens,99,93,6,Alphahull-PointsKO-Adjacents,305
Eucalyptus_varia,102,85,17,Alphahull-PointsKO-Adjacents,229
Eucalyptus_vegrandis,233,218,15,Alphahull-PointsKO-Adjacents,1099
Eucalyptus_verrucata,35,27,8,Alphahull-PointsKO-Adjacents,77
Eucalyptus_vesiculosa,13,0,13,Points-PointsKO-Adjacents,42
Eucalyptus_vicina,209,0,209,Points-PointsKO-Adjacents,801
Eucalyptus_victoriana,18,0,18,Points-PointsKO-Adjacents,45
Eucalyptus_victrix,767,709,58,Alphahull-PointsKO-Adjacents,18972
Eucalyptus_viminalis,5698,5502,196,Alphahull-PointsKO-Adjacents,7418
Eucalyptus_virens,43,30,13,Alphahull-PointsKO-Adjacents,456
Eucalyptus_virginea,9,5,4,Points-PointsKO-Adjacents,23
Eucalyptus_viridis,1053,1001,52,Alphahull-PointsKO-Adjacents,10893
Eucalyptus_vittata,129,114,15,Alphahull-PointsKO-Adjacents,1090
Eucalyptus_vokesensis,41,32,9,Alphahull-PointsKO-Adjacents,158
Eucalyptus_volcanica,69,62,7,Alphahull-PointsKO-Adjacents,283
Eucalyptus_wandoo,470,440,30,Alphahull-PointsKO-Adjacents,1848
Eucalyptus_websteriana,102,83,19,Alphahull-PointsKO-Adjacents,1220
Eucalyptus_wetarensis,8,0,8,Points-PointsKO-Adjacents,33
Eucalyptus_whitei,205,185,20,Alphahull-PointsKO-Adjacents,1889
Eucalyptus_wilcoxii,22,15,7,Points-PointsKO-Adjacents,70
Eucalyptus_williamsiana,135,116,19,Alphahull-PointsKO-Adjacents,322
Eucalyptus_willisii,298,277,21,Alphahull-PointsKO-Adjacents,1266
Eucalyptus_woodwardii,38,25,13,Alphahull-PointsKO-Adjacents,147
Eucalyptus_woollsiana,536,507,29,Alphahull-PointsKO-Adjacents,3805
Eucalyptus_wubinensis,80,65,15,Alphahull-PointsKO-Adjacents,486
Eucalyptus_wyolensis,10,0,10,Points-PointsKO-Adjacents,46
Eucalyptus_xanthoclada,105,94,11,Alphahull-PointsKO-Adjacents,1094
Eucalyptus_xanthonema,149,0,149,Points-PointsKO-Adjacents,385
Eucalyptus_xerothermica,139,122,17,Alphahull-PointsKO-Adjacents,2026
Eucalyptus_yalatensis,692,652,40,Alphahull-PointsKO-Adjacents,2239
Eucalyptus_yarraensis,636,572,64,Alphahull-PointsKO-Adjacents,858
Eucalyptus_yilgarnensis,409,396,13,Alphahull-PointsKO-Adjacents,2936
Eucalyptus_youmanii,378,0,378,Points-PointsKO-Adjacents,611
Eucalyptus_youngiana,333,293,40,Alphahull-PointsKO-Adjacents,8071
Eucalyptus_yumbarrana,308,292,16,Alphahull-PointsKO-Adjacents,1523
Eucalyptus_zopherophloia,35,25,10,Alphahull-PointsKO-Adjacents,162
Euceraea_nitida,165,123,42,Alphahull-PointsKO-Adjacents,8494
Euceraea_sleumeriana,2,2,0,Points-PointsKO-Adjacents,12
Euchorium_cubense,0,0,0,NA,0
Euclea_balfourii,8,3,5,Points-PointsKO-Adjacents,23
Euclea_coriacea,24,11,13,Points-PointsKO-Adjacents,211
Euclea_crispa,315,265,50,Alphahull-PointsKO-Adjacents,12182
Euclea_divinorum,228,153,75,Alphahull-PointsKO-Adjacents,9469
Euclea_laurina,8,4,4,Points-PointsKO-Adjacents,23
Euclea_natalensis,295,206,89,Alphahull-PointsKO-Adjacents,9148
Euclea_neghellensis,NA,NA,NA,NA,NA
Euclea_pseudebenus,54,32,22,Alphahull-PointsKO-Adjacents,1271
Euclea_racemosa,316,208,108,Alphahull-PointsKO-Adjacents,13463
Euclea_tomentosa,39,31,8,Alphahull-PointsKO-Adjacents,538
Euclea_undulata,250,191,59,Alphahull-PointsKO-Adjacents,13264
Euclinia_longiflora,204,142,62,Alphahull-PointsKO-Adjacents,6845
Euclinia_squamifera,8,1,7,Points-PointsKO-Adjacents,66
Eucommia_ulmoides,55,30,25,Alphahull-PointsKO-Adjacents,7548
Eucryphia_cordifolia,44,31,13,Alphahull-PointsKO-Adjacents,1059
Eucryphia_glutinosa,76,36,40,Alphahull-PointsKO-Adjacents,1268
Eucryphia_jinksii,8,6,2,Points-PointsKO-Adjacents,15
Eucryphia_lucida,1314,1290,24,Alphahull-PointsKO-Adjacents,990
Eucryphia_milliganii,224,216,8,Alphahull-PointsKO-Adjacents,285
Eucryphia_moorei,284,268,16,Alphahull-PointsKO-Adjacents,322
Eucryphia_wilkiei,5,1,4,Points-PointsKO-Adjacents,12
Eugeissona_insignis,0,0,0,NA,0
Eugeissona_utilis,2,2,0,Points-PointsKO-Adjacents,18
Eugenia_abbreviata,0,0,0,NA,0
Eugenia_aboukirensis,0,0,0,NA,0
Eugenia_acapulcensis,635,487,148,Alphahull-PointsKO-Adjacents,9821
Eugenia_aceitillo,0,0,0,NA,0
Eugenia_acrensis,13,4,9,Points-PointsKO-Adjacents,104
Eugenia_acrisepala,1,1,0,Points-PointsKO-Adjacents,9
Eugenia_acunae,0,0,0,NA,0
Eugenia_acutissima,0,0,0,NA,0
Eugenia_adenantha,37,17,20,Points-PointsKO-Adjacents,272
Eugenia_adenocarpa,2,2,0,Points-PointsKO-Adjacents,18
Eugenia_aerosa,5,1,4,Points-PointsKO-Adjacents,27
Eugenia_aeruginea,150,120,30,Alphahull-PointsKO-Adjacents,1870
Eugenia_agathopoda,6,1,5,Points-PointsKO-Adjacents,50
Eugenia_aherniana,1,1,0,Points-PointsKO-Adjacents,9
Eugenia_alainii,0,0,0,NA,0
Eugenia_alaotrensis,15,11,4,Points-PointsKO-Adjacents,21
Eugenia_albicans,22,11,11,Points-PointsKO-Adjacents,128
Eugenia_albimarginata,0,0,0,NA,0
Eugenia_alnifolia,3,3,0,Points-PointsKO-Adjacents,18
Eugenia_aloysii,NA,NA,NA,NA,NA
Eugenia_alpina,3,2,1,Points-PointsKO-Adjacents,23
Eugenia_amatenangensis,26,18,8,Points-PointsKO-Adjacents,115
Eugenia_ambanizanensis,2,2,0,Points-PointsKO-Adjacents,11
Eugenia_amblyosepala,7,0,7,Points-PointsKO-Adjacents,63
Eugenia_amoena,1,1,0,Points-PointsKO-Adjacents,9
Eugenia_amplifolia,0,0,0,NA,0
Eugenia_amshoffiae,1,1,0,Points-PointsKO-Adjacents,9
Eugenia_analamerensis,7,4,3,Points-PointsKO-Adjacents,33
Eugenia_anastomosans,95,44,51,Alphahull-PointsKO-Adjacents,3086
Eugenia_ancorifera,1,1,0,Points-PointsKO-Adjacents,9
Eugenia_angelyana,0,0,0,NA,0
Eugenia_angustissima,123,83,40,Alphahull-PointsKO-Adjacents,3603
Eugenia_antongilensis,3,3,0,Points-PointsKO-Adjacents,24
Eugenia_arawakorum,9,4,5,Points-PointsKO-Adjacents,54
Eugenia_arayan,0,0,0,NA,0
Eugenia_ardisioides,2,1,1,Points-PointsKO-Adjacents,18
Eugenia_ardyceae,4,4,0,Points-PointsKO-Adjacents,8
Eugenia_arenaria,21,0,21,Points-PointsKO-Adjacents,128
Eugenia_arenicola,5,3,2,Points-PointsKO-Adjacents,18
Eugenia_argentea,0,0,0,NA,0
Eugenia_argyrophylla,5,4,1,Points-PointsKO-Adjacents,39
Eugenia_armeniaca,6,1,5,Points-PointsKO-Adjacents,39
Eugenia_arrabidae,0,0,0,NA,0
Eugenia_arthroopoda,15,7,8,Points-PointsKO-Adjacents,57
Eugenia_arvensis,1,0,1,Points-PointsKO-Adjacents,9
Eugenia_astringens,169,101,68,Alphahull-PointsKO-Adjacents,3995
Eugenia_atroracemosa,5,5,0,Points-PointsKO-Adjacents,45
Eugenia_atrosquamata,4,4,0,Points-PointsKO-Adjacents,36
Eugenia_augustana,4,4,0,Points-PointsKO-Adjacents,23
Eugenia_aurata,242,192,50,Alphahull-PointsKO-Adjacents,17134
Eugenia_austin-smithii,95,70,25,Alphahull-PointsKO-Adjacents,254
Eugenia_axillaris,271,193,78,Alphahull-PointsKO-Adjacents,7382
Eugenia_azeda,11,4,7,Points-PointsKO-Adjacents,39
Eugenia_azurensis,17,4,13,Points-PointsKO-Adjacents,138
Eugenia_bacopari,22,6,16,Points-PointsKO-Adjacents,187
Eugenia_badia,4,3,1,Points-PointsKO-Adjacents,29
Eugenia_bahiana,1,1,0,Points-PointsKO-Adjacents,9
Eugenia_bahiensis,54,28,26,Alphahull-PointsKO-Adjacents,539
Eugenia_baileyi,12,2,10,Points-PointsKO-Adjacents,75
Eugenia_bajaverapazana,2,2,0,Points-PointsKO-Adjacents,18
Eugenia_balancanensis,4,4,0,Points-PointsKO-Adjacents,18
Eugenia_balansae,2,2,0,Points-PointsKO-Adjacents,16
Eugenia_barbosae,NA,NA,NA,NA,NA
Eugenia_basilaris,39,29,10,Alphahull-PointsKO-Adjacents,218
Eugenia_batingabranca,14,7,7,Points-PointsKO-Adjacents,92
Eugenia_bayatensis,0,0,0,NA,0
Eugenia_belemitana,2,1,1,Points-PointsKO-Adjacents,18
Eugenia_belladerensis,0,0,0,NA,0
Eugenia_belloi,8,4,4,Points-PointsKO-Adjacents,30
Eugenia_biflora,569,371,198,Alphahull-PointsKO-Adjacents,40138
Eugenia_bimarginata,258,212,46,Alphahull-PointsKO-Adjacents,16848
Eugenia_blanchetiana,10,2,8,Points-PointsKO-Adjacents,90
Eugenia_bocainensis,8,1,7,Points-PointsKO-Adjacents,69
Eugenia_bojeri,0,0,0,NA,0
Eugenia_boliviana,18,12,6,Points-PointsKO-Adjacents,99
Eugenia_boqueronensis,0,0,0,NA,0
Eugenia_bosseri,5,5,0,Points-PointsKO-Adjacents,18
Eugenia_botequimensis,4,4,0,Points-PointsKO-Adjacents,26
Eugenia_brachysepala,2,2,0,Points-PointsKO-Adjacents,18
Eugenia_brasiliana,0,0,0,NA,0
Eugenia_brasiliensis,173,124,49,Alphahull-PointsKO-Adjacents,6673
Eugenia_breedlovei,10,0,10,Points-PointsKO-Adjacents,39
Eugenia_brejoensis,51,31,20,Alphahull-PointsKO-Adjacents,542
Eugenia_breviracemosa,1,1,0,Points-PointsKO-Adjacents,9
Eugenia_brevistyla,96,66,30,Alphahull-PointsKO-Adjacents,3607
Eugenia_brongniartiana,53,40,13,Alphahull-PointsKO-Adjacents,174
Eugenia_brownei,0,0,0,NA,0
Eugenia_brownsbergii,5,0,5,Points-PointsKO-Adjacents,36
Eugenia_brunneopubescens,2,2,0,Points-PointsKO-Adjacents,18
Eugenia_bryanii,1,1,0,Points-PointsKO-Adjacents,6
Eugenia_bukobensis,29,18,11,Points-PointsKO-Adjacents,213
Eugenia_bullata,11,5,6,Points-PointsKO-Adjacents,61
Eugenia_bumelioides,15,5,10,Points-PointsKO-Adjacents,103
Eugenia_bunchosiifolia,13,1,12,Points-PointsKO-Adjacents,102
Eugenia_burkartiana,96,73,23,Alphahull-PointsKO-Adjacents,3339
Eugenia_buxifolia,1,1,0,Points-PointsKO-Adjacents,8
Eugenia_cachoeirensis,27,8,19,Points-PointsKO-Adjacents,211
Eugenia_cacuminum,12,10,2,Points-PointsKO-Adjacents,27
Eugenia_caducibracteata,7,0,7,Points-PointsKO-Adjacents,57
Eugenia_cajalbanica,0,0,0,NA,0
Eugenia_callichroma,1,1,0,Points-PointsKO-Adjacents,9
Eugenia_calva,6,0,6,Points-PointsKO-Adjacents,45
Eugenia_canapuensis,0,0,0,NA,0
Eugenia_candolleana,235,164,71,Alphahull-PointsKO-Adjacents,5832
Eugenia_cantuana,2,2,0,Points-PointsKO-Adjacents,18
Eugenia_capensis,271,171,100,Alphahull-PointsKO-Adjacents,11549
Eugenia_capitulifera,7,0,7,Points-PointsKO-Adjacents,55
Eugenia_capixaba,0,0,0,NA,0
Eugenia_capparidifolia,29,16,13,Points-PointsKO-Adjacents,169
Eugenia_capuli,848,753,95,Alphahull-PointsKO-Adjacents,8769
Eugenia_capulioides,33,0,33,Points-PointsKO-Adjacents,205
Eugenia_cararensis,NA,NA,NA,NA,NA
Eugenia_cartagensis,63,48,15,Alphahull-PointsKO-Adjacents,144
Eugenia_casearioides,8,2,6,Points-PointsKO-Adjacents,60
Eugenia_cassinoides,2,2,0,Points-PointsKO-Adjacents,16
Eugenia_catharinae,13,0,13,Points-PointsKO-Adjacents,81
Eugenia_catharinensis,28,0,28,Points-PointsKO-Adjacents,150
Eugenia_catingiflora,4,4,0,Points-PointsKO-Adjacents,21
Eugenia_cavalcanteana,1,1,0,Points-PointsKO-Adjacents,9
Eugenia_cayoana,4,4,0,Points-PointsKO-Adjacents,30
Eugenia_cerasiflora,204,150,54,Alphahull-PointsKO-Adjacents,6481
Eugenia_cereja,21,0,21,Points-PointsKO-Adjacents,160
Eugenia_cerrocacaoensis,4,4,0,Points-PointsKO-Adjacents,18
Eugenia_cervina,4,4,0,Points-PointsKO-Adjacents,32
Eugenia_chahalana,12,7,5,Points-PointsKO-Adjacents,58
Eugenia_chartacea,6,1,5,Points-PointsKO-Adjacents,51
Eugenia_chavarriae,9,7,2,Points-PointsKO-Adjacents,39
Eugenia_chepensis,32,16,16,Points-PointsKO-Adjacents,204
Eugenia_chiapensis,5,5,0,Points-PointsKO-Adjacents,23
Eugenia_chinajensis,9,3,6,Points-PointsKO-Adjacents,44
Eugenia_chiquitensis,25,7,18,Points-PointsKO-Adjacents,198
Eugenia_chlorocarpa,3,3,0,Points-PointsKO-Adjacents,27
Eugenia_chlorophylla,18,0,18,Points-PointsKO-Adjacents,127
Eugenia_choapamensis,28,13,15,Points-PointsKO-Adjacents,165
Eugenia_christii,0,0,0,NA,0
Eugenia_chrootricha,3,3,0,Points-PointsKO-Adjacents,25
Eugenia_chrysobalanoides,1,0,1,Points-PointsKO-Adjacents,9
Eugenia_churutensis,1,1,0,Points-PointsKO-Adjacents,9
Eugenia_cincta,1,1,0,Points-PointsKO-Adjacents,9
Eugenia_cinerascens,7,2,5,Points-PointsKO-Adjacents,48
Eugenia_citrifolia,37,11,26,Points-PointsKO-Adjacents,263
Eugenia_citroides,14,11,3,Points-PointsKO-Adjacents,64
Eugenia_clarensis,3,3,0,Points-PointsKO-Adjacents,27
Eugenia_cloiselii,12,6,6,Points-PointsKO-Adjacents,48
Eugenia_coaetanea,NA,NA,NA,NA,NA
Eugenia_coccifera,0,0,0,NA,0
Eugenia_cocosensis,1,1,0,Points-PointsKO-Adjacents,9
Eugenia_codyensis,0,0,0,NA,0
Eugenia_coffeifolia,104,61,43,Alphahull-PointsKO-Adjacents,3175
Eugenia_coibensis,11,7,4,Points-PointsKO-Adjacents,34
Eugenia_colipensis,16,7,9,Points-PointsKO-Adjacents,56
Eugenia_columbiensis,0,0,0,NA,0
Eugenia_commutata,NA,NA,NA,NA,NA
Eugenia_complicata,87,59,28,Alphahull-PointsKO-Adjacents,1584
Eugenia_concolor,0,0,0,NA,0
Eugenia_conduplicata,8,0,8,Points-PointsKO-Adjacents,61
Eugenia_confusa,46,19,27,Points-PointsKO-Adjacents,186
Eugenia_conjuncta,7,3,4,Points-PointsKO-Adjacents,57
Eugenia_consolatae,NA,NA,NA,NA,NA
Eugenia_convexinervia,20,0,20,Points-PointsKO-Adjacents,156
Eugenia_copacabanensis,44,0,44,Points-PointsKO-Adjacents,221
Eugenia_corcovadensis,3,2,1,Points-PointsKO-Adjacents,25
Eugenia_cordata,24,19,5,Points-PointsKO-Adjacents,80
Eugenia_coronata,28,11,17,Points-PointsKO-Adjacents,180
Eugenia_corrientina,6,1,5,Points-PointsKO-Adjacents,54
Eugenia_corusca,16,13,3,Points-PointsKO-Adjacents,66
Eugenia_costaricensis,160,137,23,Alphahull-PointsKO-Adjacents,713
Eugenia_cotinifolia,0,0,0,NA,0
Eugenia_cowanii,4,0,4,Points-PointsKO-Adjacents,27
Eugenia_coyolensis,3,3,0,Points-PointsKO-Adjacents,27
Eugenia_crassa,3,3,0,Points-PointsKO-Adjacents,12
Eugenia_crassicaulis,0,0,0,NA,0
Eugenia_crassipetala,0,0,0,NA,0
Eugenia_crenata,0,0,0,NA,0
Eugenia_crenularis,44,34,10,Alphahull-PointsKO-Adjacents,465
Eugenia_crenulata,2,2,0,Points-PointsKO-Adjacents,18
Eugenia_cribrata,21,9,12,Points-PointsKO-Adjacents,178
Eugenia_cricamolensis,10,6,4,Points-PointsKO-Adjacents,44
Eugenia_cristalensis,2,2,0,Points-PointsKO-Adjacents,17
Eugenia_crucigera,0,0,0,NA,0
Eugenia_cuaoensis,1,1,0,Points-PointsKO-Adjacents,9
Eugenia_cucullata,10,5,5,Points-PointsKO-Adjacents,75
Eugenia_calycina,38,19,19,Points-PointsKO-Adjacents,260
Eugenia_culminicola,29,19,10,Points-PointsKO-Adjacents,109
Eugenia_cuprea,64,0,64,Points-PointsKO-Adjacents,441
Eugenia_cupulata,56,17,39,Points-PointsKO-Adjacents,468
Eugenia_cupuligera,2,2,0,Points-PointsKO-Adjacents,17
Eugenia_curvivenia,4,3,1,Points-PointsKO-Adjacents,36
Eugenia_cuspidifolia,25,13,12,Points-PointsKO-Adjacents,179
Eugenia_cyclophylla,36,10,26,Points-PointsKO-Adjacents,221
Eugenia_cydoniifolia,5,5,0,Points-PointsKO-Adjacents,45
Eugenia_cymatodes,10,4,6,Points-PointsKO-Adjacents,90
Eugenia_daaouiensis,3,3,0,Points-PointsKO-Adjacents,26
Eugenia_daenikeri,0,0,0,NA,0
Eugenia_darcyi,9,4,5,Points-PointsKO-Adjacents,36
Eugenia_decussata,10,0,10,Points-PointsKO-Adjacents,78
Eugenia_denigrata,2,2,0,Points-PointsKO-Adjacents,18
Eugenia_dentata,4,3,1,Points-PointsKO-Adjacents,36
Eugenia_dewevrei,7,2,5,Points-PointsKO-Adjacents,54
Eugenia_dibrachiata,9,1,8,Points-PointsKO-Adjacents,75
Eugenia_dichroma,26,10,16,Points-PointsKO-Adjacents,156
Eugenia_dictyophleba,27,11,16,Points-PointsKO-Adjacents,210
Eugenia_dictyophylla,4,4,0,Points-PointsKO-Adjacents,36
Eugenia_diminutiflora,0,0,0,NA,0
Eugenia_dimorpha,9,2,7,Points-PointsKO-Adjacents,59
Eugenia_dinklagei,NA,NA,NA,NA,NA
Eugenia_diplocampta,21,5,16,Points-PointsKO-Adjacents,154
Eugenia_discifera,NA,NA,NA,NA,NA
Eugenia_discolorans,2,2,0,Points-PointsKO-Adjacents,18
Eugenia_discors,0,0,0,NA,0
Eugenia_discreta,33,0,33,Points-PointsKO-Adjacents,266
Eugenia_disperma,4,4,0,Points-PointsKO-Adjacents,30
Eugenia_disticha,7,2,5,Points-PointsKO-Adjacents,42
Eugenia_dittocrepis,41,3,38,Points-PointsKO-Adjacents,346
Eugenia_dodoana,NA,NA,NA,NA,NA
Eugenia_dodonaeifolia,143,116,27,Alphahull-PointsKO-Adjacents,3028
Eugenia_domingensis,29,15,14,Points-PointsKO-Adjacents,185
Eugenia_doubledayi,8,4,4,Points-PointsKO-Adjacents,56
Eugenia_duarteana,25,4,21,Points-PointsKO-Adjacents,184
Eugenia_duchassaingiana,0,0,0,NA,0
Eugenia_dulcis,NA,NA,NA,NA,NA
Eugenia_dumosa,0,0,0,NA,0
Eugenia_dysenterica,309,254,55,Alphahull-PointsKO-Adjacents,23249
Eugenia_earhartii,0,0,0,NA,0
Eugenia_earthiana,7,3,4,Points-PointsKO-Adjacents,40
Eugenia_egensis,491,364,127,Alphahull-PointsKO-Adjacents,47978
Eugenia_eggersii,22,14,8,Points-PointsKO-Adjacents,60
Eugenia_eliasii,3,3,0,Points-PointsKO-Adjacents,26
Eugenia_elliotii,7,0,7,Points-PointsKO-Adjacents,48
Eugenia_ellipsoidea,15,4,11,Points-PointsKO-Adjacents,114
Eugenia_elliptica,0,0,0,NA,0
Eugenia_elongata,3,2,1,Points-PointsKO-Adjacents,26
Eugenia_emarginata,2,2,0,Points-PointsKO-Adjacents,18
Eugenia_ependytes,9,2,7,Points-PointsKO-Adjacents,78
Eugenia_eperforata,2,2,0,Points-PointsKO-Adjacents,17
Eugenia_ericoides,9,3,6,Points-PointsKO-Adjacents,55
Eugenia_erythrocarpa,2,2,0,Points-PointsKO-Adjacents,18
Eugenia_erythrophylla,11,3,8,Points-PointsKO-Adjacents,76
Eugenia_essequiboensis,1,1,0,Points-PointsKO-Adjacents,9
Eugenia_esteliensis,23,18,5,Points-PointsKO-Adjacents,65
Eugenia_eurycheila,21,16,5,Points-PointsKO-Adjacents,118
Eugenia_exaltata,8,3,5,Points-PointsKO-Adjacents,72
Eugenia_excelsa,178,114,64,Alphahull-PointsKO-Adjacents,4557
Eugenia_excisa,1,1,0,Points-PointsKO-Adjacents,8
Eugenia_excoriata,13,4,9,Points-PointsKO-Adjacents,73
Eugenia_expansa,4,0,4,Points-PointsKO-Adjacents,30
Eugenia_farameoides,21,11,10,Points-PointsKO-Adjacents,136
Eugenia_farinacea,8,3,5,Points-PointsKO-Adjacents,33
Eugenia_fernandopoana,4,2,2,Points-PointsKO-Adjacents,29
Eugenia_ferreiraeana,39,14,25,Points-PointsKO-Adjacents,262
Eugenia_flavescens,254,147,107,Alphahull-PointsKO-Adjacents,37728
Eugenia_flavoviridis,24,14,10,Points-PointsKO-Adjacents,161
Eugenia_fleuryi,NA,NA,NA,NA,NA
Eugenia_floccosa,0,0,0,NA,0
Eugenia_florida,1222,1073,149,Alphahull-PointsKO-Adjacents,72614
Eugenia_fluminensis,2,2,0,Points-PointsKO-Adjacents,18
Eugenia_foetida,186,137,49,Alphahull-PointsKO-Adjacents,2164
Eugenia_francavilleana,130,89,41,Alphahull-PointsKO-Adjacents,13229
Eugenia_froesii,2,2,0,Points-PointsKO-Adjacents,14
Eugenia_fulva,0,0,0,NA,0
Eugenia_funkiana,NA,NA,NA,NA,NA
Eugenia_fusca,68,39,29,Alphahull-PointsKO-Adjacents,1421
Eugenia_fuscopunctata,1,1,0,Points-PointsKO-Adjacents,9
Eugenia_gacognei,17,8,9,Points-PointsKO-Adjacents,109
Eugenia_galalonensis,159,109,50,Alphahull-PointsKO-Adjacents,3413
Eugenia_galbaoensis,2,2,0,Points-PointsKO-Adjacents,12
Eugenia_galeata,2,2,0,Points-PointsKO-Adjacents,12
Eugenia_gatopensis,3,3,0,Points-PointsKO-Adjacents,26
Eugenia_gaudichaudiana,9,2,7,Points-PointsKO-Adjacents,73
Eugenia_gaumeri,105,90,15,Alphahull-PointsKO-Adjacents,1386
Eugenia_gemmiflora,47,28,19,Alphahull-PointsKO-Adjacents,2815
Eugenia_gibberosa,3,3,0,Points-PointsKO-Adjacents,27
Eugenia_gigas,4,4,0,Points-PointsKO-Adjacents,26
Eugenia_gilgii,20,13,7,Points-PointsKO-Adjacents,105
Eugenia_glabra,0,0,0,NA,0
Eugenia_glabrata,10,2,8,Points-PointsKO-Adjacents,75
Eugenia_glandulosa,10,1,9,Points-PointsKO-Adjacents,75
Eugenia_glandulosopunctata,28,19,9,Points-PointsKO-Adjacents,136
Eugenia_goiapabana,6,1,5,Points-PointsKO-Adjacents,33
Eugenia_gomesiana,100,71,29,Alphahull-PointsKO-Adjacents,8309
Eugenia_gomezii,25,23,2,Alphahull-PointsKO-Adjacents,39
Eugenia_gongylocarpa,11,2,9,Points-PointsKO-Adjacents,90
Eugenia_goviala,24,15,9,Points-PointsKO-Adjacents,60
Eugenia_gracillima,58,22,36,Alphahull-PointsKO-Adjacents,524
Eugenia_grandiflora,6,0,6,Points-PointsKO-Adjacents,50
Eugenia_grandifolia,2,2,0,Points-PointsKO-Adjacents,18
Eugenia_grayumii,8,2,6,Points-PointsKO-Adjacents,41
Eugenia_grazielae,1,1,0,Points-PointsKO-Adjacents,9
Eugenia_greggii,2,2,0,Points-PointsKO-Adjacents,12
Eugenia_grijalvae,6,0,6,Points-PointsKO-Adjacents,30
Eugenia_griseiflora,9,3,6,Points-PointsKO-Adjacents,47
Eugenia_grisiana,0,0,0,NA,0
Eugenia_gryposperma,0,0,0,NA,0
Eugenia_guajavoides,6,0,6,Points-PointsKO-Adjacents,14
Eugenia_guatemalensis,44,28,16,Alphahull-PointsKO-Adjacents,733
Eugenia_guayaquilensis,2,2,0,Points-PointsKO-Adjacents,18
Eugenia_guillotii,8,2,6,Points-PointsKO-Adjacents,51
Eugenia_gyrosepala,1,1,0,Points-PointsKO-Adjacents,9
Eugenia_haberi,6,1,5,Points-PointsKO-Adjacents,18
Eugenia_haematocarpa,1,0,1,Points-PointsKO-Adjacents,9
Eugenia_hammelii,13,6,7,Points-PointsKO-Adjacents,57
Eugenia_handroana,55,26,29,Alphahull-PointsKO-Adjacents,1912
Eugenia_handroi,41,0,41,Points-PointsKO-Adjacents,309
Eugenia_hanoverensis,0,0,0,NA,0
Eugenia_haputalense,NA,NA,NA,NA,NA
Eugenia_harrisii,2,1,1,Points-PointsKO-Adjacents,18
Eugenia_hartmanniae,0,0,0,NA,0
Eugenia_hartshornii,15,8,7,Points-PointsKO-Adjacents,88
Eugenia_hastilis,1,1,0,Points-PointsKO-Adjacents,9
Eugenia_hazompasika,9,3,6,Points-PointsKO-Adjacents,63
Eugenia_herbacea,6,0,6,Points-PointsKO-Adjacents,39
Eugenia_hermesiana,3,3,0,Points-PointsKO-Adjacents,16
Eugenia_herrerae,4,0,4,Points-PointsKO-Adjacents,32
Eugenia_heterochroa,0,0,0,NA,0
Eugenia_heterochroma,27,0,27,Points-PointsKO-Adjacents,217
Eugenia_hexovulata,2,2,0,Points-PointsKO-Adjacents,18
Eugenia_hiemalis,528,442,86,Alphahull-PointsKO-Adjacents,18312
Eugenia_hiraeifolia,121,91,30,Alphahull-PointsKO-Adjacents,629
Eugenia_hirta,118,72,46,Alphahull-PointsKO-Adjacents,1480
Eugenia_hodgei,0,0,0,NA,0
Eugenia_holdridgei,0,0,0,NA,0
Eugenia_hondurensis,79,70,9,Alphahull-PointsKO-Adjacents,350
Eugenia_horizontalis,17,7,10,Points-PointsKO-Adjacents,84
Eugenia_howardiana,3,3,0,Points-PointsKO-Adjacents,12
Eugenia_humblotii,0,0,0,NA,0
Eugenia_hurlimannii,11,6,5,Points-PointsKO-Adjacents,36
Eugenia_hypargyrea,54,35,19,Alphahull-PointsKO-Adjacents,153
Eugenia_ibarrae,13,9,4,Points-PointsKO-Adjacents,79
Eugenia_ignambiensis,2,2,0,Points-PointsKO-Adjacents,14
Eugenia_ilalensis,0,0,0,NA,0
Eugenia_illepida,5,4,1,Points-PointsKO-Adjacents,36
Eugenia_imaruiensis,1,1,0,Points-PointsKO-Adjacents,9
Eugenia_imbricata,1,1,0,Points-PointsKO-Adjacents,9
Eugenia_imbricatocordata,4,4,0,Points-PointsKO-Adjacents,21
Eugenia_impressa,0,0,0,NA,0
Eugenia_impunctata,0,0,0,NA,0
Eugenia_inaequisepala,0,0,0,NA,0
Eugenia_incanescens,9,3,6,Points-PointsKO-Adjacents,63
Eugenia_inconspicua,3,2,1,Points-PointsKO-Adjacents,18
Eugenia_indica,1,0,1,Points-PointsKO-Adjacents,9
Eugenia_inirebensis,14,10,4,Points-PointsKO-Adjacents,45
Eugenia_intibucana,6,1,5,Points-PointsKO-Adjacents,52
Eugenia_inundata,49,18,31,Points-PointsKO-Adjacents,413
Eugenia_inversa,3,3,0,Points-PointsKO-Adjacents,17
Eugenia_involucrata,510,424,86,Alphahull-PointsKO-Adjacents,21102
Eugenia_irazuensis,NA,NA,NA,NA,NA
Eugenia_irirensis,0,0,0,NA,0
Eugenia_isabeliana,10,7,3,Points-PointsKO-Adjacents,62
Eugenia_ischnosceles,6,0,6,Points-PointsKO-Adjacents,34
Eugenia_isosticta,0,0,0,NA,0
Eugenia_itacarensis,15,10,5,Points-PointsKO-Adjacents,63
Eugenia_itaguahiensis,1,1,0,Points-PointsKO-Adjacents,9
Eugenia_itahypensis,1,1,0,Points-PointsKO-Adjacents,9
Eugenia_itajurensis,8,3,5,Points-PointsKO-Adjacents,62
Eugenia_itapemirimensis,71,0,71,Points-PointsKO-Adjacents,334
Eugenia_izabalana,7,3,4,Points-PointsKO-Adjacents,23
Eugenia_jambosoides,0,0,0,NA,0
Eugenia_janeirensis,4,4,0,Points-PointsKO-Adjacents,34
Eugenia_jimenezii,0,0,0,NA,0
Eugenia_joenssonii,4,0,4,Points-PointsKO-Adjacents,30
Eugenia_jutiapensis,7,2,5,Points-PointsKO-Adjacents,46
Eugenia_kaalensis,7,1,6,Points-PointsKO-Adjacents,32
Eugenia_kaieteurensis,18,9,9,Points-PointsKO-Adjacents,126
Eugenia_kalbreyeri,6,0,6,Points-PointsKO-Adjacents,32
Eugenia_kamelii,0,0,0,NA,0
Eugenia_kanakana,3,2,1,Points-PointsKO-Adjacents,18
Eugenia_karwinskyana,122,89,33,Alphahull-PointsKO-Adjacents,2863
Eugenia_kellyana,0,0,0,NA,0
Eugenia_klaineana,36,23,13,Alphahull-PointsKO-Adjacents,465
Eugenia_kleinii,70,48,22,Alphahull-PointsKO-Adjacents,1079
Eugenia_klotzschiana,43,19,24,Points-PointsKO-Adjacents,287
Eugenia_koepperi,48,41,7,Alphahull-PointsKO-Adjacents,336
Eugenia_koolauensis,3,3,0,Points-PointsKO-Adjacents,15
Eugenia_krapovickasiana,0,0,0,NA,0
Eugenia_krukoffiana,0,0,0,NA,0
Eugenia_kuebuniensis,2,2,0,Points-PointsKO-Adjacents,14
Eugenia_laeteviridis,1,1,0,Points-PointsKO-Adjacents,8
Eugenia_laevis,56,40,16,Alphahull-PointsKO-Adjacents,822
Eugenia_lagoensis,15,7,8,Points-PointsKO-Adjacents,75
Eugenia_lambertiana,298,178,120,Alphahull-PointsKO-Adjacents,37526
Eugenia_lamprophylla,0,0,0,NA,0
Eugenia_lancetillae,3,3,0,Points-PointsKO-Adjacents,27
Eugenia_langsdorffii,39,0,39,Points-PointsKO-Adjacents,171
Eugenia_laruotteana,12,4,8,Points-PointsKO-Adjacents,70
Eugenia_latifolia,25,12,13,Points-PointsKO-Adjacents,184
Eugenia_laurae,0,0,0,NA,0
Eugenia_laxa,9,2,7,Points-PointsKO-Adjacents,72
Eugenia_ledermannii,1,1,0,Points-PointsKO-Adjacents,9
Eugenia_ledophylla,4,0,4,Points-PointsKO-Adjacents,30
Eugenia_legrandii,0,0,0,NA,0
Eugenia_lempana,2,2,0,Points-PointsKO-Adjacents,18
Eugenia_leonanii,1,1,0,Points-PointsKO-Adjacents,9
Eugenia_leonensis,40,26,14,Alphahull-PointsKO-Adjacents,2145
Eugenia_lepidota,18,13,5,Points-PointsKO-Adjacents,42
Eugenia_leptoclada,67,0,67,Points-PointsKO-Adjacents,532
Eugenia_letreroana,8,4,4,Points-PointsKO-Adjacents,50
Eugenia_leucadendron,2,1,1,Points-PointsKO-Adjacents,15
Eugenia_lheritieriana,0,0,0,NA,0
Eugenia_lhotzkyana,0,0,0,NA,0
Eugenia_liberiana,4,4,0,Points-PointsKO-Adjacents,20
Eugenia_librevillensis,1,0,1,Points-PointsKO-Adjacents,9
Eugenia_liebmannii,26,0,26,Points-PointsKO-Adjacents,168
Eugenia_liesneri,12,8,4,Points-PointsKO-Adjacents,45
Eugenia_ligustrina,466,353,113,Alphahull-PointsKO-Adjacents,16565
Eugenia_ligustroides,0,0,0,NA,0
Eugenia_limbosa,35,8,27,Points-PointsKO-Adjacents,247
Eugenia_lindahlii,6,4,2,Points-PointsKO-Adjacents,40
Eugenia_linearis,3,3,0,Points-PointsKO-Adjacents,27
Eugenia_lineata,2,2,0,Points-PointsKO-Adjacents,18
Eugenia_lineolata,0,0,0,NA,0
Eugenia_lithosperma,13,7,6,Points-PointsKO-Adjacents,61
Eugenia_littoralis,19,10,9,Points-PointsKO-Adjacents,91
Eugenia_livida,10,5,5,Points-PointsKO-Adjacents,70
Eugenia_locuples,8,3,5,Points-PointsKO-Adjacents,63
Eugenia_loheri,0,0,0,NA,0
Eugenia_lokobensis,1,1,0,Points-PointsKO-Adjacents,9
Eugenia_lokohensis,11,6,5,Points-PointsKO-Adjacents,73
Eugenia_longibracteata,5,5,0,Points-PointsKO-Adjacents,33
Eugenia_longicuspis,3,3,0,Points-PointsKO-Adjacents,27
Eugenia_longifolia,7,1,6,Points-PointsKO-Adjacents,41
Eugenia_longipetiolata,4,3,1,Points-PointsKO-Adjacents,36
Eugenia_longiracemosa,12,0,12,Points-PointsKO-Adjacents,80
Eugenia_longuensis,NA,NA,NA,NA,NA
Eugenia_louisae,3,3,0,Points-PointsKO-Adjacents,21
Eugenia_louvelii,6,1,5,Points-PointsKO-Adjacents,46
Eugenia_lucens,0,0,0,NA,0
Eugenia_luciae,6,0,6,Points-PointsKO-Adjacents,41
Eugenia_lucida,0,0,0,NA,0
Eugenia_ludoviciana,NA,NA,NA,NA,NA
Eugenia_luschnathiana,33,11,22,Points-PointsKO-Adjacents,262
Eugenia_lutescens,6,1,5,Points-PointsKO-Adjacents,18
Eugenia_mabaeoides,3,3,0,Points-PointsKO-Adjacents,25
Eugenia_macahensis,9,1,8,Points-PointsKO-Adjacents,78
Eugenia_macedoi,1,1,0,Points-PointsKO-Adjacents,9
Eugenia_mackeeana,12,5,7,Points-PointsKO-Adjacents,51
Eugenia_macnabiana,0,0,0,NA,0
Eugenia_macradenia,0,0,0,NA,0
Eugenia_macrantha,14,5,9,Points-PointsKO-Adjacents,114
Eugenia_macrobracteolata,4,4,0,Points-PointsKO-Adjacents,36
Eugenia_macrocarpa,73,54,19,Alphahull-PointsKO-Adjacents,787
Eugenia_macrosperma,45,31,14,Alphahull-PointsKO-Adjacents,1912
Eugenia_madugodaense,0,0,0,NA,0
Eugenia_maestrensis,1,1,0,Points-PointsKO-Adjacents,9
Eugenia_magna,9,3,6,Points-PointsKO-Adjacents,58
Eugenia_magnibracteolata,5,0,5,Points-PointsKO-Adjacents,36
Eugenia_magnifica,53,31,22,Alphahull-PointsKO-Adjacents,775
Eugenia_magniflora,5,2,3,Points-PointsKO-Adjacents,30
Eugenia_magoana,3,3,0,Points-PointsKO-Adjacents,21
Eugenia_malacantha,15,4,11,Points-PointsKO-Adjacents,118
Eugenia_malpighioides,4,4,0,Points-PointsKO-Adjacents,30
Eugenia_mandevillensis,2,2,0,Points-PointsKO-Adjacents,18
Eugenia_mandioccensis,16,0,16,Points-PointsKO-Adjacents,69
Eugenia_mandonii,2,2,0,Points-PointsKO-Adjacents,18
Eugenia_manonae,7,3,4,Points-PointsKO-Adjacents,21
Eugenia_mansoi,93,53,40,Alphahull-PointsKO-Adjacents,4415
Eugenia_marambaiensis,1,1,0,Points-PointsKO-Adjacents,8
Eugenia_maranhaoensis,0,0,0,NA,0
Eugenia_maricaensis,0,0,0,NA,0
Eugenia_maritima,30,10,20,Points-PointsKO-Adjacents,208
Eugenia_marlierioides,7,0,7,Points-PointsKO-Adjacents,34
Eugenia_marowynensis,7,0,7,Points-PointsKO-Adjacents,63
Eugenia_marshiana,1,1,0,Points-PointsKO-Adjacents,9
Eugenia_matagalpensis,13,10,3,Points-PointsKO-Adjacents,39
Eugenia_matogrossensis,9,3,6,Points-PointsKO-Adjacents,75
Eugenia_mattosii,6,3,3,Points-PointsKO-Adjacents,30
Eugenia_matudae,1,1,0,Points-PointsKO-Adjacents,8
Eugenia_mcphersonii,6,0,6,Points-PointsKO-Adjacents,33
Eugenia_mcvaughii,6,2,4,Points-PointsKO-Adjacents,48
Eugenia_megaflora,25,7,18,Points-PointsKO-Adjacents,181
Eugenia_melanadenia,1,1,0,Points-PointsKO-Adjacents,9
Eugenia_melanogyna,40,15,25,Points-PointsKO-Adjacents,312
Eugenia_membranifolia,3,3,0,Points-PointsKO-Adjacents,27
Eugenia_memecylifolia,NA,NA,NA,NA,NA
Eugenia_meridensis,1,1,0,Points-PointsKO-Adjacents,9
Eugenia_mespiloides,3,3,0,Points-PointsKO-Adjacents,17
Eugenia_michoacanensis,7,3,4,Points-PointsKO-Adjacents,39
Eugenia_micranthoides,2,2,0,Points-PointsKO-Adjacents,18
Eugenia_micropora,0,0,0,NA,0
Eugenia_mimus,19,8,11,Points-PointsKO-Adjacents,163
Eugenia_minguetii,0,0,0,NA,0
Eugenia_minuscula,2,2,0,Points-PointsKO-Adjacents,18
Eugenia_modesta,90,50,40,Alphahull-PointsKO-Adjacents,816
Eugenia_moensis,5,5,0,Points-PointsKO-Adjacents,17
Eugenia_molinae,3,3,0,Points-PointsKO-Adjacents,27
Eugenia_mollicoma,2,1,1,Points-PointsKO-Adjacents,18
Eugenia_monosperma,44,22,22,Alphahull-PointsKO-Adjacents,815
Eugenia_montalbanica,0,0,0,NA,0
Eugenia_monteverdensis,20,12,8,Points-PointsKO-Adjacents,73
Eugenia_monticola,239,150,89,Alphahull-PointsKO-Adjacents,2044
Eugenia_mooniana,5,0,5,Points-PointsKO-Adjacents,43
Eugenia_moonioides,4,4,0,Points-PointsKO-Adjacents,27
Eugenia_morii,1,1,0,Points-PointsKO-Adjacents,9
Eugenia_moritziana,9,0,9,Points-PointsKO-Adjacents,64
Eugenia_moschata,24,0,24,Points-PointsKO-Adjacents,190
Eugenia_mosenii,48,26,22,Alphahull-PointsKO-Adjacents,480
Eugenia_mouensis,10,3,7,Points-PointsKO-Adjacents,73
Eugenia_mozomboensis,8,5,3,Points-PointsKO-Adjacents,27
Eugenia_mufindiensis,10,0,10,Points-PointsKO-Adjacents,35
Eugenia_multicostata,47,27,20,Alphahull-PointsKO-Adjacents,1171
Eugenia_multirimosa,54,0,54,Points-PointsKO-Adjacents,363
Eugenia_muscicola,1,1,0,Points-PointsKO-Adjacents,9
Eugenia_myrcianthes,352,303,49,Alphahull-PointsKO-Adjacents,18562
Eugenia_myrciariifolia,4,4,0,Points-PointsKO-Adjacents,36
Eugenia_myrobalana,4,3,1,Points-PointsKO-Adjacents,36
Eugenia_neibensis,0,0,0,NA,0
Eugenia_nematopoda,1,1,0,Points-PointsKO-Adjacents,8
Eugenia_neofasciculata,0,0,0,NA,0
Eugenia_neoformosa,31,15,16,Points-PointsKO-Adjacents,252
Eugenia_neoglomerata,53,1,52,Points-PointsKO-Adjacents,400
Eugenia_neolaurifolia,3,3,0,Points-PointsKO-Adjacents,23
Eugenia_neomyrtifolia,18,8,10,Points-PointsKO-Adjacents,125
Eugenia_neosilvestris,16,5,11,Points-PointsKO-Adjacents,125
Eugenia_neotristis,3,3,0,Points-PointsKO-Adjacents,18
Eugenia_neoverrucosa,115,0,115,Points-PointsKO-Adjacents,726
Eugenia_nervosa,0,0,0,NA,0
Eugenia_nesiotica,6,4,2,Points-PointsKO-Adjacents,28
Eugenia_nigerina,12,1,11,Points-PointsKO-Adjacents,77
Eugenia_nigrita,28,13,15,Points-PointsKO-Adjacents,117
Eugenia_nipensis,3,3,0,Points-PointsKO-Adjacents,22
Eugenia_nompa,8,0,8,Points-PointsKO-Adjacents,48
Eugenia_nosibensis,3,3,0,Points-PointsKO-Adjacents,11
Eugenia_noumeensis,9,2,7,Points-PointsKO-Adjacents,65
Eugenia_nutans,85,64,21,Alphahull-PointsKO-Adjacents,1699
Eugenia_oaxacana,0,0,0,NA,0
Eugenia_oblongata,74,43,31,Alphahull-PointsKO-Adjacents,941
Eugenia_ocanensis,0,0,0,NA,0
Eugenia_ochrophloea,12,1,11,Points-PointsKO-Adjacents,89
Eugenia_octopleura,15,9,6,Points-PointsKO-Adjacents,83
Eugenia_oerstediana,360,275,85,Alphahull-PointsKO-Adjacents,8549
Eugenia_oligandra,4,4,0,Points-PointsKO-Adjacents,35
Eugenia_omissa,72,30,42,Alphahull-PointsKO-Adjacents,1688
Eugenia_ophthalmantha,5,0,5,Points-PointsKO-Adjacents,36
Eugenia_orbiculata,9,4,5,Points-PointsKO-Adjacents,28
Eugenia_ouen-toroensis,0,0,0,NA,0
Eugenia_ovalis,0,0,0,NA,0
Eugenia_ovandensis,2,2,0,Points-PointsKO-Adjacents,18
Eugenia_pachnantha,10,3,7,Points-PointsKO-Adjacents,84
Eugenia_pachychlamys,9,2,7,Points-PointsKO-Adjacents,63
Eugenia_pachychremastra,0,0,0,NA,0
Eugenia_pachyclada,5,0,5,Points-PointsKO-Adjacents,44
Eugenia_pachystachya,6,1,5,Points-PointsKO-Adjacents,51
Eugenia_pacifica,5,5,0,Points-PointsKO-Adjacents,2
Eugenia_padronii,4,3,1,Points-PointsKO-Adjacents,30
Eugenia_pallidopunctata,1,1,0,Points-PointsKO-Adjacents,9
Eugenia_paloverdensis,3,3,0,Points-PointsKO-Adjacents,25
Eugenia_paludosa,14,5,9,Points-PointsKO-Adjacents,96
Eugenia_palumbis,0,0,0,NA,0
Eugenia_pantagensis,9,1,8,Points-PointsKO-Adjacents,75
Eugenia_papalensis,1,1,0,Points-PointsKO-Adjacents,9
Eugenia_paracatuana,120,86,34,Alphahull-PointsKO-Adjacents,6019
Eugenia_paranahybensis,17,3,14,Points-PointsKO-Adjacents,133
Eugenia_paranapiacabensis,0,0,0,NA,0
Eugenia_pardensis,4,4,0,Points-PointsKO-Adjacents,33
Eugenia_pasacaensis,0,0,0,NA,0
Eugenia_patens,110,72,38,Alphahull-PointsKO-Adjacents,8346
Eugenia_patrisii,261,168,93,Alphahull-PointsKO-Adjacents,33390
Eugenia_pauciflora,19,5,14,Points-PointsKO-Adjacents,146
Eugenia_percincta,3,3,0,Points-PointsKO-Adjacents,27
Eugenia_percivalii,14,7,7,Points-PointsKO-Adjacents,85
Eugenia_percrenata,4,4,0,Points-PointsKO-Adjacents,36
Eugenia_persicifolia,45,0,45,Points-PointsKO-Adjacents,375
Eugenia_peruibensis,0,0,0,NA,0
Eugenia_petrophila,0,0,0,NA,0
Eugenia_phillyraeoides,1,1,0,Points-PointsKO-Adjacents,9
Eugenia_pia,2,1,1,Points-PointsKO-Adjacents,18
Eugenia_picardiae,1,1,0,Points-PointsKO-Adjacents,9
Eugenia_piloesis,5,4,1,Points-PointsKO-Adjacents,26
Eugenia_piresiana,6,0,6,Points-PointsKO-Adjacents,50
Eugenia_piresii,8,0,8,Points-PointsKO-Adjacents,57
Eugenia_pisiformis,160,122,38,Alphahull-PointsKO-Adjacents,2016
Eugenia_pistaciifolia,62,46,16,Alphahull-PointsKO-Adjacents,705
Eugenia_pittieri,33,14,19,Points-PointsKO-Adjacents,182
Eugenia_platyphylla,43,24,19,Alphahull-PointsKO-Adjacents,558
Eugenia_platysema,26,0,26,Points-PointsKO-Adjacents,169
Eugenia_pleurocarpa,10,5,5,Points-PointsKO-Adjacents,68
Eugenia_plicata,7,1,6,Points-PointsKO-Adjacents,57
Eugenia_plicatocostata,12,4,8,Points-PointsKO-Adjacents,98
Eugenia_pluricymosa,14,2,12,Points-PointsKO-Adjacents,100
Eugenia_pluriflora,127,93,34,Alphahull-PointsKO-Adjacents,5646
Eugenia_pobeguinii,11,4,7,Points-PointsKO-Adjacents,50
Eugenia_pohliana,30,0,30,Points-PointsKO-Adjacents,181
Eugenia_poiteaui,2,2,0,Points-PointsKO-Adjacents,18
Eugenia_poliensis,0,0,0,NA,0
Eugenia_pollicina,1,0,1,Points-PointsKO-Adjacents,9
Eugenia_polyadena,5,0,5,Points-PointsKO-Adjacents,45
Eugenia_polypora,0,0,0,NA,0
Eugenia_polystachya,49,6,43,Points-PointsKO-Adjacents,430
Eugenia_praeterita,2,2,0,Points-PointsKO-Adjacents,12
Eugenia_prasina,230,180,50,Alphahull-PointsKO-Adjacents,11054
Eugenia_principium,28,10,18,Points-PointsKO-Adjacents,154
Eugenia_procera,53,29,24,Alphahull-PointsKO-Adjacents,462
Eugenia_producta,2,2,0,Points-PointsKO-Adjacents,18
Eugenia_prolixa,9,0,9,Points-PointsKO-Adjacents,42
Eugenia_pronyensis,3,2,1,Points-PointsKO-Adjacents,25
Eugenia_prostrata,0,0,0,NA,0
Eugenia_protenta,34,7,27,Points-PointsKO-Adjacents,245
Eugenia_pruinosa,31,12,19,Points-PointsKO-Adjacents,262
Eugenia_pruniformis,42,22,20,Alphahull-PointsKO-Adjacents,562
Eugenia_pseudomabaeoides,NA,NA,NA,NA,NA
Eugenia_pseudomalacantha,2,2,0,Points-PointsKO-Adjacents,18
Eugenia_pseudopsidium,157,79,78,Alphahull-PointsKO-Adjacents,8129
Eugenia_psidiiflora,127,1,126,Points-PointsKO-Adjacents,762
Eugenia_pterocarpa,NA,NA,NA,NA,NA
Eugenia_puberula,18,8,10,Points-PointsKO-Adjacents,140
Eugenia_pubescens,4,4,0,Points-PointsKO-Adjacents,36
Eugenia_pubicalyx,0,0,0,NA,0
Eugenia_pueblana,11,3,8,Points-PointsKO-Adjacents,59
Eugenia_pulcherrima,6,1,5,Points-PointsKO-Adjacents,47
Eugenia_punicifolia,2046,1850,196,Alphahull-PointsKO-Adjacents,89822
Eugenia_purpusii,6,0,6,Points-PointsKO-Adjacents,41
Eugenia_pusilla,1,1,0,Points-PointsKO-Adjacents,9
Eugenia_pustulescens,4,4,0,Points-PointsKO-Adjacents,34
Eugenia_pycnantha,7,1,6,Points-PointsKO-Adjacents,63
Eugenia_pyriflora,3,3,0,Points-PointsKO-Adjacents,27
Eugenia_pyriformis,485,416,69,Alphahull-PointsKO-Adjacents,14450
Eugenia_pyxidata,4,4,0,Points-PointsKO-Adjacents,18
Eugenia_quadrijuga,7,0,7,Points-PointsKO-Adjacents,59
Eugenia_quadriovulata,0,0,0,NA,0
Eugenia_quebradensis,1,1,0,Points-PointsKO-Adjacents,9
Eugenia_quercetorum,8,3,5,Points-PointsKO-Adjacents,58
Eugenia_racemiflora,2,2,0,Points-PointsKO-Adjacents,18
Eugenia_ramboi,80,52,28,Alphahull-PointsKO-Adjacents,3473
Eugenia_ramiflora,13,0,13,Points-PointsKO-Adjacents,117
Eugenia_ramonae,0,0,0,NA,0
Eugenia_randrianasoloi,2,2,0,Points-PointsKO-Adjacents,14
Eugenia_ravenii,11,7,4,Points-PointsKO-Adjacents,45
Eugenia_rigida,5,4,1,Points-PointsKO-Adjacents,45
Eugenia_reinwardtiana,280,206,74,Alphahull-PointsKO-Adjacents,2340
Eugenia_rekoi,14,3,11,Points-PointsKO-Adjacents,87
Eugenia_rendlei,0,0,0,NA,0
Eugenia_repanda,163,110,53,Alphahull-PointsKO-Adjacents,5512
Eugenia_retinadenia,3,3,0,Points-PointsKO-Adjacents,21
Eugenia_rheophytica,0,0,0,NA,0
Eugenia_rhombea,173,104,69,Alphahull-PointsKO-Adjacents,4104
Eugenia_riosiae,9,4,5,Points-PointsKO-Adjacents,54
Eugenia_rivulorum,3,3,0,Points-PointsKO-Adjacents,18
Eugenia_rizzoana,1,1,0,Points-PointsKO-Adjacents,9
Eugenia_rodriguesensis,2,2,0,Points-PointsKO-Adjacents,7
Eugenia_rosea,28,19,9,Points-PointsKO-Adjacents,134
Eugenia_roseiflora,68,40,28,Alphahull-PointsKO-Adjacents,1818
Eugenia_roseopetiolata,2,2,0,Points-PointsKO-Adjacents,11
Eugenia_rostrata,43,18,25,Points-PointsKO-Adjacents,293
Eugenia_rostratofalcata,0,0,0,NA,0
Eugenia_rostrifolia,27,15,12,Points-PointsKO-Adjacents,227
Eugenia_rottleriana,0,0,0,NA,0
Eugenia_rotundata,0,0,0,NA,0
Eugenia_rotundicosta,4,4,0,Points-PointsKO-Adjacents,36
Eugenia_roxburghii,3,2,1,Points-PointsKO-Adjacents,27
Eugenia_rubella,11,5,6,Points-PointsKO-Adjacents,87
Eugenia_rufidula,3,2,1,Points-PointsKO-Adjacents,24
Eugenia_rufofulva,2,2,0,Points-PointsKO-Adjacents,18
Eugenia_rugosissima,2,2,0,Points-PointsKO-Adjacents,12
Eugenia_urschiana,6,3,3,Points-PointsKO-Adjacents,20
Eugenia_ruscifolia,0,0,0,NA,0
Eugenia_sachetae,0,0,0,NA,0
Eugenia_salacioides,53,39,14,Alphahull-PointsKO-Adjacents,1140
Eugenia_salamensis,74,35,39,Alphahull-PointsKO-Adjacents,949
Eugenia_salomonica,1,1,0,Points-PointsKO-Adjacents,9
Eugenia_samanensis,1,1,0,Points-PointsKO-Adjacents,4
Eugenia_sancarlosensis,6,5,1,Points-PointsKO-Adjacents,30
Eugenia_sanjuanensis,9,4,5,Points-PointsKO-Adjacents,29
Eugenia_sarapiquensis,12,5,7,Points-PointsKO-Adjacents,68
Eugenia_sarasinii,3,3,0,Points-PointsKO-Adjacents,26
Eugenia_sargentii,1,1,0,Points-PointsKO-Adjacents,9
Eugenia_sasoana,4,4,0,Points-PointsKO-Adjacents,27
Eugenia_savannarum,33,22,11,Alphahull-PointsKO-Adjacents,326
Eugenia_scalariformis,9,1,8,Points-PointsKO-Adjacents,70
Eugenia_schatzii,3,3,0,Points-PointsKO-Adjacents,27
Eugenia_scheffleri,1,1,0,Points-PointsKO-Adjacents,9
Eugenia_schottiana,35,0,35,Points-PointsKO-Adjacents,226
Eugenia_schulziana,0,0,0,NA,0
Eugenia_schunkei,6,0,6,Points-PointsKO-Adjacents,48
Eugenia_sclerocalyx,8,2,6,Points-PointsKO-Adjacents,65
Eugenia_scottii,4,0,4,Points-PointsKO-Adjacents,26
Eugenia_seithurensis,NA,NA,NA,NA,NA
Eugenia_selloi,56,27,29,Alphahull-PointsKO-Adjacents,418
Eugenia_selvana,7,3,4,Points-PointsKO-Adjacents,15
Eugenia_sericifolia,4,4,0,Points-PointsKO-Adjacents,36
Eugenia_serrasuela,0,0,0,NA,0
Eugenia_sessiliflora,6,2,4,Points-PointsKO-Adjacents,27
Eugenia_sessilifolia,2,0,2,Points-PointsKO-Adjacents,18
Eugenia_shettyana,NA,NA,NA,NA,NA
Eugenia_shimishito,4,4,0,Points-PointsKO-Adjacents,30
Eugenia_shookii,6,1,5,Points-PointsKO-Adjacents,39
Eugenia_sieberi,4,3,1,Points-PointsKO-Adjacents,18
Eugenia_siggersii,80,64,16,Alphahull-PointsKO-Adjacents,516
Eugenia_sigillata,4,3,1,Points-PointsKO-Adjacents,34
Eugenia_sihanakensis,1,1,0,Points-PointsKO-Adjacents,9
Eugenia_siltepecana,36,25,11,Alphahull-PointsKO-Adjacents,182
Eugenia_sinaloae,4,3,1,Points-PointsKO-Adjacents,32
Eugenia_singampattiana,NA,NA,NA,NA,NA
Eugenia_sobralii,2,0,2,Points-PointsKO-Adjacents,18
Eugenia_solimoensis,1,1,0,Points-PointsKO-Adjacents,9
Eugenia_sonderiana,251,207,44,Alphahull-PointsKO-Adjacents,9922
Eugenia_sooiana,0,0,0,NA,0
Eugenia_sotoesparzae,5,2,3,Points-PointsKO-Adjacents,25
Eugenia_sparsa,57,36,21,Alphahull-PointsKO-Adjacents,3508
Eugenia_speciosa,145,98,47,Alphahull-PointsKO-Adjacents,5440
Eugenia_sphenoides,2,2,0,Points-PointsKO-Adjacents,18
Eugenia_splendens,76,0,76,Points-PointsKO-Adjacents,264
Eugenia_sprengelii,8,1,7,Points-PointsKO-Adjacents,70
Eugenia_spruceana,21,2,19,Points-PointsKO-Adjacents,144
Eugenia_squamiflora,5,1,4,Points-PointsKO-Adjacents,45
Eugenia_sripadaense,1,1,0,Points-PointsKO-Adjacents,9
Eugenia_stahlii,19,13,6,Points-PointsKO-Adjacents,61
Eugenia_standleyi,6,1,5,Points-PointsKO-Adjacents,36
Eugenia_staudtii,1,1,0,Points-PointsKO-Adjacents,9
Eugenia_stenosepala,3,3,0,Points-PointsKO-Adjacents,27
Eugenia_stenosepaloides,0,0,0,NA,0
Eugenia_stephanii,1,1,0,Points-PointsKO-Adjacents,9
Eugenia_stephanophylla,1,1,0,Points-PointsKO-Adjacents,9
Eugenia_stewardsonii,7,4,3,Points-PointsKO-Adjacents,44
Eugenia_stibephylla,0,0,0,NA,0
Eugenia_stictopetala,422,354,68,Alphahull-PointsKO-Adjacents,27649
Eugenia_stictophylla,1,1,0,Points-PointsKO-Adjacents,8
Eugenia_stigmatosa,54,28,26,Alphahull-PointsKO-Adjacents,765
Eugenia_stipitata,79,35,44,Alphahull-PointsKO-Adjacents,7210
Eugenia_strellensis,4,4,0,Points-PointsKO-Adjacents,30
Eugenia_stricta,36,21,15,Alphahull-PointsKO-Adjacents,112
Eugenia_strigipes,0,0,0,NA,0
Eugenia_sturrockii,0,0,0,NA,0
Eugenia_stylaris,7,2,5,Points-PointsKO-Adjacents,51
Eugenia_subamplexicaulis,2,1,1,Points-PointsKO-Adjacents,18
Eugenia_subavenia,59,38,21,Alphahull-PointsKO-Adjacents,707
Eugenia_suberosa,37,11,26,Points-PointsKO-Adjacents,286
Eugenia_subreticulata,12,0,12,Points-PointsKO-Adjacents,105
Eugenia_subspinulosa,0,0,0,NA,0
Eugenia_subterminalis,199,149,50,Alphahull-PointsKO-Adjacents,13525
Eugenia_subundulata,18,12,6,Points-PointsKO-Adjacents,133
Eugenia_sulcata,70,32,38,Alphahull-PointsKO-Adjacents,1837
Eugenia_sulcivenia,0,0,0,NA,0
Eugenia_sumbensis,6,0,6,Points-PointsKO-Adjacents,47
Eugenia_supraaxillaris,8,1,7,Points-PointsKO-Adjacents,62
Eugenia_symphoricarpos,16,7,9,Points-PointsKO-Adjacents,114
Eugenia_tachirensis,1,1,0,Points-PointsKO-Adjacents,9
Eugenia_tafelbergica,5,1,4,Points-PointsKO-Adjacents,36
Eugenia_tamaensis,2,2,0,Points-PointsKO-Adjacents,18
Eugenia_tapirorum,3,3,0,Points-PointsKO-Adjacents,27
Eugenia_teapensis,9,0,9,Points-PointsKO-Adjacents,55
Eugenia_tenuiflora,2,2,0,Points-PointsKO-Adjacents,15
Eugenia_tenuimarginata,6,1,5,Points-PointsKO-Adjacents,50
Eugenia_tenuipedunculata,6,0,6,Points-PointsKO-Adjacents,46
Eugenia_tepuiensis,2,2,0,Points-PointsKO-Adjacents,18
Eugenia_teresae,14,9,5,Points-PointsKO-Adjacents,59
Eugenia_ternatifolia,89,41,48,Alphahull-PointsKO-Adjacents,1836
Eugenia_terpnophylla,0,0,0,NA,0
Eugenia_tetramera,18,8,10,Points-PointsKO-Adjacents,123
Eugenia_tetrasticha,6,2,4,Points-PointsKO-Adjacents,54
Eugenia_theodorae,2,2,0,Points-PointsKO-Adjacents,18
Eugenia_thouvenotiana,7,3,4,Points-PointsKO-Adjacents,32
Eugenia_tikalana,77,64,13,Alphahull-PointsKO-Adjacents,1050
Eugenia_tilarana,9,6,3,Points-PointsKO-Adjacents,42
Eugenia_tinifolia,3,2,1,Points-PointsKO-Adjacents,22
Eugenia_toaensis,0,0,0,NA,0
Eugenia_toledinensis,9,4,5,Points-PointsKO-Adjacents,52
Eugenia_tonii,3,3,0,Points-PointsKO-Adjacents,18
Eugenia_toxanatolica,22,13,9,Points-PointsKO-Adjacents,104
Eugenia_trahyra,NA,NA,NA,NA,NA
Eugenia_triflora,1,1,0,Points-PointsKO-Adjacents,9
Eugenia_trikii,56,48,8,Alphahull-PointsKO-Adjacents,521
Eugenia_trinervia,2,1,1,Points-PointsKO-Adjacents,18
Eugenia_trinitatis,2,2,0,Points-PointsKO-Adjacents,9
Eugenia_tropophylla,7,4,3,Points-PointsKO-Adjacents,47
Eugenia_truncata,44,31,13,Alphahull-PointsKO-Adjacents,97
Eugenia_trunciflora,45,35,10,Alphahull-PointsKO-Adjacents,194
Eugenia_tulanan,0,0,0,NA,0
Eugenia_tumulescens,8,4,4,Points-PointsKO-Adjacents,63
Eugenia_tungo,2,2,0,Points-PointsKO-Adjacents,18
Eugenia_turneri,0,0,0,NA,0
Eugenia_ulei,1,1,0,Points-PointsKO-Adjacents,9
Eugenia_uliginosa,24,16,8,Points-PointsKO-Adjacents,103
Eugenia_umbonata,8,3,5,Points-PointsKO-Adjacents,36
Eugenia_umbrosa,37,21,16,Alphahull-PointsKO-Adjacents,427
Eugenia_uminganensis,NA,NA,NA,NA,NA
Eugenia_umtamvunensis,4,4,0,Points-PointsKO-Adjacents,32
Eugenia_underwoodii,1,0,1,Points-PointsKO-Adjacents,9
Eugenia_undulata,1,1,0,Points-PointsKO-Adjacents,9
Eugenia_uniflora,830,570,260,Alphahull-PointsKO-Adjacents,34580
Eugenia_uninervia,4,4,0,Points-PointsKO-Adjacents,21
Eugenia_ursina,1,1,0,Points-PointsKO-Adjacents,9
Eugenia_uruguayensis,119,86,33,Alphahull-PointsKO-Adjacents,9388
Eugenia_uxpanapensis,7,4,3,Points-PointsKO-Adjacents,15
Eugenia_valsuganana,3,3,0,Points-PointsKO-Adjacents,18
Eugenia_valvata,11,3,8,Points-PointsKO-Adjacents,71
Eugenia_vanderveldei,0,0,0,NA,0
Eugenia_variareolata,9,0,9,Points-PointsKO-Adjacents,81
Eugenia_vatomandrensis,0,0,0,NA,0
Eugenia_vaughanii,2,1,1,Points-PointsKO-Adjacents,14
Eugenia_venezuelensis,171,113,58,Alphahull-PointsKO-Adjacents,3468
Eugenia_verapazensis,8,3,5,Points-PointsKO-Adjacents,39
Eugenia_verdoorniae,6,2,4,Points-PointsKO-Adjacents,38
Eugenia_vernicosa,13,0,13,Points-PointsKO-Adjacents,117
Eugenia_verruculata,5,5,0,Points-PointsKO-Adjacents,18
Eugenia_versicolor,3,3,0,Points-PointsKO-Adjacents,27
Eugenia_verticillata,72,0,72,Points-PointsKO-Adjacents,533
Eugenia_vesca,14,7,7,Points-PointsKO-Adjacents,80
Eugenia_vetula,83,65,18,Alphahull-PointsKO-Adjacents,2369
Eugenia_victoriana,7,2,5,Points-PointsKO-Adjacents,51
Eugenia_viguieriana,5,5,0,Points-PointsKO-Adjacents,45
Eugenia_vilersii,0,0,0,NA,0
Eugenia_villae-novae,8,2,6,Points-PointsKO-Adjacents,54
Eugenia_violascens,NA,NA,NA,NA,NA
Eugenia_viridiflora,5,5,0,Points-PointsKO-Adjacents,36
Eugenia_viridis,0,0,0,NA,0
Eugenia_virotii,2,2,0,Points-PointsKO-Adjacents,12
Eugenia_wentii,66,0,66,Points-PointsKO-Adjacents,433
Eugenia_whytei,13,3,10,Points-PointsKO-Adjacents,78
Eugenia_widgrenii,20,11,9,Points-PointsKO-Adjacents,173
Eugenia_williamsiana,3,3,0,Points-PointsKO-Adjacents,9
Eugenia_winzerlingii,96,83,13,Alphahull-PointsKO-Adjacents,936
Eugenia_woodburyana,9,7,2,Points-PointsKO-Adjacents,28
Eugenia_woodii,0,0,0,NA,0
Eugenia_wullschlaegeliana,7,2,5,Points-PointsKO-Adjacents,61
Eugenia_xalapensis,111,86,25,Alphahull-PointsKO-Adjacents,1956
Eugenia_xanthoxyloides,12,7,5,Points-PointsKO-Adjacents,72
Eugenia_xilitlensis,12,7,5,Points-PointsKO-Adjacents,16
Eugenia_xiriricana,6,0,6,Points-PointsKO-Adjacents,36
Eugenia_yangambensis,2,2,0,Points-PointsKO-Adjacents,12
Eugenia_yasuniana,1,1,0,Points-PointsKO-Adjacents,9
Eugenia_yatuae,5,5,0,Points-PointsKO-Adjacents,45
Eugenia_yautepecana,8,3,5,Points-PointsKO-Adjacents,47
Eugenia_yunckeri,3,3,0,Points-PointsKO-Adjacents,27
Eugenia_zelayensis,7,3,4,Points-PointsKO-Adjacents,15
Eugenia_zuccarinii,19,0,19,Points-PointsKO-Adjacents,121
Eugenia_zuchowskiae,6,3,3,Points-PointsKO-Adjacents,26
Eugenia_zuluensis,6,2,4,Points-PointsKO-Adjacents,54
Eugenia_zygophylla,25,12,13,Points-PointsKO-Adjacents,103
Eulychnia_acida,7,3,4,Points-PointsKO-Adjacents,62
Eulychnia_breviflora,1,1,0,Points-PointsKO-Adjacents,8
Eulychnia_castanea,3,3,0,Points-PointsKO-Adjacents,24
Eulychnia_iquiquensis,6,0,6,Points-PointsKO-Adjacents,45
Euodia_fraxinifolia,35,0,35,Points-PointsKO-Adjacents,153
Euodia_robusta,0,0,0,NA,0
Euonymus_acanthocarpus,85,49,36,Alphahull-PointsKO-Adjacents,9286
Euonymus_acuminifolius,6,0,6,Points-PointsKO-Adjacents,54
Euonymus_angulatus,0,0,0,NA,0
Euonymus_atropurpureus,842,587,255,Alphahull-PointsKO-Adjacents,29207
Euonymus_attenuatus,1,1,0,Points-PointsKO-Adjacents,9
Euonymus_australianus,111,85,26,Alphahull-PointsKO-Adjacents,520
Euonymus_benthamii,39,21,18,Alphahull-PointsKO-Adjacents,879
Euonymus_bockii,14,2,12,Points-PointsKO-Adjacents,124
Euonymus_bullatus,3,3,0,Points-PointsKO-Adjacents,27
Euonymus_carnosus,148,100,48,Alphahull-PointsKO-Adjacents,2682
Euonymus_castaneifolius,25,14,11,Points-PointsKO-Adjacents,185
Euonymus_cochinchinensis,53,13,40,Points-PointsKO-Adjacents,325
Euonymus_congolensis,23,12,11,Points-PointsKO-Adjacents,153
Euonymus_costaricensis,108,96,12,Alphahull-PointsKO-Adjacents,538
Euonymus_crenulatus,0,0,0,NA,0
Euonymus_dichotomus,0,0,0,NA,0
Euonymus_dielsianus,79,48,31,Alphahull-PointsKO-Adjacents,4958
Euonymus_eberhardtii,1,1,0,Points-PointsKO-Adjacents,9
Euonymus_echinatus,126,80,46,Alphahull-PointsKO-Adjacents,9974
Euonymus_elaeodendroides,5,5,0,Points-PointsKO-Adjacents,36
Euonymus_europaeus,38752,32143,6609,Alphahull-PointsKO-Adjacents,66107
Euonymus_ficoides,1,1,0,Points-PointsKO-Adjacents,9
Euonymus_frigidus,90,2,88,Points-PointsKO-Adjacents,446
Euonymus_fusiformis,0,0,0,NA,0
Euonymus_gibber,6,0,6,Points-PointsKO-Adjacents,45
Euonymus_giraldii,42,1,41,Points-PointsKO-Adjacents,378
Euonymus_glaber,14,4,10,Points-PointsKO-Adjacents,111
Euonymus_glandulosus,5,5,0,Points-PointsKO-Adjacents,23
Euonymus_gracillimus,3,3,0,Points-PointsKO-Adjacents,27
Euonymus_grandiflorus,78,44,34,Alphahull-PointsKO-Adjacents,3179
Euonymus_hainanensis,3,3,0,Points-PointsKO-Adjacents,27
Euonymus_hamiltonianus,555,360,195,Alphahull-PointsKO-Adjacents,15773
Euonymus_huae,0,0,0,NA,0
Euonymus_huangii,0,0,0,NA,0
Euonymus_hukuangensis,3,3,0,Points-PointsKO-Adjacents,27
Euonymus_impressus,0,0,0,NA,0
Euonymus_indicus,63,12,51,Points-PointsKO-Adjacents,500
Euonymus_japonicus,131,24,107,Alphahull-PointsKO-Adjacents,420
Euonymus_kengmaensis,9,0,9,Points-PointsKO-Adjacents,81
Euonymus_latifolius,629,528,101,Alphahull-PointsKO-Adjacents,8666
Euonymus_laxiflorus,247,194,53,Alphahull-PointsKO-Adjacents,11993
Euonymus_lucidus,15,6,9,Points-PointsKO-Adjacents,109
Euonymus_lutchuensis,10,6,4,Points-PointsKO-Adjacents,21
Euonymus_maackii,60,19,41,Points-PointsKO-Adjacents,519
Euonymus_mexicanus,23,11,12,Points-PointsKO-Adjacents,109
Euonymus_microcarpus,20,6,14,Points-PointsKO-Adjacents,180
Euonymus_moluccensis,0,0,0,NA,0
Euonymus_myrianthus,120,98,22,Alphahull-PointsKO-Adjacents,14513
Euonymus_nanus,64,14,50,Points-PointsKO-Adjacents,410
Euonymus_nitidus,109,71,38,Alphahull-PointsKO-Adjacents,11231
Euonymus_occidentalis,228,177,51,Alphahull-PointsKO-Adjacents,1915
Euonymus_oxyphyllus,781,618,163,Alphahull-PointsKO-Adjacents,3904
Euonymus_pallidifolius,12,8,4,Points-PointsKO-Adjacents,32
Euonymus_parasimilis,0,0,0,NA,0
Euonymus_percoriaceus,2,2,0,Points-PointsKO-Adjacents,18
Euonymus_pittosporoides,4,4,0,Points-PointsKO-Adjacents,36
Euonymus_pleurostylioides,9,0,9,Points-PointsKO-Adjacents,58
Euonymus_potingensis,2,2,0,Points-PointsKO-Adjacents,18
Euonymus_rehderianus,16,5,11,Points-PointsKO-Adjacents,143
Euonymus_sanguineus,72,46,26,Alphahull-PointsKO-Adjacents,5299
Euonymus_serratifolius,NA,NA,NA,NA,NA
Euonymus_tibeticus,1,1,0,Points-PointsKO-Adjacents,9
Euonymus_tingens,33,10,23,Points-PointsKO-Adjacents,263
Euonymus_tsoi,5,5,0,Points-PointsKO-Adjacents,45
Euonymus_vagans,37,0,37,Points-PointsKO-Adjacents,305
Euonymus_velutinus,6,0,6,Points-PointsKO-Adjacents,42
Euonymus_venosus,17,5,12,Points-PointsKO-Adjacents,153
Euonymus_verrucocarpus,1,1,0,Points-PointsKO-Adjacents,9
Euonymus_verrucosus,361,1,360,Points-PointsKO-Adjacents,1084
Euonymus_viburnoides,20,9,11,Points-PointsKO-Adjacents,174
Euonymus_walkeri,0,0,0,NA,0
Euonymus_wrayi,2,2,0,Points-PointsKO-Adjacents,18
Euonymus_wui,2,2,0,Points-PointsKO-Adjacents,18
Euonymus_yunnanensis,17,9,8,Points-PointsKO-Adjacents,151
Eupatorium_urbanii,1,1,0,Points-PointsKO-Adjacents,9
Euphorbia_abdelkuri,0,0,0,NA,0
Euphorbia_abyssinica,15,6,9,Points-PointsKO-Adjacents,117
Euphorbia_adenopoda,23,8,15,Points-PointsKO-Adjacents,172
Euphorbia_adjurana,3,3,0,Points-PointsKO-Adjacents,27
Euphorbia_alcicornis,3,3,0,Points-PointsKO-Adjacents,27
Euphorbia_alluaudii,89,73,16,Alphahull-PointsKO-Adjacents,1804
Euphorbia_amicorum,0,0,0,NA,0
Euphorbia_ammak,1,1,0,Points-PointsKO-Adjacents,9
Euphorbia_ampliphylla,22,6,16,Points-PointsKO-Adjacents,192
Euphorbia_analalavensis,12,5,7,Points-PointsKO-Adjacents,73
Euphorbia_analamerae,2,2,0,Points-PointsKO-Adjacents,9
Euphorbia_ankaranae,14,6,8,Points-PointsKO-Adjacents,77
Euphorbia_antiquorum,17,0,17,Points-PointsKO-Adjacents,152
Euphorbia_antso,47,35,12,Alphahull-PointsKO-Adjacents,874
Euphorbia_appendiculata,3,3,0,Points-PointsKO-Adjacents,27
Euphorbia_apurimacensis,3,3,0,Points-PointsKO-Adjacents,27
Euphorbia_arahaka,10,0,10,Points-PointsKO-Adjacents,73
Euphorbia_arbuscula,5,5,0,Points-PointsKO-Adjacents,32
Euphorbia_articulata,30,11,19,Points-PointsKO-Adjacents,94
Euphorbia_atoto,7,2,5,Points-PointsKO-Adjacents,23
Euphorbia_atrocarmesina,0,0,0,NA,0
Euphorbia_atrococca,3,3,0,Points-PointsKO-Adjacents,9
Euphorbia_betulicortex,1,1,0,Points-PointsKO-Adjacents,9
Euphorbia_bicompacta,16,4,12,Points-PointsKO-Adjacents,127
Euphorbia_biselegans,10,5,5,Points-PointsKO-Adjacents,48
Euphorbia_bisglobosa,6,2,4,Points-PointsKO-Adjacents,39
Euphorbia_boinensis,3,3,0,Points-PointsKO-Adjacents,18
Euphorbia_boivinii,34,14,20,Points-PointsKO-Adjacents,218
Euphorbia_bongolavensis,0,0,0,NA,0
Euphorbia_bougheyi,0,0,0,NA,0
Euphorbia_brassii,9,0,9,Points-PointsKO-Adjacents,51
Euphorbia_breviarticulata,4,4,0,Points-PointsKO-Adjacents,36
Euphorbia_burgeri,0,0,0,NA,0
Euphorbia_bussei,48,35,13,Alphahull-PointsKO-Adjacents,1406
Euphorbia_buxoides,10,5,5,Points-PointsKO-Adjacents,64
Euphorbia_bwambensis,1,1,0,Points-PointsKO-Adjacents,9
Euphorbia_calyculata,57,41,16,Alphahull-PointsKO-Adjacents,730
Euphorbia_cameronii,0,0,0,NA,0
Euphorbia_canariensis,129,111,18,Alphahull-PointsKO-Adjacents,199
Euphorbia_candelabrum,27,5,22,Points-PointsKO-Adjacents,207
Euphorbia_capuronii,2,2,0,Points-PointsKO-Adjacents,18
Euphorbia_carinulata,1,1,0,Points-PointsKO-Adjacents,9
Euphorbia_cassythoides,3,3,0,Points-PointsKO-Adjacents,25
Euphorbia_cedrorum,NA,NA,NA,NA,NA
Euphorbia_celastroides,33,0,33,Points-PointsKO-Adjacents,142
Euphorbia_coalcomanensis,8,0,8,Points-PointsKO-Adjacents,45
Euphorbia_comosa,193,145,48,Alphahull-PointsKO-Adjacents,12817
Euphorbia_confinalis,8,3,5,Points-PointsKO-Adjacents,59
Euphorbia_conspicua,3,3,0,Points-PointsKO-Adjacents,27
Euphorbia_cooperi,62,34,28,Alphahull-PointsKO-Adjacents,1487
Euphorbia_cotinifolia,328,191,137,Alphahull-PointsKO-Adjacents,10030
Euphorbia_cuneata,77,44,33,Alphahull-PointsKO-Adjacents,1450
Euphorbia_cupularis,28,17,11,Points-PointsKO-Adjacents,246
Euphorbia_cussonioides,4,4,0,Points-PointsKO-Adjacents,30
Euphorbia_dawei,13,6,7,Points-PointsKO-Adjacents,98
Euphorbia_decliviticola,3,3,0,Points-PointsKO-Adjacents,26
Euphorbia_decorsei,12,5,7,Points-PointsKO-Adjacents,77
Euphorbia_defoliata,2,1,1,Points-PointsKO-Adjacents,18
Euphorbia_deightonii,6,0,6,Points-PointsKO-Adjacents,52
Euphorbia_dendroides,322,239,83,Alphahull-PointsKO-Adjacents,2663
Euphorbia_desmondii,8,2,6,Points-PointsKO-Adjacents,55
Euphorbia_dispersa,1,1,0,Points-PointsKO-Adjacents,9
Euphorbia_doloensis,1,1,0,Points-PointsKO-Adjacents,9
Euphorbia_drupifera,89,49,40,Alphahull-PointsKO-Adjacents,401
Euphorbia_dumalis,7,5,2,Points-PointsKO-Adjacents,43
Euphorbia_dumeticola,5,1,4,Points-PointsKO-Adjacents,30
Euphorbia_eduardoi,3,3,0,Points-PointsKO-Adjacents,27
Euphorbia_elastica,5,5,0,Points-PointsKO-Adjacents,36
Euphorbia_elliotii,10,7,3,Points-PointsKO-Adjacents,34
Euphorbia_enterophora,64,51,13,Alphahull-PointsKO-Adjacents,1104
Euphorbia_epiphylloides,0,0,0,NA,0
Euphorbia_erythroxyloides,5,5,0,Points-PointsKO-Adjacents,39
Euphorbia_espinosa,8,0,8,Points-PointsKO-Adjacents,72
Euphorbia_euonymoclada,10,1,9,Points-PointsKO-Adjacents,54
Euphorbia_excelsa,3,3,0,Points-PointsKO-Adjacents,27
Euphorbia_famatamboay,12,3,9,Points-PointsKO-Adjacents,81
Euphorbia_faucicola,1,1,0,Points-PointsKO-Adjacents,9
Euphorbia_fiherenensis,20,14,6,Points-PointsKO-Adjacents,100
Euphorbia_fissispina,0,0,0,NA,0
Euphorbia_fortissima,1,1,0,Points-PointsKO-Adjacents,9
Euphorbia_friesiorum,15,11,4,Points-PointsKO-Adjacents,103
Euphorbia_fuscolanata,1,1,0,Points-PointsKO-Adjacents,9
Euphorbia_giumboensis,0,0,0,NA,0
Euphorbia_gossypina,19,0,19,Points-PointsKO-Adjacents,145
Euphorbia_gracilicaulis,0,0,0,NA,0
Euphorbia_grandialata,2,2,0,Points-PointsKO-Adjacents,12
Euphorbia_grandidens,49,29,20,Alphahull-PointsKO-Adjacents,1171
Euphorbia_grandifolia,18,3,15,Points-PointsKO-Adjacents,130
Euphorbia_graniticola,3,3,0,Points-PointsKO-Adjacents,21
Euphorbia_grantii,27,13,14,Points-PointsKO-Adjacents,186
Euphorbia_griseola,15,4,11,Points-PointsKO-Adjacents,135
Euphorbia_guerichiana,68,40,28,Alphahull-PointsKO-Adjacents,1794
Euphorbia_gymnonota,2,2,0,Points-PointsKO-Adjacents,12
Euphorbia_haeleeleana,3,3,0,Points-PointsKO-Adjacents,14
Euphorbia_halipedicola,2,2,0,Points-PointsKO-Adjacents,18
Euphorbia_hararensis,0,0,0,NA,0
Euphorbia_helenae,23,14,9,Points-PointsKO-Adjacents,91
Euphorbia_herbstii,2,1,1,Points-PointsKO-Adjacents,13
Euphorbia_hiernii,0,0,0,NA,0
Euphorbia_hubertii,5,4,1,Points-PointsKO-Adjacents,33
Euphorbia_indistincta,4,4,0,Points-PointsKO-Adjacents,18
Euphorbia_ingens,56,35,21,Alphahull-PointsKO-Adjacents,2932
Euphorbia_intisy,21,15,6,Points-PointsKO-Adjacents,132
Euphorbia_jatrophoides,0,0,0,NA,0
Euphorbia_kamerunica,51,0,51,Points-PointsKO-Adjacents,139
Euphorbia_kamponii,0,0,0,NA,0
Euphorbia_kanalensis,10,3,7,Points-PointsKO-Adjacents,60
Euphorbia_keithii,1,1,0,Points-PointsKO-Adjacents,9
Euphorbia_kirkii,3,3,0,Points-PointsKO-Adjacents,27
Euphorbia_kuwaleana,1,1,0,Points-PointsKO-Adjacents,9
Euphorbia_lacei,4,4,0,Points-PointsKO-Adjacents,35
Euphorbia_lactea,0,0,0,NA,0
Euphorbia_laurifolia,107,65,42,Alphahull-PointsKO-Adjacents,1306
Euphorbia_leucocephala,97,62,35,Alphahull-PointsKO-Adjacents,1662
Euphorbia_lividiflora,17,4,13,Points-PointsKO-Adjacents,110
Euphorbia_magnicapsula,NA,NA,NA,NA,NA
Euphorbia_mainty,19,7,12,Points-PointsKO-Adjacents,124
Euphorbia_mananarensis,7,3,4,Points-PointsKO-Adjacents,44
Euphorbia_mandravioky,20,15,5,Points-PointsKO-Adjacents,68
Euphorbia_mangorensis,3,3,0,Points-PointsKO-Adjacents,26
Euphorbia_margalidiana,3,3,0,Points-PointsKO-Adjacents,17
Euphorbia_martinae,2,2,0,Points-PointsKO-Adjacents,18
Euphorbia_matabelensis,44,15,29,Points-PointsKO-Adjacents,352
Euphorbia_memoralis,1,1,0,Points-PointsKO-Adjacents,9
Euphorbia_meuleniana,8,6,2,Points-PointsKO-Adjacents,52
Euphorbia_milii,103,79,24,Alphahull-PointsKO-Adjacents,1863
Euphorbia_neoarborescens,5,2,3,Points-PointsKO-Adjacents,27
Euphorbia_neocymosa,0,0,0,NA,0
Euphorbia_neoglaucescens,20,12,8,Points-PointsKO-Adjacents,152
Euphorbia_neriifolia,1,1,0,Points-PointsKO-Adjacents,9
Euphorbia_nigrispinoides,3,3,0,Points-PointsKO-Adjacents,27
Euphorbia_nivulia,2,2,0,Points-PointsKO-Adjacents,18
Euphorbia_noxia,1,1,0,Points-PointsKO-Adjacents,9
Euphorbia_nyikae,66,49,17,Alphahull-PointsKO-Adjacents,682
Euphorbia_obcordata,2,2,0,Points-PointsKO-Adjacents,17
Euphorbia_officinarum,5,4,1,Points-PointsKO-Adjacents,40
Euphorbia_ogadenensis,1,1,0,Points-PointsKO-Adjacents,9
Euphorbia_olowaluana,10,7,3,Points-PointsKO-Adjacents,32
Euphorbia_pachysantha,11,3,8,Points-PointsKO-Adjacents,65
Euphorbia_parciramulosa,0,0,0,NA,0
Euphorbia_parviceps,1,1,0,Points-PointsKO-Adjacents,9
Euphorbia_pereskiifolia,28,15,13,Points-PointsKO-Adjacents,164
Euphorbia_persistentifolia,0,0,0,NA,0
Euphorbia_pervilleana,43,0,43,Points-PointsKO-Adjacents,241
Euphorbia_petiolaris,12,2,10,Points-PointsKO-Adjacents,64
Euphorbia_physoclada,18,8,10,Points-PointsKO-Adjacents,134
Euphorbia_piceoides,1,1,0,Points-PointsKO-Adjacents,9
Euphorbia_plagiantha,21,13,8,Points-PointsKO-Adjacents,128
Euphorbia_plumerioides,45,18,27,Points-PointsKO-Adjacents,197
Euphorbia_podocarpifolia,7,3,4,Points-PointsKO-Adjacents,30
Euphorbia_poissonii,19,1,18,Points-PointsKO-Adjacents,146
Euphorbia_pseudoburuana,7,3,4,Points-PointsKO-Adjacents,60
Euphorbia_pseudomollis,18,10,8,Points-PointsKO-Adjacents,121
Euphorbia_pseudonudicaulis,2,2,0,Points-PointsKO-Adjacents,18
Euphorbia_pseudovolkensii,2,2,0,Points-PointsKO-Adjacents,18
Euphorbia_pulcherrima,184,133,51,Alphahull-PointsKO-Adjacents,5811
Euphorbia_pyrifolia,11,3,8,Points-PointsKO-Adjacents,64
Euphorbia_qarad,0,0,0,NA,0
Euphorbia_quadrialata,10,4,6,Points-PointsKO-Adjacents,83
Euphorbia_quinquecostata,14,9,5,Points-PointsKO-Adjacents,92
Euphorbia_ramofraga,0,0,0,NA,0
Euphorbia_robecchii,1,1,0,Points-PointsKO-Adjacents,9
Euphorbia_rockii,4,3,1,Points-PointsKO-Adjacents,18
Euphorbia_royleana,7,0,7,Points-PointsKO-Adjacents,63
Euphorbia_sachetiana,2,2,0,Points-PointsKO-Adjacents,6
Euphorbia_santapaui,0,0,0,NA,0
Euphorbia_scheffleri,6,1,5,Points-PointsKO-Adjacents,52
Euphorbia_schlechtendalii,502,427,75,Alphahull-PointsKO-Adjacents,11181
Euphorbia_scutiformis,2,2,0,Points-PointsKO-Adjacents,17
Euphorbia_sekukuniensis,4,4,0,Points-PointsKO-Adjacents,36
Euphorbia_seretii,2,2,0,Points-PointsKO-Adjacents,18
Euphorbia_shebeliensis,NA,NA,NA,NA,NA
Euphorbia_sinclairiana,97,70,27,Alphahull-PointsKO-Adjacents,517
Euphorbia_smithii,8,3,5,Points-PointsKO-Adjacents,30
Euphorbia_socotrana,6,2,4,Points-PointsKO-Adjacents,23
Euphorbia_stenoclada,44,31,13,Alphahull-PointsKO-Adjacents,1114
Euphorbia_sudanica,25,7,18,Points-PointsKO-Adjacents,184
Euphorbia_sumati,2,2,0,Points-PointsKO-Adjacents,18
Euphorbia_susan-holmesiae,0,0,0,NA,0
Euphorbia_syncalycina,2,2,0,Points-PointsKO-Adjacents,18
Euphorbia_syncameronii,1,1,0,Points-PointsKO-Adjacents,9
Euphorbia_tanaensis,4,4,0,Points-PointsKO-Adjacents,12
Euphorbia_tanquahuete,87,74,13,Alphahull-PointsKO-Adjacents,2221
Euphorbia_teixeirae,0,0,0,NA,0
Euphorbia_teke,16,0,16,Points-PointsKO-Adjacents,96
Euphorbia_tessmannii,0,0,0,NA,0
Euphorbia_tetragona,8,1,7,Points-PointsKO-Adjacents,72
Euphorbia_tetraptera,165,136,29,Alphahull-PointsKO-Adjacents,2959
Euphorbia_thulinii,1,1,0,Points-PointsKO-Adjacents,9
Euphorbia_tirucalli,866,760,106,Alphahull-PointsKO-Adjacents,11634
Euphorbia_tithymaloides,351,211,140,Alphahull-PointsKO-Adjacents,9965
Euphorbia_tortilis,0,0,0,NA,0
Euphorbia_triangolensis,2,2,0,Points-PointsKO-Adjacents,18
Euphorbia_triangularis,42,26,16,Alphahull-PointsKO-Adjacents,1005
Euphorbia_trigona,0,0,0,NA,0
Euphorbia_umbellata,12,7,5,Points-PointsKO-Adjacents,106
Euphorbia_umbelliformis,1,1,0,Points-PointsKO-Adjacents,9
Euphorbia_uniglans,4,4,0,Points-PointsKO-Adjacents,9
Euphorbia_uzmuk,0,0,0,NA,0
Euphorbia_vajravelui,NA,NA,NA,NA,NA
Euphorbia_vallaris,1,1,0,Points-PointsKO-Adjacents,9
Euphorbia_venenifica,2,2,0,Points-PointsKO-Adjacents,18
Euphorbia_viduiflora,0,0,0,NA,0
Euphorbia_wakefieldii,9,7,2,Points-PointsKO-Adjacents,42
Euphorbia_xylophylloides,64,52,12,Alphahull-PointsKO-Adjacents,1098
Euphorbia_zakamenae,2,2,0,Points-PointsKO-Adjacents,12
Euphorbia_zoutpansbergensis,6,3,3,Points-PointsKO-Adjacents,39
Euphorianthus_euneurus,12,4,8,Points-PointsKO-Adjacents,94
Euphronia_acuminatissima,17,7,10,Points-PointsKO-Adjacents,134
Euphronia_guianensis,45,28,17,Alphahull-PointsKO-Adjacents,445
Euphronia_hirtelloides,131,101,30,Alphahull-PointsKO-Adjacents,4938
Euplassa_bahiensis,14,6,8,Points-PointsKO-Adjacents,90
Euplassa_cantareirae,42,27,15,Alphahull-PointsKO-Adjacents,588
Euplassa_chimantensis,4,4,0,Points-PointsKO-Adjacents,32
Euplassa_duquei,8,3,5,Points-PointsKO-Adjacents,59
Euplassa_glaziovii,9,3,6,Points-PointsKO-Adjacents,66
Euplassa_hoehnei,9,2,7,Points-PointsKO-Adjacents,67
Euplassa_inaequalis,311,253,58,Alphahull-PointsKO-Adjacents,16862
Euplassa_incana,26,16,10,Points-PointsKO-Adjacents,142
Euplassa_isernii,5,5,0,Points-PointsKO-Adjacents,45
Euplassa_itatiaiae,15,9,6,Points-PointsKO-Adjacents,81
Euplassa_legalis,136,103,33,Alphahull-PointsKO-Adjacents,5200
Euplassa_madeirae,8,0,8,Points-PointsKO-Adjacents,72
Euplassa_nebularis,42,0,42,Points-PointsKO-Adjacents,279
Euplassa_occidentalis,19,13,6,Points-PointsKO-Adjacents,116
Euplassa_organensis,24,13,11,Points-PointsKO-Adjacents,164
Euplassa_pinnata,1,1,0,Points-PointsKO-Adjacents,9
Euplassa_rufa,35,26,9,Alphahull-PointsKO-Adjacents,454
Euplassa_saxicola,22,11,11,Points-PointsKO-Adjacents,110
Euplassa_semicostata,11,0,11,Points-PointsKO-Adjacents,74
Euplassa_taubertiana,9,0,9,Points-PointsKO-Adjacents,74
Euploca_ocellata,3,2,1,Points-PointsKO-Adjacents,27
Eupomatia_barbata,60,45,15,Alphahull-PointsKO-Adjacents,176
Eupomatia_laurina,2411,2240,171,Alphahull-PointsKO-Adjacents,3200
Euptelea_pleiosperma,72,51,21,Alphahull-PointsKO-Adjacents,4193
Euptelea_polyandra,400,327,73,Alphahull-PointsKO-Adjacents,2038
Euroschinus_aoupiniensis,8,2,6,Points-PointsKO-Adjacents,27
Euroschinus_elegans,16,8,8,Points-PointsKO-Adjacents,73
Euroschinus_falcatus,1086,1004,82,Alphahull-PointsKO-Adjacents,4619
Euroschinus_jaffrei,21,11,10,Points-PointsKO-Adjacents,96
Euroschinus_obtusifolius,34,22,12,Alphahull-PointsKO-Adjacents,183
Euroschinus_papuanus,49,26,23,Alphahull-PointsKO-Adjacents,355
Euroschinus_rubromarginatus,37,27,10,Alphahull-PointsKO-Adjacents,82
Euroschinus_verrucosus,17,11,6,Points-PointsKO-Adjacents,80
Euroschinus_vieillardii,24,14,10,Points-PointsKO-Adjacents,103
Eurya_acromonodontus,1,1,0,Points-PointsKO-Adjacents,9
Eurya_acuminata,68,11,57,Points-PointsKO-Adjacents,523
Eurya_acuminatissima,27,18,9,Points-PointsKO-Adjacents,243
Eurya_acuminoides,NA,NA,NA,NA,NA
Eurya_acutisepala,0,0,0,NA,0
Eurya_alata,36,14,22,Points-PointsKO-Adjacents,303
Eurya_albiflora,9,1,8,Points-PointsKO-Adjacents,62
Eurya_amplexicaulis,2,2,0,Points-PointsKO-Adjacents,16
Eurya_amplexifolia,5,5,0,Points-PointsKO-Adjacents,45
Eurya_arunachalensis,NA,NA,NA,NA,NA
Eurya_asterica,1,1,0,Points-PointsKO-Adjacents,9
Eurya_auriformis,3,3,0,Points-PointsKO-Adjacents,27
Eurya_bifidostyla,NA,NA,NA,NA,NA
Eurya_boninensis,73,23,50,Alphahull-PointsKO-Adjacents,478
Eurya_brassii,36,19,17,Points-PointsKO-Adjacents,176
Eurya_brevistyla,63,43,20,Alphahull-PointsKO-Adjacents,6198
Eurya_buxifolia,0,0,0,NA,0
Eurya_calotricha,1,1,0,Points-PointsKO-Adjacents,9
Eurya_castaneifolia,0,0,0,NA,0
Eurya_cavinervis,41,23,18,Alphahull-PointsKO-Adjacents,617
Eurya_celebica,3,3,0,Points-PointsKO-Adjacents,27
Eurya_ceylanica,0,0,0,NA,0
Eurya_chinensis,378,319,59,Alphahull-PointsKO-Adjacents,476
Eurya_ciliata,22,7,15,Points-PointsKO-Adjacents,189
Eurya_coriacea,1,1,0,Points-PointsKO-Adjacents,9
Eurya_crassilimba,NA,NA,NA,NA,NA
Eurya_crenatifolia,144,118,26,Alphahull-PointsKO-Adjacents,268
Eurya_cuneata,4,4,0,Points-PointsKO-Adjacents,36
Eurya_decurrens,1,1,0,Points-PointsKO-Adjacents,9
Eurya_degeneri,15,6,9,Points-PointsKO-Adjacents,54
Eurya_dielsiana,0,0,0,NA,0
Eurya_disticha,1,1,0,Points-PointsKO-Adjacents,9
Eurya_distichophylla,32,14,18,Points-PointsKO-Adjacents,288
Eurya_domaensis,2,2,0,Points-PointsKO-Adjacents,18
Eurya_eymae,1,1,0,Points-PointsKO-Adjacents,9
Eurya_fangii,9,2,7,Points-PointsKO-Adjacents,73
Eurya_finisterrica,NA,NA,NA,NA,NA
Eurya_fragilis,1,1,0,Points-PointsKO-Adjacents,9
Eurya_glaberrima,202,190,12,Alphahull-PointsKO-Adjacents,192
Eurya_glabra,1,0,1,Points-PointsKO-Adjacents,9
Eurya_glandulosa,10,6,4,Points-PointsKO-Adjacents,90
Eurya_gnaphalocarpa,197,182,15,Alphahull-PointsKO-Adjacents,322
Eurya_gracilipes,1,1,0,Points-PointsKO-Adjacents,9
Eurya_greenmaniana,3,3,0,Points-PointsKO-Adjacents,27
Eurya_greenwoodii,0,0,0,NA,0
Eurya_groffi,133,103,30,Alphahull-PointsKO-Adjacents,7426
Eurya_gungshanensis,16,9,7,Points-PointsKO-Adjacents,53
Eurya_hainanensis,3,3,0,Points-PointsKO-Adjacents,27
Eurya_handel-mazzettii,35,24,11,Alphahull-PointsKO-Adjacents,1325
Eurya_hebbemensis,NA,NA,NA,NA,NA
Eurya_hebeclados,100,76,24,Alphahull-PointsKO-Adjacents,6009
Eurya_hellwigii,1,1,0,Points-PointsKO-Adjacents,9
Eurya_henryi,5,4,1,Points-PointsKO-Adjacents,36
Eurya_hupehensis,24,13,11,Points-PointsKO-Adjacents,216
Eurya_idenburgiensis,0,0,0,NA,0
Eurya_impressinervis,19,1,18,Points-PointsKO-Adjacents,171
Eurya_inaequalis,3,3,0,Points-PointsKO-Adjacents,27
Eurya_jintungensis,19,13,6,Points-PointsKO-Adjacents,85
Eurya_kerigomnica,1,1,0,Points-PointsKO-Adjacents,9
Eurya_kuboriensis,0,0,0,NA,0
Eurya_kueichouensis,0,0,0,NA,0
Eurya_lanceiformis,NA,NA,NA,NA,NA
Eurya_laotica,2,2,0,Points-PointsKO-Adjacents,16
Eurya_leptanta,1,1,0,Points-PointsKO-Adjacents,9
Eurya_leptophylla,165,152,13,Alphahull-PointsKO-Adjacents,256
Eurya_longisepala,8,3,5,Points-PointsKO-Adjacents,60
Eurya_loquaiana,443,396,47,Alphahull-PointsKO-Adjacents,13674
Eurya_luchunensis,0,0,0,NA,0
Eurya_lunglingensis,1,1,0,Points-PointsKO-Adjacents,9
Eurya_macartneyi,39,0,39,Points-PointsKO-Adjacents,347
Eurya_magniflora,NA,NA,NA,NA,NA
Eurya_marlipoensis,1,1,0,Points-PointsKO-Adjacents,9
Eurya_megatrichocarpa,2,2,0,Points-PointsKO-Adjacents,12
Eurya_meizophylla,13,5,8,Points-PointsKO-Adjacents,81
Eurya_merrilliana,1,1,0,Points-PointsKO-Adjacents,9
Eurya_metcalfiana,7,1,6,Points-PointsKO-Adjacents,63
Eurya_montis-wilhelmii,1,1,0,Points-PointsKO-Adjacents,9
Eurya_muricata,64,33,31,Alphahull-PointsKO-Adjacents,4926
Eurya_nitida,197,0,197,Points-PointsKO-Adjacents,861
Eurya_obliquifolia,9,1,8,Points-PointsKO-Adjacents,72
Eurya_oblonga,20,9,11,Points-PointsKO-Adjacents,161
Eurya_obovata,12,0,12,Points-PointsKO-Adjacents,80
Eurya_obtusifolia,46,28,18,Alphahull-PointsKO-Adjacents,2043
Eurya_osimensis,9,2,7,Points-PointsKO-Adjacents,36
Eurya_ovatifolia,1,1,0,Points-PointsKO-Adjacents,9
Eurya_oxysepala,6,0,6,Points-PointsKO-Adjacents,42
Eurya_pahangensis,0,0,0,NA,0
Eurya_paratetragonoclada,7,0,7,Points-PointsKO-Adjacents,63
Eurya_patentipila,11,6,5,Points-PointsKO-Adjacents,99
Eurya_pentagyna,1,1,0,Points-PointsKO-Adjacents,9
Eurya_pentastyla,0,0,0,NA,0
Eurya_perryana,0,0,0,NA,0
Eurya_perserrata,4,4,0,Points-PointsKO-Adjacents,24
Eurya_persicifolia,1,1,0,Points-PointsKO-Adjacents,9
Eurya_phyllopoda,0,0,0,NA,0
Eurya_pickeringii,0,0,0,NA,0
Eurya_pittosporifolia,1,1,0,Points-PointsKO-Adjacents,9
Eurya_platyptera,NA,NA,NA,NA,NA
Eurya_pluriflora,6,2,4,Points-PointsKO-Adjacents,39
Eurya_polygama,4,4,0,Points-PointsKO-Adjacents,30
Eurya_polyneura,1,1,0,Points-PointsKO-Adjacents,9
Eurya_prunifolia,1,1,0,Points-PointsKO-Adjacents,9
Eurya_pseudocerasifera,28,17,11,Points-PointsKO-Adjacents,173
Eurya_pullenii,3,3,0,Points-PointsKO-Adjacents,12
Eurya_pyracanthifolia,26,12,14,Points-PointsKO-Adjacents,171
Eurya_quinquelocularis,14,4,10,Points-PointsKO-Adjacents,117
Eurya_reflexa,3,3,0,Points-PointsKO-Adjacents,23
Eurya_rehderiana,1,1,0,Points-PointsKO-Adjacents,9
Eurya_rengechiensis,17,12,5,Points-PointsKO-Adjacents,57
Eurya_richii,0,0,0,NA,0
Eurya_rigida,NA,NA,NA,NA,NA
Eurya_roemeri,2,2,0,Points-PointsKO-Adjacents,12
Eurya_rubiginosa,44,23,21,Alphahull-PointsKO-Adjacents,1802
Eurya_rugosa,1,1,0,Points-PointsKO-Adjacents,9
Eurya_ryozoana,5,5,0,Points-PointsKO-Adjacents,37
Eurya_sakishimensis,6,2,4,Points-PointsKO-Adjacents,19
Eurya_sandwichensis,0,0,0,NA,0
Eurya_saxicola,10,1,9,Points-PointsKO-Adjacents,90
Eurya_semiserrulata,3,3,0,Points-PointsKO-Adjacents,27
Eurya_septata,3,3,0,Points-PointsKO-Adjacents,27
Eurya_spiralis,0,0,0,NA,0
Eurya_steenisii,0,0,0,NA,0
Eurya_stenophylla,18,7,11,Points-PointsKO-Adjacents,162
Eurya_strigillosa,95,83,12,Alphahull-PointsKO-Adjacents,201
Eurya_subcordata,NA,NA,NA,NA,NA
Eurya_subintegra,4,4,0,Points-PointsKO-Adjacents,36
Eurya_taronensis,1,1,0,Points-PointsKO-Adjacents,9
Eurya_ternatana,1,1,0,Points-PointsKO-Adjacents,5
Eurya_tetragonoclada,33,8,25,Points-PointsKO-Adjacents,294
Eurya_tigang,54,30,24,Alphahull-PointsKO-Adjacents,575
Eurya_tonkinensis,3,3,0,Points-PointsKO-Adjacents,27
Eurya_trichocarpa,34,0,34,Points-PointsKO-Adjacents,255
Eurya_tsaii,18,9,9,Points-PointsKO-Adjacents,123
Eurya_tsingpienensis,2,1,1,Points-PointsKO-Adjacents,18
Eurya_turfosa,0,0,0,NA,0
Eurya_urophylla,0,0,0,NA,0
Eurya_velutina,1,1,0,Points-PointsKO-Adjacents,9
Eurya_vestita,0,0,0,NA,0
Eurya_vitiensis,0,0,0,NA,0
Eurya_wardii,0,0,0,NA,0
Eurya_wenshanensis,2,1,1,Points-PointsKO-Adjacents,9
Eurya_wuliangshanensis,0,0,0,NA,0
Eurya_yaeyamensis,9,6,3,Points-PointsKO-Adjacents,11
Eurya_yakushimensis,74,23,51,Alphahull-PointsKO-Adjacents,487
Eurya_yunnanensis,5,5,0,Points-PointsKO-Adjacents,39
Eurya_zigzag,2,2,0,Points-PointsKO-Adjacents,15
Eurycoma_apiculata,2,2,0,Points-PointsKO-Adjacents,18
Eurycoma_harmandiana,0,0,0,NA,0
Eurycoma_longifolia,147,86,61,Alphahull-PointsKO-Adjacents,8613
Eurycorymbus_cavaleriei,46,23,23,Alphahull-PointsKO-Adjacents,703
Eurydochus_bracteatus,3,3,0,Points-PointsKO-Adjacents,25
Eurypetalum_tessmannii,54,38,16,Alphahull-PointsKO-Adjacents,622
Eurypetalum_unijugum,17,12,5,Points-PointsKO-Adjacents,127
Euscaphis_japonica,604,349,255,Alphahull-PointsKO-Adjacents,19062
Euscaphis_tonkinensis,0,0,0,NA,0
Eusideroxylon_zwageri,21,6,15,Points-PointsKO-Adjacents,179
Eustigma_balansae,7,1,6,Points-PointsKO-Adjacents,63
Eustigma_lenticellatum,1,1,0,Points-PointsKO-Adjacents,9
Eustigma_oblongifolium,65,44,21,Alphahull-PointsKO-Adjacents,598
Euterpe_broadwayi,6,3,3,Points-PointsKO-Adjacents,26
Euterpe_catinga,227,184,43,Alphahull-PointsKO-Adjacents,15219
Euterpe_edulis,732,634,98,Alphahull-PointsKO-Adjacents,19767
Euterpe_longibracteata,24,0,24,Points-PointsKO-Adjacents,207
Euterpe_luminosa,8,3,5,Points-PointsKO-Adjacents,39
Euterpe_oleracea,360,287,73,Alphahull-PointsKO-Adjacents,18923
Euterpe_precatoria,1779,1678,101,Alphahull-PointsKO-Adjacents,70977
Euthemis_leucocarpa,14,3,11,Points-PointsKO-Adjacents,96
Euthemis_minor,18,6,12,Points-PointsKO-Adjacents,123
Euxylophora_paraensis,35,18,17,Points-PointsKO-Adjacents,266
Everistia_vacciniifolia,324,276,48,Alphahull-PointsKO-Adjacents,4606
Evodia_cuspidata,2,2,0,Points-PointsKO-Adjacents,18
Evodia_pubifolia,4,4,0,Points-PointsKO-Adjacents,14
Evonymopsis_humbertii,9,1,8,Points-PointsKO-Adjacents,62
Exarata_chocoensis,20,0,20,Points-PointsKO-Adjacents,125
Exbucklandia_longipetala,2,2,0,Points-PointsKO-Adjacents,18
Exbucklandia_populnea,80,44,36,Alphahull-PointsKO-Adjacents,2447
Exbucklandia_tonkinensis,33,17,16,Points-PointsKO-Adjacents,297
Excoecaria_acerifolia,77,55,22,Alphahull-PointsKO-Adjacents,2557
Excoecaria_acuminata,0,0,0,NA,0
Excoecaria_agallocha,573,390,183,Alphahull-PointsKO-Adjacents,7792
Excoecaria_bantamensis,2,2,0,Points-PointsKO-Adjacents,18
Excoecaria_benthamiana,2,2,0,Points-PointsKO-Adjacents,9
Excoecaria_borneensis,9,0,9,Points-PointsKO-Adjacents,71
Excoecaria_bussei,19,4,15,Points-PointsKO-Adjacents,153
Excoecaria_cochinchinensis,40,7,33,Points-PointsKO-Adjacents,333
Excoecaria_confertiflora,0,0,0,NA,0
Excoecaria_dallachyana,224,193,31,Alphahull-PointsKO-Adjacents,1757
Excoecaria_formosana,17,12,5,Points-PointsKO-Adjacents,16
Excoecaria_goudotiana,31,15,16,Points-PointsKO-Adjacents,161
Excoecaria_holophylla,0,0,0,NA,0
Excoecaria_lissophylla,2,2,0,Points-PointsKO-Adjacents,16
Excoecaria_madagascariensis,94,51,43,Alphahull-PointsKO-Adjacents,2599
Excoecaria_oppositifolia,15,0,15,Points-PointsKO-Adjacents,108
Excoecaria_parvifolia,565,542,23,Alphahull-PointsKO-Adjacents,6818
Excoecaria_philippinensis,3,3,0,Points-PointsKO-Adjacents,24
Excoecaria_simii,33,0,33,Points-PointsKO-Adjacents,264
Excoecaria_yunnanensis,NA,NA,NA,NA,NA
Exellodendron_barbatum,145,101,44,Alphahull-PointsKO-Adjacents,10838
Exellodendron_cordatum,159,138,21,Alphahull-PointsKO-Adjacents,5877
Exellodendron_coriaceum,125,91,34,Alphahull-PointsKO-Adjacents,9503
Exellodendron_gracile,16,5,11,Points-PointsKO-Adjacents,107
Exocarpos_aphyllus,3809,3714,95,Alphahull-PointsKO-Adjacents,25669
Exocarpos_clavatus,6,3,3,Points-PointsKO-Adjacents,33
Exocarpos_cupressiformis,13287,12695,592,Alphahull-PointsKO-Adjacents,17422
Exocarpos_gaudichaudii,10,6,4,Points-PointsKO-Adjacents,50
Exocarpos_homalocladus,13,13,0,Points-PointsKO-Adjacents,5
Exocarpos_latifolius,1921,1776,145,Alphahull-PointsKO-Adjacents,14972
Exocarpos_luteolus,4,4,0,Points-PointsKO-Adjacents,14
Exocarpos_menziesii,3,3,0,Points-PointsKO-Adjacents,20
Exocarpos_montanus,9,1,8,Points-PointsKO-Adjacents,72
Exocarpos_neocaledonicus,20,10,10,Points-PointsKO-Adjacents,100
Exocarpos_phyllanthoides,11,1,10,Points-PointsKO-Adjacents,29
Exocarpos_sparteus,2052,1914,138,Alphahull-PointsKO-Adjacents,34041
Exostema_acuminatum,16,10,6,Points-PointsKO-Adjacents,86
Exostema_angustifolium,1,1,0,Points-PointsKO-Adjacents,8
Exostema_bicolor,1,1,0,Points-PointsKO-Adjacents,9
Exostema_brachycarpum,3,3,0,Points-PointsKO-Adjacents,21
Exostema_caribaeum,589,465,124,Alphahull-PointsKO-Adjacents,12733
Exostema_cordatum,2,2,0,Points-PointsKO-Adjacents,18
Exostema_coriaceum,0,0,0,NA,0
Exostema_corymbosum,23,10,13,Points-PointsKO-Adjacents,179
Exostema_curbeloi,1,1,0,Points-PointsKO-Adjacents,9
Exostema_glaberrimum,1,1,0,Points-PointsKO-Adjacents,6
Exostema_lancifolium,2,2,0,Points-PointsKO-Adjacents,14
Exostema_lineatum,21,12,9,Points-PointsKO-Adjacents,101
Exostema_longiflorum,36,15,21,Points-PointsKO-Adjacents,242
Exostema_maynense,48,21,27,Alphahull-PointsKO-Adjacents,2189
Exostema_mexicanum,398,333,65,Alphahull-PointsKO-Adjacents,8681
Exostema_microcarpum,0,0,0,NA,0
Exostema_myrtifolium,17,11,6,Points-PointsKO-Adjacents,81
Exostema_nitens,20,15,5,Points-PointsKO-Adjacents,40
Exostema_orbiculatum,0,0,0,NA,0
Exostema_parviflorum,47,27,20,Alphahull-PointsKO-Adjacents,432
Exostema_pervestitum,1,1,0,Points-PointsKO-Adjacents,6
Exostema_polyphyllum,1,1,0,Points-PointsKO-Adjacents,7
Exostema_pulverulentum,0,0,0,NA,0
Exostema_purpureum,16,0,16,Points-PointsKO-Adjacents,61
Exostema_rotundatum,5,5,0,Points-PointsKO-Adjacents,31
Exostema_salicifolium,3,3,0,Points-PointsKO-Adjacents,23
Exostema_sanctae-luciae,8,0,8,Points-PointsKO-Adjacents,45
Exostema_spinosum,22,9,13,Points-PointsKO-Adjacents,136
Exostema_stenophyllum,7,3,4,Points-PointsKO-Adjacents,26
Exostema_triflorum,3,3,0,Points-PointsKO-Adjacents,21
Exostema_velutinum,1,0,1,Points-PointsKO-Adjacents,9
Exostyles_amazonica,9,1,8,Points-PointsKO-Adjacents,77
Exostyles_glabra,3,3,0,Points-PointsKO-Adjacents,27
Exostyles_godoyensis,22,14,8,Points-PointsKO-Adjacents,111
Exostyles_venusta,113,75,38,Alphahull-PointsKO-Adjacents,971
Exothea_copalillo,72,58,14,Alphahull-PointsKO-Adjacents,257
Exothea_diphylla,112,0,112,Points-PointsKO-Adjacents,452
Exothea_paniculata,317,223,94,Alphahull-PointsKO-Adjacents,6250
Eysenhardtia_adenostylis,77,55,22,Alphahull-PointsKO-Adjacents,623
Eysenhardtia_officinalis,2,2,0,Points-PointsKO-Adjacents,18
Eysenhardtia_orthocarpa,159,137,22,Alphahull-PointsKO-Adjacents,1761
Eysenhardtia_platycarpa,95,63,32,Alphahull-PointsKO-Adjacents,2968
Eysenhardtia_polystachya,907,817,90,Alphahull-PointsKO-Adjacents,10797
Eysenhardtia_punctata,30,10,20,Points-PointsKO-Adjacents,223
Eysenhardtia_schizocalyx,6,1,5,Points-PointsKO-Adjacents,54
Eysenhardtia_subcoriacea,6,0,6,Points-PointsKO-Adjacents,54
Eysenhardtia_texana,248,190,58,Alphahull-PointsKO-Adjacents,5562
Facheiroa_braunii,17,7,10,Points-PointsKO-Adjacents,131
Facheiroa_cephaliomelana,11,5,6,Points-PointsKO-Adjacents,97
Facheiroa_squamosa,30,17,13,Points-PointsKO-Adjacents,233
Facheiroa_ulei,5,1,4,Points-PointsKO-Adjacents,45
Fadogia_erythrophloea,114,0,114,Points-PointsKO-Adjacents,401
Fadogia_leucophloea,0,0,0,NA,0
Fadogia_tomentosa,24,10,14,Points-PointsKO-Adjacents,140
Fagara_dimorphophylla,38,22,16,Alphahull-PointsKO-Adjacents,1508
Fagara_externa,0,0,0,NA,0
Fagara_negrilensis,NA,NA,NA,NA,NA
Fagara_vitiensis,0,0,0,NA,0
Fagaropsis_angolensis,44,22,22,Alphahull-PointsKO-Adjacents,217
Fagaropsis_glabra,3,3,0,Points-PointsKO-Adjacents,21
Fagaropsis_hildebrandtii,4,3,1,Points-PointsKO-Adjacents,36
Fagraea_annulata,0,0,0,NA,0
Fagraea_auriculata,17,0,17,Points-PointsKO-Adjacents,141
Fagraea_belukar,0,0,0,NA,0
Fagraea_berteroana,170,84,86,Alphahull-PointsKO-Adjacents,2173
Fagraea_blumei,23,0,23,Points-PointsKO-Adjacents,180
Fagraea_bodenii,43,17,26,Points-PointsKO-Adjacents,310
Fagraea_borneensis,5,5,0,Points-PointsKO-Adjacents,38
Fagraea_carnosa,2,2,0,Points-PointsKO-Adjacents,18
Fagraea_carstensensis,0,0,0,NA,0
Fagraea_caudata,NA,NA,NA,NA,NA
Fagraea_ceilanica,119,36,83,Alphahull-PointsKO-Adjacents,3541
Fagraea_collina,1,1,0,Points-PointsKO-Adjacents,9
Fagraea_curtisii,2,2,0,Points-PointsKO-Adjacents,18
Fagraea_cuspidata,4,4,0,Points-PointsKO-Adjacents,26
Fagraea_dulitensis,0,0,0,NA,0
Fagraea_elliptica,57,26,31,Alphahull-PointsKO-Adjacents,618
Fagraea_euneura,13,0,13,Points-PointsKO-Adjacents,105
Fagraea_gitingensis,1,1,0,Points-PointsKO-Adjacents,8
Fagraea_gracilipes,1,1,0,Points-PointsKO-Adjacents,9
Fagraea_havilandii,NA,NA,NA,NA,NA
Fagraea_involucrata,1,1,0,Points-PointsKO-Adjacents,9
Fagraea_kalimantanensis,2,2,0,Points-PointsKO-Adjacents,9
Fagraea_kinabaluensis,3,3,0,Points-PointsKO-Adjacents,15
Fagraea_kuminii,NA,NA,NA,NA,NA
Fagraea_litoralis,0,0,0,NA,0
Fagraea_longipetiolata,0,0,0,NA,0
Fagraea_macroscypha,7,0,7,Points-PointsKO-Adjacents,63
Fagraea_maingayi,0,0,0,NA,0
Fagraea_megalantha,NA,NA,NA,NA,NA
Fagraea_montana,2,2,0,Points-PointsKO-Adjacents,9
Fagraea_oblonga,8,0,8,Points-PointsKO-Adjacents,60
Fagraea_oreophila,3,3,0,Points-PointsKO-Adjacents,23
Fagraea_peninsularis,0,0,0,NA,0
Fagraea_philippinensis,0,0,0,NA,0
Fagraea_plumeriiflora,1,1,0,Points-PointsKO-Adjacents,7
Fagraea_racemosa,18,4,14,Points-PointsKO-Adjacents,149
Fagraea_resinosa,3,3,0,Points-PointsKO-Adjacents,23
Fagraea_rugulosa,0,0,0,NA,0
Fagraea_salticola,26,11,15,Points-PointsKO-Adjacents,155
Fagraea_spicata,2,2,0,Points-PointsKO-Adjacents,18
Fagraea_stenophylla,5,5,0,Points-PointsKO-Adjacents,45
Fagraea_tacapala,5,5,0,Points-PointsKO-Adjacents,40
Fagraea_umbelliflora,0,0,0,NA,0
Fagraea_volubilis,3,3,0,Points-PointsKO-Adjacents,27
Fagraea_woodiana,17,4,13,Points-PointsKO-Adjacents,112
Faguetia_falcata,9,3,6,Points-PointsKO-Adjacents,46
Fagus_chienii,1,1,0,Points-PointsKO-Adjacents,9
Fagus_crenata,596,508,88,Alphahull-PointsKO-Adjacents,3613
Fagus_engleriana,18,7,11,Points-PointsKO-Adjacents,162
Fagus_grandifolia,19737,18229,1508,Alphahull-PointsKO-Adjacents,43923
Fagus_hayatae,21,18,3,Points-PointsKO-Adjacents,42
Fagus_japonica,310,262,48,Alphahull-PointsKO-Adjacents,1383
Fagus_longipetiolata,136,102,34,Alphahull-PointsKO-Adjacents,9982
Fagus_lucida,23,5,18,Points-PointsKO-Adjacents,207
Fagus_orientalis,134,105,29,Alphahull-PointsKO-Adjacents,3999
Fagus_sylvatica,7988,6805,1183,Alphahull-PointsKO-Adjacents,32605
Faidherbia_albida,414,230,184,Alphahull-PointsKO-Adjacents,13971
Falcataria_moluccana,131,74,57,Alphahull-PointsKO-Adjacents,2798
Falcataria_pullenii,4,4,0,Points-PointsKO-Adjacents,27
Falcataria_toona,130,93,37,Alphahull-PointsKO-Adjacents,761
Falcatifolium_angustum,2,2,0,Points-PointsKO-Adjacents,18
Falcatifolium_falciforme,26,7,19,Points-PointsKO-Adjacents,156
Falcatifolium_gruezoi,6,0,6,Points-PointsKO-Adjacents,49
Falcatifolium_papuanum,33,22,11,Alphahull-PointsKO-Adjacents,88
Falcatifolium_taxoides,84,69,15,Alphahull-PointsKO-Adjacents,146
Falconeria_insignis,13,0,13,Points-PointsKO-Adjacents,113
Faradaya_lehuntei,0,0,0,NA,0
Faramea_accumulans,4,4,0,Points-PointsKO-Adjacents,17
Faramea_acuminatissima,1,1,0,Points-PointsKO-Adjacents,9
Faramea_affinis,1,1,0,Points-PointsKO-Adjacents,9
Faramea_altipetens,3,3,0,Points-PointsKO-Adjacents,15
Faramea_ampla,13,4,9,Points-PointsKO-Adjacents,110
Faramea_amplifolia,6,1,5,Points-PointsKO-Adjacents,54
Faramea_angusta,8,3,5,Points-PointsKO-Adjacents,72
Faramea_anisocalyx,357,291,66,Alphahull-PointsKO-Adjacents,27959
Faramea_anisodonta,1,1,0,Points-PointsKO-Adjacents,9
Faramea_areolata,24,16,8,Points-PointsKO-Adjacents,69
Faramea_aristata,2,2,0,Points-PointsKO-Adjacents,18
Faramea_atlantica,51,29,22,Alphahull-PointsKO-Adjacents,1333
Faramea_australis,0,0,0,NA,0
Faramea_axillaris,47,32,15,Alphahull-PointsKO-Adjacents,1331
Faramea_bahiensis,27,11,16,Points-PointsKO-Adjacents,208
Faramea_bangii,22,13,9,Points-PointsKO-Adjacents,73
Faramea_belizensis,4,3,1,Points-PointsKO-Adjacents,30
Faramea_berryi,19,0,19,Points-PointsKO-Adjacents,138
Faramea_bicolor,21,16,5,Points-PointsKO-Adjacents,92
Faramea_biflora,27,21,6,Alphahull-PointsKO-Adjacents,273
Faramea_boomii,25,9,16,Points-PointsKO-Adjacents,213
Faramea_brachyloba,5,3,2,Points-PointsKO-Adjacents,31
Faramea_brachysiphon,22,16,6,Points-PointsKO-Adjacents,123
Faramea_bracteata,95,52,43,Alphahull-PointsKO-Adjacents,4562
Faramea_brevipes,6,0,6,Points-PointsKO-Adjacents,45
Faramea_calimana,9,4,5,Points-PointsKO-Adjacents,71
Faramea_calophylla,57,41,16,Alphahull-PointsKO-Adjacents,681
Faramea_calyptrata,80,60,20,Alphahull-PointsKO-Adjacents,896
Faramea_campanella,8,2,6,Points-PointsKO-Adjacents,52
Faramea_campanularis,2,1,1,Points-PointsKO-Adjacents,15
Faramea_candelabrum,90,0,90,Points-PointsKO-Adjacents,356
Faramea_capillipes,712,649,63,Alphahull-PointsKO-Adjacents,69624
Faramea_capulifolia,26,13,13,Points-PointsKO-Adjacents,133
Faramea_cardiophylla,1,1,0,Points-PointsKO-Adjacents,9
Faramea_cardonae,13,5,8,Points-PointsKO-Adjacents,102
Faramea_cestroides,11,4,7,Points-PointsKO-Adjacents,30
Faramea_cobana,11,5,6,Points-PointsKO-Adjacents,60
Faramea_coerulea,51,32,19,Alphahull-PointsKO-Adjacents,314
Faramea_coerulescens,59,38,21,Alphahull-PointsKO-Adjacents,615
Faramea_coffeoides,37,29,8,Alphahull-PointsKO-Adjacents,287
Faramea_congesta,0,0,0,NA,0
Faramea_cordifolia,NA,NA,NA,NA,NA
Faramea_correae,4,4,0,Points-PointsKO-Adjacents,27
Faramea_corymbosa,180,90,90,Alphahull-PointsKO-Adjacents,13579
Faramea_crassifolia,78,41,37,Alphahull-PointsKO-Adjacents,877
Faramea_cuatrecasasii,1,1,0,Points-PointsKO-Adjacents,9
Faramea_cuspidata,30,13,17,Points-PointsKO-Adjacents,219
Faramea_cyathocalyx,16,8,8,Points-PointsKO-Adjacents,110
Faramea_dichotoma,6,1,5,Points-PointsKO-Adjacents,34
Faramea_diversifolia,1,1,0,Points-PointsKO-Adjacents,9
Faramea_egregia,16,9,7,Points-PointsKO-Adjacents,107
Faramea_elegans,9,3,6,Points-PointsKO-Adjacents,81
Faramea_erythropoda,0,0,0,NA,0
Faramea_eurycarpa,169,131,38,Alphahull-PointsKO-Adjacents,2219
Faramea_exemplaris,8,1,7,Points-PointsKO-Adjacents,54
Faramea_fallax,2,2,0,Points-PointsKO-Adjacents,18
Faramea_fanshawei,0,0,0,NA,0
Faramea_filamentosa,4,4,0,Points-PointsKO-Adjacents,28
Faramea_fragrans,43,27,16,Alphahull-PointsKO-Adjacents,390
Faramea_frondosa,2,2,0,Points-PointsKO-Adjacents,18
Faramea_gagnepainiana,NA,NA,NA,NA,NA
Faramea_garciae,NA,NA,NA,NA,NA
Faramea_glandulosa,438,356,82,Alphahull-PointsKO-Adjacents,17363
Faramea_grandifolia,0,0,0,NA,0
Faramea_guayaquilensis,NA,NA,NA,NA,NA
Faramea_guianensis,102,93,9,Alphahull-PointsKO-Adjacents,902
Faramea_herbacea,0,0,0,NA,0
Faramea_heterocalyx,2,2,0,Points-PointsKO-Adjacents,18
Faramea_heteromera,1,1,0,Points-PointsKO-Adjacents,9
Faramea_heterophylla,1,1,0,Points-PointsKO-Adjacents,9
Faramea_hyacinthina,299,246,53,Alphahull-PointsKO-Adjacents,10797
Faramea_hymenocalyx,4,3,1,Points-PointsKO-Adjacents,15
Faramea_includens,2,2,0,Points-PointsKO-Adjacents,18
Faramea_insignis,65,49,16,Alphahull-PointsKO-Adjacents,735
Faramea_intercedens,4,4,0,Points-PointsKO-Adjacents,36
Faramea_irwinii,22,15,7,Points-PointsKO-Adjacents,168
Faramea_jasminoides,217,172,45,Alphahull-PointsKO-Adjacents,4161
Faramea_juruana,38,0,38,Points-PointsKO-Adjacents,311
Faramea_langlassei,9,2,7,Points-PointsKO-Adjacents,66
Faramea_larensis,1,1,0,Points-PointsKO-Adjacents,9
Faramea_latifolia,153,0,153,Points-PointsKO-Adjacents,1134
Faramea_lehmannii,30,13,17,Points-PointsKO-Adjacents,193
Faramea_leucocalyx,1,1,0,Points-PointsKO-Adjacents,9
Faramea_liebmannii,0,0,0,NA,0
Faramea_liesneri,9,5,4,Points-PointsKO-Adjacents,33
Faramea_longistipula,11,0,11,Points-PointsKO-Adjacents,48
Faramea_lourteigiana,31,1,30,Points-PointsKO-Adjacents,199
Faramea_luteovirens,84,65,19,Alphahull-PointsKO-Adjacents,514
Faramea_lutescens,16,9,7,Points-PointsKO-Adjacents,90
Faramea_lutzeana,NA,NA,NA,NA,NA
Faramea_macra,1,1,0,Points-PointsKO-Adjacents,9
Faramea_macrura,12,3,9,Points-PointsKO-Adjacents,76
Faramea_maguirei,26,16,10,Points-PointsKO-Adjacents,126
Faramea_malmei,22,3,19,Points-PointsKO-Adjacents,189
Faramea_martiana,108,1,107,Points-PointsKO-Adjacents,714
Faramea_mattogrossensis,1,1,0,Points-PointsKO-Adjacents,9
Faramea_megalophylla,1,1,0,Points-PointsKO-Adjacents,9
Faramea_miconioides,28,10,18,Points-PointsKO-Adjacents,217
Faramea_micrantha,3,3,0,Points-PointsKO-Adjacents,27
Faramea_monsalveae,24,16,8,Points-PointsKO-Adjacents,100
Faramea_montevidensis,343,279,64,Alphahull-PointsKO-Adjacents,6576
Faramea_multiflora,1533,1317,216,Alphahull-PointsKO-Adjacents,95993
Faramea_neblinae,8,0,8,Points-PointsKO-Adjacents,35
Faramea_nigrescens,192,161,31,Alphahull-PointsKO-Adjacents,7197
Faramea_nocturna,22,13,9,Points-PointsKO-Adjacents,85
Faramea_oaxacensis,NA,NA,NA,NA,NA
Faramea_oblongifolia,228,185,43,Alphahull-PointsKO-Adjacents,3691
Faramea_obtusifolia,3,3,0,Points-PointsKO-Adjacents,27
Faramea_occidentalis,253,147,106,Alphahull-PointsKO-Adjacents,24981
Faramea_oligantha,46,17,29,Points-PointsKO-Adjacents,288
Faramea_oraria,5,2,3,Points-PointsKO-Adjacents,45
Faramea_orinocencis,24,6,18,Points-PointsKO-Adjacents,214
Faramea_ovalis,78,44,34,Alphahull-PointsKO-Adjacents,329
Faramea_pachyantha,67,42,25,Alphahull-PointsKO-Adjacents,558
Faramea_paniculata,28,6,22,Points-PointsKO-Adjacents,242
Faramea_panurensis,1,1,0,Points-PointsKO-Adjacents,9
Faramea_papillata,8,5,3,Points-PointsKO-Adjacents,24
Faramea_papirifolia,12,0,12,Points-PointsKO-Adjacents,51
Faramea_paratiensis,10,7,3,Points-PointsKO-Adjacents,41
Faramea_parvibractea,143,97,46,Alphahull-PointsKO-Adjacents,2750
Faramea_parvula,7,0,7,Points-PointsKO-Adjacents,56
Faramea_paupera,0,0,0,NA,0
Faramea_pedunculata,6,0,6,Points-PointsKO-Adjacents,45
Faramea_persistisepta,NA,NA,NA,NA,NA
Faramea_phaneroneura,NA,NA,NA,NA,NA
Faramea_picinguabae,13,7,6,Points-PointsKO-Adjacents,48
Faramea_platyclada,2,2,0,Points-PointsKO-Adjacents,17
Faramea_platyneura,55,25,30,Alphahull-PointsKO-Adjacents,1220
Faramea_platypoda,2,2,0,Points-PointsKO-Adjacents,18
Faramea_pohliana,1,1,0,Points-PointsKO-Adjacents,9
Faramea_polytriadophora,4,4,0,Points-PointsKO-Adjacents,27
Faramea_porophylla,51,31,20,Alphahull-PointsKO-Adjacents,2481
Faramea_pseudospathacea,1,1,0,Points-PointsKO-Adjacents,9
Faramea_purdieana,1,0,1,Points-PointsKO-Adjacents,6
Faramea_quadricostata,40,29,11,Alphahull-PointsKO-Adjacents,785
Faramea_quinqueflora,270,224,46,Alphahull-PointsKO-Adjacents,10269
Faramea_saldanhaei,0,0,0,NA,0
Faramea_scalaris,22,12,10,Points-PointsKO-Adjacents,120
Faramea_schultesii,20,12,8,Points-PointsKO-Adjacents,75
Faramea_sellowiana,6,1,5,Points-PointsKO-Adjacents,45
Faramea_sertulifera,2,2,0,Points-PointsKO-Adjacents,18
Faramea_sessiliflora,43,15,28,Points-PointsKO-Adjacents,345
Faramea_sessilifolia,366,289,77,Alphahull-PointsKO-Adjacents,35397
Faramea_singularis,1,1,0,Points-PointsKO-Adjacents,9
Faramea_standleyana,4,4,0,Points-PointsKO-Adjacents,34
Faramea_stenantha,3,3,0,Points-PointsKO-Adjacents,27
Faramea_stenomeris,0,0,0,NA,0
Faramea_stenopetala,10,1,9,Points-PointsKO-Adjacents,78
Faramea_stipulacea,83,47,36,Alphahull-PointsKO-Adjacents,1900
Faramea_suaveolens,0,0,0,NA,0
Faramea_subbasilaris,1,1,0,Points-PointsKO-Adjacents,9
Faramea_subsessilis,4,4,0,Points-PointsKO-Adjacents,24
Faramea_suerrensis,246,215,31,Alphahull-PointsKO-Adjacents,1348
Faramea_tamberlikiana,213,135,78,Alphahull-PointsKO-Adjacents,15228
Faramea_tenuiflora,3,3,0,Points-PointsKO-Adjacents,27
Faramea_tenuifolia,2,2,0,Points-PointsKO-Adjacents,18
Faramea_tetragona,45,1,44,Points-PointsKO-Adjacents,236
Faramea_tinguana,2,2,0,Points-PointsKO-Adjacents,18
Faramea_torquata,448,360,88,Alphahull-PointsKO-Adjacents,45896
Faramea_trinervia,49,34,15,Alphahull-PointsKO-Adjacents,205
Faramea_truncata,34,17,17,Points-PointsKO-Adjacents,215
Faramea_umbellifera,NA,NA,NA,NA,NA
Faramea_uniflora,126,99,27,Alphahull-PointsKO-Adjacents,3480
Faramea_urophylla,3,3,0,Points-PointsKO-Adjacents,27
Faramea_vaginata,1,1,0,Points-PointsKO-Adjacents,9
Faramea_vasquezii,16,9,7,Points-PointsKO-Adjacents,116
Faramea_verticillata,17,6,11,Points-PointsKO-Adjacents,128
Faramea_vidensis,4,4,0,Points-PointsKO-Adjacents,36
Faramea_weddellii,3,3,0,Points-PointsKO-Adjacents,27
Faramea_yavitensis,7,2,5,Points-PointsKO-Adjacents,57
Farsetia_somalensis,0,0,0,NA,0
Fatsia_oligocarpella,0,0,0,NA,0
Fatsia_polycarpa,151,135,16,Alphahull-PointsKO-Adjacents,233
Faucherea_ambrensis,34,19,15,Points-PointsKO-Adjacents,201
Faucherea_glutinosa,17,3,14,Points-PointsKO-Adjacents,105
Faucherea_hexandra,50,24,26,Alphahull-PointsKO-Adjacents,570
Faucherea_longepedicellata,2,2,0,Points-PointsKO-Adjacents,17
Faucherea_manongarivensis,46,34,12,Alphahull-PointsKO-Adjacents,599
Faucherea_parvifolia,44,29,15,Alphahull-PointsKO-Adjacents,347
Faucherea_sambiranensis,9,0,9,Points-PointsKO-Adjacents,72
Faucherea_tampoloensis,22,15,7,Points-PointsKO-Adjacents,111
Faucherea_thouvenotii,65,46,19,Alphahull-PointsKO-Adjacents,580
Faucherea_urschii,8,2,6,Points-PointsKO-Adjacents,47
Faurea_arborea,1,1,0,Points-PointsKO-Adjacents,9
Faurea_argentea,1,1,0,Points-PointsKO-Adjacents,9
Faurea_coriacea,9,5,4,Points-PointsKO-Adjacents,38
Faurea_delevoyi,8,1,7,Points-PointsKO-Adjacents,63
Faurea_discolor,3,3,0,Points-PointsKO-Adjacents,21
Faurea_forficuliflora,143,124,19,Alphahull-PointsKO-Adjacents,1737
Faurea_galpinii,23,12,11,Points-PointsKO-Adjacents,197
Faurea_intermedia,2,1,1,Points-PointsKO-Adjacents,18
Faurea_lucida,NA,NA,NA,NA,NA
Faurea_macnaughtonii,30,14,16,Points-PointsKO-Adjacents,228
Faurea_racemosa,6,1,5,Points-PointsKO-Adjacents,36
Faurea_rochetiana,126,64,62,Alphahull-PointsKO-Adjacents,3400
Faurea_rubriflora,2,2,0,Points-PointsKO-Adjacents,18
Faurea_saligna,171,103,68,Alphahull-PointsKO-Adjacents,6797
Faurea_wentzeliana,8,3,5,Points-PointsKO-Adjacents,60
Fedorovia_inopinata,NA,NA,NA,NA,NA
Fedorovia_laxa,NA,NA,NA,NA,NA
Fegimanra_acuminatissima,6,0,6,Points-PointsKO-Adjacents,36
Fegimanra_africana,22,8,14,Points-PointsKO-Adjacents,104
Fegimanra_afzelii,16,14,2,Points-PointsKO-Adjacents,85
Fenerivia_angustielliptica,6,0,6,Points-PointsKO-Adjacents,43
Fenerivia_capuronii,27,12,15,Points-PointsKO-Adjacents,134
Fenerivia_chapelieri,15,5,10,Points-PointsKO-Adjacents,73
Fenerivia_ghesquiereana,49,28,21,Alphahull-PointsKO-Adjacents,320
Fenerivia_humbertii,22,8,14,Points-PointsKO-Adjacents,128
Fenerivia_madagascariensis,6,0,6,Points-PointsKO-Adjacents,38
Fenerivia_richardiana,18,0,18,Points-PointsKO-Adjacents,92
Ferdinandusa_boomii,2,2,0,Points-PointsKO-Adjacents,18
Ferdinandusa_chlorantha,185,107,78,Alphahull-PointsKO-Adjacents,11692
Ferdinandusa_cordata,3,3,0,Points-PointsKO-Adjacents,27
Ferdinandusa_dissimiliflora,9,2,7,Points-PointsKO-Adjacents,66
Ferdinandusa_edmundoi,64,45,19,Alphahull-PointsKO-Adjacents,1140
Ferdinandusa_elliptica,488,423,65,Alphahull-PointsKO-Adjacents,26137
Ferdinandusa_goudotiana,92,62,30,Alphahull-PointsKO-Adjacents,4967
Ferdinandusa_guainiae,92,58,34,Alphahull-PointsKO-Adjacents,4151
Ferdinandusa_hirsuta,19,6,13,Points-PointsKO-Adjacents,134
Ferdinandusa_leucantha,2,2,0,Points-PointsKO-Adjacents,18
Ferdinandusa_loretensis,73,43,30,Alphahull-PointsKO-Adjacents,3650
Ferdinandusa_neblinensis,14,0,14,Points-PointsKO-Adjacents,54
Ferdinandusa_nitida,4,4,0,Points-PointsKO-Adjacents,34
Ferdinandusa_panamensis,84,64,20,Alphahull-PointsKO-Adjacents,611
Ferdinandusa_paporiensis,1,1,0,Points-PointsKO-Adjacents,9
Ferdinandusa_paraensis,89,39,50,Alphahull-PointsKO-Adjacents,5559
Ferdinandusa_rudgeoides,113,62,51,Alphahull-PointsKO-Adjacents,8385
Ferdinandusa_speciosa,296,252,44,Alphahull-PointsKO-Adjacents,17401
Ferdinandusa_sprucei,40,22,18,Alphahull-PointsKO-Adjacents,2282
Ferdinandusa_uaupensis,120,61,59,Alphahull-PointsKO-Adjacents,5167
Feretia_aeruginescens,41,19,22,Points-PointsKO-Adjacents,325
Feretia_apodanthera,515,440,75,Alphahull-PointsKO-Adjacents,8093
Fernandoa_abbreviata,6,1,5,Points-PointsKO-Adjacents,54
Fernandoa_adenophylla,8,0,8,Points-PointsKO-Adjacents,66
Fernandoa_adolfi-friderici,23,10,13,Points-PointsKO-Adjacents,156
Fernandoa_bracteata,0,0,0,NA,0
Fernandoa_brilletii,1,1,0,Points-PointsKO-Adjacents,9
Fernandoa_coccinea,21,4,17,Points-PointsKO-Adjacents,161
Fernandoa_collignonii,1,1,0,Points-PointsKO-Adjacents,9
Fernandoa_ferdinandi,7,1,6,Points-PointsKO-Adjacents,63
Fernandoa_guangxiensis,1,1,0,Points-PointsKO-Adjacents,9
Fernandoa_lutea,2,2,0,Points-PointsKO-Adjacents,12
Fernandoa_macrantha,7,0,7,Points-PointsKO-Adjacents,63
Fernandoa_macroloba,0,0,0,NA,0
Fernandoa_madagascariensis,63,45,18,Alphahull-PointsKO-Adjacents,1682
Fernandoa_magnifica,16,3,13,Points-PointsKO-Adjacents,142
Fernandoa_serrata,5,5,0,Points-PointsKO-Adjacents,28
Fernelia_buxifolia,2,2,0,Points-PointsKO-Adjacents,12
Fernelia_obovata,0,0,0,NA,0
Ferocactus_diguetii,9,5,4,Points-PointsKO-Adjacents,30
Ferocactus_gracilis,48,40,8,Alphahull-PointsKO-Adjacents,261
Ferocactus_wislizeni,1139,1033,106,Alphahull-PointsKO-Adjacents,2266
Feuilleea_vitiensis,0,0,0,NA,0
Ficus_abelii,107,64,43,Alphahull-PointsKO-Adjacents,7145
Ficus_abscondita,6,0,6,Points-PointsKO-Adjacents,50
Ficus_abutilifolia,251,0,251,Points-PointsKO-Adjacents,1800
Ficus_acamptophylla,10,3,7,Points-PointsKO-Adjacents,71
Ficus_acreana,8,0,8,Points-PointsKO-Adjacents,66
Ficus_aculeata,1723,1625,98,Alphahull-PointsKO-Adjacents,19294
Ficus_adelpha,13,8,5,Points-PointsKO-Adjacents,84
Ficus_adenosperma,480,0,480,Points-PointsKO-Adjacents,2104
Ficus_adhatodifolia,928,799,129,Alphahull-PointsKO-Adjacents,43230
Ficus_adolphi-friderici,0,0,0,NA,0
Ficus_albert-smithii,142,72,70,Alphahull-PointsKO-Adjacents,17745
Ficus_albipila,82,50,32,Alphahull-PointsKO-Adjacents,650
Ficus_alongensis,1,1,0,Points-PointsKO-Adjacents,9
Ficus_altissima,68,33,35,Alphahull-PointsKO-Adjacents,2939
Ficus_amadiensis,8,0,8,Points-PointsKO-Adjacents,72
Ficus_amazonica,65,18,47,Points-PointsKO-Adjacents,469
Ficus_americana,1804,1613,191,Alphahull-PointsKO-Adjacents,52633
Ficus_ampana,11,3,8,Points-PointsKO-Adjacents,78
Ficus_ampelas,315,249,66,Alphahull-PointsKO-Adjacents,937
Ficus_ampelos,53,22,31,Alphahull-PointsKO-Adjacents,1362
Ficus_amplissima,4,1,3,Points-PointsKO-Adjacents,36
Ficus_anastomosans,3,3,0,Points-PointsKO-Adjacents,18
Ficus_andamanica,NA,NA,NA,NA,NA
Ficus_androchaete,8,0,8,Points-PointsKO-Adjacents,63
Ficus_annulata,78,24,54,Alphahull-PointsKO-Adjacents,1128
Ficus_anserina,1,1,0,Points-PointsKO-Adjacents,9
Ficus_antandronarum,83,59,24,Alphahull-PointsKO-Adjacents,616
Ficus_apiocarpa,7,0,7,Points-PointsKO-Adjacents,63
Ficus_apollinaris,136,80,56,Alphahull-PointsKO-Adjacents,1470
Ficus_arawaensis,0,0,0,NA,0
Ficus_archboldiana,5,5,0,Points-PointsKO-Adjacents,41
Ficus_archeri,2,2,0,Points-PointsKO-Adjacents,18
Ficus_ardisioides,31,8,23,Points-PointsKO-Adjacents,246
Ficus_arfakensis,90,50,40,Alphahull-PointsKO-Adjacents,2230
Ficus_aripuanensis,9,2,7,Points-PointsKO-Adjacents,75
Ficus_armitii,58,29,29,Alphahull-PointsKO-Adjacents,1366
Ficus_arnottiana,0,0,0,NA,0
Ficus_aspera,2,2,0,Points-PointsKO-Adjacents,15
Ficus_asperifolia,289,211,78,Alphahull-PointsKO-Adjacents,12583
Ficus_asperula,33,24,9,Alphahull-PointsKO-Adjacents,100
Ficus_assimilis,13,3,10,Points-PointsKO-Adjacents,96
Ficus_atricha,321,294,27,Alphahull-PointsKO-Adjacents,4619
Ficus_aurantiacifolia,NA,NA,NA,NA,NA
Ficus_aurata,89,1,88,Points-PointsKO-Adjacents,610
Ficus_aurea,813,668,145,Alphahull-PointsKO-Adjacents,14142
Ficus_aureobrunnea,NA,NA,NA,NA,NA
Ficus_auricoma,0,0,0,NA,0
Ficus_auriculata,113,73,40,Alphahull-PointsKO-Adjacents,8495
Ficus_auriculigera,2,2,0,Points-PointsKO-Adjacents,17
Ficus_aurita,33,6,27,Points-PointsKO-Adjacents,244
Ficus_austrina,17,2,15,Points-PointsKO-Adjacents,106
Ficus_austrocaledonica,59,47,12,Alphahull-PointsKO-Adjacents,180
Ficus_baccaureoides,0,0,0,NA,0
Ficus_badiopurpurea,1,1,0,Points-PointsKO-Adjacents,9
Ficus_bahiensis,102,60,42,Alphahull-PointsKO-Adjacents,3398
Ficus_balete,2,2,0,Points-PointsKO-Adjacents,18
Ficus_balica,0,0,0,NA,0
Ficus_bambusifolia,2,2,0,Points-PointsKO-Adjacents,18
Ficus_banahaensis,6,0,6,Points-PointsKO-Adjacents,53
Ficus_banosensis,13,6,7,Points-PointsKO-Adjacents,72
Ficus_barclayana,3,3,0,Points-PointsKO-Adjacents,11
Ficus_barraui,0,0,0,NA,0
Ficus_barteri,62,28,34,Alphahull-PointsKO-Adjacents,999
Ficus_bataanensis,8,1,7,Points-PointsKO-Adjacents,61
Ficus_beccarii,9,4,5,Points-PointsKO-Adjacents,46
Ficus_beddomei,0,0,0,NA,0
Ficus_beipeiensis,0,0,0,NA,0
Ficus_benghalensis,27,2,25,Points-PointsKO-Adjacents,212
Ficus_benguetensis,49,19,30,Points-PointsKO-Adjacents,338
Ficus_benjamina,531,326,205,Alphahull-PointsKO-Adjacents,6105
Ficus_bernaysii,75,50,25,Alphahull-PointsKO-Adjacents,1492
Ficus_binnendijkii,8,0,8,Points-PointsKO-Adjacents,63
Ficus_bivalvata,3,3,0,Points-PointsKO-Adjacents,26
Ficus_bizanae,7,2,5,Points-PointsKO-Adjacents,54
Ficus_blepharophylla,3,3,0,Points-PointsKO-Adjacents,27
Ficus_boanensis,1,1,0,Points-PointsKO-Adjacents,9
Ficus_bojeri,2,2,0,Points-PointsKO-Adjacents,6
Ficus_boliviana,53,28,25,Alphahull-PointsKO-Adjacents,1504
Ficus_bonijesulapensis,56,41,15,Alphahull-PointsKO-Adjacents,1879
Ficus_boninsimae,2,2,0,Points-PointsKO-Adjacents,7
Ficus_borneensis,3,3,0,Points-PointsKO-Adjacents,24
Ficus_botryocarpa,36,5,31,Points-PointsKO-Adjacents,254
Ficus_botryoides,32,13,19,Points-PointsKO-Adjacents,216
Ficus_bougainvillei,0,0,0,NA,0
Ficus_brachyclada,134,110,24,Alphahull-PointsKO-Adjacents,1453
Ficus_brachypoda,1400,1309,91,Alphahull-PointsKO-Adjacents,30863
Ficus_bracteata,1,1,0,Points-PointsKO-Adjacents,9
Ficus_brasiliensis,NA,NA,NA,NA,NA
Ficus_brenesii,25,15,10,Points-PointsKO-Adjacents,102
Ficus_brevibracteata,186,149,37,Alphahull-PointsKO-Adjacents,3211
Ficus_brittonii,0,0,0,NA,0
Ficus_broadwayi,45,8,37,Points-PointsKO-Adjacents,358
Ficus_bruneiensis,3,3,0,Points-PointsKO-Adjacents,27
Ficus_brunneoaurata,7,0,7,Points-PointsKO-Adjacents,63
Ficus_bubu,30,4,26,Points-PointsKO-Adjacents,217
Ficus_bullenei,67,36,31,Alphahull-PointsKO-Adjacents,907
Ficus_burretiana,8,1,7,Points-PointsKO-Adjacents,54
Ficus_burtt-davyi,63,0,63,Points-PointsKO-Adjacents,524
Ficus_bussei,17,5,12,Points-PointsKO-Adjacents,130
Ficus_caatingae,40,29,11,Alphahull-PointsKO-Adjacents,1216
Ficus_caballina,281,186,95,Alphahull-PointsKO-Adjacents,36868
Ficus_cahuitensis,52,37,15,Alphahull-PointsKO-Adjacents,194
Ficus_calcarata,3,3,0,Points-PointsKO-Adjacents,23
Ficus_calcicola,1,1,0,Points-PointsKO-Adjacents,9
Ficus_caldasiana,91,60,31,Alphahull-PointsKO-Adjacents,1271
Ficus_calimana,30,16,14,Points-PointsKO-Adjacents,205
Ficus_callophylla,19,0,19,Points-PointsKO-Adjacents,144
Ficus_callosa,19,2,17,Points-PointsKO-Adjacents,152
Ficus_calopilina,58,39,19,Alphahull-PointsKO-Adjacents,1337
Ficus_calyculata,29,17,12,Points-PointsKO-Adjacents,165
Ficus_calyptrata,13,4,9,Points-PointsKO-Adjacents,105
Ficus_calyptroceras,265,202,63,Alphahull-PointsKO-Adjacents,19536
Ficus_capillipes,5,5,0,Points-PointsKO-Adjacents,45
Ficus_capreifolia,146,83,63,Alphahull-PointsKO-Adjacents,2518
Ficus_carautana,26,18,8,Points-PointsKO-Adjacents,143
Ficus_carchiana,14,4,10,Points-PointsKO-Adjacents,100
Ficus_carica,6747,5443,1304,Alphahull-PointsKO-Adjacents,23541
Ficus_carinata,0,0,0,NA,0
Ficus_carpenteriana,2,2,0,Points-PointsKO-Adjacents,16
Ficus_cartagenensis,1,0,1,Points-PointsKO-Adjacents,7
Ficus_casapiensis,42,15,27,Points-PointsKO-Adjacents,351
Ficus_casearioides,86,59,27,Alphahull-PointsKO-Adjacents,1711
Ficus_cassidyana,1,1,0,Points-PointsKO-Adjacents,8
Ficus_castellviana,132,61,71,Alphahull-PointsKO-Adjacents,4694
Ficus_catappifolia,82,24,58,Alphahull-PointsKO-Adjacents,4692
Ficus_cataractorum,2,2,0,Points-PointsKO-Adjacents,16
Ficus_caulocarpa,60,25,35,Alphahull-PointsKO-Adjacents,292
Ficus_cauta,1,1,0,Points-PointsKO-Adjacents,9
Ficus_cavronii,NA,NA,NA,NA,NA
Ficus_celebensis,0,0,0,NA,0
Ficus_cerasicarpa,0,0,0,NA,0
Ficus_cereicarpa,5,5,0,Points-PointsKO-Adjacents,36
Ficus_cervantesiana,99,53,46,Alphahull-PointsKO-Adjacents,930
Ficus_cestrifolia,365,285,80,Alphahull-PointsKO-Adjacents,6435
Ficus_chaetostyla,0,0,0,NA,0
Ficus_chapaensis,35,23,12,Alphahull-PointsKO-Adjacents,845
Ficus_chaparensis,3,3,0,Points-PointsKO-Adjacents,27
Ficus_chaponensis,1,1,0,Points-PointsKO-Adjacents,9
Ficus_chartacea,88,33,55,Alphahull-PointsKO-Adjacents,1522
Ficus_chirindensis,3,3,0,Points-PointsKO-Adjacents,27
Ficus_chlamydocarpa,9,1,8,Points-PointsKO-Adjacents,66
Ficus_chocoensis,29,12,17,Points-PointsKO-Adjacents,234
Ficus_christianii,38,6,32,Points-PointsKO-Adjacents,327
Ficus_chrysochaete,0,0,0,NA,0
Ficus_chrysolepis,10,2,8,Points-PointsKO-Adjacents,75
Ficus_citrifolia,1931,1621,310,Alphahull-PointsKO-Adjacents,111887
Ficus_clusiifolia,45,0,45,Points-PointsKO-Adjacents,316
Ficus_coerulescens,246,175,71,Alphahull-PointsKO-Adjacents,17084
Ficus_colubrinae,343,294,49,Alphahull-PointsKO-Adjacents,2273
Ficus_comitis,23,10,13,Points-PointsKO-Adjacents,101
Ficus_complexa,24,14,10,Points-PointsKO-Adjacents,102
Ficus_concinna,67,25,42,Alphahull-PointsKO-Adjacents,1813
Ficus_congesta,88,46,42,Alphahull-PointsKO-Adjacents,1618
Ficus_conglobata,0,0,0,NA,0
Ficus_conocephalifolia,35,18,17,Points-PointsKO-Adjacents,171
Ficus_conraui,42,14,28,Points-PointsKO-Adjacents,329
Ficus_consociata,20,0,20,Points-PointsKO-Adjacents,161
Ficus_copiosa,203,128,75,Alphahull-PointsKO-Adjacents,3271
Ficus_cordata,152,94,58,Alphahull-PointsKO-Adjacents,10728
Ficus_cordatula,4,4,0,Points-PointsKO-Adjacents,33
Ficus_corneri,1,1,0,Points-PointsKO-Adjacents,9
Ficus_corneriana,NA,NA,NA,NA,NA
Ficus_coronata,2740,2533,207,Alphahull-PointsKO-Adjacents,5398
Ficus_coronulata,433,407,26,Alphahull-PointsKO-Adjacents,5791
Ficus_costaricana,258,200,58,Alphahull-PointsKO-Adjacents,4156
Ficus_costata,6,2,4,Points-PointsKO-Adjacents,50
Ficus_cotinifolia,892,769,123,Alphahull-PointsKO-Adjacents,13870
Ficus_crassicosta,9,0,9,Points-PointsKO-Adjacents,78
Ficus_crassinervia,374,301,73,Alphahull-PointsKO-Adjacents,7594
Ficus_crassipes,54,41,13,Alphahull-PointsKO-Adjacents,115
Ficus_crassiramea,44,0,44,Points-PointsKO-Adjacents,290
Ficus_crassiuscula,116,72,44,Alphahull-PointsKO-Adjacents,1391
Ficus_craterostoma,126,51,75,Alphahull-PointsKO-Adjacents,3000
Ficus_cremersii,8,1,7,Points-PointsKO-Adjacents,66
Ficus_crescentioides,1,1,0,Points-PointsKO-Adjacents,9
Ficus_crocata,763,537,226,Alphahull-PointsKO-Adjacents,63024
Ficus_cuatrecasasiana,409,327,82,Alphahull-PointsKO-Adjacents,8343
Ficus_cucurbitina,4,4,0,Points-PointsKO-Adjacents,24
Ficus_cumingii,60,31,29,Alphahull-PointsKO-Adjacents,682
Ficus_cundinamarcensis,19,10,9,Points-PointsKO-Adjacents,100
Ficus_cupulata,0,0,0,NA,0
Ficus_curtipes,16,2,14,Points-PointsKO-Adjacents,125
Ficus_cuspidata,5,5,0,Points-PointsKO-Adjacents,45
Ficus_cyathistipula,112,59,53,Alphahull-PointsKO-Adjacents,2861
Ficus_cyathistipuloides,4,4,0,Points-PointsKO-Adjacents,36
Ficus_cyclophylla,39,14,25,Points-PointsKO-Adjacents,249
Ficus_cynaroides,0,0,0,NA,0
Ficus_cyrtophylla,58,36,22,Alphahull-PointsKO-Adjacents,3256
Ficus_dalbertisii,1,1,0,Points-PointsKO-Adjacents,9
Ficus_dalhousiae,0,0,0,NA,0
Ficus_dammaropsis,42,26,16,Alphahull-PointsKO-Adjacents,841
Ficus_danielis,20,8,12,Points-PointsKO-Adjacents,156
Ficus_davidsoniae,33,18,15,Points-PointsKO-Adjacents,164
Ficus_decipiens,0,0,0,NA,0
Ficus_delosyce,9,0,9,Points-PointsKO-Adjacents,60
Ficus_deltoidea,162,118,44,Alphahull-PointsKO-Adjacents,6317
Ficus_dendrocida,119,0,119,Points-PointsKO-Adjacents,891
Ficus_densifolia,2,2,0,Points-PointsKO-Adjacents,9
Ficus_densistipulata,9,2,7,Points-PointsKO-Adjacents,81
Ficus_depressa,20,2,18,Points-PointsKO-Adjacents,131
Ficus_destruens,144,120,24,Alphahull-PointsKO-Adjacents,408
Ficus_diamantiphylla,NA,NA,NA,NA,NA
Ficus_dicranostyla,118,84,34,Alphahull-PointsKO-Adjacents,4786
Ficus_dimorpha,0,0,0,NA,0
Ficus_dissipata,0,0,0,NA,0
Ficus_diversiformis,2,2,0,Points-PointsKO-Adjacents,12
Ficus_donnell-smithii,262,145,117,Alphahull-PointsKO-Adjacents,16983
Ficus_drupacea,126,58,68,Alphahull-PointsKO-Adjacents,923
Ficus_dryepondtiana,13,2,11,Points-PointsKO-Adjacents,108
Ficus_duartei,9,1,8,Points-PointsKO-Adjacents,63
Ficus_dubia,4,4,0,Points-PointsKO-Adjacents,35
Ficus_duckeana,17,3,14,Points-PointsKO-Adjacents,139
Ficus_dugandii,45,14,31,Points-PointsKO-Adjacents,342
Ficus_dulciaria,44,29,15,Alphahull-PointsKO-Adjacents,561
Ficus_dzumacensis,16,12,4,Points-PointsKO-Adjacents,51
Ficus_edelfeltii,12,0,12,Points-PointsKO-Adjacents,84
Ficus_elastica,6,1,5,Points-PointsKO-Adjacents,54
Ficus_elasticoides,22,6,16,Points-PointsKO-Adjacents,174
Ficus_eliadis,13,3,10,Points-PointsKO-Adjacents,88
Ficus_elmeri,3,2,1,Points-PointsKO-Adjacents,27
Ficus_endochaete,37,24,13,Alphahull-PointsKO-Adjacents,224
Ficus_endospermifolia,10,5,5,Points-PointsKO-Adjacents,31
Ficus_enormis,509,434,75,Alphahull-PointsKO-Adjacents,22708
Ficus_erecta,838,574,264,Alphahull-PointsKO-Adjacents,10046
Ficus_erinobotrya,14,5,9,Points-PointsKO-Adjacents,81
Ficus_erythrosperma,189,137,52,Alphahull-PointsKO-Adjacents,2809
Ficus_esquiroliana,38,15,23,Points-PointsKO-Adjacents,252
Ficus_estanislana,0,0,0,NA,0
Ficus_eumorpha,2,2,0,Points-PointsKO-Adjacents,18
Ficus_eustephana,3,3,0,Points-PointsKO-Adjacents,27
Ficus_exasperata,396,304,92,Alphahull-PointsKO-Adjacents,13533
Ficus_eximia,517,402,115,Alphahull-PointsKO-Adjacents,26474
Ficus_faulkneriana,10,5,5,Points-PointsKO-Adjacents,48
Ficus_fergusonii,1,1,0,Points-PointsKO-Adjacents,9
Ficus_filicauda,8,0,8,Points-PointsKO-Adjacents,72
Ficus_fischeri,9,2,7,Points-PointsKO-Adjacents,72
Ficus_fiskei,8,1,7,Points-PointsKO-Adjacents,58
Ficus_fistulosa,397,274,123,Alphahull-PointsKO-Adjacents,5821
Ficus_flagellaris,1,1,0,Points-PointsKO-Adjacents,9
Ficus_floresana,NA,NA,NA,NA,NA
Ficus_forstenii,18,3,15,Points-PointsKO-Adjacents,154
Ficus_francisci,5,0,5,Points-PointsKO-Adjacents,27
Ficus_francoae,10,4,6,Points-PointsKO-Adjacents,84
Ficus_fraseri,0,0,0,NA,0
Ficus_fresnoensis,9,0,9,Points-PointsKO-Adjacents,55
Ficus_fulva,103,47,56,Alphahull-PointsKO-Adjacents,3094
Ficus_fulvopilosa,0,0,0,NA,0
Ficus_gasparriniana,61,21,40,Alphahull-PointsKO-Adjacents,2023
Ficus_geniculata,7,2,5,Points-PointsKO-Adjacents,63
Ficus_geocarpa,0,0,0,NA,0
Ficus_geocharis,3,3,0,Points-PointsKO-Adjacents,27
Ficus_gibbsiae,17,7,10,Points-PointsKO-Adjacents,108
Ficus_gigantifolia,0,0,0,NA,0
Ficus_gigantosyce,82,51,31,Alphahull-PointsKO-Adjacents,1559
Ficus_gilapong,0,0,0,NA,0
Ficus_glaberrima,80,36,44,Alphahull-PointsKO-Adjacents,5290
Ficus_glabristipulata,NA,NA,NA,NA,NA
Ficus_glandulifera,63,21,42,Alphahull-PointsKO-Adjacents,664
Ficus_glareosa,3,3,0,Points-PointsKO-Adjacents,21
Ficus_glumosa,731,595,136,Alphahull-PointsKO-Adjacents,14424
Ficus_godeffroyi,5,0,5,Points-PointsKO-Adjacents,27
Ficus_gomelleira,916,760,156,Alphahull-PointsKO-Adjacents,99092
Ficus_goniophylla,0,0,0,NA,0
Ficus_gracilis,1,1,0,Points-PointsKO-Adjacents,9
Ficus_gracillima,47,23,24,Alphahull-PointsKO-Adjacents,1100
Ficus_granatum,10,2,8,Points-PointsKO-Adjacents,61
Ficus_gratiosa,0,0,0,NA,0
Ficus_greenwoodii,1,1,0,Points-PointsKO-Adjacents,9
Ficus_grevei,35,21,14,Alphahull-PointsKO-Adjacents,430
Ficus_grewiifolia,9,0,9,Points-PointsKO-Adjacents,81
Ficus_griffithii,0,0,0,NA,0
Ficus_grossularioides,42,15,27,Points-PointsKO-Adjacents,315
Ficus_gryllus,0,0,0,NA,0
Ficus_guajavoides,16,11,5,Points-PointsKO-Adjacents,90
Ficus_guatiquiae,2,2,0,Points-PointsKO-Adjacents,18
Ficus_guayaquilensis,0,0,0,NA,0
Ficus_gul,163,102,61,Alphahull-PointsKO-Adjacents,3087
Ficus_guntheri,1,1,0,Points-PointsKO-Adjacents,9
Ficus_habrophylla,30,21,9,Alphahull-PointsKO-Adjacents,159
Ficus_hadroneura,9,2,7,Points-PointsKO-Adjacents,57
Ficus_hahliana,14,7,7,Points-PointsKO-Adjacents,77
Ficus_halmaherae,NA,NA,NA,NA,NA
Ficus_hartwegii,256,235,21,Alphahull-PointsKO-Adjacents,2649
Ficus_hatschbachii,9,1,8,Points-PointsKO-Adjacents,74
Ficus_hebetifolia,19,0,19,Points-PointsKO-Adjacents,145
Ficus_hemsleyana,37,15,22,Points-PointsKO-Adjacents,273
Ficus_henryi,50,24,26,Alphahull-PointsKO-Adjacents,4041
Ficus_herthae,NA,NA,NA,NA,NA
Ficus_hesperia,0,0,0,NA,0
Ficus_hesperidiiformis,113,84,29,Alphahull-PointsKO-Adjacents,3350
Ficus_heteromorpha,145,0,145,Points-PointsKO-Adjacents,1271
Ficus_heteropleura,114,41,73,Alphahull-PointsKO-Adjacents,1336
Ficus_heteropoda,5,5,0,Points-PointsKO-Adjacents,43
Ficus_heteroselis,0,0,0,NA,0
Ficus_hirsuta,110,51,59,Alphahull-PointsKO-Adjacents,2373
Ficus_hirta,171,0,171,Points-PointsKO-Adjacents,1424
Ficus_hispida,442,317,125,Alphahull-PointsKO-Adjacents,18534
Ficus_holosericea,22,6,16,Points-PointsKO-Adjacents,152
Ficus_hombroniana,12,1,11,Points-PointsKO-Adjacents,81
Ficus_hookeriana,15,5,10,Points-PointsKO-Adjacents,135
Ficus_hotteana,NA,NA,NA,NA,NA
Ficus_huilensis,18,12,6,Points-PointsKO-Adjacents,104
Ficus_humbertii,6,3,3,Points-PointsKO-Adjacents,17
Ficus_hurlimannii,0,0,0,NA,0
Ficus_hypogaea,0,0,0,NA,0
Ficus_ihuensis,3,3,0,Points-PointsKO-Adjacents,14
Ficus_iidaiana,1,1,0,Points-PointsKO-Adjacents,9
Ficus_ilias-paiei,NA,NA,NA,NA,NA
Ficus_ilicina,36,18,18,Points-PointsKO-Adjacents,310
Ficus_illiberalis,2,2,0,Points-PointsKO-Adjacents,12
Ficus_imbricata,0,0,0,NA,0
Ficus_immanis,0,0,0,NA,0
Ficus_inaequifolia,2,2,0,Points-PointsKO-Adjacents,18
Ficus_inaequipetiolata,13,6,7,Points-PointsKO-Adjacents,102
Ficus_indigofera,1,1,0,Points-PointsKO-Adjacents,9
Ficus_ingens,426,295,131,Alphahull-PointsKO-Adjacents,11575
Ficus_insipida,408,289,119,Alphahull-PointsKO-Adjacents,44995
Ficus_intramarginalis,17,7,10,Points-PointsKO-Adjacents,106
Ficus_involucrata,1,1,0,Points-PointsKO-Adjacents,9
Ficus_iodotricha,29,19,10,Points-PointsKO-Adjacents,206
Ficus_ischnopoda,67,29,38,Alphahull-PointsKO-Adjacents,7523
Ficus_itoana,66,38,28,Alphahull-PointsKO-Adjacents,1569
Ficus_ixoroides,1,1,0,Points-PointsKO-Adjacents,9
Ficus_jacobii,30,0,30,Points-PointsKO-Adjacents,183
Ficus_jaheriana,NA,NA,NA,NA,NA
Ficus_jansii,6,0,6,Points-PointsKO-Adjacents,45
Ficus_jaramilloi,38,23,15,Alphahull-PointsKO-Adjacents,1041
Ficus_johannis,9,0,9,Points-PointsKO-Adjacents,74
Ficus_juglandiformis,2,2,0,Points-PointsKO-Adjacents,18
Ficus_kamerunensis,46,15,31,Points-PointsKO-Adjacents,365
Ficus_karthalensis,0,0,0,NA,0
Ficus_katendei,0,0,0,NA,0
Ficus_kerkhovenii,4,4,0,Points-PointsKO-Adjacents,27
Ficus_kjellbergii,1,1,0,Points-PointsKO-Adjacents,9
Ficus_kochummeniana,8,1,7,Points-PointsKO-Adjacents,62
Ficus_kofmaniae,2,2,0,Points-PointsKO-Adjacents,18
Ficus_koutumensis,1,1,0,Points-PointsKO-Adjacents,9
Ficus_krukovii,90,38,52,Alphahull-PointsKO-Adjacents,8656
Ficus_kuchinensis,3,3,0,Points-PointsKO-Adjacents,27
Ficus_kurzii,4,4,0,Points-PointsKO-Adjacents,36
Ficus_lacor,2,1,1,Points-PointsKO-Adjacents,16
Ficus_lacunata,9,7,2,Points-PointsKO-Adjacents,64
Ficus_laevicarpa,24,10,14,Points-PointsKO-Adjacents,201
Ficus_lagoensis,33,0,33,Points-PointsKO-Adjacents,272
Ficus_lamponga,11,0,11,Points-PointsKO-Adjacents,88
Ficus_lancibracteata,0,0,0,NA,0
Ficus_langkokensis,54,29,25,Alphahull-PointsKO-Adjacents,3711
Ficus_lapathifolia,60,45,15,Alphahull-PointsKO-Adjacents,699
Ficus_lasiocarpa,0,0,0,NA,0
Ficus_lasiosyce,9,3,6,Points-PointsKO-Adjacents,34
Ficus_lateriflora,1,1,0,Points-PointsKO-Adjacents,9
Ficus_latimarginata,0,0,0,NA,0
Ficus_laureola,25,11,14,Points-PointsKO-Adjacents,165
Ficus_lauretana,66,30,36,Alphahull-PointsKO-Adjacents,4158
Ficus_laurifolia,2,1,1,Points-PointsKO-Adjacents,18
Ficus_lawesii,14,2,12,Points-PointsKO-Adjacents,113
Ficus_lawrancei,1,1,0,Points-PointsKO-Adjacents,9
Ficus_lehmannii,4,4,0,Points-PointsKO-Adjacents,36
Ficus_leiocarpa,8,2,6,Points-PointsKO-Adjacents,45
Ficus_leiophylla,17,11,6,Points-PointsKO-Adjacents,117
Ficus_leonensis,8,0,8,Points-PointsKO-Adjacents,59
Ficus_lepicarpa,102,43,59,Alphahull-PointsKO-Adjacents,1937
Ficus_leptocalama,5,5,0,Points-PointsKO-Adjacents,30
Ficus_leptoclada,158,135,23,Alphahull-PointsKO-Adjacents,352
Ficus_leptodictya,11,3,8,Points-PointsKO-Adjacents,86
Ficus_leptogramma,3,3,0,Points-PointsKO-Adjacents,26
Ficus_lifouensis,4,4,0,Points-PointsKO-Adjacents,18
Ficus_lilliputiana,40,36,4,Alphahull-PointsKO-Adjacents,42
Ficus_limosa,NA,NA,NA,NA,NA
Ficus_linearifolia,2,0,2,Points-PointsKO-Adjacents,18
Ficus_lingua,52,10,42,Points-PointsKO-Adjacents,368
Ficus_litseifolia,2,2,0,Points-PointsKO-Adjacents,18
Ficus_longibracteata,0,0,0,NA,0
Ficus_longicuspidata,0,0,0,NA,0
Ficus_longifolia,38,15,23,Points-PointsKO-Adjacents,268
Ficus_longistipulata,NA,NA,NA,NA,NA
Ficus_louisii,8,0,8,Points-PointsKO-Adjacents,72
Ficus_lowii,2,2,0,Points-PointsKO-Adjacents,17
Ficus_luschnathiana,1089,985,104,Alphahull-PointsKO-Adjacents,19805
Ficus_lutea,352,217,135,Alphahull-PointsKO-Adjacents,9709
Ficus_lyrata,41,18,23,Points-PointsKO-Adjacents,226
Ficus_macbridei,369,308,61,Alphahull-PointsKO-Adjacents,9324
Ficus_machetana,2,2,0,Points-PointsKO-Adjacents,18
Ficus_machupicchuensis,9,0,9,Points-PointsKO-Adjacents,79
Ficus_macilenta,17,7,10,Points-PointsKO-Adjacents,108
Ficus_maclellandii,7,2,5,Points-PointsKO-Adjacents,63
Ficus_macrophylla,482,380,102,Alphahull-PointsKO-Adjacents,1412
Ficus_macrorrhyncha,50,27,23,Alphahull-PointsKO-Adjacents,1354
Ficus_macrostyla,1,1,0,Points-PointsKO-Adjacents,9
Ficus_macrothyrsa,1,1,0,Points-PointsKO-Adjacents,9
Ficus_madagascariensis,7,1,6,Points-PointsKO-Adjacents,63
Ficus_magdalenica,7,0,7,Points-PointsKO-Adjacents,60
Ficus_magnoliifolia,5,0,5,Points-PointsKO-Adjacents,40
Ficus_maialis,1,1,0,Points-PointsKO-Adjacents,9
Ficus_maitin,32,14,18,Points-PointsKO-Adjacents,230
Ficus_malayana,10,0,10,Points-PointsKO-Adjacents,55
Ficus_manuselensis,1,1,0,Points-PointsKO-Adjacents,7
Ficus_mariae,49,21,28,Alphahull-PointsKO-Adjacents,934
Ficus_marmorata,19,11,8,Points-PointsKO-Adjacents,88
Ficus_maroma,89,50,39,Alphahull-PointsKO-Adjacents,1260
Ficus_maroniensis,10,2,8,Points-PointsKO-Adjacents,81
Ficus_masonii,1,1,0,Points-PointsKO-Adjacents,9
Ficus_matanoensis,4,4,0,Points-PointsKO-Adjacents,36
Ficus_mathewsii,204,136,68,Alphahull-PointsKO-Adjacents,17290
Ficus_matiziana,112,52,60,Alphahull-PointsKO-Adjacents,2427
Ficus_mauritiana,1,1,0,Points-PointsKO-Adjacents,9
Ficus_maxima,2257,2010,247,Alphahull-PointsKO-Adjacents,113377
Ficus_maximoides,37,16,21,Points-PointsKO-Adjacents,298
Ficus_megaleia,18,9,9,Points-PointsKO-Adjacents,121
Ficus_megalophylla,3,3,0,Points-PointsKO-Adjacents,27
Ficus_meistosyce,8,1,7,Points-PointsKO-Adjacents,64
Ficus_melinocarpa,82,42,40,Alphahull-PointsKO-Adjacents,824
Ficus_membranacea,73,29,44,Alphahull-PointsKO-Adjacents,806
Ficus_menabeensis,51,33,18,Alphahull-PointsKO-Adjacents,666
Ficus_merrittii,0,0,0,NA,0
Ficus_microcarpa,402,220,182,Alphahull-PointsKO-Adjacents,5526
Ficus_microclada,13,1,12,Points-PointsKO-Adjacents,117
Ficus_microdictya,50,35,15,Alphahull-PointsKO-Adjacents,319
Ficus_microphylla,0,0,0,NA,0
Ficus_microsphaera,0,0,0,NA,0
Ficus_microsyce,1,1,0,Points-PointsKO-Adjacents,9
Ficus_microtophora,2,2,0,Points-PointsKO-Adjacents,12
Ficus_midotis,22,15,7,Points-PointsKO-Adjacents,147
Ficus_minahassae,12,2,10,Points-PointsKO-Adjacents,95
Ficus_miqueliana,1,1,0,Points-PointsKO-Adjacents,9
Ficus_mollicula,34,25,9,Alphahull-PointsKO-Adjacents,184
Ficus_mollior,188,134,54,Alphahull-PointsKO-Adjacents,3812
Ficus_mollis,5,0,5,Points-PointsKO-Adjacents,43
Ficus_mollissima,0,0,0,NA,0
Ficus_montana,13,0,13,Points-PointsKO-Adjacents,115
Ficus_morobensis,6,0,6,Points-PointsKO-Adjacents,39
Ficus_mucuso,152,96,56,Alphahull-PointsKO-Adjacents,4807
Ficus_muelleriana,NA,NA,NA,NA,NA
Ficus_multistipularis,0,0,0,NA,0
Ficus_mutabilis,5,5,0,Points-PointsKO-Adjacents,26
Ficus_mutisii,187,136,51,Alphahull-PointsKO-Adjacents,4799
Ficus_myiopotamica,1,1,0,Points-PointsKO-Adjacents,9
Ficus_nasuta,0,0,0,NA,0
Ficus_natalensis,160,75,85,Alphahull-PointsKO-Adjacents,2940
Ficus_neriifolia,90,66,24,Alphahull-PointsKO-Adjacents,569
Ficus_nervosa,231,0,231,Points-PointsKO-Adjacents,800
Ficus_nigropunctata,10,2,8,Points-PointsKO-Adjacents,90
Ficus_nishimurae,NA,NA,NA,NA,NA
Ficus_nitidifolia,34,23,11,Alphahull-PointsKO-Adjacents,94
Ficus_nota,6,1,5,Points-PointsKO-Adjacents,53
Ficus_novae-georgiae,1,1,0,Points-PointsKO-Adjacents,9
Ficus_novahibernica,1,1,0,Points-PointsKO-Adjacents,8
Ficus_nymphaeifolia,737,537,200,Alphahull-PointsKO-Adjacents,52225
Ficus_obliqua,804,687,117,Alphahull-PointsKO-Adjacents,5060
Ficus_obpyramidata,1,1,0,Points-PointsKO-Adjacents,9
Ficus_obscura,47,17,30,Points-PointsKO-Adjacents,321
Ficus_obtusifolia,1461,1219,242,Alphahull-PointsKO-Adjacents,102528
Ficus_obtusiuscula,445,365,80,Alphahull-PointsKO-Adjacents,48115
Ficus_ochracea,NA,NA,NA,NA,NA
Ficus_ocoana,2,2,0,Points-PointsKO-Adjacents,18
Ficus_odorata,3,3,0,Points-PointsKO-Adjacents,27
Ficus_oleifolia,108,65,43,Alphahull-PointsKO-Adjacents,1544
Ficus_oleracea,1,1,0,Points-PointsKO-Adjacents,9
Ficus_opposita,1,1,0,Points-PointsKO-Adjacents,9
Ficus_oreodryadum,6,0,6,Points-PointsKO-Adjacents,42
Ficus_oreophila,3,3,0,Points-PointsKO-Adjacents,21
Ficus_oresbia,1,1,0,Points-PointsKO-Adjacents,9
Ficus_orocuensis,52,35,17,Alphahull-PointsKO-Adjacents,1829
Ficus_orthoneura,23,12,11,Points-PointsKO-Adjacents,199
Ficus_osensis,8,1,7,Points-PointsKO-Adjacents,56
Ficus_otophora,11,3,8,Points-PointsKO-Adjacents,56
Ficus_otophoroides,8,2,6,Points-PointsKO-Adjacents,27
Ficus_ottoniifolia,103,52,51,Alphahull-PointsKO-Adjacents,3917
Ficus_ovatifolia,1,1,0,Points-PointsKO-Adjacents,9
Ficus_pachyclada,32,12,20,Points-PointsKO-Adjacents,191
Ficus_pachyneura,7,1,6,Points-PointsKO-Adjacents,40
Ficus_pachyrrhachis,15,7,8,Points-PointsKO-Adjacents,103
Ficus_pachysycia,0,0,0,NA,0
Ficus_padana,9,0,9,Points-PointsKO-Adjacents,64
Ficus_pakkensis,35,5,30,Points-PointsKO-Adjacents,271
Ficus_pallescens,2,2,0,Points-PointsKO-Adjacents,9
Ficus_pallida,147,95,52,Alphahull-PointsKO-Adjacents,3452
Ficus_palmata,38,11,27,Points-PointsKO-Adjacents,226
Ficus_paludica,20,0,20,Points-PointsKO-Adjacents,171
Ficus_pancheriana,14,6,8,Points-PointsKO-Adjacents,61
Ficus_panurensis,47,19,28,Points-PointsKO-Adjacents,399
Ficus_papuana,12,3,9,Points-PointsKO-Adjacents,88
Ficus_paracamptophylla,6,1,5,Points-PointsKO-Adjacents,45
Ficus_paraensis,949,825,124,Alphahull-PointsKO-Adjacents,81147
Ficus_parietalis,44,16,28,Points-PointsKO-Adjacents,337
Ficus_parvibracteata,0,0,0,NA,0
Ficus_patellata,1,1,0,Points-PointsKO-Adjacents,9
Ficus_pedunculosa,53,28,25,Alphahull-PointsKO-Adjacents,393
Ficus_pellucidopunctata,19,5,14,Points-PointsKO-Adjacents,149
Ficus_pertusa,2994,2666,328,Alphahull-PointsKO-Adjacents,145921
Ficus_petiolaris,380,327,53,Alphahull-PointsKO-Adjacents,6142
Ficus_phaeosyce,37,21,16,Alphahull-PointsKO-Adjacents,233
Ficus_phanrangensis,1,1,0,Points-PointsKO-Adjacents,9
Ficus_pilulifera,5,0,5,Points-PointsKO-Adjacents,33
Ficus_piresiana,100,45,55,Alphahull-PointsKO-Adjacents,3569
Ficus_pisifera,83,34,49,Alphahull-PointsKO-Adjacents,2514
Ficus_pisocarpa,26,5,21,Points-PointsKO-Adjacents,207
Ficus_platyphylla,159,115,44,Alphahull-PointsKO-Adjacents,5220
Ficus_platypoda,497,424,73,Alphahull-PointsKO-Adjacents,14374
Ficus_pleurocarpa,91,80,11,Alphahull-PointsKO-Adjacents,150
Ficus_pleyteana,0,0,0,NA,0
Ficus_podocarpifolia,37,27,10,Alphahull-PointsKO-Adjacents,211
Ficus_polita,172,89,83,Alphahull-PointsKO-Adjacents,4693
Ficus_politoria,317,291,26,Alphahull-PointsKO-Adjacents,2957
Ficus_polyantha,25,6,19,Points-PointsKO-Adjacents,126
Ficus_polyphlebia,60,40,20,Alphahull-PointsKO-Adjacents,830
Ficus_popayanensis,4,0,4,Points-PointsKO-Adjacents,36
Ficus_popenoei,156,87,69,Alphahull-PointsKO-Adjacents,5321
Ficus_populifolia,48,24,24,Alphahull-PointsKO-Adjacents,491
Ficus_porphyrochaete,14,5,9,Points-PointsKO-Adjacents,74
Ficus_porrecta,0,0,0,NA,0
Ficus_praestans,13,5,8,Points-PointsKO-Adjacents,68
Ficus_praetermissa,5,5,0,Points-PointsKO-Adjacents,36
Ficus_preussii,23,7,16,Points-PointsKO-Adjacents,176
Ficus_primaria,14,6,8,Points-PointsKO-Adjacents,72
Ficus_pritchardii,2,2,0,Points-PointsKO-Adjacents,3
Ficus_profusa,0,0,0,NA,0
Ficus_prolixa,19,0,19,Points-PointsKO-Adjacents,100
Ficus_prostrata,2,2,0,Points-PointsKO-Adjacents,18
Ficus_pseudojaca,8,4,4,Points-PointsKO-Adjacents,34
Ficus_pseudomangifera,30,10,20,Points-PointsKO-Adjacents,218
Ficus_pseudopalma,10,7,3,Points-PointsKO-Adjacents,70
Ficus_pseudowassa,5,5,0,Points-PointsKO-Adjacents,42
Ficus_pteroporum,2,2,0,Points-PointsKO-Adjacents,17
Ficus_pubigera,37,11,26,Points-PointsKO-Adjacents,320
Ficus_pubilimba,1,1,0,Points-PointsKO-Adjacents,9
Ficus_pulchella,128,64,64,Alphahull-PointsKO-Adjacents,2156
Ficus_pungens,132,95,37,Alphahull-PointsKO-Adjacents,3795
Ficus_pustulata,8,1,7,Points-PointsKO-Adjacents,66
Ficus_pygmaea,39,24,15,Alphahull-PointsKO-Adjacents,1287
Ficus_pyriformis,62,30,32,Alphahull-PointsKO-Adjacents,2168
Ficus_quercetorum,23,12,11,Points-PointsKO-Adjacents,136
Ficus_quichauensis,NA,NA,NA,NA,NA
Ficus_quijosana,22,15,7,Points-PointsKO-Adjacents,132
Ficus_racemigera,46,35,11,Alphahull-PointsKO-Adjacents,107
Ficus_racemosa,862,741,121,Alphahull-PointsKO-Adjacents,14632
Ficus_recurvata,7,0,7,Points-PointsKO-Adjacents,54
Ficus_reflexa,238,203,35,Alphahull-PointsKO-Adjacents,5838
Ficus_religiosa,6,0,6,Points-PointsKO-Adjacents,54
Ficus_retusa,4,0,4,Points-PointsKO-Adjacents,36
Ficus_rheedei,NA,NA,NA,NA,NA
Ficus_rhizophoriphylla,18,3,15,Points-PointsKO-Adjacents,92
Ficus_ribes,27,5,22,Points-PointsKO-Adjacents,211
Ficus_richteri,6,1,5,Points-PointsKO-Adjacents,54
Ficus_ridleyana,0,0,0,NA,0
Ficus_rieberiana,13,5,8,Points-PointsKO-Adjacents,105
Ficus_riedelii,12,2,10,Points-PointsKO-Adjacents,96
Ficus_rigo,2,1,1,Points-PointsKO-Adjacents,18
Ficus_robusta,5,5,0,Points-PointsKO-Adjacents,27
Ficus_romeroi,16,10,6,Points-PointsKO-Adjacents,133
Ficus_roraimensis,2,2,0,Points-PointsKO-Adjacents,18
Ficus_rosulata,7,1,6,Points-PointsKO-Adjacents,63
Ficus_rubiginosa,2374,2092,282,Alphahull-PointsKO-Adjacents,15697
Ficus_rubra,26,6,20,Points-PointsKO-Adjacents,184
Ficus_rubrocuspidata,11,2,9,Points-PointsKO-Adjacents,99
Ficus_rubromidotis,2,2,0,Points-PointsKO-Adjacents,9
Ficus_rubrosyce,NA,NA,NA,NA,NA
Ficus_ruficaulis,41,24,17,Alphahull-PointsKO-Adjacents,191
Ficus_rumphii,19,2,17,Points-PointsKO-Adjacents,157
Ficus_ruyuanensis,3,3,0,Points-PointsKO-Adjacents,27
Ficus_rzedowskiana,15,0,15,Points-PointsKO-Adjacents,96
Ficus_saccata,16,2,14,Points-PointsKO-Adjacents,96
Ficus_sagittata,53,10,43,Points-PointsKO-Adjacents,408
Ficus_salomonensis,0,0,0,NA,0
Ficus_samoensis,1,1,0,Points-PointsKO-Adjacents,9
Ficus_sansibarica,38,14,24,Points-PointsKO-Adjacents,300
Ficus_saruensis,5,5,0,Points-PointsKO-Adjacents,22
Ficus_satterthwaitei,7,1,6,Points-PointsKO-Adjacents,58
Ficus_saurauioides,NA,NA,NA,NA,NA
Ficus_saussureana,83,56,27,Alphahull-PointsKO-Adjacents,1960
Ficus_saxophila,8,0,8,Points-PointsKO-Adjacents,38
Ficus_scabra,7,1,6,Points-PointsKO-Adjacents,49
Ficus_scaposa,0,0,0,NA,0
Ficus_scassellatii,37,9,28,Points-PointsKO-Adjacents,291
Ficus_schefferiana,5,5,0,Points-PointsKO-Adjacents,45
Ficus_schippii,64,41,23,Alphahull-PointsKO-Adjacents,3278
Ficus_schultesii,35,0,35,Points-PointsKO-Adjacents,242
Ficus_schumacheri,41,10,31,Points-PointsKO-Adjacents,310
Ficus_schumanniana,NA,NA,NA,NA,NA
Ficus_schwarzii,53,16,37,Points-PointsKO-Adjacents,386
Ficus_sciaphila,4,4,0,Points-PointsKO-Adjacents,29
Ficus_sclerosycia,2,2,0,Points-PointsKO-Adjacents,12
Ficus_scobina,775,740,35,Alphahull-PointsKO-Adjacents,3382
Ficus_scopulifera,3,3,0,Points-PointsKO-Adjacents,27
Ficus_scortechinii,5,4,1,Points-PointsKO-Adjacents,45
Ficus_scott-elliottii,15,3,12,Points-PointsKO-Adjacents,123
Ficus_semicordata,64,37,27,Alphahull-PointsKO-Adjacents,1874
Ficus_semivestita,9,2,7,Points-PointsKO-Adjacents,60
Ficus_septica,645,468,177,Alphahull-PointsKO-Adjacents,8606
Ficus_serraria,2,2,0,Points-PointsKO-Adjacents,18
Ficus_setiflora,20,10,10,Points-PointsKO-Adjacents,84
Ficus_simplicissima,72,34,38,Alphahull-PointsKO-Adjacents,1857
Ficus_sinuata,49,0,49,Points-PointsKO-Adjacents,336
Ficus_smithii,5,5,0,Points-PointsKO-Adjacents,40
Ficus_soatensis,16,10,6,Points-PointsKO-Adjacents,69
Ficus_soepadmoi,1,1,0,Points-PointsKO-Adjacents,9
Ficus_spathulifolia,7,0,7,Points-PointsKO-Adjacents,47
Ficus_sphenophylla,126,85,41,Alphahull-PointsKO-Adjacents,13628
Ficus_squamosa,7,1,6,Points-PointsKO-Adjacents,63
Ficus_stellaris,29,12,17,Points-PointsKO-Adjacents,152
Ficus_stenophylla,72,43,29,Alphahull-PointsKO-Adjacents,6319
Ficus_stolonifera,8,1,7,Points-PointsKO-Adjacents,62
Ficus_storckii,1,1,0,Points-PointsKO-Adjacents,9
Ficus_stricta,7,0,7,Points-PointsKO-Adjacents,57
Ficus_stuhlmannii,61,31,30,Alphahull-PointsKO-Adjacents,1152
Ficus_subandina,127,87,40,Alphahull-PointsKO-Adjacents,2697
Ficus_subcaudata,NA,NA,NA,NA,NA
Ficus_subcongesta,17,4,13,Points-PointsKO-Adjacents,78
Ficus_subcordata,33,0,33,Points-PointsKO-Adjacents,208
Ficus_subcostata,8,0,8,Points-PointsKO-Adjacents,63
Ficus_subcuneata,68,41,27,Alphahull-PointsKO-Adjacents,1537
Ficus_subfulva,1,1,0,Points-PointsKO-Adjacents,9
Ficus_subgelderi,7,1,6,Points-PointsKO-Adjacents,54
Ficus_subglabritepala,NA,NA,NA,NA,NA
Ficus_subincisa,55,29,26,Alphahull-PointsKO-Adjacents,3170
Ficus_sublimbata,10,3,7,Points-PointsKO-Adjacents,59
Ficus_subnervosa,26,9,17,Points-PointsKO-Adjacents,158
Ficus_subpisocarpa,173,104,69,Alphahull-PointsKO-Adjacents,2731
Ficus_subpuberula,201,174,27,Alphahull-PointsKO-Adjacents,4465
Ficus_subsagittifolia,15,6,9,Points-PointsKO-Adjacents,120
Ficus_subterranea,3,3,0,Points-PointsKO-Adjacents,12
Ficus_subtrinervia,80,48,32,Alphahull-PointsKO-Adjacents,1468
Ficus_subulata,400,269,131,Alphahull-PointsKO-Adjacents,7155
Ficus_sulcata,0,0,0,NA,0
Ficus_sumatrana,42,6,36,Points-PointsKO-Adjacents,322
Ficus_sundaica,59,23,36,Alphahull-PointsKO-Adjacents,2209
Ficus_superba,8,1,7,Points-PointsKO-Adjacents,59
Ficus_supperforata,2,2,0,Points-PointsKO-Adjacents,18
Ficus_sur,1043,858,185,Alphahull-PointsKO-Adjacents,37932
Ficus_sycomorus,532,335,197,Alphahull-PointsKO-Adjacents,23977
Ficus_talbotii,7,0,7,Points-PointsKO-Adjacents,62
Ficus_tanypoda,2,2,0,Points-PointsKO-Adjacents,9
Ficus_tarennifolia,4,4,0,Points-PointsKO-Adjacents,18
Ficus_tenuicuspidata,NA,NA,NA,NA,NA
Ficus_tepuiensis,11,3,8,Points-PointsKO-Adjacents,71
Ficus_tequendamae,14,5,9,Points-PointsKO-Adjacents,81
Ficus_ternatana,2,2,0,Points-PointsKO-Adjacents,5
Ficus_tesselata,15,4,11,Points-PointsKO-Adjacents,116
Ficus_tettensis,28,19,9,Points-PointsKO-Adjacents,220
Ficus_theophrastoides,1,1,0,Points-PointsKO-Adjacents,9
Ficus_thonningii,729,543,186,Alphahull-PointsKO-Adjacents,34448
Ficus_tiliifolia,81,50,31,Alphahull-PointsKO-Adjacents,1160
Ficus_tinctoria,398,210,188,Alphahull-PointsKO-Adjacents,10251
Ficus_tonduzii,597,519,78,Alphahull-PointsKO-Adjacents,11854
Ficus_tonsa,1,0,1,Points-PointsKO-Adjacents,9
Ficus_torrentium,14,1,13,Points-PointsKO-Adjacents,101
Ficus_tovarensis,14,5,9,Points-PointsKO-Adjacents,92
Ficus_trachypison,96,63,33,Alphahull-PointsKO-Adjacents,2875
Ficus_trapezicola,10,1,9,Points-PointsKO-Adjacents,89
Ficus_travancorica,NA,NA,NA,NA,NA
Ficus_tremula,40,13,27,Points-PointsKO-Adjacents,271
Ficus_treubii,17,8,9,Points-PointsKO-Adjacents,107
Ficus_trianae,67,49,18,Alphahull-PointsKO-Adjacents,749
Ficus_trichocarpa,13,0,13,Points-PointsKO-Adjacents,114
Ficus_trichocerasa,93,75,18,Alphahull-PointsKO-Adjacents,1086
Ficus_trichoclada,60,38,22,Alphahull-PointsKO-Adjacents,909
Ficus_trichopoda,204,129,75,Alphahull-PointsKO-Adjacents,4675
Ficus_tricolor,2,2,0,Points-PointsKO-Adjacents,18
Ficus_trigona,1306,1166,140,Alphahull-PointsKO-Adjacents,108339
Ficus_trigonata,128,67,61,Alphahull-PointsKO-Adjacents,7443
Ficus_trimenii,1,0,1,Points-PointsKO-Adjacents,9
Ficus_triradiata,62,52,10,Alphahull-PointsKO-Adjacents,74
Ficus_tristaniifolia,2,2,0,Points-PointsKO-Adjacents,9
Ficus_trivia,12,4,8,Points-PointsKO-Adjacents,108
Ficus_tsiangii,32,16,16,Points-PointsKO-Adjacents,288
Ficus_tsjahela,0,0,0,NA,0
Ficus_tsjakela,0,0,0,NA,0
Ficus_tunicata,0,0,0,NA,0
Ficus_tuphapensis,14,2,12,Points-PointsKO-Adjacents,126
Ficus_turrialbana,68,22,46,Alphahull-PointsKO-Adjacents,400
Ficus_ulmifolia,7,1,6,Points-PointsKO-Adjacents,62
Ficus_umbellata,82,51,31,Alphahull-PointsKO-Adjacents,2153
Ficus_umbonata,0,0,0,NA,0
Ficus_uncinata,15,5,10,Points-PointsKO-Adjacents,92
Ficus_uniauriculata,2,2,0,Points-PointsKO-Adjacents,9
Ficus_uniglandulosa,63,0,63,Points-PointsKO-Adjacents,403
Ficus_ursina,3,3,0,Points-PointsKO-Adjacents,27
Ficus_usambarensis,0,0,0,NA,0
Ficus_vallis-caucae,0,0,0,NA,0
Ficus_vallis-choudae,222,144,78,Alphahull-PointsKO-Adjacents,4732
Ficus_variegata,137,59,78,Alphahull-PointsKO-Adjacents,3567
Ficus_variifolia,35,4,31,Points-PointsKO-Adjacents,232
Ficus_variolosa,118,1,117,Points-PointsKO-Adjacents,1020
Ficus_vasculosa,46,0,46,Points-PointsKO-Adjacents,381
Ficus_vasta,47,24,23,Alphahull-PointsKO-Adjacents,1951
Ficus_velutina,40,23,17,Alphahull-PointsKO-Adjacents,267
Ficus_venezuelensis,1,1,0,Points-PointsKO-Adjacents,9
Ficus_verruculosa,85,32,53,Alphahull-PointsKO-Adjacents,605
Ficus_versicolor,22,17,5,Points-PointsKO-Adjacents,58
Ficus_verticillaris,2,2,0,Points-PointsKO-Adjacents,15
Ficus_vieillardiana,29,13,16,Points-PointsKO-Adjacents,98
Ficus_virens,2132,1882,250,Alphahull-PointsKO-Adjacents,29422
Ficus_virescens,5,5,0,Points-PointsKO-Adjacents,30
Ficus_virgata,351,250,101,Alphahull-PointsKO-Adjacents,3095
Ficus_vitiensis,1,1,0,Points-PointsKO-Adjacents,3
Ficus_vittata,13,4,9,Points-PointsKO-Adjacents,110
Ficus_vogeliana,132,87,45,Alphahull-PointsKO-Adjacents,2891
Ficus_vrieseana,1,1,0,Points-PointsKO-Adjacents,9
Ficus_wakefieldii,2,0,2,Points-PointsKO-Adjacents,18
Ficus_wassa,208,145,63,Alphahull-PointsKO-Adjacents,4448
Ficus_watkinsiana,568,529,39,Alphahull-PointsKO-Adjacents,1534
Ficus_webbiana,46,32,14,Alphahull-PointsKO-Adjacents,125
Ficus_wildemaniana,11,0,11,Points-PointsKO-Adjacents,62
Ficus_xylophylla,16,2,14,Points-PointsKO-Adjacents,127
Ficus_yoponensis,306,205,101,Alphahull-PointsKO-Adjacents,10823
Ficus_yunnanensis,NA,NA,NA,NA,NA
Ficus_zarzalensis,19,4,15,Points-PointsKO-Adjacents,137
Ficus_zuliensis,0,0,0,NA,0
Filicium_decipiens,29,8,21,Points-PointsKO-Adjacents,200
Filicium_longifolium,22,11,11,Points-PointsKO-Adjacents,122
Filicium_thouarsianum,26,0,26,Points-PointsKO-Adjacents,100
Fillaeopsis_discophora,80,56,24,Alphahull-PointsKO-Adjacents,2521
Finschia_carrii,6,0,6,Points-PointsKO-Adjacents,48
Finschia_chloroxantha,101,64,37,Alphahull-PointsKO-Adjacents,2039
Finschia_ferruginiflora,1,1,0,Points-PointsKO-Adjacents,9
Finschia_rufa,19,6,13,Points-PointsKO-Adjacents,89
Firmiana_bracteata,NA,NA,NA,NA,NA
Firmiana_colorata,15,0,15,Points-PointsKO-Adjacents,135
Firmiana_danxiaensis,2,2,0,Points-PointsKO-Adjacents,9
Firmiana_diversifolia,0,0,0,NA,0
Firmiana_fulgens,1,1,0,Points-PointsKO-Adjacents,9
Firmiana_hainanensis,0,0,0,NA,0
Firmiana_kerri,1,1,0,Points-PointsKO-Adjacents,9
Firmiana_kwangsiensis,8,3,5,Points-PointsKO-Adjacents,72
Firmiana_major,4,3,1,Points-PointsKO-Adjacents,36
Firmiana_malayana,4,0,4,Points-PointsKO-Adjacents,34
Firmiana_minabassae,0,0,0,NA,0
Firmiana_papuana,10,7,3,Points-PointsKO-Adjacents,39
Firmiana_pulcherrima,4,4,0,Points-PointsKO-Adjacents,36
Firmiana_simplex,174,74,100,Alphahull-PointsKO-Adjacents,9275
Firmiana_subglabra,4,4,0,Points-PointsKO-Adjacents,36
Firmiana_sumbawaensis,0,0,0,NA,0
Fissicalyx_fendleri,84,46,38,Alphahull-PointsKO-Adjacents,3156
Fitchia_cordata,1,1,0,Points-PointsKO-Adjacents,4
Fitchia_cuneata,1,1,0,Points-PointsKO-Adjacents,6
Fitchia_mangarevensis,NA,NA,NA,NA,NA
Fitchia_nutans,5,5,0,Points-PointsKO-Adjacents,20
Fitchia_rapensis,3,3,0,Points-PointsKO-Adjacents,4
Fitchia_speciosa,6,3,3,Points-PointsKO-Adjacents,5
Fitchia_tahitensis,4,4,0,Points-PointsKO-Adjacents,26
Fittingia_carnosifolia,0,0,0,NA,0
Fittingia_mariae,NA,NA,NA,NA,NA
Fittingia_tuberculata,4,4,0,Points-PointsKO-Adjacents,28
Fittingia_tubiflora,18,4,14,Points-PointsKO-Adjacents,113
Fittingia_urceolata,5,5,0,Points-PointsKO-Adjacents,34
Fitzroya_cupressoides,74,0,74,Points-PointsKO-Adjacents,286
Flacourtia_degeneri,0,0,0,NA,0
Flacourtia_flavescens,66,52,14,Alphahull-PointsKO-Adjacents,2454
Flacourtia_helferi,0,0,0,NA,0
Flacourtia_indica,330,190,140,Alphahull-PointsKO-Adjacents,18845
Flacourtia_inermis,20,2,18,Points-PointsKO-Adjacents,154
Flacourtia_jangomas,1,1,0,Points-PointsKO-Adjacents,9
Flacourtia_kinabaluensis,4,4,0,Points-PointsKO-Adjacents,22
Flacourtia_latifolia,NA,NA,NA,NA,NA
Flacourtia_mollis,0,0,0,NA,0
Flacourtia_montana,0,0,0,NA,0
Flacourtia_occidentalis,NA,NA,NA,NA,NA
Flacourtia_oppositifolia,NA,NA,NA,NA,NA
Flacourtia_rukam,90,40,50,Alphahull-PointsKO-Adjacents,3277
Flacourtia_subintegra,0,0,0,NA,0
Flacourtia_tomentella,0,0,0,NA,0
Flacourtia_vitiensis,1,1,0,Points-PointsKO-Adjacents,9
Flacourtia_vogelii,15,6,9,Points-PointsKO-Adjacents,122
Flacourtia_zippelii,43,18,25,Points-PointsKO-Adjacents,234
Flagenium_farafanganense,8,3,5,Points-PointsKO-Adjacents,60
Flagenium_latifolium,0,0,0,NA,0
Flagenium_petrikense,8,5,3,Points-PointsKO-Adjacents,14
Flagenium_setosum,0,0,0,NA,0
Flagenium_triflorum,20,11,9,Points-PointsKO-Adjacents,90
Fleroya_ledermannii,126,82,44,Alphahull-PointsKO-Adjacents,3955
Fleroya_stipulosa,99,49,50,Alphahull-PointsKO-Adjacents,894
Fleurydora_felicis,4,4,0,Points-PointsKO-Adjacents,30
Flexanthera_subcordata,2,2,0,Points-PointsKO-Adjacents,15
Flindersia_acuminata,106,88,18,Alphahull-PointsKO-Adjacents,185
Flindersia_amboinensis,54,38,16,Alphahull-PointsKO-Adjacents,2094
Flindersia_australis,414,377,37,Alphahull-PointsKO-Adjacents,3054
Flindersia_bennettiana,108,85,23,Alphahull-PointsKO-Adjacents,438
Flindersia_bourjotiana,148,0,148,Points-PointsKO-Adjacents,268
Flindersia_brassii,14,9,5,Points-PointsKO-Adjacents,54
Flindersia_brayleyana,86,72,14,Alphahull-PointsKO-Adjacents,197
Flindersia_collina,242,205,37,Alphahull-PointsKO-Adjacents,1851
Flindersia_dissosperma,120,105,15,Alphahull-PointsKO-Adjacents,2307
Flindersia_fournieri,14,7,7,Points-PointsKO-Adjacents,66
Flindersia_ifflaiana,87,60,27,Alphahull-PointsKO-Adjacents,265
Flindersia_laevicarpa,85,61,24,Alphahull-PointsKO-Adjacents,464
Flindersia_maculosa,586,563,23,Alphahull-PointsKO-Adjacents,7992
Flindersia_pimenteliana,201,169,32,Alphahull-PointsKO-Adjacents,612
Flindersia_schottiana,510,446,64,Alphahull-PointsKO-Adjacents,1808
Flindersia_unifoliolata,23,1,22,Points-PointsKO-Adjacents,54
Flindersia_xanthoxyla,170,143,27,Alphahull-PointsKO-Adjacents,597
Floydia_praealta,107,0,107,Points-PointsKO-Adjacents,209
Flueggea_acidoton,33,10,23,Points-PointsKO-Adjacents,237
Flueggea_anatolica,NA,NA,NA,NA,NA
Flueggea_elliptica,1,1,0,Points-PointsKO-Adjacents,9
Flueggea_flexuosa,10,0,10,Points-PointsKO-Adjacents,76
Flueggea_gracilis,6,1,5,Points-PointsKO-Adjacents,42
Flueggea_leucopyrus,3,3,0,Points-PointsKO-Adjacents,27
Flueggea_monticola,3,3,0,Points-PointsKO-Adjacents,18
Flueggea_neowawraea,8,3,5,Points-PointsKO-Adjacents,38
Flueggea_virosa,3283,2909,374,Alphahull-PointsKO-Adjacents,47014
Foetidia_africana,0,0,0,NA,0
Foetidia_asymetrica,30,16,14,Points-PointsKO-Adjacents,186
Foetidia_asymmetrica,30,15,15,Points-PointsKO-Adjacents,186
Foetidia_capuronii,3,3,0,Points-PointsKO-Adjacents,16
Foetidia_clusioides,7,1,6,Points-PointsKO-Adjacents,59
Foetidia_cuneata,5,5,0,Points-PointsKO-Adjacents,25
Foetidia_delphinensis,4,4,0,Points-PointsKO-Adjacents,12
Foetidia_dracaenoides,8,3,5,Points-PointsKO-Adjacents,41
Foetidia_macrocarpa,8,3,5,Points-PointsKO-Adjacents,60
Foetidia_mauritiana,2,1,1,Points-PointsKO-Adjacents,8
Foetidia_obliqua,53,32,21,Alphahull-PointsKO-Adjacents,236
Foetidia_parviflora,1,1,0,Points-PointsKO-Adjacents,6
Foetidia_pterocarpa,3,3,0,Points-PointsKO-Adjacents,20
Foetidia_retusa,27,11,16,Points-PointsKO-Adjacents,146
Foetidia_rodriguesiana,0,0,0,NA,0
Foetidia_rubescens,1,1,0,Points-PointsKO-Adjacents,9
Foetidia_sambiranensis,2,2,0,Points-PointsKO-Adjacents,18
Foetidia_vohemarensis,6,1,5,Points-PointsKO-Adjacents,49
Fokienia_hodginsii,101,61,40,Alphahull-PointsKO-Adjacents,5187
Fontainea_borealis,1,1,0,Points-PointsKO-Adjacents,9
Fontainea_oraria,7,2,5,Points-PointsKO-Adjacents,41
Fontainea_pancheri,37,25,12,Alphahull-PointsKO-Adjacents,269
Fontainea_picrosperma,57,52,5,Alphahull-PointsKO-Adjacents,44
Fontainea_rostrata,29,22,7,Alphahull-PointsKO-Adjacents,50
Fontainea_subpapuana,2,2,0,Points-PointsKO-Adjacents,14
Fontainea_venosa,32,22,10,Alphahull-PointsKO-Adjacents,66
Fontanesia_fortunei,24,1,23,Points-PointsKO-Adjacents,205
Forchhammeria_haitiensis,1,1,0,Points-PointsKO-Adjacents,9
Forchhammeria_hintonii,9,0,9,Points-PointsKO-Adjacents,72
Forchhammeria_iltisii,14,7,7,Points-PointsKO-Adjacents,71
Forchhammeria_laxiflora,8,4,4,Points-PointsKO-Adjacents,44
Forchhammeria_macrocarpa,31,23,8,Alphahull-PointsKO-Adjacents,245
Forchhammeria_pallida,127,0,127,Points-PointsKO-Adjacents,376
Forchhammeria_polyandra,2,2,0,Points-PointsKO-Adjacents,17
Forchhammeria_sessilifolia,11,6,5,Points-PointsKO-Adjacents,41
Forchhammeria_trifoliata,139,111,28,Alphahull-PointsKO-Adjacents,5782
Forchhammeria_watsonii,82,62,20,Alphahull-PointsKO-Adjacents,760
Fordia_albiflora,15,7,8,Points-PointsKO-Adjacents,90
Fordia_brachybotrys,23,8,15,Points-PointsKO-Adjacents,170
Fordia_bracteolata,NA,NA,NA,NA,NA
Fordia_cauliflora,10,5,5,Points-PointsKO-Adjacents,90
Fordia_incredibilis,0,0,0,NA,0
Fordia_johorensis,2,2,0,Points-PointsKO-Adjacents,18
Fordia_lanceolata,NA,NA,NA,NA,NA
Fordia_leptobotrys,3,3,0,Points-PointsKO-Adjacents,21
Fordia_microphylla,7,2,5,Points-PointsKO-Adjacents,63
Fordia_ngii,NA,NA,NA,NA,NA
Fordia_nivea,3,3,0,Points-PointsKO-Adjacents,27
Fordia_ophirensis,NA,NA,NA,NA,NA
Fordia_pauciflora,1,1,0,Points-PointsKO-Adjacents,9
Fordia_rheophytica,3,3,0,Points-PointsKO-Adjacents,27
Fordia_splendidissima,89,70,19,Alphahull-PointsKO-Adjacents,4951
Fordia_stipularis,1,1,0,Points-PointsKO-Adjacents,9
Fordia_unifoliata,1,1,0,Points-PointsKO-Adjacents,9
Forestiera_acuminata,341,264,77,Alphahull-PointsKO-Adjacents,12114
Forestiera_angustifolia,244,207,37,Alphahull-PointsKO-Adjacents,10311
Forestiera_cartaginensis,40,16,24,Points-PointsKO-Adjacents,210
Forestiera_corollata,9,3,6,Points-PointsKO-Adjacents,79
Forestiera_ecuadorensis,3,3,0,Points-PointsKO-Adjacents,27
Forestiera_eggersiana,9,3,6,Points-PointsKO-Adjacents,38
Forestiera_isabelae,1,1,0,Points-PointsKO-Adjacents,6
Forestiera_macrocarpa,7,5,2,Points-PointsKO-Adjacents,30
Forestiera_phillyreoides,194,152,42,Alphahull-PointsKO-Adjacents,3063
Forestiera_racemosa,50,40,10,Alphahull-PointsKO-Adjacents,421
Forestiera_rhamnifolia,84,31,53,Alphahull-PointsKO-Adjacents,1842
Forestiera_segregata,125,74,51,Alphahull-PointsKO-Adjacents,3268
Forestiera_shrevei,39,28,11,Alphahull-PointsKO-Adjacents,597
Forestiera_tomentosa,39,23,16,Alphahull-PointsKO-Adjacents,754
Forgesia_racemosa,5,5,0,Points-PointsKO-Adjacents,29
Forsteronia_acouci,205,107,98,Alphahull-PointsKO-Adjacents,4124
Forsteronia_tarapotensis,12,0,12,Points-PointsKO-Adjacents,108
Fortunearia_sinensis,17,5,12,Points-PointsKO-Adjacents,153
Fosbergia_alleizettii,NA,NA,NA,NA,NA
Fosbergia_petelotii,1,1,0,Points-PointsKO-Adjacents,9
Fosbergia_shweliensis,9,7,2,Points-PointsKO-Adjacents,38
Fosbergia_thailandica,0,0,0,NA,0
Fouquieria_columnaris,82,70,12,Alphahull-PointsKO-Adjacents,381
Fouquieria_diguetii,164,148,16,Alphahull-PointsKO-Adjacents,1331
Fouquieria_fasciculata,27,18,9,Points-PointsKO-Adjacents,106
Fouquieria_formosa,242,205,37,Alphahull-PointsKO-Adjacents,854
Fouquieria_leonilae,9,1,8,Points-PointsKO-Adjacents,41
Fouquieria_macdougalii,134,114,20,Alphahull-PointsKO-Adjacents,1701
Fouquieria_purpusii,35,30,5,Alphahull-PointsKO-Adjacents,57
Fouquieria_splendens,1979,0,1979,Points-PointsKO-Adjacents,4201
Franciscodendron_laurifolium,107,98,9,Alphahull-PointsKO-Adjacents,214
Frangula_alnus,56542,49623,6919,Alphahull-PointsKO-Adjacents,77619
Frangula_azorica,2,2,0,Points-PointsKO-Adjacents,15
Frangula_betulifolia,266,225,41,Alphahull-PointsKO-Adjacents,12137
Frangula_californica,2844,2549,295,Alphahull-PointsKO-Adjacents,8177
Frangula_capreifolia,379,308,71,Alphahull-PointsKO-Adjacents,4796
Frangula_caroliniana,981,785,196,Alphahull-PointsKO-Adjacents,19171
Frangula_circumscissa,9,3,6,Points-PointsKO-Adjacents,51
Frangula_crenata,190,127,63,Alphahull-PointsKO-Adjacents,2035
Frangula_darienensis,1,1,0,Points-PointsKO-Adjacents,9
Frangula_discolor,341,293,48,Alphahull-PointsKO-Adjacents,1903
Frangula_grandiflora,5,5,0,Points-PointsKO-Adjacents,42
Frangula_grandifolia,0,0,0,NA,0
Frangula_granulosa,40,13,27,Points-PointsKO-Adjacents,257
Frangula_henryi,30,10,20,Points-PointsKO-Adjacents,200
Frangula_inconspicua,5,5,0,Points-PointsKO-Adjacents,18
Frangula_lindeniana,3,3,0,Points-PointsKO-Adjacents,27
Frangula_longipes,0,0,0,NA,0
Frangula_marahuacensis,8,5,3,Points-PointsKO-Adjacents,46
Frangula_mcvaughii,27,15,12,Points-PointsKO-Adjacents,135
Frangula_mucronata,287,253,34,Alphahull-PointsKO-Adjacents,4377
Frangula_oreodendron,145,136,9,Alphahull-PointsKO-Adjacents,150
Frangula_pendula,92,77,15,Alphahull-PointsKO-Adjacents,168
Frangula_purshiana,702,574,128,Alphahull-PointsKO-Adjacents,11099
Frangula_rhododendriphylla,1,1,0,Points-PointsKO-Adjacents,9
Frangula_sphaerosperma,320,254,66,Alphahull-PointsKO-Adjacents,13030
Frangula_ulei,7,1,6,Points-PointsKO-Adjacents,40
Frangula_wendtii,4,4,0,Points-PointsKO-Adjacents,27
Franklinia_alatamaha,15,0,15,Points-PointsKO-Adjacents,120
Fraunhofera_multiflora,128,105,23,Alphahull-PointsKO-Adjacents,3141
Fraxinus_americana,21023,19695,1328,Alphahull-PointsKO-Adjacents,49299
Fraxinus_angustifolia,5748,4957,791,Alphahull-PointsKO-Adjacents,20828
Fraxinus_anomala,477,453,24,Alphahull-PointsKO-Adjacents,6114
Fraxinus_apertisquamifera,106,85,21,Alphahull-PointsKO-Adjacents,556
Fraxinus_baroniana,1,1,0,Points-PointsKO-Adjacents,9
Fraxinus_berlandieriana,84,48,36,Alphahull-PointsKO-Adjacents,4718
Fraxinus_bornmuelleri,NA,NA,NA,NA,NA
Fraxinus_bungeana,18,1,17,Points-PointsKO-Adjacents,162
Fraxinus_caroliniana,601,496,105,Alphahull-PointsKO-Adjacents,11751
Fraxinus_chiisanensis,0,0,0,NA,0
Fraxinus_chinensis,236,139,97,Alphahull-PointsKO-Adjacents,18008
Fraxinus_cuspidata,207,171,36,Alphahull-PointsKO-Adjacents,4633
Fraxinus_depauperata,0,0,0,NA,0
Fraxinus_dimorpha,5,5,0,Points-PointsKO-Adjacents,36
Fraxinus_dipetala,622,573,49,Alphahull-PointsKO-Adjacents,3210
Fraxinus_dubia,89,70,19,Alphahull-PointsKO-Adjacents,347
Fraxinus_excelsior,13275,10804,2471,Alphahull-PointsKO-Adjacents,32674
Fraxinus_ferruginea,2,2,0,Points-PointsKO-Adjacents,18
Fraxinus_floribunda,51,9,42,Points-PointsKO-Adjacents,448
Fraxinus_gooddingii,60,47,13,Alphahull-PointsKO-Adjacents,595
Fraxinus_greggii,209,185,24,Alphahull-PointsKO-Adjacents,6488
Fraxinus_griffithii,168,129,39,Alphahull-PointsKO-Adjacents,507
Fraxinus_hookeri,0,0,0,NA,0
Fraxinus_hubeiensis,2,2,0,Points-PointsKO-Adjacents,18
Fraxinus_insularis,134,89,45,Alphahull-PointsKO-Adjacents,6687
Fraxinus_lanuginosa,488,390,98,Alphahull-PointsKO-Adjacents,3143
Fraxinus_latifolia,785,654,131,Alphahull-PointsKO-Adjacents,4655
Fraxinus_longicuspis,217,132,85,Alphahull-PointsKO-Adjacents,1798
Fraxinus_malacophylla,7,2,5,Points-PointsKO-Adjacents,63
Fraxinus_mandshurica,174,116,58,Alphahull-PointsKO-Adjacents,8484
Fraxinus_micrantha,1,1,0,Points-PointsKO-Adjacents,9
Fraxinus_nigra,5820,5496,324,Alphahull-PointsKO-Adjacents,36397
Fraxinus_odontocalyx,9,1,8,Points-PointsKO-Adjacents,81
Fraxinus_ornus,2204,1831,373,Alphahull-PointsKO-Adjacents,28653
Fraxinus_pallisae,4,1,3,Points-PointsKO-Adjacents,26
Fraxinus_papillosa,42,0,42,Points-PointsKO-Adjacents,263
Fraxinus_paxiana,22,7,15,Points-PointsKO-Adjacents,198
Fraxinus_pennsylvanica,16642,15106,1536,Alphahull-PointsKO-Adjacents,87644
Fraxinus_platypoda,99,64,35,Alphahull-PointsKO-Adjacents,484
Fraxinus_potosina,9,4,5,Points-PointsKO-Adjacents,38
Fraxinus_pringlei,15,5,10,Points-PointsKO-Adjacents,97
Fraxinus_profunda,390,278,112,Alphahull-PointsKO-Adjacents,21681
Fraxinus_punctata,4,4,0,Points-PointsKO-Adjacents,36
Fraxinus_purpusii,84,55,29,Alphahull-PointsKO-Adjacents,787
Fraxinus_quadrangulata,746,582,164,Alphahull-PointsKO-Adjacents,13142
Fraxinus_raibocarpa,5,4,1,Points-PointsKO-Adjacents,45
Fraxinus_reflexiflora,0,0,0,NA,0
Fraxinus_rufescens,20,13,7,Points-PointsKO-Adjacents,107
Fraxinus_sieboldiana,476,353,123,Alphahull-PointsKO-Adjacents,2928
Fraxinus_sogdiana,1,1,0,Points-PointsKO-Adjacents,9
Fraxinus_stylosa,8,1,7,Points-PointsKO-Adjacents,72
Fraxinus_suaveolens,3,3,0,Points-PointsKO-Adjacents,27
Fraxinus_texensis,165,131,34,Alphahull-PointsKO-Adjacents,1385
Fraxinus_trifoliolata,4,4,0,Points-PointsKO-Adjacents,36
Fraxinus_uhdei,421,337,84,Alphahull-PointsKO-Adjacents,7084
Fraxinus_velutina,726,655,71,Alphahull-PointsKO-Adjacents,13971
Fraxinus_xanthoxyloides,65,43,22,Alphahull-PointsKO-Adjacents,1644
Fremontodendron_californicum,779,724,55,Alphahull-PointsKO-Adjacents,3734
Fremontodendron_mexicanum,34,0,34,Points-PointsKO-Adjacents,138
Freziera_angulosa,3,3,0,Points-PointsKO-Adjacents,27
Freziera_arbutifolia,22,16,6,Points-PointsKO-Adjacents,127
Freziera_bonplandiana,34,24,10,Alphahull-PointsKO-Adjacents,603
Freziera_caloneura,3,3,0,Points-PointsKO-Adjacents,27
Freziera_calophylla,29,10,19,Points-PointsKO-Adjacents,196
Freziera_candicans,119,86,33,Alphahull-PointsKO-Adjacents,531
Freziera_canescens,107,89,18,Alphahull-PointsKO-Adjacents,782
Freziera_carinata,1,1,0,Points-PointsKO-Adjacents,9
Freziera_chrysophylla,48,34,14,Alphahull-PointsKO-Adjacents,873
Freziera_cordata,1,1,0,Points-PointsKO-Adjacents,9
Freziera_dudleyi,14,4,10,Points-PointsKO-Adjacents,91
Freziera_echinata,0,0,0,NA,0
Freziera_euryoides,3,3,0,Points-PointsKO-Adjacents,27
Freziera_ferruginea,3,3,0,Points-PointsKO-Adjacents,27
Freziera_forerorum,1,1,0,Points-PointsKO-Adjacents,9
Freziera_friedrichsthaliana,12,6,6,Points-PointsKO-Adjacents,38
Freziera_grisebachii,15,0,15,Points-PointsKO-Adjacents,90
Freziera_guatemalensis,43,27,16,Alphahull-PointsKO-Adjacents,177
Freziera_ilicioides,0,0,0,NA,0
Freziera_inaequilatera,6,0,6,Points-PointsKO-Adjacents,42
Freziera_jaramilloi,1,1,0,Points-PointsKO-Adjacents,9
Freziera_karsteniana,29,10,19,Points-PointsKO-Adjacents,208
Freziera_lanata,59,42,17,Alphahull-PointsKO-Adjacents,612
Freziera_longipes,6,1,5,Points-PointsKO-Adjacents,43
Freziera_macrophylla,9,0,9,Points-PointsKO-Adjacents,39
Freziera_mexicana,71,50,21,Alphahull-PointsKO-Adjacents,1164
Freziera_microphylla,4,4,0,Points-PointsKO-Adjacents,36
Freziera_minima,11,7,4,Points-PointsKO-Adjacents,46
Freziera_monsonensis,NA,NA,NA,NA,NA
Freziera_nervosa,21,8,13,Points-PointsKO-Adjacents,136
Freziera_parva,4,4,0,Points-PointsKO-Adjacents,36
Freziera_reticulata,38,26,12,Alphahull-PointsKO-Adjacents,115
Freziera_retinervia,1,1,0,Points-PointsKO-Adjacents,9
Freziera_roraimensis,2,2,0,Points-PointsKO-Adjacents,18
Freziera_sericea,5,5,0,Points-PointsKO-Adjacents,34
Freziera_sessiliflora,5,1,4,Points-PointsKO-Adjacents,39
Freziera_smithiana,0,0,0,NA,0
Freziera_spathulifolia,2,2,0,Points-PointsKO-Adjacents,18
Freziera_stuebelii,1,1,0,Points-PointsKO-Adjacents,9
Freziera_suberosa,9,0,9,Points-PointsKO-Adjacents,65
Freziera_subintegrifolia,4,4,0,Points-PointsKO-Adjacents,36
Freziera_tomentosa,19,5,14,Points-PointsKO-Adjacents,149
Freziera_undulata,14,3,11,Points-PointsKO-Adjacents,69
Freziera_verrucosa,88,64,24,Alphahull-PointsKO-Adjacents,697
Fridericia_candicans,381,256,125,Alphahull-PointsKO-Adjacents,11372
Fridericia_dichotoma,710,502,208,Alphahull-PointsKO-Adjacents,51866
Fridericia_florida,612,450,162,Alphahull-PointsKO-Adjacents,42224
Fridericia_nigrescens,92,30,62,Alphahull-PointsKO-Adjacents,3638
Friesodielsia_maclellandii,0,0,0,NA,0
Friesodielsia_obovata,226,160,66,Alphahull-PointsKO-Adjacents,19115
Froesia_crassiflora,7,0,7,Points-PointsKO-Adjacents,60
Froesia_diffusa,32,26,6,Alphahull-PointsKO-Adjacents,1801
Froesia_gereauana,2,2,0,Points-PointsKO-Adjacents,18
Froesia_tricarpa,8,1,7,Points-PointsKO-Adjacents,72
Froesia_venezuelensis,2,2,0,Points-PointsKO-Adjacents,18
Froesiodendron_amazonicum,38,12,26,Points-PointsKO-Adjacents,260
Froesiodendron_longicuspe,1,1,0,Points-PointsKO-Adjacents,9
Froesiodendron_urceocalyx,1,1,0,Points-PointsKO-Adjacents,9
Fuchsia_arborescens,269,231,38,Alphahull-PointsKO-Adjacents,3989
Fuchsia_boliviana,195,151,44,Alphahull-PointsKO-Adjacents,1191
Fuchsia_cyrtandroides,4,4,0,Points-PointsKO-Adjacents,13
Fuchsia_denticulata,134,105,29,Alphahull-PointsKO-Adjacents,1311
Fuchsia_encliandra,203,171,32,Alphahull-PointsKO-Adjacents,3354
Fuchsia_excorticata,5948,1,5947,Points-PointsKO-Adjacents,3093
Fuchsia_hartwegii,40,30,10,Alphahull-PointsKO-Adjacents,1021
Fuchsia_magdalenae,2,2,0,Points-PointsKO-Adjacents,14
Fuchsia_mezae,0,0,0,NA,0
Fuchsia_paniculata,765,693,72,Alphahull-PointsKO-Adjacents,5321
Fuchsia_regia,291,252,39,Alphahull-PointsKO-Adjacents,4561
Fuchsia_triphylla,27,21,6,Alphahull-PointsKO-Adjacents,143
Fulcaldea_laurifolia,21,10,11,Points-PointsKO-Adjacents,95
Funifera_brasiliensis,21,6,15,Points-PointsKO-Adjacents,125
Funifera_grandifolia,18,8,10,Points-PointsKO-Adjacents,124
Funtumia_africana,306,220,86,Alphahull-PointsKO-Adjacents,9846
Funtumia_elastica,166,117,49,Alphahull-PointsKO-Adjacents,3212
Furcraea_acaulis,0,0,0,NA,0
Furcraea_longaeva,39,3,36,Points-PointsKO-Adjacents,161
Furcraea_macdougalii,24,16,8,Points-PointsKO-Adjacents,94
Furcraea_martinezii,2,2,0,Points-PointsKO-Adjacents,18
Furcraea_parmentieri,120,99,21,Alphahull-PointsKO-Adjacents,452
Fusaea_decurrens,8,0,8,Points-PointsKO-Adjacents,53
Fusaea_longifolia,605,532,73,Alphahull-PointsKO-Adjacents,58641
Fusaea_peruviana,42,25,17,Alphahull-PointsKO-Adjacents,3005
Fusispermum_laxiflorum,51,27,24,Alphahull-PointsKO-Adjacents,531
Fusispermum_minutiflorum,29,16,13,Points-PointsKO-Adjacents,194
Fusispermum_rubrolignosum,16,4,12,Points-PointsKO-Adjacents,128
Gabonius_ngouniensis,56,46,10,Alphahull-PointsKO-Adjacents,470
Gaertnera_arenaria,111,85,26,Alphahull-PointsKO-Adjacents,761
Gaertnera_bambusifolia,6,0,6,Points-PointsKO-Adjacents,42
Gaertnera_bieleri,70,41,29,Alphahull-PointsKO-Adjacents,568
Gaertnera_breviflora,30,23,7,Alphahull-PointsKO-Adjacents,63
Gaertnera_brevipedicellata,9,5,4,Points-PointsKO-Adjacents,30
Gaertnera_cardiocarpa,15,5,10,Points-PointsKO-Adjacents,88
Gaertnera_cooperi,67,48,19,Alphahull-PointsKO-Adjacents,657
Gaertnera_crassiflora,0,0,0,NA,0
Gaertnera_cuneifolia,2,2,0,Points-PointsKO-Adjacents,9
Gaertnera_darcyana,11,4,7,Points-PointsKO-Adjacents,39
Gaertnera_divaricata,5,4,1,Points-PointsKO-Adjacents,30
Gaertnera_drakeana,7,2,5,Points-PointsKO-Adjacents,47
Gaertnera_eketensis,2,2,0,Points-PointsKO-Adjacents,17
Gaertnera_fractiflexa,1,1,0,Points-PointsKO-Adjacents,9
Gaertnera_globigera,1,1,0,Points-PointsKO-Adjacents,9
Gaertnera_grisea,1,0,1,Points-PointsKO-Adjacents,9
Gaertnera_guillotii,85,53,32,Alphahull-PointsKO-Adjacents,389
Gaertnera_hirsuta,7,2,5,Points-PointsKO-Adjacents,30
Gaertnera_hirtiflora,3,3,0,Points-PointsKO-Adjacents,9
Gaertnera_hispida,14,9,5,Points-PointsKO-Adjacents,39
Gaertnera_humblotii,21,13,8,Points-PointsKO-Adjacents,124
Gaertnera_ianthina,42,32,10,Alphahull-PointsKO-Adjacents,178
Gaertnera_inflexa,38,19,19,Points-PointsKO-Adjacents,167
Gaertnera_junghuhniana,72,39,33,Alphahull-PointsKO-Adjacents,3113
Gaertnera_laevis,11,5,6,Points-PointsKO-Adjacents,52
Gaertnera_leucothyrsa,22,6,16,Points-PointsKO-Adjacents,160
Gaertnera_liberiensis,1,1,0,Points-PointsKO-Adjacents,9
Gaertnera_littoralis,5,5,0,Points-PointsKO-Adjacents,26
Gaertnera_longifolia,2,2,0,Points-PointsKO-Adjacents,9
Gaertnera_longivaginalis,108,70,38,Alphahull-PointsKO-Adjacents,8541
Gaertnera_lowryi,8,6,2,Points-PointsKO-Adjacents,35
Gaertnera_macrobotrys,30,17,13,Points-PointsKO-Adjacents,169
Gaertnera_macrostipula,130,107,23,Alphahull-PointsKO-Adjacents,1135
Gaertnera_madagascariensis,43,32,11,Alphahull-PointsKO-Adjacents,218
Gaertnera_masoalana,6,1,5,Points-PointsKO-Adjacents,33
Gaertnera_microphylla,6,2,4,Points-PointsKO-Adjacents,21
Gaertnera_monstruosa,8,4,4,Points-PointsKO-Adjacents,51
Gaertnera_obesa,1,1,0,Points-PointsKO-Adjacents,9
Gaertnera_obovata,282,258,24,Alphahull-PointsKO-Adjacents,2726
Gaertnera_paniculata,328,248,80,Alphahull-PointsKO-Adjacents,20879
Gaertnera_pauciflora,32,18,14,Points-PointsKO-Adjacents,137
Gaertnera_pendula,0,0,0,NA,0
Gaertnera_phanerophlebia,71,61,10,Alphahull-PointsKO-Adjacents,757
Gaertnera_phyllosepala,53,30,23,Alphahull-PointsKO-Adjacents,380
Gaertnera_phyllostachya,78,66,12,Alphahull-PointsKO-Adjacents,486
Gaertnera_psychotrioides,8,2,6,Points-PointsKO-Adjacents,24
Gaertnera_ramosa,3,3,0,Points-PointsKO-Adjacents,9
Gaertnera_raphaelii,42,33,9,Alphahull-PointsKO-Adjacents,179
Gaertnera_razakamalalana,6,1,5,Points-PointsKO-Adjacents,33
Gaertnera_robusta,20,6,14,Points-PointsKO-Adjacents,131
Gaertnera_rosea,2,2,0,Points-PointsKO-Adjacents,18
Gaertnera_rotundifolia,4,4,0,Points-PointsKO-Adjacents,12
Gaertnera_rubra,18,7,11,Points-PointsKO-Adjacents,98
Gaertnera_schatzii,3,3,0,Points-PointsKO-Adjacents,8
Gaertnera_sclerophylla,17,5,12,Points-PointsKO-Adjacents,62
Gaertnera_spicata,10,6,4,Points-PointsKO-Adjacents,18
Gaertnera_stictophylla,1,1,0,Points-PointsKO-Adjacents,9
Gaertnera_ternifolia,3,3,0,Points-PointsKO-Adjacents,18
Gaertnera_trachystyla,84,65,19,Alphahull-PointsKO-Adjacents,1156
Gaertnera_vaginans,5,5,0,Points-PointsKO-Adjacents,43
Gaertnera_vaginata,4,3,1,Points-PointsKO-Adjacents,19
Gaertnera_velutina,14,1,13,Points-PointsKO-Adjacents,68
Gaertnera_vernicosa,6,1,5,Points-PointsKO-Adjacents,45
Gaertnera_viminea,1,1,0,Points-PointsKO-Adjacents,9
Gaertnera_walkeri,3,3,0,Points-PointsKO-Adjacents,27
Gaertnera_xerophila,6,1,5,Points-PointsKO-Adjacents,40
Gagnebina_bakoliae,1,1,0,Points-PointsKO-Adjacents,9
Gagnebina_commersoniana,114,87,27,Alphahull-PointsKO-Adjacents,2912
Gagnebina_pterocarpa,7,1,6,Points-PointsKO-Adjacents,38
Gaiadendron_punctatum,1284,1175,109,Alphahull-PointsKO-Adjacents,12184
Galbulimima_belgraveana,224,175,49,Alphahull-PointsKO-Adjacents,1189
Galearia_aristifera,4,3,1,Points-PointsKO-Adjacents,36
Galearia_celebica,64,35,29,Alphahull-PointsKO-Adjacents,1335
Galearia_filiformis,9,0,9,Points-PointsKO-Adjacents,74
Galearia_fulva,61,24,37,Alphahull-PointsKO-Adjacents,1714
Galearia_maingayi,3,3,0,Points-PointsKO-Adjacents,27
Galiniera_saxifraga,251,202,49,Alphahull-PointsKO-Adjacents,13934
Galipea_carinata,11,2,9,Points-PointsKO-Adjacents,68
Galipea_ciliata,126,93,33,Alphahull-PointsKO-Adjacents,2972
Galipea_congestiflora,60,36,24,Alphahull-PointsKO-Adjacents,4033
Galipea_dasysperma,42,31,11,Alphahull-PointsKO-Adjacents,450
Galipea_grandifolia,3,3,0,Points-PointsKO-Adjacents,23
Galipea_jasminiflora,351,294,57,Alphahull-PointsKO-Adjacents,11607
Galipea_laxiflora,42,0,42,Points-PointsKO-Adjacents,250
Galipea_lucida,4,4,0,Points-PointsKO-Adjacents,27
Galipea_panamensis,14,10,4,Points-PointsKO-Adjacents,113
Galipea_revoluta,12,4,8,Points-PointsKO-Adjacents,85
Galipea_simplicifolia,6,0,6,Points-PointsKO-Adjacents,54
Galipea_trifoliata,327,238,89,Alphahull-PointsKO-Adjacents,37910
Gallesia_integrifolia,487,378,109,Alphahull-PointsKO-Adjacents,11460
Gallienia_sclerophylla,37,21,16,Alphahull-PointsKO-Adjacents,277
Galphimia_mirandae,0,0,0,NA,0
Galphimia_oaxacana,4,3,1,Points-PointsKO-Adjacents,32
Galpinia_transvaalica,43,35,8,Alphahull-PointsKO-Adjacents,832
Gamanthera_herrerae,12,7,5,Points-PointsKO-Adjacents,43
Gamblea_ciliata,66,32,34,Alphahull-PointsKO-Adjacents,1312
Gamblea_innovans,215,155,60,Alphahull-PointsKO-Adjacents,2069
Gamblea_malayana,2,2,0,Points-PointsKO-Adjacents,12
Gamblea_pseudoevodiifolia,10,5,5,Points-PointsKO-Adjacents,62
Ganophyllum_falcatum,545,0,545,Points-PointsKO-Adjacents,1830
Ganophyllum_giganteum,42,27,15,Alphahull-PointsKO-Adjacents,1009
Garcia_nutans,9,0,9,Points-PointsKO-Adjacents,57
Garcia_parviflora,58,44,14,Alphahull-PointsKO-Adjacents,440
Garcinia_acutifolia,2,2,0,Points-PointsKO-Adjacents,18
Garcinia_adinantha,0,0,0,NA,0
Garcinia_afzelii,32,23,9,Alphahull-PointsKO-Adjacents,1273
Garcinia_amabilis,0,0,0,NA,0
Garcinia_amboinensis,2,2,0,Points-PointsKO-Adjacents,18
Garcinia_ambrensis,9,4,5,Points-PointsKO-Adjacents,44
Garcinia_amplexicaulis,9,2,7,Points-PointsKO-Adjacents,65
Garcinia_andamanica,1,1,0,Points-PointsKO-Adjacents,9
Garcinia_angustifolia,0,0,0,NA,0
Garcinia_anjouanensis,5,5,0,Points-PointsKO-Adjacents,31
Garcinia_anomala,2,2,0,Points-PointsKO-Adjacents,18
Garcinia_apetala,0,0,0,NA,0
Garcinia_aphanophlebia,25,9,16,Points-PointsKO-Adjacents,175
Garcinia_archboldiana,11,0,11,Points-PointsKO-Adjacents,93
Garcinia_arenicola,9,3,6,Points-PointsKO-Adjacents,77
Garcinia_aristata,17,3,14,Points-PointsKO-Adjacents,146
Garcinia_assugu,7,0,7,Points-PointsKO-Adjacents,50
Garcinia_asterandra,33,24,9,Alphahull-PointsKO-Adjacents,197
Garcinia_atroviridis,12,5,7,Points-PointsKO-Adjacents,104
Garcinia_baillonii,1,0,1,Points-PointsKO-Adjacents,9
Garcinia_bakeriana,1,1,0,Points-PointsKO-Adjacents,9
Garcinia_balimensis,0,0,0,NA,0
Garcinia_bancana,13,1,12,Points-PointsKO-Adjacents,102
Garcinia_barkeriana,0,0,0,NA,0
Garcinia_beccarii,5,5,0,Points-PointsKO-Adjacents,44
Garcinia_benthamiana,55,40,15,Alphahull-PointsKO-Adjacents,2223
Garcinia_bifasciculata,3,3,0,Points-PointsKO-Adjacents,12
Garcinia_binucao,7,2,5,Points-PointsKO-Adjacents,48
Garcinia_blumei,2,0,2,Points-PointsKO-Adjacents,18
Garcinia_bonii,0,0,0,NA,0
Garcinia_borneensis,1,1,0,Points-PointsKO-Adjacents,9
Garcinia_bracteata,13,4,9,Points-PointsKO-Adjacents,117
Garcinia_branderhorstii,NA,NA,NA,NA,NA
Garcinia_brasiliensis,440,362,78,Alphahull-PointsKO-Adjacents,25389
Garcinia_brassii,39,30,9,Alphahull-PointsKO-Adjacents,37
Garcinia_brevipedicellata,8,3,5,Points-PointsKO-Adjacents,62
Garcinia_brevipes,0,0,0,NA,0
Garcinia_brevirostris,9,0,9,Points-PointsKO-Adjacents,61
Garcinia_buchananii,13,0,13,Points-PointsKO-Adjacents,114
Garcinia_burkillii,0,0,0,NA,0
Garcinia_cadelliana,1,1,0,Points-PointsKO-Adjacents,9
Garcinia_calcicola,43,25,18,Alphahull-PointsKO-Adjacents,1359
Garcinia_calycina,0,0,0,NA,0
Garcinia_cambodgiensis,1,1,0,Points-PointsKO-Adjacents,9
Garcinia_cantleyana,0,0,0,NA,0
Garcinia_capuronii,1,1,0,Points-PointsKO-Adjacents,9
Garcinia_carolinensis,NA,NA,NA,NA,NA
Garcinia_caudiculata,2,2,0,Points-PointsKO-Adjacents,18
Garcinia_cauliflora,0,0,0,NA,0
Garcinia_celebica,19,0,19,Points-PointsKO-Adjacents,143
Garcinia_cerasifer,13,5,8,Points-PointsKO-Adjacents,77
Garcinia_chapelieri,71,45,26,Alphahull-PointsKO-Adjacents,760
Garcinia_choisyiana,NA,NA,NA,NA,NA
Garcinia_chromocarpa,40,24,16,Alphahull-PointsKO-Adjacents,1657
Garcinia_cincta,0,0,0,NA,0
Garcinia_clusiifolia,0,0,0,NA,0
Garcinia_cochinchinensis,5,1,4,Points-PointsKO-Adjacents,45
Garcinia_costata,0,0,0,NA,0
Garcinia_cowa,19,4,15,Points-PointsKO-Adjacents,168
Garcinia_crassiflora,20,11,9,Points-PointsKO-Adjacents,92
Garcinia_crassinervis,NA,NA,NA,NA,NA
Garcinia_cuspidata,1,1,0,Points-PointsKO-Adjacents,8
Garcinia_cymosa,4,4,0,Points-PointsKO-Adjacents,25
Garcinia_dalleizettei,8,2,6,Points-PointsKO-Adjacents,41
Garcinia_dallmannensis,0,0,0,NA,0
Garcinia_dauphinensis,73,49,24,Alphahull-PointsKO-Adjacents,742
Garcinia_decipiens,51,38,13,Alphahull-PointsKO-Adjacents,944
Garcinia_decussata,1,1,0,Points-PointsKO-Adjacents,9
Garcinia_delpyana,0,0,0,NA,0
Garcinia_densiflora,1,1,0,Points-PointsKO-Adjacents,8
Garcinia_densivenia,28,14,14,Points-PointsKO-Adjacents,182
Garcinia_diospyrifolia,0,0,0,NA,0
Garcinia_evonymoides,18,14,4,Points-PointsKO-Adjacents,97
Garcinia_diversifolia,0,0,0,NA,0
Garcinia_dives,3,3,0,Points-PointsKO-Adjacents,26
Garcinia_dryobalanoides,2,1,1,Points-PointsKO-Adjacents,18
Garcinia_dulcis,133,70,63,Alphahull-PointsKO-Adjacents,1325
Garcinia_echinocarpa,3,3,0,Points-PointsKO-Adjacents,9
Garcinia_elliptica,0,0,0,NA,0
Garcinia_epunctata,7,2,5,Points-PointsKO-Adjacents,53
Garcinia_erythrosepala,NA,NA,NA,NA,NA
Garcinia_esculenta,2,2,0,Points-PointsKO-Adjacents,18
Garcinia_fagraeoides,2,1,1,Points-PointsKO-Adjacents,18
Garcinia_forbesii,7,0,7,Points-PointsKO-Adjacents,63
Garcinia_fusca,1,1,0,Points-PointsKO-Adjacents,9
Garcinia_gardneriana,1376,1200,176,Alphahull-PointsKO-Adjacents,88120
Garcinia_gaudichaudii,8,1,7,Points-PointsKO-Adjacents,66
Garcinia_gerrardii,17,6,11,Points-PointsKO-Adjacents,142
Garcinia_gibbsiae,48,42,6,Alphahull-PointsKO-Adjacents,52
Garcinia_goudotiana,46,26,20,Alphahull-PointsKO-Adjacents,488
Garcinia_griffithii,6,0,6,Points-PointsKO-Adjacents,43
Garcinia_guacopary,83,34,49,Alphahull-PointsKO-Adjacents,3081
Garcinia_gummi-gutta,2,0,2,Points-PointsKO-Adjacents,18
Garcinia_hanburyi,4,4,0,Points-PointsKO-Adjacents,36
Garcinia_harmandii,1,1,0,Points-PointsKO-Adjacents,9
Garcinia_havilandii,2,0,2,Points-PointsKO-Adjacents,18
Garcinia_hendersoniana,1,1,0,Points-PointsKO-Adjacents,9
Garcinia_hermonii,0,0,0,NA,0
Garcinia_hessii,5,4,1,Points-PointsKO-Adjacents,29
Garcinia_heterandra,0,0,0,NA,0
Garcinia_hollrungii,12,0,12,Points-PointsKO-Adjacents,98
Garcinia_holttumii,0,0,0,NA,0
Garcinia_huillensis,9,1,8,Points-PointsKO-Adjacents,81
Garcinia_humilis,12,0,12,Points-PointsKO-Adjacents,84
Garcinia_hunsteinii,37,16,21,Points-PointsKO-Adjacents,215
Garcinia_imbertii,0,0,0,NA,0
Garcinia_indica,0,0,0,NA,0
Garcinia_intermedia,540,472,68,Alphahull-PointsKO-Adjacents,9340
Garcinia_jaweri,3,3,0,Points-PointsKO-Adjacents,25
Garcinia_jelinckii,0,0,0,NA,0
Garcinia_keenania,0,0,0,NA,0
Garcinia_kingaensis,42,22,20,Alphahull-PointsKO-Adjacents,461
Garcinia_klabang,0,0,0,NA,0
Garcinia_klossii,0,0,0,NA,0
Garcinia_kola,111,66,45,Alphahull-PointsKO-Adjacents,2510
Garcinia_kwangsiensis,1,1,0,Points-PointsKO-Adjacents,9
Garcinia_kydia,NA,NA,NA,NA,NA
Garcinia_lanceifolia,0,0,0,NA,0
Garcinia_lancilimba,1,1,0,Points-PointsKO-Adjacents,9
Garcinia_lanessanii,2,2,0,Points-PointsKO-Adjacents,18
Garcinia_latissima,49,25,24,Alphahull-PointsKO-Adjacents,345
Garcinia_le-testui,11,6,5,Points-PointsKO-Adjacents,87
Garcinia_linii,5,1,4,Points-PointsKO-Adjacents,19
Garcinia_livingstonei,214,124,90,Alphahull-PointsKO-Adjacents,7125
Garcinia_longifolia,0,0,0,NA,0
Garcinia_lowryi,50,31,19,Alphahull-PointsKO-Adjacents,406
Garcinia_lucida,81,65,16,Alphahull-PointsKO-Adjacents,710
Garcinia_luzoniensis,1,1,0,Points-PointsKO-Adjacents,8
Garcinia_macgregorii,0,0,0,NA,0
Garcinia_macrophylla,776,625,151,Alphahull-PointsKO-Adjacents,75879
Garcinia_madagascariensis,44,26,18,Alphahull-PointsKO-Adjacents,284
Garcinia_madruno,1141,1020,121,Alphahull-PointsKO-Adjacents,83754
Garcinia_magnifolia,95,68,27,Alphahull-PointsKO-Adjacents,1728
Garcinia_maingayi,4,0,4,Points-PointsKO-Adjacents,36
Garcinia_malaccensis,4,1,3,Points-PointsKO-Adjacents,18
Garcinia_maluensis,20,10,10,Points-PointsKO-Adjacents,105
Garcinia_mammeoides,1,1,0,Points-PointsKO-Adjacents,9
Garcinia_mangorensis,27,10,17,Points-PointsKO-Adjacents,196
Garcinia_mangostifera,0,0,0,NA,0
Garcinia_mannii,159,141,18,Alphahull-PointsKO-Adjacents,2741
Garcinia_matsudae,0,0,0,NA,0
Garcinia_mckeaniana,2,2,0,Points-PointsKO-Adjacents,18
Garcinia_megistophylla,16,7,9,Points-PointsKO-Adjacents,92
Garcinia_memecyloides,1,1,0,Points-PointsKO-Adjacents,9
Garcinia_merguensis,12,2,10,Points-PointsKO-Adjacents,96
Garcinia_mestoni,22,18,4,Points-PointsKO-Adjacents,32
Garcinia_microcarpa,1,0,1,Points-PointsKO-Adjacents,9
Garcinia_microphylla,0,0,0,NA,0
Garcinia_microstigma,0,0,0,NA,0
Garcinia_microtropidiiformis,0,0,0,NA,0
Garcinia_minahassensis,4,4,0,Points-PointsKO-Adjacents,32
Garcinia_mindanaensis,0,0,0,NA,0
Garcinia_minimiflora,0,0,0,NA,0
Garcinia_minutiflora,0,0,0,NA,0
Garcinia_miquelii,1,0,1,Points-PointsKO-Adjacents,9
Garcinia_monantha,0,0,0,NA,0
Garcinia_montana,NA,NA,NA,NA,NA
Garcinia_morella,0,0,0,NA,0
Garcinia_moseleyana,0,0,0,NA,0
Garcinia_moszkowskii,1,1,0,Points-PointsKO-Adjacents,9
Garcinia_mottleyana,1,1,0,Points-PointsKO-Adjacents,9
Garcinia_moulmeinensis,0,0,0,NA,0
Garcinia_multibracteolata,0,0,0,NA,0
Garcinia_multifida,2,2,0,Points-PointsKO-Adjacents,18
Garcinia_multiflora,118,87,31,Alphahull-PointsKO-Adjacents,5505
Garcinia_mungotia,10,6,4,Points-PointsKO-Adjacents,40
Garcinia_murdochii,0,0,0,NA,0
Garcinia_murtonii,0,0,0,NA,0
Garcinia_myristicifolia,0,0,0,NA,0
Garcinia_myrtifolia,3,3,0,Points-PointsKO-Adjacents,22
Garcinia_nervosa,16,3,13,Points-PointsKO-Adjacents,114
Garcinia_nigricans,0,0,0,NA,0
Garcinia_nigrolineata,3,2,1,Points-PointsKO-Adjacents,27
Garcinia_nitida,2,0,2,Points-PointsKO-Adjacents,18
Garcinia_nujiangensis,5,5,0,Points-PointsKO-Adjacents,27
Garcinia_ochrocarpoides,3,3,0,Points-PointsKO-Adjacents,23
Garcinia_oliveri,7,2,5,Points-PointsKO-Adjacents,44
Garcinia_opaca,4,4,0,Points-PointsKO-Adjacents,27
Garcinia_oreophila,0,0,0,NA,0
Garcinia_orthoclada,119,101,18,Alphahull-PointsKO-Adjacents,903
Garcinia_ovalifolia,230,155,75,Alphahull-PointsKO-Adjacents,13297
Garcinia_pachyantha,0,0,0,NA,0
Garcinia_pachycarpa,0,0,0,NA,0
Garcinia_pachyclada,6,1,5,Points-PointsKO-Adjacents,45
Garcinia_pachypetala,NA,NA,NA,NA,NA
Garcinia_pacifica,0,0,0,NA,0
Garcinia_pallida,0,0,0,NA,0
Garcinia_pallidesanguinea,NA,NA,NA,NA,NA
Garcinia_pancheri,3,3,0,Points-PointsKO-Adjacents,26
Garcinia_parviflora,0,0,0,NA,0
Garcinia_parvifolia,33,14,19,Points-PointsKO-Adjacents,253
Garcinia_parvula,30,22,8,Alphahull-PointsKO-Adjacents,230
Garcinia_pauciflora,57,35,22,Alphahull-PointsKO-Adjacents,1058
Garcinia_paucinervis,7,3,4,Points-PointsKO-Adjacents,63
Garcinia_pedicellata,10,6,4,Points-PointsKO-Adjacents,40
Garcinia_pedunculata,1,1,0,Points-PointsKO-Adjacents,9
Garcinia_penangiana,0,0,0,NA,0
Garcinia_petiolaris,2,0,2,Points-PointsKO-Adjacents,18
Garcinia_picrorhiza,6,0,6,Points-PointsKO-Adjacents,45
Garcinia_planchonii,1,1,0,Points-PointsKO-Adjacents,9
Garcinia_platyphylla,0,0,0,NA,0
Garcinia_plena,0,0,0,NA,0
Garcinia_poilanei,0,0,0,NA,0
Garcinia_polyneura,2,2,0,Points-PointsKO-Adjacents,11
Garcinia_ponapensis,3,3,0,Points-PointsKO-Adjacents,10
Garcinia_portoricensis,16,11,5,Points-PointsKO-Adjacents,67
Garcinia_prainiana,4,4,0,Points-PointsKO-Adjacents,36
Garcinia_preussii,39,28,11,Alphahull-PointsKO-Adjacents,1624
Garcinia_propinqua,1,1,0,Points-PointsKO-Adjacents,9
Garcinia_pseudoguttifera,16,6,10,Points-PointsKO-Adjacents,91
Garcinia_puat,6,2,4,Points-PointsKO-Adjacents,47
Garcinia_pullei,0,0,0,NA,0
Garcinia_punctata,248,206,42,Alphahull-PointsKO-Adjacents,15190
Garcinia_pyrifera,2,2,0,Points-PointsKO-Adjacents,18
Garcinia_quadrifaria,79,53,26,Alphahull-PointsKO-Adjacents,2183
Garcinia_quaesita,0,0,0,NA,0
Garcinia_ramulosa,0,0,0,NA,0
Garcinia_revoluta,3,3,0,Points-PointsKO-Adjacents,16
Garcinia_rheedei,3,2,1,Points-PointsKO-Adjacents,21
Garcinia_rhizophoroides,2,2,0,Points-PointsKO-Adjacents,8
Garcinia_riedeliana,4,4,0,Points-PointsKO-Adjacents,29
Garcinia_rigida,1,1,0,Points-PointsKO-Adjacents,9
Garcinia_riparia,6,0,6,Points-PointsKO-Adjacents,43
Garcinia_robsoniana,3,3,0,Points-PointsKO-Adjacents,27
Garcinia_rostrata,10,2,8,Points-PointsKO-Adjacents,87
Garcinia_rubra,2,2,0,Points-PointsKO-Adjacents,8
Garcinia_rubriflora,0,0,0,NA,0
Garcinia_rubroechinata,0,0,0,NA,0
Garcinia_rumiyo,1,1,0,Points-PointsKO-Adjacents,7
Garcinia_rupestris,NA,NA,NA,NA,NA
Garcinia_ruscifolia,7,0,7,Points-PointsKO-Adjacents,52
Garcinia_sabangensis,8,1,7,Points-PointsKO-Adjacents,48
Garcinia_salakensis,0,0,0,NA,0
Garcinia_sampitana,NA,NA,NA,NA,NA
Garcinia_scaphopetala,0,0,0,NA,0
Garcinia_schefferi,1,1,0,Points-PointsKO-Adjacents,9
Garcinia_schlecbteri,0,0,0,NA,0
Garcinia_schomburgkiana,1,1,0,Points-PointsKO-Adjacents,9
Garcinia_schraderi,13,4,9,Points-PointsKO-Adjacents,78
Garcinia_scortechinii,5,5,0,Points-PointsKO-Adjacents,27
Garcinia_semseii,8,3,5,Points-PointsKO-Adjacents,47
Garcinia_serpentini,4,4,0,Points-PointsKO-Adjacents,27
Garcinia_sessilis,1,1,0,Points-PointsKO-Adjacents,6
Garcinia_sizygiifolia,5,5,0,Points-PointsKO-Adjacents,12
Garcinia_smeathmanii,247,180,67,Alphahull-PointsKO-Adjacents,5899
Garcinia_sopsopia,1,1,0,Points-PointsKO-Adjacents,9
Garcinia_spectabilis,0,0,0,NA,0
Garcinia_spicata,3,0,3,Points-PointsKO-Adjacents,27
Garcinia_squamata,NA,NA,NA,NA,NA
Garcinia_staudtii,16,8,8,Points-PointsKO-Adjacents,93
Garcinia_stigmacantha,1,0,1,Points-PointsKO-Adjacents,9
Garcinia_stipulata,1,1,0,Points-PointsKO-Adjacents,9
Garcinia_subelliptica,16,0,16,Points-PointsKO-Adjacents,69
Garcinia_subfalcata,2,2,0,Points-PointsKO-Adjacents,18
Garcinia_subtilinervis,5,5,0,Points-PointsKO-Adjacents,39
Garcinia_succifolia,1,0,1,Points-PointsKO-Adjacents,9
Garcinia_talbotii,0,0,0,NA,0
Garcinia_tanzaniensis,5,5,0,Points-PointsKO-Adjacents,30
Garcinia_terpnophylla,2,2,0,Points-PointsKO-Adjacents,18
Garcinia_tetralata,1,1,0,Points-PointsKO-Adjacents,9
Garcinia_tetrandra,7,0,7,Points-PointsKO-Adjacents,53
Garcinia_teysmanniana,1,1,0,Points-PointsKO-Adjacents,9
Garcinia_thorelii,0,0,0,NA,0
Garcinia_thouvenotii,9,4,5,Points-PointsKO-Adjacents,48
Garcinia_tonkinensis,0,0,0,NA,0
Garcinia_torensis,0,0,0,NA,0
Garcinia_travancorica,1,1,0,Points-PointsKO-Adjacents,9
Garcinia_treubii,0,0,0,NA,0
Garcinia_tsaratananae,59,44,15,Alphahull-PointsKO-Adjacents,572
Garcinia_tsimatimia,7,1,6,Points-PointsKO-Adjacents,42
Garcinia_tuberculata,0,0,0,NA,0
Garcinia_umbellulata,0,0,0,NA,0
Garcinia_umbonata,0,0,0,NA,0
Garcinia_uniflora,3,3,0,Points-PointsKO-Adjacents,21
Garcinia_urophylla,5,0,5,Points-PointsKO-Adjacents,45
Garcinia_urschii,15,0,15,Points-PointsKO-Adjacents,72
Garcinia_valetoniana,0,0,0,NA,0
Garcinia_venulosa,0,0,0,NA,0
Garcinia_verrucosa,233,206,27,Alphahull-PointsKO-Adjacents,1749
Garcinia_versteegii,0,0,0,NA,0
Garcinia_verticillata,1,1,0,Points-PointsKO-Adjacents,9
Garcinia_vidalii,3,3,0,Points-PointsKO-Adjacents,27
Garcinia_vidua,0,0,0,NA,0
Garcinia_vieillardii,3,3,0,Points-PointsKO-Adjacents,18
Garcinia_vilersiana,2,0,2,Points-PointsKO-Adjacents,18
Garcinia_viridiflora,0,0,0,NA,0
Garcinia_vitiensis,9,1,8,Points-PointsKO-Adjacents,60
Garcinia_volkensii,0,0,0,NA,0
Garcinia_vriesiana,NA,NA,NA,NA,NA
Garcinia_warburgiana,7,0,7,Points-PointsKO-Adjacents,54
Garcinia_warrenii,189,156,33,Alphahull-PointsKO-Adjacents,1042
Garcinia_wightii,0,0,0,NA,0
Garcinia_wollastonii,0,0,0,NA,0
Garcinia_xanthochymus,17,5,12,Points-PointsKO-Adjacents,153
Garcinia_xipshuanbannaensis,1,1,0,Points-PointsKO-Adjacents,9
Garcinia_xylosperma,1,1,0,Points-PointsKO-Adjacents,9
Garcinia_yunnanensis,7,0,7,Points-PointsKO-Adjacents,63
Garcinia_zeylanica,0,0,0,NA,0
Gardenia_actinocarpa,15,10,5,Points-PointsKO-Adjacents,17
Gardenia_anapetes,0,0,0,NA,0
Gardenia_annamensis,0,0,0,NA,0
Gardenia_aubryi,14,8,6,Points-PointsKO-Adjacents,53
Gardenia_barnesii,4,4,0,Points-PointsKO-Adjacents,33
Gardenia_beamanii,0,0,0,NA,0
Gardenia_brachythamnus,12,1,11,Points-PointsKO-Adjacents,99
Gardenia_brevicalyx,14,8,6,Points-PointsKO-Adjacents,62
Gardenia_brighamii,4,1,3,Points-PointsKO-Adjacents,23
Gardenia_candida,0,0,0,NA,0
Gardenia_carinata,3,1,2,Points-PointsKO-Adjacents,27
Gardenia_chanii,0,0,0,NA,0
Gardenia_colnettiana,1,1,0,Points-PointsKO-Adjacents,8
Gardenia_cornuta,24,14,10,Points-PointsKO-Adjacents,213
Gardenia_coronaria,4,0,4,Points-PointsKO-Adjacents,18
Gardenia_crameri,1,1,0,Points-PointsKO-Adjacents,9
Gardenia_cuneata,NA,NA,NA,NA,NA
Gardenia_dacryoides,98,81,17,Alphahull-PointsKO-Adjacents,960
Gardenia_elata,19,5,14,Points-PointsKO-Adjacents,161
Gardenia_erubescens,402,371,31,Alphahull-PointsKO-Adjacents,6084
Gardenia_ewartii,182,159,23,Alphahull-PointsKO-Adjacents,2868
Gardenia_faucicola,67,55,12,Alphahull-PointsKO-Adjacents,403
Gardenia_fiorii,5,5,0,Points-PointsKO-Adjacents,36
Gardenia_forsteniana,0,0,0,NA,0
Gardenia_fucata,446,423,23,Alphahull-PointsKO-Adjacents,3125
Gardenia_gardneri,7,2,5,Points-PointsKO-Adjacents,54
Gardenia_gordonii,0,0,0,NA,0
Gardenia_grandis,1,0,1,Points-PointsKO-Adjacents,9
Gardenia_grievei,0,0,0,NA,0
Gardenia_griffithii,2,2,0,Points-PointsKO-Adjacents,14
Gardenia_gummifera,2,2,0,Points-PointsKO-Adjacents,18
Gardenia_hainanensis,7,0,7,Points-PointsKO-Adjacents,54
Gardenia_hillii,0,0,0,NA,0
Gardenia_hutchinsoniana,0,0,0,NA,0
Gardenia_imperialis,168,74,94,Alphahull-PointsKO-Adjacents,7870
Gardenia_jabiluka,5,3,2,Points-PointsKO-Adjacents,27
Gardenia_jasminoides,613,459,154,Alphahull-PointsKO-Adjacents,17983
Gardenia_kamialiensis,3,3,0,Points-PointsKO-Adjacents,16
Gardenia_leopoldiana,6,3,3,Points-PointsKO-Adjacents,51
Gardenia_mannii,2,2,0,Points-PointsKO-Adjacents,12
Gardenia_manongarivensis,2,2,0,Points-PointsKO-Adjacents,9
Gardenia_megasperma,1686,1655,31,Alphahull-PointsKO-Adjacents,5840
Gardenia_mollis,2,2,0,Points-PointsKO-Adjacents,14
Gardenia_mutabilis,1,1,0,Points-PointsKO-Adjacents,9
Gardenia_obtusifolia,4,4,0,Points-PointsKO-Adjacents,36
Gardenia_ornata,1,1,0,Points-PointsKO-Adjacents,9
Gardenia_oudiepe,3,3,0,Points-PointsKO-Adjacents,24
Gardenia_ovularis,102,89,13,Alphahull-PointsKO-Adjacents,155
Gardenia_papuana,7,1,6,Points-PointsKO-Adjacents,60
Gardenia_philastrei,2,2,0,Points-PointsKO-Adjacents,18
Gardenia_posoquerioides,21,9,12,Points-PointsKO-Adjacents,104
Gardenia_pterocalyx,3,3,0,Points-PointsKO-Adjacents,25
Gardenia_pyriformis,302,262,40,Alphahull-PointsKO-Adjacents,5132
Gardenia_remyi,7,1,6,Points-PointsKO-Adjacents,41
Gardenia_resinifera,1,1,0,Points-PointsKO-Adjacents,9
Gardenia_resiniflua,52,24,28,Alphahull-PointsKO-Adjacents,1011
Gardenia_resinosa,447,428,19,Alphahull-PointsKO-Adjacents,4066
Gardenia_rutenbergiana,62,43,19,Alphahull-PointsKO-Adjacents,1313
Gardenia_sambiranensis,10,4,6,Points-PointsKO-Adjacents,55
Gardenia_scabrella,89,77,12,Alphahull-PointsKO-Adjacents,273
Gardenia_schwarzii,204,188,16,Alphahull-PointsKO-Adjacents,1318
Gardenia_sericea,8,3,5,Points-PointsKO-Adjacents,50
Gardenia_sootepensis,11,2,9,Points-PointsKO-Adjacents,86
Gardenia_storckii,0,0,0,NA,0
Gardenia_subcarinata,NA,NA,NA,NA,NA
Gardenia_taitensis,6,1,5,Points-PointsKO-Adjacents,39
Gardenia_tannaensis,16,6,10,Points-PointsKO-Adjacents,92
Gardenia_ternifolia,814,674,140,Alphahull-PointsKO-Adjacents,17806
Gardenia_tessellaris,66,53,13,Alphahull-PointsKO-Adjacents,772
Gardenia_thailandica,0,0,0,NA,0
Gardenia_thunbergia,27,9,18,Points-PointsKO-Adjacents,222
Gardenia_transvenulosa,47,35,12,Alphahull-PointsKO-Adjacents,485
Gardenia_truncata,0,0,0,NA,0
Gardenia_tubifera,8,0,8,Points-PointsKO-Adjacents,72
Gardenia_vilhelmii,132,115,17,Alphahull-PointsKO-Adjacents,1083
Gardenia_vitiensis,1,1,0,Points-PointsKO-Adjacents,9
Gardenia_vogelii,52,21,31,Alphahull-PointsKO-Adjacents,1567
Gardenia_volkensii,117,71,46,Alphahull-PointsKO-Adjacents,3865
Gardenia_vulcanica,1,1,0,Points-PointsKO-Adjacents,9
Gardeniopsis_longifolia,10,0,10,Points-PointsKO-Adjacents,80
Garnieria_spathulifolia,11,5,6,Points-PointsKO-Adjacents,49
Garrettia_siamensis,7,0,7,Points-PointsKO-Adjacents,49
Garrya_congdonii,145,132,13,Alphahull-PointsKO-Adjacents,1057
Garrya_corvorum,4,4,0,Points-PointsKO-Adjacents,27
Garrya_elliptica,453,366,87,Alphahull-PointsKO-Adjacents,1935
Garrya_fadyenii,67,51,16,Alphahull-PointsKO-Adjacents,326
Garrya_flavescens,886,846,40,Alphahull-PointsKO-Adjacents,8058
Garrya_fremontii,622,0,622,Points-PointsKO-Adjacents,1829
Garrya_glaberrima,54,44,10,Alphahull-PointsKO-Adjacents,328
Garrya_laurifolia,740,676,64,Alphahull-PointsKO-Adjacents,8981
Garrya_longifolia,105,79,26,Alphahull-PointsKO-Adjacents,1335
Garrya_ovata,345,298,47,Alphahull-PointsKO-Adjacents,11053
Garrya_salicifolia,13,0,13,Points-PointsKO-Adjacents,52
Garrya_veatchii,460,421,39,Alphahull-PointsKO-Adjacents,1713
Garrya_wrightii,436,397,39,Alphahull-PointsKO-Adjacents,8042
Garuga_floribunda,162,93,69,Alphahull-PointsKO-Adjacents,1345
Garuga_forrestii,9,2,7,Points-PointsKO-Adjacents,81
Garuga_pierrei,2,0,2,Points-PointsKO-Adjacents,16
Garuga_pinnata,19,2,17,Points-PointsKO-Adjacents,167
Gastrolepis_austrocaledonica,11,7,4,Points-PointsKO-Adjacents,44
Gastrolobium_bilobum,218,193,25,Alphahull-PointsKO-Adjacents,1257
Gastrolobium_ferrugineum,8,6,2,Points-PointsKO-Adjacents,40
Gastrolobium_spectabile,14,7,7,Points-PointsKO-Adjacents,81
Gaulettia_canescens,10,2,8,Points-PointsKO-Adjacents,83
Gaulettia_canomensis,128,77,51,Alphahull-PointsKO-Adjacents,11461
Gaulettia_cognata,37,23,14,Alphahull-PointsKO-Adjacents,423
Gaulettia_elata,40,17,23,Points-PointsKO-Adjacents,318
Gaulettia_foveolata,9,3,6,Points-PointsKO-Adjacents,71
Gaulettia_parillo,99,60,39,Alphahull-PointsKO-Adjacents,5407
Gaulettia_racemosa,116,0,116,Points-PointsKO-Adjacents,884
Gaulettia_steyermarkii,4,4,0,Points-PointsKO-Adjacents,33
Gaultheria_acuminata,328,286,42,Alphahull-PointsKO-Adjacents,2370
Gaultheria_bracteata,161,127,34,Alphahull-PointsKO-Adjacents,958
Gaultheria_erecta,1573,0,1573,Points-PointsKO-Adjacents,4526
Gaultheria_eriophylla,131,110,21,Alphahull-PointsKO-Adjacents,1666
Gaultheria_fragrantissima,121,0,121,Points-PointsKO-Adjacents,574
Gaultheria_griffithiana,81,0,81,Points-PointsKO-Adjacents,345
Gaultheria_itatiaiae,22,0,22,Points-PointsKO-Adjacents,133
Gaultheria_malayana,8,3,5,Points-PointsKO-Adjacents,49
Gaussia_attenuata,4,0,4,Points-PointsKO-Adjacents,25
Gaussia_gomez-pompae,7,1,6,Points-PointsKO-Adjacents,57
Gaussia_maya,39,31,8,Alphahull-PointsKO-Adjacents,212
Gaussia_princeps,2,2,0,Points-PointsKO-Adjacents,18
Gaussia_spirituana,0,0,0,NA,0
Gaylussacia_brasiliensis,906,805,101,Alphahull-PointsKO-Adjacents,19463
Gaylussacia_montana,88,65,23,Alphahull-PointsKO-Adjacents,659
Gaylussacia_oleifolia,33,0,33,Points-PointsKO-Adjacents,125
Gaylussacia_rhododendron,22,10,12,Points-PointsKO-Adjacents,118
Gaylussacia_salicifolia,45,33,12,Alphahull-PointsKO-Adjacents,1092
Geijera_balansae,7,3,4,Points-PointsKO-Adjacents,46
Geijera_deplanchei,0,0,0,NA,0
Geijera_helmsiae,73,51,22,Alphahull-PointsKO-Adjacents,716
Geijera_linearifolia,2008,1953,55,Alphahull-PointsKO-Adjacents,4261
Geijera_paniculata,140,107,33,Alphahull-PointsKO-Adjacents,870
Geijera_parviflora,3830,3783,47,Alphahull-PointsKO-Adjacents,17210
Geijera_salicifolia,1116,1015,101,Alphahull-PointsKO-Adjacents,10084
Geissanthus_ambiguus,189,141,48,Alphahull-PointsKO-Adjacents,8988
Geissanthus_andinus,111,93,18,Alphahull-PointsKO-Adjacents,1351
Geissanthus_angustiflorus,1,1,0,Points-PointsKO-Adjacents,9
Geissanthus_argutus,20,13,7,Points-PointsKO-Adjacents,146
Geissanthus_bangii,23,11,12,Points-PointsKO-Adjacents,108
Geissanthus_barraganus,1,1,0,Points-PointsKO-Adjacents,9
Geissanthus_betancurii,11,4,7,Points-PointsKO-Adjacents,74
Geissanthus_bogotensis,81,67,14,Alphahull-PointsKO-Adjacents,1235
Geissanthus_boliviana,4,4,0,Points-PointsKO-Adjacents,36
Geissanthus_callejasii,2,2,0,Points-PointsKO-Adjacents,9
Geissanthus_cestrifolius,1,1,0,Points-PointsKO-Adjacents,9
Geissanthus_challuayacus,7,7,0,Points-PointsKO-Adjacents,48
Geissanthus_cogolloi,6,3,3,Points-PointsKO-Adjacents,33
Geissanthus_dentatus,1,1,0,Points-PointsKO-Adjacents,9
Geissanthus_durifolius,1,1,0,Points-PointsKO-Adjacents,9
Geissanthus_ecuadorensis,16,8,8,Points-PointsKO-Adjacents,115
Geissanthus_fallenae,7,2,5,Points-PointsKO-Adjacents,36
Geissanthus_floccosus,1,1,0,Points-PointsKO-Adjacents,9
Geissanthus_floribundus,3,3,0,Points-PointsKO-Adjacents,27
Geissanthus_fragrans,24,15,9,Points-PointsKO-Adjacents,105
Geissanthus_francoae,5,5,0,Points-PointsKO-Adjacents,36
Geissanthus_furfuraceus,0,0,0,NA,0
Geissanthus_glaber,0,0,0,NA,0
Geissanthus_goudotianus,3,3,0,Points-PointsKO-Adjacents,24
Geissanthus_haenkeanus,2,1,1,Points-PointsKO-Adjacents,18
Geissanthus_kalbreyeri,5,0,5,Points-PointsKO-Adjacents,36
Geissanthus_lehmannii,2,2,0,Points-PointsKO-Adjacents,18
Geissanthus_lepidotus,1,1,0,Points-PointsKO-Adjacents,9
Geissanthus_longistamineus,78,54,24,Alphahull-PointsKO-Adjacents,1361
Geissanthus_longistylus,1,1,0,Points-PointsKO-Adjacents,9
Geissanthus_mameicillo,NA,NA,NA,NA,NA
Geissanthus_mezianus,0,0,0,NA,0
Geissanthus_multiflorus,1,1,0,Points-PointsKO-Adjacents,9
Geissanthus_myrianthus,2,2,0,Points-PointsKO-Adjacents,18
Geissanthus_occidentalis,59,45,14,Alphahull-PointsKO-Adjacents,1153
Geissanthus_pentlandii,0,0,0,NA,0
Geissanthus_perpuncticulosus,18,7,11,Points-PointsKO-Adjacents,113
Geissanthus_peruvianus,4,4,0,Points-PointsKO-Adjacents,36
Geissanthus_pichinchae,14,10,4,Points-PointsKO-Adjacents,99
Geissanthus_quindiensis,27,15,12,Points-PointsKO-Adjacents,192
Geissanthus_sararensis,4,4,0,Points-PointsKO-Adjacents,27
Geissanthus_serulatus,35,21,14,Alphahull-PointsKO-Adjacents,223
Geissanthus_sessiliflorus,0,0,0,NA,0
Geissanthus_sodiroanus,4,4,0,Points-PointsKO-Adjacents,34
Geissanthus_spectabilis,1,1,0,Points-PointsKO-Adjacents,9
Geissanthus_vanderwerffii,17,8,9,Points-PointsKO-Adjacents,98
Geissanthus_zakii,1,1,0,Points-PointsKO-Adjacents,9
Geissois_bradfordii,1,1,0,Points-PointsKO-Adjacents,9
Geissois_denhamii,17,7,10,Points-PointsKO-Adjacents,78
Geissois_hippocastaneifolia,2,2,0,Points-PointsKO-Adjacents,13
Geissois_hirsuta,12,6,6,Points-PointsKO-Adjacents,50
Geissois_imthurnii,1,1,0,Points-PointsKO-Adjacents,9
Geissois_lanceolata,0,0,0,NA,0
Geissois_montana,12,4,8,Points-PointsKO-Adjacents,59
Geissois_parviflora,NA,NA,NA,NA,NA
Geissois_pentaphylla,0,0,0,NA,0
Geissois_polyphylla,8,3,5,Points-PointsKO-Adjacents,52
Geissois_pruinosa,27,16,11,Points-PointsKO-Adjacents,118
Geissois_racemosa,9,3,6,Points-PointsKO-Adjacents,63
Geissois_stipularis,0,0,0,NA,0
Geissois_superba,6,0,6,Points-PointsKO-Adjacents,18
Geissois_ternata,2,2,0,Points-PointsKO-Adjacents,8
Geissois_trifoliolata,5,5,0,Points-PointsKO-Adjacents,27
Geissois_velutina,1,1,0,Points-PointsKO-Adjacents,9
Geissospermum_argenteum,35,21,14,Alphahull-PointsKO-Adjacents,1425
Geissospermum_fuscum,2,2,0,Points-PointsKO-Adjacents,18
Geissospermum_laeve,156,89,67,Alphahull-PointsKO-Adjacents,9771
Geissospermum_reticulatum,51,30,21,Alphahull-PointsKO-Adjacents,632
Geissospermum_sericeum,22,14,8,Points-PointsKO-Adjacents,188
Geissospermum_urceolatum,36,8,28,Points-PointsKO-Adjacents,296
Geniostoma_antherotrichum,52,28,24,Alphahull-PointsKO-Adjacents,348
Geniostoma_balansaeanum,6,2,4,Points-PointsKO-Adjacents,35
Geniostoma_biseriale,2,2,0,Points-PointsKO-Adjacents,9
Geniostoma_celastrineum,7,2,5,Points-PointsKO-Adjacents,57
Geniostoma_densiflora,12,6,6,Points-PointsKO-Adjacents,66
Geniostoma_erythrosperma,2,2,0,Points-PointsKO-Adjacents,18
Geniostoma_gagnae,0,0,0,NA,0
Geniostoma_glaucescens,4,4,0,Points-PointsKO-Adjacents,33
Geniostoma_leenhoutsii,2,2,0,Points-PointsKO-Adjacents,18
Geniostoma_macrophyllum,1,1,0,Points-PointsKO-Adjacents,9
Geniostoma_mooreanum,1,1,0,Points-PointsKO-Adjacents,9
Geniostoma_novae-caledoniae,4,3,1,Points-PointsKO-Adjacents,27
Geniostoma_petiolosum,17,12,5,Points-PointsKO-Adjacents,5
Geniostoma_randianum,11,5,6,Points-PointsKO-Adjacents,55
Geniostoma_rapense,4,4,0,Points-PointsKO-Adjacents,4
Geniostoma_remyana,15,0,15,Points-PointsKO-Adjacents,73
Geniostoma_rupestre,156,63,93,Alphahull-PointsKO-Adjacents,1331
Geniostoma_stipulare,0,0,0,NA,0
Geniostoma_sykesii,2,2,0,Points-PointsKO-Adjacents,1
Geniostoma_trichostylum,1,1,0,Points-PointsKO-Adjacents,9
Geniostoma_umbellatum,NA,NA,NA,NA,NA
Geniostoma_vestitum,4,4,0,Points-PointsKO-Adjacents,30
Geniostoma_weinlandii,27,14,13,Points-PointsKO-Adjacents,168
Genipa_americana,3141,2834,307,Alphahull-PointsKO-Adjacents,150927
Genipa_infundibuliformis,43,26,17,Alphahull-PointsKO-Adjacents,1375
Genipa_spruceana,311,248,63,Alphahull-PointsKO-Adjacents,24274
Genista_aetnensis,23,11,12,Points-PointsKO-Adjacents,63
Genista_angustifolia,NA,NA,NA,NA,NA
Genista_maderensis,15,11,4,Points-PointsKO-Adjacents,20
Gentingia_subsessilis,0,0,0,NA,0
Gentlea_penduliflora,84,66,18,Alphahull-PointsKO-Adjacents,725
Gentlea_standleyi,93,77,16,Alphahull-PointsKO-Adjacents,210
Gentlea_tacanensis,23,14,9,Points-PointsKO-Adjacents,52
Geoffroea_decorticans,265,211,54,Alphahull-PointsKO-Adjacents,21745
Geoffroea_spinosa,417,327,90,Alphahull-PointsKO-Adjacents,13632
Geonoma_baculifera,141,99,42,Alphahull-PointsKO-Adjacents,6362
Geonoma_brongniartii,384,340,44,Alphahull-PointsKO-Adjacents,10649
Geonoma_calyptrogynoidea,59,39,20,Alphahull-PointsKO-Adjacents,1213
Geonoma_camana,184,155,29,Alphahull-PointsKO-Adjacents,6980
Geonoma_chococola,55,37,18,Alphahull-PointsKO-Adjacents,320
Geonoma_congesta,284,257,27,Alphahull-PointsKO-Adjacents,1895
Geonoma_cuneata,606,560,46,Alphahull-PointsKO-Adjacents,3914
Geonoma_deversa,1561,1468,93,Alphahull-PointsKO-Adjacents,72381
Geonoma_elegans,233,181,52,Alphahull-PointsKO-Adjacents,1302
Geonoma_ferruginea,168,149,19,Alphahull-PointsKO-Adjacents,700
Geonoma_galeanoae,4,4,0,Points-PointsKO-Adjacents,28
Geonoma_hollinensis,2,2,0,Points-PointsKO-Adjacents,12
Geonoma_interrupta,572,455,117,Alphahull-PointsKO-Adjacents,22584
Geonoma_laxiflora,110,70,40,Alphahull-PointsKO-Adjacents,11983
Geonoma_lehmannii,118,70,48,Alphahull-PointsKO-Adjacents,1258
Geonoma_longivaginata,67,53,14,Alphahull-PointsKO-Adjacents,629
Geonoma_macrostachys,975,912,63,Alphahull-PointsKO-Adjacents,26864
Geonoma_maxima,1014,945,69,Alphahull-PointsKO-Adjacents,61394
Geonoma_mooreana,26,17,9,Points-PointsKO-Adjacents,72
Geonoma_multisecta,22,17,5,Points-PointsKO-Adjacents,138
Geonoma_occidentalis,177,110,67,Alphahull-PointsKO-Adjacents,6954
Geonoma_oldemanii,22,11,11,Points-PointsKO-Adjacents,162
Geonoma_oligoclona,12,2,10,Points-PointsKO-Adjacents,74
Geonoma_orbignyana,636,559,77,Alphahull-PointsKO-Adjacents,8401
Geonoma_pinnatifrons,223,160,63,Alphahull-PointsKO-Adjacents,6299
Geonoma_poeppigiana,209,182,27,Alphahull-PointsKO-Adjacents,5658
Geonoma_pohliana,1050,923,127,Alphahull-PointsKO-Adjacents,41935
Geonoma_schizocarpa,9,4,5,Points-PointsKO-Adjacents,33
Geonoma_schottiana,742,670,72,Alphahull-PointsKO-Adjacents,7745
Geonoma_stricta,1077,998,79,Alphahull-PointsKO-Adjacents,42862
Geonoma_triandra,20,0,20,Points-PointsKO-Adjacents,149
Geonoma_triglochin,74,1,73,Points-PointsKO-Adjacents,433
Geonoma_trigona,10,5,5,Points-PointsKO-Adjacents,71
Geonoma_undata,810,683,127,Alphahull-PointsKO-Adjacents,20869
Geranium_arboreum,4,4,0,Points-PointsKO-Adjacents,21
Gereaua_perrieri,20,7,13,Points-PointsKO-Adjacents,130
Gerrardina_foliosa,49,27,22,Alphahull-PointsKO-Adjacents,347
Gesneria_alpina,2,2,0,Points-PointsKO-Adjacents,18
Gesneria_aspera,1,1,0,Points-PointsKO-Adjacents,7
Gesneria_calycina,3,2,1,Points-PointsKO-Adjacents,25
Gesneria_calycosa,1,1,0,Points-PointsKO-Adjacents,9
Gesneria_cubensis,14,7,7,Points-PointsKO-Adjacents,100
Gesneria_exserta,3,2,1,Points-PointsKO-Adjacents,20
Gesneria_hypoclada,2,2,0,Points-PointsKO-Adjacents,9
Gesneria_pedunculosa,36,29,7,Alphahull-PointsKO-Adjacents,86
Gesneria_scabra,5,4,1,Points-PointsKO-Adjacents,42
Gesneria_viridiflora,22,6,16,Points-PointsKO-Adjacents,131
Gesnouinia_arborea,65,54,11,Alphahull-PointsKO-Adjacents,113
Gevuina_avellana,66,52,14,Alphahull-PointsKO-Adjacents,1852
Gibsoniothamnus_allenii,15,9,6,Points-PointsKO-Adjacents,53
Gibsoniothamnus_cornutus,29,16,13,Points-PointsKO-Adjacents,161
Gibsoniothamnus_latidentatus,8,3,5,Points-PointsKO-Adjacents,26
Gibsoniothamnus_mirificus,16,9,7,Points-PointsKO-Adjacents,35
Gigasiphon_humblotianum,8,3,5,Points-PointsKO-Adjacents,46
Gigasiphon_macrosiphon,13,3,10,Points-PointsKO-Adjacents,64
Gilbertiodendron_aylmeri,12,6,6,Points-PointsKO-Adjacents,83
Gilbertiodendron_barbulatum,4,4,0,Points-PointsKO-Adjacents,30
Gilbertiodendron_bilineatum,28,13,15,Points-PointsKO-Adjacents,223
Gilbertiodendron_brachystegioides,58,40,18,Alphahull-PointsKO-Adjacents,1620
Gilbertiodendron_demonstrans,35,17,18,Points-PointsKO-Adjacents,194
Gilbertiodendron_dewevrei,195,155,40,Alphahull-PointsKO-Adjacents,19190
Gilbertiodendron_grandiflorum,7,1,6,Points-PointsKO-Adjacents,63
Gilbertiodendron_grandistipulatum,12,7,5,Points-PointsKO-Adjacents,105
Gilbertiodendron_imenoense,7,4,3,Points-PointsKO-Adjacents,57
Gilbertiodendron_ivorense,23,13,10,Points-PointsKO-Adjacents,158
Gilbertiodendron_klainei,13,4,9,Points-PointsKO-Adjacents,92
Gilbertiodendron_limba,76,61,15,Alphahull-PointsKO-Adjacents,1840
Gilbertiodendron_limosum,5,5,0,Points-PointsKO-Adjacents,36
Gilbertiodendron_mayombense,18,6,12,Points-PointsKO-Adjacents,136
Gilbertiodendron_ngouniense,8,7,1,Points-PointsKO-Adjacents,26
Gilbertiodendron_obliquum,2,2,0,Points-PointsKO-Adjacents,18
Gilbertiodendron_ogoouense,76,63,13,Alphahull-PointsKO-Adjacents,1799
Gilbertiodendron_pachyanthum,2,2,0,Points-PointsKO-Adjacents,18
Gilbertiodendron_preussii,83,54,29,Alphahull-PointsKO-Adjacents,921
Gilbertiodendron_quadrifolium,NA,NA,NA,NA,NA
Gilbertiodendron_robynsianum,15,10,5,Points-PointsKO-Adjacents,73
Gilbertiodendron_splendidum,48,37,11,Alphahull-PointsKO-Adjacents,1146
Gilbertiodendron_stipulaceum,30,19,11,Points-PointsKO-Adjacents,194
Gilbertiodendron_unijugum,34,24,10,Alphahull-PointsKO-Adjacents,571
Gilbertiodendron_zenkeri,3,3,0,Points-PointsKO-Adjacents,27
Gillbeea_adenopetala,137,0,137,Points-PointsKO-Adjacents,247
Gillbeea_papuana,20,14,6,Points-PointsKO-Adjacents,107
Gillbeea_whypallana,34,28,6,Alphahull-PointsKO-Adjacents,50
Gillespiea_speciosa,0,0,0,NA,0
Gilletiodendron_escherichii,0,0,0,NA,0
Gilletiodendron_glandulosum,22,16,6,Points-PointsKO-Adjacents,89
Gilletiodendron_kisantuense,14,5,9,Points-PointsKO-Adjacents,90
Gilletiodendron_mildbraedii,20,5,15,Points-PointsKO-Adjacents,125
Gilletiodendron_pierreanum,69,55,14,Alphahull-PointsKO-Adjacents,1141
Ginkgo_biloba,122,73,49,Alphahull-PointsKO-Adjacents,12646
Ginoria_arborea,0,0,0,NA,0
Ginoria_callosa,2,2,0,Points-PointsKO-Adjacents,16
Ginoria_curvispina,2,2,0,Points-PointsKO-Adjacents,18
Ginoria_ginorioides,2,2,0,Points-PointsKO-Adjacents,9
Ginoria_glabra,1,1,0,Points-PointsKO-Adjacents,9
Ginoria_jimenezii,0,0,0,NA,0
Ginoria_koehneana,2,2,0,Points-PointsKO-Adjacents,12
Ginoria_nudiflora,62,42,20,Alphahull-PointsKO-Adjacents,425
Ginoria_rohrii,8,1,7,Points-PointsKO-Adjacents,34
Gironniera_celtidifolia,94,37,57,Alphahull-PointsKO-Adjacents,1542
Gironniera_hirta,9,1,8,Points-PointsKO-Adjacents,81
Gironniera_nervosa,72,38,34,Alphahull-PointsKO-Adjacents,5028
Gironniera_parvifolia,13,0,13,Points-PointsKO-Adjacents,88
Gironniera_rhamnifolia,2,2,0,Points-PointsKO-Adjacents,18
Gironniera_subaequalis,91,40,51,Alphahull-PointsKO-Adjacents,4604
Givotia_gosai,2,2,0,Points-PointsKO-Adjacents,18
Givotia_moluccana,2,0,2,Points-PointsKO-Adjacents,18
Givotia_stipularis,38,24,14,Alphahull-PointsKO-Adjacents,258
Gjellerupia_papuana,6,1,5,Points-PointsKO-Adjacents,39
Glandonia_macrocarpa,29,15,14,Points-PointsKO-Adjacents,207
Glandonia_prancei,9,1,8,Points-PointsKO-Adjacents,79
Glandonia_williamsii,51,36,15,Alphahull-PointsKO-Adjacents,1902
Gleasonia_cururuensis,4,4,0,Points-PointsKO-Adjacents,36
Gleasonia_duidana,44,29,15,Alphahull-PointsKO-Adjacents,2101
Gleasonia_macrocalyx,2,2,0,Points-PointsKO-Adjacents,18
Gleasonia_prancei,14,8,6,Points-PointsKO-Adjacents,37
Gleasonia_uaupensis,13,6,7,Points-PointsKO-Adjacents,103
Gleditsia_amorphoides,254,0,254,Points-PointsKO-Adjacents,1932
Gleditsia_aquatica,466,400,66,Alphahull-PointsKO-Adjacents,14747
Gleditsia_assamica,NA,NA,NA,NA,NA
Gleditsia_australis,13,3,10,Points-PointsKO-Adjacents,108
Gleditsia_caspica,0,0,0,NA,0
Gleditsia_fera,7,1,6,Points-PointsKO-Adjacents,63
Gleditsia_japonica,84,22,62,Alphahull-PointsKO-Adjacents,604
Gleditsia_microphylla,2,2,0,Points-PointsKO-Adjacents,18
Gleditsia_rolfei,16,9,7,Points-PointsKO-Adjacents,24
Gleditsia_sinensis,106,73,33,Alphahull-PointsKO-Adjacents,12124
Gleditsia_triacanthos,5487,4614,873,Alphahull-PointsKO-Adjacents,62223
Glenniea_adamii,9,5,4,Points-PointsKO-Adjacents,54
Glenniea_africana,9,0,9,Points-PointsKO-Adjacents,69
Glenniea_penangensis,0,0,0,NA,0
Glenniea_pervillei,29,13,16,Points-PointsKO-Adjacents,190
Glenniea_philippinensis,1,1,0,Points-PointsKO-Adjacents,9
Glenniea_thorelii,0,0,0,NA,0
Glenniea_unijuga,3,2,1,Points-PointsKO-Adjacents,18
Glenniea_unijugata,6,0,6,Points-PointsKO-Adjacents,54
Glionnetia_sericea,0,0,0,NA,0
Gliricidia_brenningii,49,37,12,Alphahull-PointsKO-Adjacents,568
Gliricidia_maculata,143,120,23,Alphahull-PointsKO-Adjacents,1944
Gliricidia_robusta,10,2,8,Points-PointsKO-Adjacents,38
Gliricidia_sepium,1214,1035,179,Alphahull-PointsKO-Adjacents,18502
Globulostylis_cuvieroides,23,12,11,Points-PointsKO-Adjacents,131
Globulostylis_leniochlamys,21,18,3,Points-PointsKO-Adjacents,72
Globulostylis_minor,17,9,8,Points-PointsKO-Adjacents,80
Globulostylis_uncinula,26,11,15,Points-PointsKO-Adjacents,187
Glochidion_acuminatissimum,3,3,0,Points-PointsKO-Adjacents,27
Glochidion_acustylum,6,0,6,Points-PointsKO-Adjacents,48
Glochidion_alstonii,NA,NA,NA,NA,NA
Glochidion_alticola,1,1,0,Points-PointsKO-Adjacents,9
Glochidion_aluminescens,0,0,0,NA,0
Glochidion_ambiguum,9,0,9,Points-PointsKO-Adjacents,74
Glochidion_andersonii,0,0,0,NA,0
Glochidion_angulatum,21,3,18,Points-PointsKO-Adjacents,148
Glochidion_apodogynum,236,193,43,Alphahull-PointsKO-Adjacents,3352
Glochidion_auii,1,1,0,Points-PointsKO-Adjacents,9
Glochidion_azaleon,1,1,0,Points-PointsKO-Adjacents,9
Glochidion_bachmaense,NA,NA,NA,NA,NA
Glochidion_barronense,7,3,4,Points-PointsKO-Adjacents,36
Glochidion_beccarii,1,1,0,Points-PointsKO-Adjacents,9
Glochidion_beehleri,2,2,0,Points-PointsKO-Adjacents,9
Glochidion_beguinii,4,4,0,Points-PointsKO-Adjacents,22
Glochidion_benthamianum,146,102,44,Alphahull-PointsKO-Adjacents,1784
Glochidion_borgmannii,7,0,7,Points-PointsKO-Adjacents,59
Glochidion_bourdillonii,0,0,0,NA,0
Glochidion_brideliifolium,3,3,0,Points-PointsKO-Adjacents,18
Glochidion_brooksii,0,0,0,NA,0
Glochidion_bullatissimum,2,2,0,Points-PointsKO-Adjacents,9
Glochidion_butonicum,0,0,0,NA,0
Glochidion_caloneurum,1,1,0,Points-PointsKO-Adjacents,9
Glochidion_calospermum,11,4,7,Points-PointsKO-Adjacents,87
Glochidion_canescens,1,1,0,Points-PointsKO-Adjacents,5
Glochidion_carrickii,1,1,0,Points-PointsKO-Adjacents,9
Glochidion_carrii,2,2,0,Points-PointsKO-Adjacents,18
Glochidion_castaneum,8,1,7,Points-PointsKO-Adjacents,61
Glochidion_chlamydogyne,5,5,0,Points-PointsKO-Adjacents,27
Glochidion_chodoense,NA,NA,NA,NA,NA
Glochidion_chondrocarpum,4,4,0,Points-PointsKO-Adjacents,36
Glochidion_collectorum,1,1,0,Points-PointsKO-Adjacents,8
Glochidion_conostylum,3,3,0,Points-PointsKO-Adjacents,12
Glochidion_cupreum,3,3,0,Points-PointsKO-Adjacents,27
Glochidion_decorum,0,0,0,NA,0
Glochidion_delticola,4,4,0,Points-PointsKO-Adjacents,19
Glochidion_discogyne,0,0,0,NA,0
Glochidion_disparipes,198,140,58,Alphahull-PointsKO-Adjacents,4879
Glochidion_dodecapterum,2,2,0,Points-PointsKO-Adjacents,18
Glochidion_drypetifolium,3,3,0,Points-PointsKO-Adjacents,15
Glochidion_dumicola,3,3,0,Points-PointsKO-Adjacents,18
Glochidion_elaphrocarpum,2,2,0,Points-PointsKO-Adjacents,9
Glochidion_ellipticum,2,0,2,Points-PointsKO-Adjacents,18
Glochidion_elmeri,7,4,3,Points-PointsKO-Adjacents,51
Glochidion_eucleoides,16,4,12,Points-PointsKO-Adjacents,85
Glochidion_formanii,0,0,0,NA,0
Glochidion_frodinii,4,4,0,Points-PointsKO-Adjacents,23
Glochidion_galorii,5,5,0,Points-PointsKO-Adjacents,24
Glochidion_gimi,0,0,0,NA,0
Glochidion_glaucops,0,0,0,NA,0
Glochidion_goniocarpum,NA,NA,NA,NA,NA
Glochidion_gracile,3,3,0,Points-PointsKO-Adjacents,18
Glochidion_granulare,13,5,8,Points-PointsKO-Adjacents,80
Glochidion_grossum,3,3,0,Points-PointsKO-Adjacents,9
Glochidion_heterocalyx,3,3,0,Points-PointsKO-Adjacents,18
Glochidion_huntii,0,0,0,NA,0
Glochidion_hylandii,89,0,89,Points-PointsKO-Adjacents,150
Glochidion_insectum,19,8,11,Points-PointsKO-Adjacents,135
Glochidion_intercastellanum,1,1,0,Points-PointsKO-Adjacents,9
Glochidion_katikii,3,3,0,Points-PointsKO-Adjacents,27
Glochidion_kerangae,8,3,5,Points-PointsKO-Adjacents,55
Glochidion_kopiaginis,3,3,0,Points-PointsKO-Adjacents,9
Glochidion_kostermansii,2,2,0,Points-PointsKO-Adjacents,9
Glochidion_kunstlerianum,7,0,7,Points-PointsKO-Adjacents,59
Glochidion_lalae,0,0,0,NA,0
Glochidion_lambiricum,1,1,0,Points-PointsKO-Adjacents,9
Glochidion_lanceolatum,80,55,25,Alphahull-PointsKO-Adjacents,383
Glochidion_leptostylum,0,0,0,NA,0
Glochidion_loerzingii,2,2,0,Points-PointsKO-Adjacents,18
Glochidion_macrocarpum,37,18,19,Points-PointsKO-Adjacents,229
Glochidion_macrostigma,14,0,14,Points-PointsKO-Adjacents,116
Glochidion_maingayi,NA,NA,NA,NA,NA
Glochidion_manono,14,9,5,Points-PointsKO-Adjacents,32
Glochidion_medogense,NA,NA,NA,NA,NA
Glochidion_mehipitense,NA,NA,NA,NA,NA
Glochidion_mindorense,5,5,0,Points-PointsKO-Adjacents,41
Glochidion_mitrastylum,7,1,6,Points-PointsKO-Adjacents,54
Glochidion_moluccanum,5,5,0,Points-PointsKO-Adjacents,45
Glochidion_monostylum,7,2,5,Points-PointsKO-Adjacents,48
Glochidion_mop,2,2,0,Points-PointsKO-Adjacents,12
Glochidion_muscisilvae,1,1,0,Points-PointsKO-Adjacents,9
Glochidion_myrianthum,5,0,5,Points-PointsKO-Adjacents,33
Glochidion_namilo,2,2,0,Points-PointsKO-Adjacents,17
Glochidion_nesophilum,8,0,8,Points-PointsKO-Adjacents,55
Glochidion_nobile,2,2,0,Points-PointsKO-Adjacents,18
Glochidion_nothofageticum,2,2,0,Points-PointsKO-Adjacents,18
Glochidion_novaegeorgiae,8,0,8,Points-PointsKO-Adjacents,52
Glochidion_novoguineense,83,44,39,Alphahull-PointsKO-Adjacents,1517
Glochidion_oblongifolium,3,3,0,Points-PointsKO-Adjacents,27
Glochidion_obovatum,72,44,28,Alphahull-PointsKO-Adjacents,441
Glochidion_oxygonum,1,1,0,Points-PointsKO-Adjacents,6
Glochidion_pachyconum,9,7,2,Points-PointsKO-Adjacents,62
Glochidion_paludicola,1,1,0,Points-PointsKO-Adjacents,9
Glochidion_phellocarpum,0,0,0,NA,0
Glochidion_philippicum,157,88,69,Alphahull-PointsKO-Adjacents,3020
Glochidion_phyllanthoides,NA,NA,NA,NA,NA
Glochidion_phyllochlamys,2,2,0,Points-PointsKO-Adjacents,18
Glochidion_pleiosepalum,1,1,0,Points-PointsKO-Adjacents,9
Glochidion_pomiferum,31,17,14,Points-PointsKO-Adjacents,180
Glochidion_praeclarum,0,0,0,NA,0
Glochidion_pruinosum,3,3,0,Points-PointsKO-Adjacents,15
Glochidion_pubicapsa,11,0,11,Points-PointsKO-Adjacents,93
Glochidion_punctatum,NA,NA,NA,NA,NA
Glochidion_pungens,27,18,9,Points-PointsKO-Adjacents,50
Glochidion_pyriforme,4,4,0,Points-PointsKO-Adjacents,21
Glochidion_ramiflorum,39,11,28,Points-PointsKO-Adjacents,172
Glochidion_retinerve,2,2,0,Points-PointsKO-Adjacents,12
Glochidion_rubrum,546,420,126,Alphahull-PointsKO-Adjacents,2866
Glochidion_rugulosum,6,1,5,Points-PointsKO-Adjacents,20
Glochidion_runikerae,0,0,0,NA,0
Glochidion_saccocarpum,0,0,0,NA,0
Glochidion_santisukii,1,1,0,Points-PointsKO-Adjacents,9
Glochidion_sessiliflorum,88,71,17,Alphahull-PointsKO-Adjacents,255
Glochidion_singaporense,4,3,1,Points-PointsKO-Adjacents,36
Glochidion_stipulare,8,1,7,Points-PointsKO-Adjacents,54
Glochidion_striatum,1,1,0,Points-PointsKO-Adjacents,9
Glochidion_styliferum,11,2,9,Points-PointsKO-Adjacents,99
Glochidion_stylosum,0,0,0,NA,0
Glochidion_subfalcatum,3,2,1,Points-PointsKO-Adjacents,27
Glochidion_symingtonii,0,0,0,NA,0
Glochidion_tetrapteron,3,3,0,Points-PointsKO-Adjacents,21
Glochidion_timorense,NA,NA,NA,NA,NA
Glochidion_triandrum,34,9,25,Points-PointsKO-Adjacents,290
Glochidion_trusanicum,0,0,0,NA,0
Glochidion_williamsii,2,2,0,Points-PointsKO-Adjacents,18
Glochidion_wisselense,5,5,0,Points-PointsKO-Adjacents,45
Glochidion_wonenggau,0,0,0,NA,0
Glochidion_xestophyllum,0,0,0,NA,0
Glochidion_zeylanicum,1029,771,258,Alphahull-PointsKO-Adjacents,13539
Gloeocarpus_patentivalvis,3,3,0,Points-PointsKO-Adjacents,22
Gloeospermum_andinum,6,0,6,Points-PointsKO-Adjacents,48
Gloeospermum_boreale,7,5,2,Points-PointsKO-Adjacents,24
Gloeospermum_dichotomum,10,2,8,Points-PointsKO-Adjacents,63
Gloeospermum_diversipetalum,140,121,19,Alphahull-PointsKO-Adjacents,679
Gloeospermum_eneidense,10,6,4,Points-PointsKO-Adjacents,36
Gloeospermum_equatoriense,160,129,31,Alphahull-PointsKO-Adjacents,4076
Gloeospermum_falcatum,17,5,12,Points-PointsKO-Adjacents,109
Gloeospermum_ferrugineostictum,6,5,1,Points-PointsKO-Adjacents,15
Gloeospermum_gossypium,3,3,0,Points-PointsKO-Adjacents,27
Gloeospermum_grandifolium,23,15,8,Points-PointsKO-Adjacents,140
Gloeospermum_longifolium,127,92,35,Alphahull-PointsKO-Adjacents,6918
Gloeospermum_martii,6,0,6,Points-PointsKO-Adjacents,54
Gloeospermum_portobelense,5,4,1,Points-PointsKO-Adjacents,25
Gloeospermum_sclerophyllum,15,6,9,Points-PointsKO-Adjacents,90
Gloeospermum_sphaerocarpum,341,270,71,Alphahull-PointsKO-Adjacents,18261
Glossocalyx_longicuspis,149,130,19,Alphahull-PointsKO-Adjacents,1954
Glossocarya_scandens,0,0,0,NA,0
Glossostipula_blepharophylla,25,0,25,Points-PointsKO-Adjacents,104
Glossostipula_concinna,135,112,23,Alphahull-PointsKO-Adjacents,1005
Glossostipula_strigosa,4,4,0,Points-PointsKO-Adjacents,30
Gluema_ivorensis,32,17,15,Points-PointsKO-Adjacents,195
Gluema_korupensis,5,5,0,Points-PointsKO-Adjacents,12
Gluta_aptera,6,1,5,Points-PointsKO-Adjacents,54
Gluta_beccarii,3,3,0,Points-PointsKO-Adjacents,27
Gluta_cambodiana,5,5,0,Points-PointsKO-Adjacents,21
Gluta_capituliflora,1,1,0,Points-PointsKO-Adjacents,9
Gluta_celebica,NA,NA,NA,NA,NA
Gluta_compacta,0,0,0,NA,0
Gluta_curtisii,0,0,0,NA,0
Gluta_elegans,3,1,2,Points-PointsKO-Adjacents,24
Gluta_glabra,0,0,0,NA,0
Gluta_gracilis,0,0,0,NA,0
Gluta_laccifera,7,4,3,Points-PointsKO-Adjacents,53
Gluta_lanceolata,0,0,0,NA,0
Gluta_laxiflora,2,1,1,Points-PointsKO-Adjacents,18
Gluta_longipetiolata,NA,NA,NA,NA,NA
Gluta_macrocarpa,6,0,6,Points-PointsKO-Adjacents,50
Gluta_malayana,2,1,1,Points-PointsKO-Adjacents,12
Gluta_megalocarpa,2,2,0,Points-PointsKO-Adjacents,18
Gluta_oba,4,3,1,Points-PointsKO-Adjacents,26
Gluta_obovata,2,2,0,Points-PointsKO-Adjacents,12
Gluta_papuana,4,4,0,Points-PointsKO-Adjacents,27
Gluta_pubescens,2,2,0,Points-PointsKO-Adjacents,18
Gluta_renghas,15,1,14,Points-PointsKO-Adjacents,90
Gluta_rostrata,0,0,0,NA,0
Gluta_rugulosa,4,4,0,Points-PointsKO-Adjacents,35
Gluta_sabahana,23,12,11,Points-PointsKO-Adjacents,143
Gluta_speciosa,3,3,0,Points-PointsKO-Adjacents,27
Gluta_tavoyana,3,3,0,Points-PointsKO-Adjacents,27
Gluta_torquata,1,1,0,Points-PointsKO-Adjacents,9
Gluta_tourtour,23,14,9,Points-PointsKO-Adjacents,105
Gluta_travancorica,0,0,0,NA,0
Gluta_usitata,5,3,2,Points-PointsKO-Adjacents,45
Gluta_velutina,7,0,7,Points-PointsKO-Adjacents,60
Gluta_wallichii,38,23,15,Alphahull-PointsKO-Adjacents,2664
Gluta_wrayi,0,0,0,NA,0
Glycosmis_superba,2,2,0,Points-PointsKO-Adjacents,18
Glycosmis_chlorosperma,14,1,13,Points-PointsKO-Adjacents,116
Glycosmis_collina,0,0,0,NA,0
Glycosmis_crassifolia,0,0,0,NA,0
Glycosmis_cyanocarpa,8,0,8,Points-PointsKO-Adjacents,70
Glycosmis_decipiens,0,0,0,NA,0
Glycosmis_esquirolii,4,4,0,Points-PointsKO-Adjacents,36
Glycosmis_greenei,2,2,0,Points-PointsKO-Adjacents,16
Glycosmis_lanceolata,4,4,0,Points-PointsKO-Adjacents,27
Glycosmis_longisepala,1,1,0,Points-PointsKO-Adjacents,9
Glycosmis_macrantha,1,1,0,Points-PointsKO-Adjacents,9
Glycosmis_macrocarpa,0,0,0,NA,0
Glycosmis_macrophylla,106,84,22,Alphahull-PointsKO-Adjacents,1331
Glycosmis_mauritiana,3,2,1,Points-PointsKO-Adjacents,27
Glycosmis_oligantha,3,3,0,Points-PointsKO-Adjacents,27
Glycosmis_parviflora,255,216,39,Alphahull-PointsKO-Adjacents,2521
Glycosmis_pentaphylla,38,0,38,Points-PointsKO-Adjacents,316
Glycosmis_perakensis,NA,NA,NA,NA,NA
Glycosmis_pseudoracemosa,5,5,0,Points-PointsKO-Adjacents,45
Glycosmis_puberula,1,1,0,Points-PointsKO-Adjacents,9
Glycosmis_tirunelveliensis,NA,NA,NA,NA,NA
Glycosmis_tomentella,0,0,0,NA,0
Glycosmis_trifoliata,870,0,870,Points-PointsKO-Adjacents,2372
Glycosmis_xizangensis,NA,NA,NA,NA,NA
Glycydendron_amazonicum,311,216,95,Alphahull-PointsKO-Adjacents,33471
Glycydendron_espiritosantense,31,13,18,Points-PointsKO-Adjacents,240
Glyphaea_brevis,357,274,83,Alphahull-PointsKO-Adjacents,8478
Glyphaea_tomentosa,15,6,9,Points-PointsKO-Adjacents,111
Glyptopetalum_aquifolium,0,0,0,NA,0
Glyptopetalum_calocarpum,1,1,0,Points-PointsKO-Adjacents,9
Glyptopetalum_calyptratum,0,0,0,NA,0
Glyptopetalum_continentale,1,1,0,Points-PointsKO-Adjacents,9
Glyptopetalum_euphlebium,3,3,0,Points-PointsKO-Adjacents,26
Glyptopetalum_fengii,1,1,0,Points-PointsKO-Adjacents,9
Glyptopetalum_gracilipes,1,1,0,Points-PointsKO-Adjacents,9
Glyptopetalum_grandiflorum,0,0,0,NA,0
Glyptopetalum_lawsonii,0,0,0,NA,0
Glyptopetalum_loheri,2,2,0,Points-PointsKO-Adjacents,18
Glyptopetalum_longipedicellatum,1,1,0,Points-PointsKO-Adjacents,9
Glyptopetalum_longipedunculatum,1,1,0,Points-PointsKO-Adjacents,7
Glyptopetalum_marivelense,2,2,0,Points-PointsKO-Adjacents,8
Glyptopetalum_palawanense,0,0,0,NA,0
Glyptopetalum_poilanei,0,0,0,NA,0
Glyptopetalum_quadrangulare,0,0,0,NA,0
Glyptopetalum_sclerocarpum,1,1,0,Points-PointsKO-Adjacents,9
Glyptopetalum_zeylanicum,1,1,0,Points-PointsKO-Adjacents,9
Glyptostrobus_pensilis,22,3,19,Points-PointsKO-Adjacents,174
Gmelina_arborea,13,3,10,Points-PointsKO-Adjacents,109
Gmelina_asiatica,8,0,8,Points-PointsKO-Adjacents,72
Gmelina_chinensis,8,0,8,Points-PointsKO-Adjacents,72
Gmelina_dalrympleana,118,82,36,Alphahull-PointsKO-Adjacents,1334
Gmelina_elliptica,101,0,101,Points-PointsKO-Adjacents,756
Gmelina_evoluta,4,4,0,Points-PointsKO-Adjacents,22
Gmelina_fasciculiflora,91,81,10,Alphahull-PointsKO-Adjacents,264
Gmelina_hainanensis,2,2,0,Points-PointsKO-Adjacents,18
Gmelina_lecomtei,1,1,0,Points-PointsKO-Adjacents,9
Gmelina_ledermannii,9,0,9,Points-PointsKO-Adjacents,61
Gmelina_leichardtii,469,417,52,Alphahull-PointsKO-Adjacents,1427
Gmelina_lepidota,9,0,9,Points-PointsKO-Adjacents,45
Gmelina_lignum-vitreum,1,1,0,Points-PointsKO-Adjacents,9
Gmelina_magnifica,9,0,9,Points-PointsKO-Adjacents,24
Gmelina_moluccana,62,29,33,Alphahull-PointsKO-Adjacents,406
Gmelina_neocaledonica,12,7,5,Points-PointsKO-Adjacents,51
Gmelina_palawensis,20,4,16,Points-PointsKO-Adjacents,95
Gmelina_philippensis,5,5,0,Points-PointsKO-Adjacents,36
Gmelina_racemosa,3,3,0,Points-PointsKO-Adjacents,27
Gmelina_schlechteri,16,7,9,Points-PointsKO-Adjacents,102
Gmelina_sessilis,11,3,8,Points-PointsKO-Adjacents,86
Gmelina_smithii,13,5,8,Points-PointsKO-Adjacents,48
Gmelina_szechwanensis,0,0,0,NA,0
Gmelina_uniflora,24,11,13,Points-PointsKO-Adjacents,187
Gmelina_vitiensis,0,0,0,NA,0
Gnetum_arboreum,0,0,0,NA,0
Gnetum_costatum,86,0,86,Points-PointsKO-Adjacents,410
Gnetum_gnemon,406,253,153,Alphahull-PointsKO-Adjacents,7573
Gnetum_nodiflorum,201,130,71,Alphahull-PointsKO-Adjacents,20569
Gnidia_danguyana,26,13,13,Points-PointsKO-Adjacents,85
Gnidia_daphnifolia,123,95,28,Alphahull-PointsKO-Adjacents,427
Gnidia_gilbertae,21,12,9,Points-PointsKO-Adjacents,127
Gnidia_glauca,68,22,46,Alphahull-PointsKO-Adjacents,1526
Gnidia_lamprantha,10,0,10,Points-PointsKO-Adjacents,50
Gnidia_razakamalalana,4,4,0,Points-PointsKO-Adjacents,17
Gnidia_socotrana,7,3,4,Points-PointsKO-Adjacents,32
Gochnatia_arborescens,98,56,42,Alphahull-PointsKO-Adjacents,1012
Gochnatia_decora,3,3,0,Points-PointsKO-Adjacents,27
Gochnatia_enneantha,0,0,0,NA,0
Gochnatia_ilicifolia,2,2,0,Points-PointsKO-Adjacents,15
Gochnatia_montana,1,1,0,Points-PointsKO-Adjacents,9
Gochnatia_palosanto,51,28,23,Alphahull-PointsKO-Adjacents,1216
Gochnatia_parvifolia,0,0,0,NA,0
Gochnatia_pulchra,70,53,17,Alphahull-PointsKO-Adjacents,425
Godmania_aesculifolia,532,397,135,Alphahull-PointsKO-Adjacents,15133
Godmania_dardanoi,167,142,25,Alphahull-PointsKO-Adjacents,4865
Godoya_antioquiensis,51,37,14,Alphahull-PointsKO-Adjacents,238
Godoya_obovata,12,2,10,Points-PointsKO-Adjacents,107
Goethalsia_meiantha,166,141,25,Alphahull-PointsKO-Adjacents,1855
Goetzea_elegans,6,2,4,Points-PointsKO-Adjacents,22
Gomortega_keule,9,6,3,Points-PointsKO-Adjacents,61
Gomphandra_apoensis,2,2,0,Points-PointsKO-Adjacents,12
Gomphandra_australiana,146,110,36,Alphahull-PointsKO-Adjacents,1135
Gomphandra_capitulata,3,3,0,Points-PointsKO-Adjacents,24
Gomphandra_comosa,1,1,0,Points-PointsKO-Adjacents,9
Gomphandra_conklinii,1,1,0,Points-PointsKO-Adjacents,9
Gomphandra_coriacea,0,0,0,NA,0
Gomphandra_cumingiana,28,12,16,Points-PointsKO-Adjacents,206
Gomphandra_dolichocarpa,0,0,0,NA,0
Gomphandra_donnaiensis,2,2,0,Points-PointsKO-Adjacents,18
Gomphandra_flavicarpa,2,2,0,Points-PointsKO-Adjacents,12
Gomphandra_fuliginea,0,0,0,NA,0
Gomphandra_fusiformis,1,1,0,Points-PointsKO-Adjacents,9
Gomphandra_halconensis,1,1,0,Points-PointsKO-Adjacents,9
Gomphandra_javanica,5,1,4,Points-PointsKO-Adjacents,39
Gomphandra_lancifolia,0,0,0,NA,0
Gomphandra_luzoniensis,12,5,7,Points-PointsKO-Adjacents,57
Gomphandra_lysipetala,1,1,0,Points-PointsKO-Adjacents,9
Gomphandra_mappioides,35,16,19,Points-PointsKO-Adjacents,249
Gomphandra_mollis,8,2,6,Points-PointsKO-Adjacents,60
Gomphandra_montana,38,17,21,Points-PointsKO-Adjacents,221
Gomphandra_oblongifolia,2,2,0,Points-PointsKO-Adjacents,18
Gomphandra_oligantha,4,4,0,Points-PointsKO-Adjacents,24
Gomphandra_pallida,0,0,0,NA,0
Gomphandra_palustris,1,1,0,Points-PointsKO-Adjacents,9
Gomphandra_parviflora,0,0,0,NA,0
Gomphandra_pseudojavanica,0,0,0,NA,0
Gomphandra_pseudoprasina,9,3,6,Points-PointsKO-Adjacents,69
Gomphandra_quadrifida,40,15,25,Points-PointsKO-Adjacents,289
Gomphandra_rarinervis,17,9,8,Points-PointsKO-Adjacents,79
Gomphandra_sawiensis,0,0,0,NA,0
Gomphandra_schoepfiifolia,4,4,0,Points-PointsKO-Adjacents,27
Gomphandra_simularensis,0,0,0,NA,0
Gomphandra_subrostrata,4,4,0,Points-PointsKO-Adjacents,34
Gomphandra_tetrandra,53,27,26,Alphahull-PointsKO-Adjacents,2681
Gomphandra_tomentella,1,1,0,Points-PointsKO-Adjacents,9
Gomphandra_velutina,0,0,0,NA,0
Gomphia_hiernii,18,6,12,Points-PointsKO-Adjacents,109
Gomphia_mildbraedii,3,3,0,Points-PointsKO-Adjacents,21
Gomphia_sacleuxii,24,12,12,Points-PointsKO-Adjacents,104
Gomphia_scheffleri,47,35,12,Alphahull-PointsKO-Adjacents,517
Gonatogyne_brasiliensis,16,1,15,Points-PointsKO-Adjacents,115
Gongrodiscus_bilocularis,24,13,11,Points-PointsKO-Adjacents,106
Gongrodiscus_parvifolius,12,7,5,Points-PointsKO-Adjacents,48
Gongrodiscus_sufferrugineus,25,14,11,Points-PointsKO-Adjacents,92
Gongrospermum_philippinense,0,0,0,NA,0
Gongylolepis_benthamiana,90,75,15,Alphahull-PointsKO-Adjacents,1880
Gongylolepis_bracteata,9,2,7,Points-PointsKO-Adjacents,50
Gongylolepis_huachamacari,19,8,11,Points-PointsKO-Adjacents,86
Gongylolepis_martiana,69,50,19,Alphahull-PointsKO-Adjacents,1240
Gongylolepis_oblanceolata,8,5,3,Points-PointsKO-Adjacents,27
Gongylolepis_paniculata,35,21,14,Alphahull-PointsKO-Adjacents,518
Gongylolepis_paruana,4,4,0,Points-PointsKO-Adjacents,24
Gongylolepis_pedunculata,12,4,8,Points-PointsKO-Adjacents,74
Gongylolepis_yapacana,13,8,5,Points-PointsKO-Adjacents,96
Goniodiscus_elaeospermus,8,0,8,Points-PointsKO-Adjacents,70
Gonioma_kamassi,36,14,22,Points-PointsKO-Adjacents,238
Gonioma_malagasy,15,10,5,Points-PointsKO-Adjacents,74
Goniorrhachis_marginata,353,315,38,Alphahull-PointsKO-Adjacents,7601
Goniothalamus_acehensis,3,3,0,Points-PointsKO-Adjacents,27
Goniothalamus_alatus,NA,NA,NA,NA,NA
Goniothalamus_albiflorus,NA,NA,NA,NA,NA
Goniothalamus_amuyon,8,0,8,Points-PointsKO-Adjacents,27
Goniothalamus_andersonii,0,0,0,NA,0
Goniothalamus_aruensis,8,1,7,Points-PointsKO-Adjacents,63
Goniothalamus_aurantiacus,0,0,0,NA,0
Goniothalamus_australis,74,65,9,Alphahull-PointsKO-Adjacents,108
Goniothalamus_borneensis,1,1,0,Points-PointsKO-Adjacents,8
Goniothalamus_bracteosus,2,2,0,Points-PointsKO-Adjacents,15
Goniothalamus_brevicuspis,5,5,0,Points-PointsKO-Adjacents,30
Goniothalamus_bygravei,1,1,0,Points-PointsKO-Adjacents,9
Goniothalamus_calcareus,0,0,0,NA,0
Goniothalamus_caloneurus,0,0,0,NA,0
Goniothalamus_calvicarpus,2,2,0,Points-PointsKO-Adjacents,18
Goniothalamus_calycinus,0,0,0,NA,0
Goniothalamus_cardiopetalus,0,0,0,NA,0
Goniothalamus_carolinensis,1,1,0,Points-PointsKO-Adjacents,7
Goniothalamus_catanduanensis,NA,NA,NA,NA,NA
Goniothalamus_cauliflorus,4,4,0,Points-PointsKO-Adjacents,34
Goniothalamus_chartaceus,1,1,0,Points-PointsKO-Adjacents,9
Goniothalamus_cheliensis,1,1,0,Points-PointsKO-Adjacents,9
Goniothalamus_chinensis,3,3,0,Points-PointsKO-Adjacents,27
Goniothalamus_cleistogamus,0,0,0,NA,0
Goniothalamus_clemensii,5,5,0,Points-PointsKO-Adjacents,37
Goniothalamus_copelandii,0,0,0,NA,0
Goniothalamus_coriaceus,0,0,0,NA,0
Goniothalamus_costulatus,3,3,0,Points-PointsKO-Adjacents,27
Goniothalamus_crockerensis,NA,NA,NA,NA,NA
Goniothalamus_curtisii,2,2,0,Points-PointsKO-Adjacents,18
Goniothalamus_dewildei,1,1,0,Points-PointsKO-Adjacents,9
Goniothalamus_dolichocarpus,1,1,0,Points-PointsKO-Adjacents,9
Goniothalamus_dolichopetalus,0,0,0,NA,0
Goniothalamus_donnaiensis,0,0,0,NA,0
Goniothalamus_elegans,1,1,0,Points-PointsKO-Adjacents,9
Goniothalamus_elmeri,14,5,9,Points-PointsKO-Adjacents,122
Goniothalamus_epiphyticus,2,2,0,Points-PointsKO-Adjacents,16
Goniothalamus_euneurus,0,0,0,NA,0
Goniothalamus_expansus,1,1,0,Points-PointsKO-Adjacents,9
Goniothalamus_fulvus,0,0,0,NA,0
Goniothalamus_gabriacianus,6,0,6,Points-PointsKO-Adjacents,54
Goniothalamus_gardneri,1,1,0,Points-PointsKO-Adjacents,9
Goniothalamus_giganteus,5,1,4,Points-PointsKO-Adjacents,36
Goniothalamus_gigantifolius,0,0,0,NA,0
Goniothalamus_gitingensis,2,2,0,Points-PointsKO-Adjacents,8
Goniothalamus_gracilipes,NA,NA,NA,NA,NA
Goniothalamus_grandiflorus,10,1,9,Points-PointsKO-Adjacents,73
Goniothalamus_griffithii,1,0,1,Points-PointsKO-Adjacents,9
Goniothalamus_holttumii,0,0,0,NA,0
Goniothalamus_hookeri,1,1,0,Points-PointsKO-Adjacents,9
Goniothalamus_howii,5,5,0,Points-PointsKO-Adjacents,45
Goniothalamus_imbricatus,1,1,0,Points-PointsKO-Adjacents,9
Goniothalamus_kamarudinii,1,1,0,Points-PointsKO-Adjacents,9
Goniothalamus_kinabaluensis,1,1,0,Points-PointsKO-Adjacents,9
Goniothalamus_kostermansii,0,0,0,NA,0
Goniothalamus_lancifolius,0,0,0,NA,0
Goniothalamus_laoticus,3,3,0,Points-PointsKO-Adjacents,18
Goniothalamus_latestigma,0,0,0,NA,0
Goniothalamus_leiocarpus,3,3,0,Points-PointsKO-Adjacents,27
Goniothalamus_loerzingii,1,1,0,Points-PointsKO-Adjacents,9
Goniothalamus_longistaminus,NA,NA,NA,NA,NA
Goniothalamus_longistylus,0,0,0,NA,0
Goniothalamus_macranthus,0,0,0,NA,0
Goniothalamus_macrocalyx,1,1,0,Points-PointsKO-Adjacents,9
Goniothalamus_macrophyllus,27,4,23,Points-PointsKO-Adjacents,213
Goniothalamus_maewongensis,NA,NA,NA,NA,NA
Goniothalamus_magnificus,3,2,1,Points-PointsKO-Adjacents,25
Goniothalamus_majestatis,3,3,0,Points-PointsKO-Adjacents,27
Goniothalamus_malayanus,13,1,12,Points-PointsKO-Adjacents,110
Goniothalamus_meeboldii,0,0,0,NA,0
Goniothalamus_megalocalyx,1,1,0,Points-PointsKO-Adjacents,9
Goniothalamus_mindorensis,0,0,0,NA,0
Goniothalamus_miquelianus,4,4,0,Points-PointsKO-Adjacents,34
Goniothalamus_montanus,9,2,7,Points-PointsKO-Adjacents,60
Goniothalamus_multiovulatus,0,0,0,NA,0
Goniothalamus_ninhianus,NA,NA,NA,NA,NA
Goniothalamus_nitidus,1,1,0,Points-PointsKO-Adjacents,9
Goniothalamus_obtusifolius,2,2,0,Points-PointsKO-Adjacents,17
Goniothalamus_panayensis,0,0,0,NA,0
Goniothalamus_parallelovenius,1,1,0,Points-PointsKO-Adjacents,9
Goniothalamus_peduncularis,0,0,0,NA,0
Goniothalamus_phaeotrichus,3,3,0,Points-PointsKO-Adjacents,27
Goniothalamus_philippinensis,3,2,1,Points-PointsKO-Adjacents,25
Goniothalamus_puncticulifolius,1,1,0,Points-PointsKO-Adjacents,9
Goniothalamus_repevensis,1,1,0,Points-PointsKO-Adjacents,9
Goniothalamus_rhynchantherus,0,0,0,NA,0
Goniothalamus_ridleyi,20,7,13,Points-PointsKO-Adjacents,176
Goniothalamus_rongklanus,NA,NA,NA,NA,NA
Goniothalamus_roseus,9,5,4,Points-PointsKO-Adjacents,50
Goniothalamus_rostellatus,NA,NA,NA,NA,NA
Goniothalamus_rotundisepalus,0,0,0,NA,0
Goniothalamus_rufus,14,5,9,Points-PointsKO-Adjacents,113
Goniothalamus_saigonensis,4,4,0,Points-PointsKO-Adjacents,36
Goniothalamus_salicinus,2,2,0,Points-PointsKO-Adjacents,9
Goniothalamus_sawtehii,1,1,0,Points-PointsKO-Adjacents,9
Goniothalamus_scortechinii,4,0,4,Points-PointsKO-Adjacents,36
Goniothalamus_sesquipedalis,3,3,0,Points-PointsKO-Adjacents,27
Goniothalamus_shraddhae,NA,NA,NA,NA,NA
Goniothalamus_sibuyanensis,1,1,0,Points-PointsKO-Adjacents,8
Goniothalamus_simonsii,0,0,0,NA,0
Goniothalamus_stenopetalus,2,2,0,Points-PointsKO-Adjacents,18
Goniothalamus_stenophyllus,0,0,0,NA,0
Goniothalamus_suaveolens,28,4,24,Points-PointsKO-Adjacents,222
Goniothalamus_subevenius,3,3,0,Points-PointsKO-Adjacents,27
Goniothalamus_suluensis,0,0,0,NA,0
Goniothalamus_takhtajanii,NA,NA,NA,NA,NA
Goniothalamus_tamirensis,7,0,7,Points-PointsKO-Adjacents,41
Goniothalamus_tapis,18,2,16,Points-PointsKO-Adjacents,136
Goniothalamus_tapisoides,23,12,11,Points-PointsKO-Adjacents,153
Goniothalamus_tavoyensis,1,1,0,Points-PointsKO-Adjacents,9
Goniothalamus_tenasserimensis,NA,NA,NA,NA,NA
Goniothalamus_tenuifolius,7,2,5,Points-PointsKO-Adjacents,54
Goniothalamus_thomsonii,0,0,0,NA,0
Goniothalamus_thwaitesii,3,3,0,Points-PointsKO-Adjacents,27
Goniothalamus_tortilipetalus,2,2,0,Points-PointsKO-Adjacents,18
Goniothalamus_touranensis,0,0,0,NA,0
Goniothalamus_trunciflorus,0,0,0,NA,0
Goniothalamus_undulatus,1,1,0,Points-PointsKO-Adjacents,9
Goniothalamus_uniovulatus,4,4,0,Points-PointsKO-Adjacents,34
Goniothalamus_uvarioides,1,1,0,Points-PointsKO-Adjacents,9
Goniothalamus_velutinus,5,5,0,Points-PointsKO-Adjacents,37
Goniothalamus_vietnamensis,NA,NA,NA,NA,NA
Goniothalamus_viridiflorus,0,0,0,NA,0
Goniothalamus_walkeri,0,0,0,NA,0
Goniothalamus_wightii,0,0,0,NA,0
Goniothalamus_woodii,6,1,5,Points-PointsKO-Adjacents,48
Goniothalamus_wrayi,2,2,0,Points-PointsKO-Adjacents,18
Goniothalamus_wynaadensis,0,0,0,NA,0
Goniothalamus_yunnanensis,1,1,0,Points-PointsKO-Adjacents,9
Gonocalyx_portoricensis,7,6,1,Points-PointsKO-Adjacents,9
Gonocarpus_sanguineus,19,10,9,Points-PointsKO-Adjacents,116
Gonocaryum_calleryanum,26,12,14,Points-PointsKO-Adjacents,133
Gonocaryum_cognatum,0,0,0,NA,0
Gonocaryum_gracile,6,0,6,Points-PointsKO-Adjacents,54
Gonocaryum_impressinervium,4,4,0,Points-PointsKO-Adjacents,36
Gonocaryum_litorale,76,35,41,Alphahull-PointsKO-Adjacents,3028
Gonocaryum_lobbianum,28,0,28,Points-PointsKO-Adjacents,176
Gonocaryum_macrophyllum,5,0,5,Points-PointsKO-Adjacents,42
Gonocaryum_minus,7,2,5,Points-PointsKO-Adjacents,39
Gonocaryum_poilanei,1,1,0,Points-PointsKO-Adjacents,9
Gonocaryum_sleumeri,NA,NA,NA,NA,NA
Gonocytisus_angulatus,7,3,4,Points-PointsKO-Adjacents,63
Gonocytisus_pterocladus,1,1,0,Points-PointsKO-Adjacents,9
Gonystylus_acuminatus,1,1,0,Points-PointsKO-Adjacents,7
Gonystylus_affinis,6,3,3,Points-PointsKO-Adjacents,54
Gonystylus_areolatus,1,1,0,Points-PointsKO-Adjacents,9
Gonystylus_augescens,0,0,0,NA,0
Gonystylus_bancanus,1,1,0,Points-PointsKO-Adjacents,9
Gonystylus_borneensis,7,2,5,Points-PointsKO-Adjacents,53
Gonystylus_brunnescens,7,0,7,Points-PointsKO-Adjacents,54
Gonystylus_calophylloides,1,1,0,Points-PointsKO-Adjacents,9
Gonystylus_calophyllus,0,0,0,NA,0
Gonystylus_confusus,7,1,6,Points-PointsKO-Adjacents,51
Gonystylus_consanguineus,1,1,0,Points-PointsKO-Adjacents,9
Gonystylus_costalis,0,0,0,NA,0
Gonystylus_decipiens,1,1,0,Points-PointsKO-Adjacents,9
Gonystylus_eximius,0,0,0,NA,0
Gonystylus_forbesii,4,2,2,Points-PointsKO-Adjacents,36
Gonystylus_glaucescens,0,0,0,NA,0
Gonystylus_keithii,4,4,0,Points-PointsKO-Adjacents,36
Gonystylus_lucidulus,0,0,0,NA,0
Gonystylus_macrophyllus,34,2,32,Points-PointsKO-Adjacents,240
Gonystylus_maingayi,2,0,2,Points-PointsKO-Adjacents,18
Gonystylus_micranthus,3,0,3,Points-PointsKO-Adjacents,27
Gonystylus_nervosus,1,1,0,Points-PointsKO-Adjacents,9
Gonystylus_nobilis,0,0,0,NA,0
Gonystylus_othmanii,1,1,0,Points-PointsKO-Adjacents,9
Gonystylus_pendulus,1,1,0,Points-PointsKO-Adjacents,9
Gonystylus_punctatus,1,1,0,Points-PointsKO-Adjacents,9
Gonystylus_reticulatus,2,2,0,Points-PointsKO-Adjacents,12
Gonystylus_spectabilis,2,2,0,Points-PointsKO-Adjacents,18
Gonystylus_stenosepalus,2,2,0,Points-PointsKO-Adjacents,18
Gonystylus_velutinus,4,0,4,Points-PointsKO-Adjacents,36
Gonystylus_xylocarpus,1,1,0,Points-PointsKO-Adjacents,9
Gonzalagunia_affinis,130,113,17,Alphahull-PointsKO-Adjacents,1730
Gonzalagunia_bifida,4,4,0,Points-PointsKO-Adjacents,36
Gonzalagunia_brachyantha,12,4,8,Points-PointsKO-Adjacents,86
Gonzalagunia_brenesii,46,37,9,Alphahull-PointsKO-Adjacents,124
Gonzalagunia_bunchosioides,86,62,24,Alphahull-PointsKO-Adjacents,2604
Gonzalagunia_chiapasensis,36,30,6,Alphahull-PointsKO-Adjacents,378
Gonzalagunia_cornifolia,420,365,55,Alphahull-PointsKO-Adjacents,12917
Gonzalagunia_dependens,225,179,46,Alphahull-PointsKO-Adjacents,3517
Gonzalagunia_dicocca,480,371,109,Alphahull-PointsKO-Adjacents,13086
Gonzalagunia_discolor,15,3,12,Points-PointsKO-Adjacents,115
Gonzalagunia_dodsonii,7,4,3,Points-PointsKO-Adjacents,60
Gonzalagunia_hirsuta,74,42,32,Alphahull-PointsKO-Adjacents,597
Gonzalagunia_longithyrsa,19,10,9,Points-PointsKO-Adjacents,75
Gonzalagunia_microsepala,0,0,0,NA,0
Gonzalagunia_osaensis,75,62,13,Alphahull-PointsKO-Adjacents,322
Gonzalagunia_ovatifolia,127,98,29,Alphahull-PointsKO-Adjacents,1157
Gonzalagunia_pachystachya,7,2,5,Points-PointsKO-Adjacents,59
Gonzalagunia_panamensis,326,248,78,Alphahull-PointsKO-Adjacents,10478
Gonzalagunia_rosea,208,184,24,Alphahull-PointsKO-Adjacents,1097
Gonzalagunia_rudis,83,62,21,Alphahull-PointsKO-Adjacents,555
Gonzalagunia_stenostachya,58,44,14,Alphahull-PointsKO-Adjacents,263
Gonzalagunia_surinamensis,38,23,15,Alphahull-PointsKO-Adjacents,1426
Gonzalagunia_thyrsoidea,45,36,9,Alphahull-PointsKO-Adjacents,282
Gorceixia_decurrens,28,18,10,Points-PointsKO-Adjacents,196
Gordonia_brandegeei,85,53,32,Alphahull-PointsKO-Adjacents,839
Gordonia_obtusa,3,2,1,Points-PointsKO-Adjacents,24
Gordonia_ovalis,2,2,0,Points-PointsKO-Adjacents,18
Gordonia_penangensis,0,0,0,NA,0
Gordonia_singaporeana,1,1,0,Points-PointsKO-Adjacents,9
Gossia_acmenoides,219,187,32,Alphahull-PointsKO-Adjacents,1242
Gossia_alaternoides,21,9,12,Points-PointsKO-Adjacents,99
Gossia_aphthosa,8,5,3,Points-PointsKO-Adjacents,48
Gossia_bamagensis,23,12,11,Points-PointsKO-Adjacents,88
Gossia_bidwillii,709,640,69,Alphahull-PointsKO-Adjacents,4195
Gossia_byrnesii,1,1,0,Points-PointsKO-Adjacents,9
Gossia_clusioides,23,14,9,Points-PointsKO-Adjacents,116
Gossia_colnettiana,4,4,0,Points-PointsKO-Adjacents,19
Gossia_dallachyana,90,70,20,Alphahull-PointsKO-Adjacents,178
Gossia_diversifolia,5,4,1,Points-PointsKO-Adjacents,19
Gossia_floribunda,109,81,28,Alphahull-PointsKO-Adjacents,709
Gossia_fragrantissima,124,112,12,Alphahull-PointsKO-Adjacents,127
Gossia_gonoclada,20,2,18,Points-PointsKO-Adjacents,34
Gossia_grayi,42,30,12,Alphahull-PointsKO-Adjacents,139
Gossia_hillii,198,150,48,Alphahull-PointsKO-Adjacents,719
Gossia_inophloia,43,34,9,Alphahull-PointsKO-Adjacents,76
Gossia_kuakuensis,6,1,5,Points-PointsKO-Adjacents,43
Gossia_lewisensis,46,40,6,Alphahull-PointsKO-Adjacents,40
Gossia_longipetiolata,0,0,0,NA,0
Gossia_lucida,51,36,15,Alphahull-PointsKO-Adjacents,160
Gossia_macilwraithensis,27,19,8,Points-PointsKO-Adjacents,73
Gossia_myrsinocarpa,166,145,21,Alphahull-PointsKO-Adjacents,490
Gossia_nigripes,3,3,0,Points-PointsKO-Adjacents,17
Gossia_pancheri,27,15,12,Points-PointsKO-Adjacents,115
Gossia_pubiflora,36,33,3,Alphahull-PointsKO-Adjacents,30
Gossia_punctata,56,45,11,Alphahull-PointsKO-Adjacents,260
Gossia_retusa,34,19,15,Points-PointsKO-Adjacents,153
Gossia_salomonensis,0,0,0,NA,0
Gossia_sankowskiorum,37,30,7,Alphahull-PointsKO-Adjacents,156
Gossia_scottiana,0,0,0,NA,0
Gossia_shepherdii,76,62,14,Alphahull-PointsKO-Adjacents,234
Gossia_vieillardii,37,27,10,Alphahull-PointsKO-Adjacents,117
Gossia_virotii,2,2,0,Points-PointsKO-Adjacents,12
Gossweilerodendron_balsamiferum,50,25,25,Alphahull-PointsKO-Adjacents,2998
Gossweilerodendron_joveri,13,7,6,Points-PointsKO-Adjacents,81
Gossypioides_brevilanatum,18,6,12,Points-PointsKO-Adjacents,136
Gossypium_arboreum,5,0,5,Points-PointsKO-Adjacents,45
Gossypium_aridum,162,119,43,Alphahull-PointsKO-Adjacents,2759
Gossypium_barbadense,380,258,122,Alphahull-PointsKO-Adjacents,18190
Gossypium_darwinii,26,19,7,Points-PointsKO-Adjacents,85
Gossypium_hirsutum,611,485,126,Alphahull-PointsKO-Adjacents,12508
Gossypium_lobatum,12,7,5,Points-PointsKO-Adjacents,51
Gossypium_trilobum,21,1,20,Points-PointsKO-Adjacents,113
Gouania_lupuloides,1419,1115,304,Alphahull-PointsKO-Adjacents,19515
Gouania_mangarevica,0,0,0,NA,0
Goupia_glabra,802,720,82,Alphahull-PointsKO-Adjacents,59558
Goupia_guatemalensis,3,3,0,Points-PointsKO-Adjacents,27
Graffenrieda_bella,35,26,9,Alphahull-PointsKO-Adjacents,114
Graffenrieda_calyptrelloides,9,2,7,Points-PointsKO-Adjacents,65
Graffenrieda_caryophyllea,114,87,27,Alphahull-PointsKO-Adjacents,5822
Graffenrieda_caudata,12,7,5,Points-PointsKO-Adjacents,58
Graffenrieda_chrysandra,2,2,0,Points-PointsKO-Adjacents,17
Graffenrieda_colombiana,42,24,18,Alphahull-PointsKO-Adjacents,353
Graffenrieda_conostegioides,71,52,19,Alphahull-PointsKO-Adjacents,1140
Graffenrieda_cucullata,197,141,56,Alphahull-PointsKO-Adjacents,4106
Graffenrieda_emarginata,193,151,42,Alphahull-PointsKO-Adjacents,3134
Graffenrieda_fantastica,31,15,16,Points-PointsKO-Adjacents,170
Graffenrieda_foliosa,3,3,0,Points-PointsKO-Adjacents,27
Graffenrieda_galeottii,162,122,40,Alphahull-PointsKO-Adjacents,2105
Graffenrieda_gentlei,6,2,4,Points-PointsKO-Adjacents,44
Graffenrieda_gracilis,237,180,57,Alphahull-PointsKO-Adjacents,8824
Graffenrieda_grandifolia,40,30,10,Alphahull-PointsKO-Adjacents,120
Graffenrieda_hitchcockii,17,13,4,Points-PointsKO-Adjacents,60
Graffenrieda_intermedia,137,78,59,Alphahull-PointsKO-Adjacents,2874
Graffenrieda_jauana,6,2,4,Points-PointsKO-Adjacents,30
Graffenrieda_jefensis,3,3,0,Points-PointsKO-Adjacents,15
Graffenrieda_kralii,15,5,10,Points-PointsKO-Adjacents,51
Graffenrieda_latifolia,64,33,31,Alphahull-PointsKO-Adjacents,371
Graffenrieda_limbata,134,86,48,Alphahull-PointsKO-Adjacents,7793
Graffenrieda_maklenkensis,6,2,4,Points-PointsKO-Adjacents,24
Graffenrieda_miconioides,78,0,78,Points-PointsKO-Adjacents,530
Graffenrieda_micrantha,54,36,18,Alphahull-PointsKO-Adjacents,334
Graffenrieda_moaensis,7,0,7,Points-PointsKO-Adjacents,59
Graffenrieda_ottoschulzii,6,0,6,Points-PointsKO-Adjacents,54
Graffenrieda_phoenicea,2,2,0,Points-PointsKO-Adjacents,9
Graffenrieda_polymera,41,27,14,Alphahull-PointsKO-Adjacents,362
Graffenrieda_reticulata,13,8,5,Points-PointsKO-Adjacents,27
Graffenrieda_robusta,2,2,0,Points-PointsKO-Adjacents,18
Graffenrieda_rotundifolia,33,22,11,Alphahull-PointsKO-Adjacents,418
Graffenrieda_rupestris,83,62,21,Alphahull-PointsKO-Adjacents,5368
Graffenrieda_santamartensis,37,23,14,Alphahull-PointsKO-Adjacents,1153
Graffenrieda_scandens,7,0,7,Points-PointsKO-Adjacents,59
Graffenrieda_sessilifolia,61,49,12,Alphahull-PointsKO-Adjacents,878
Graffenrieda_sipapoana,7,3,4,Points-PointsKO-Adjacents,42
Graffenrieda_tricalcarata,8,0,8,Points-PointsKO-Adjacents,54
Graffenrieda_trichanthera,2,2,0,Points-PointsKO-Adjacents,18
Graffenrieda_weddellii,164,96,68,Alphahull-PointsKO-Adjacents,11186
Grajalesia_fasciculata,42,26,16,Alphahull-PointsKO-Adjacents,267
Grandidiera_boivinii,78,58,20,Alphahull-PointsKO-Adjacents,579
Grangeria_borbonica,9,4,5,Points-PointsKO-Adjacents,37
Grangeria_porosa,86,74,12,Alphahull-PointsKO-Adjacents,944
Graptophyllum_insularum,2,2,0,Points-PointsKO-Adjacents,3
Grazielodendron_rio-docensis,32,16,16,Points-PointsKO-Adjacents,199
Greenea_commersonii,1,1,0,Points-PointsKO-Adjacents,9
Greenea_corymbosa,24,11,13,Points-PointsKO-Adjacents,158
Greenea_parkinsonii,0,0,0,NA,0
Greenea_secunda,NA,NA,NA,NA,NA
Greeniopsis_discolor,1,1,0,Points-PointsKO-Adjacents,6
Greeniopsis_euphlebia,1,1,0,Points-PointsKO-Adjacents,9
Greeniopsis_megalantha,2,2,0,Points-PointsKO-Adjacents,16
Greeniopsis_multiflora,5,5,0,Points-PointsKO-Adjacents,42
Greeniopsis_pubescens,2,2,0,Points-PointsKO-Adjacents,14
Greeniopsis_sibuyanensis,1,1,0,Points-PointsKO-Adjacents,8
Greenwayodendron_oliveri,167,131,36,Alphahull-PointsKO-Adjacents,2512
Greenwayodendron_suaveolens,638,582,56,Alphahull-PointsKO-Adjacents,17642
Grevea_eggelingii,32,12,20,Points-PointsKO-Adjacents,212
Grevillea_agrifolia,393,376,17,Alphahull-PointsKO-Adjacents,3511
Grevillea_albiflora,92,72,20,Alphahull-PointsKO-Adjacents,680
Grevillea_argyrophylla,62,48,14,Alphahull-PointsKO-Adjacents,352
Grevillea_aspleniifolia,78,1,77,Points-PointsKO-Adjacents,179
Grevillea_baileyana,121,95,26,Alphahull-PointsKO-Adjacents,404
Grevillea_banksii,194,146,48,Alphahull-PointsKO-Adjacents,1356
Grevillea_barklyana,50,48,2,Alphahull-PointsKO-Adjacents,2274
Grevillea_berryana,150,126,24,Alphahull-PointsKO-Adjacents,7781
Grevillea_cagiana,340,325,15,Alphahull-PointsKO-Adjacents,1466
Grevillea_calcicola,6,2,4,Points-PointsKO-Adjacents,24
Grevillea_coriacea,105,96,9,Alphahull-PointsKO-Adjacents,517
Grevillea_decora,227,206,21,Alphahull-PointsKO-Adjacents,2859
Grevillea_decurrens,1457,1417,40,Alphahull-PointsKO-Adjacents,3774
Grevillea_dimidiata,390,362,28,Alphahull-PointsKO-Adjacents,5068
Grevillea_donaldiana,3,3,0,Points-PointsKO-Adjacents,15
Grevillea_eriostachya,531,482,49,Alphahull-PointsKO-Adjacents,22897
Grevillea_erythroclada,66,48,18,Alphahull-PointsKO-Adjacents,822
Grevillea_excelsior,313,285,28,Alphahull-PointsKO-Adjacents,3155
Grevillea_exul,43,30,13,Alphahull-PointsKO-Adjacents,136
Grevillea_formosa,58,49,9,Alphahull-PointsKO-Adjacents,221
Grevillea_gillivrayi,29,23,6,Alphahull-PointsKO-Adjacents,57
Grevillea_glauca,320,288,32,Alphahull-PointsKO-Adjacents,4572
Grevillea_goodii,636,0,636,Points-PointsKO-Adjacents,1141
Grevillea_gordoniana,59,51,8,Alphahull-PointsKO-Adjacents,695
Grevillea_heliosperma,982,934,48,Alphahull-PointsKO-Adjacents,6838
Grevillea_helmsiae,124,106,18,Alphahull-PointsKO-Adjacents,905
Grevillea_hilliana,163,126,37,Alphahull-PointsKO-Adjacents,822
Grevillea_juncifolia,1170,1087,83,Alphahull-PointsKO-Adjacents,34581
Grevillea_longifolia,126,97,29,Alphahull-PointsKO-Adjacents,182
Grevillea_meisneri,10,3,7,Points-PointsKO-Adjacents,50
Grevillea_mimosoides,626,582,44,Alphahull-PointsKO-Adjacents,11628
Grevillea_miniata,57,51,6,Alphahull-PointsKO-Adjacents,258
Grevillea_nematophylla,537,0,537,Points-PointsKO-Adjacents,2878
Grevillea_obliquistigma,323,306,17,Alphahull-PointsKO-Adjacents,3095
Grevillea_papuana,60,43,17,Alphahull-PointsKO-Adjacents,301
Grevillea_parallela,998,929,69,Alphahull-PointsKO-Adjacents,17296
Grevillea_pteridifolia,2418,2360,58,Alphahull-PointsKO-Adjacents,13340
Grevillea_pyramidalis,540,506,34,Alphahull-PointsKO-Adjacents,9021
Grevillea_refracta,1050,1010,40,Alphahull-PointsKO-Adjacents,13668
Grevillea_robusta,1080,676,404,Alphahull-PointsKO-Adjacents,5061
Grevillea_rogersoniana,24,17,7,Points-PointsKO-Adjacents,102
Grevillea_sessilis,93,75,18,Alphahull-PointsKO-Adjacents,1651
Grevillea_stenobotrya,931,881,50,Alphahull-PointsKO-Adjacents,28702
Grevillea_striata,1201,1121,80,Alphahull-PointsKO-Adjacents,46146
Grevillea_whiteana,47,40,7,Alphahull-PointsKO-Adjacents,111
Grevillea_wickhamii,1472,1387,85,Alphahull-PointsKO-Adjacents,22873
Grewia_abutilifolia,43,0,43,Points-PointsKO-Adjacents,376
Grewia_ambongoensis,5,5,0,Points-PointsKO-Adjacents,44
Grewia_amplifolia,9,3,6,Points-PointsKO-Adjacents,70
Grewia_analamerensis,13,10,3,Points-PointsKO-Adjacents,47
Grewia_andramparo,24,14,10,Points-PointsKO-Adjacents,125
Grewia_angolensis,3,3,0,Points-PointsKO-Adjacents,27
Grewia_arborea,20,6,14,Points-PointsKO-Adjacents,141
Grewia_asiatica,6,0,6,Points-PointsKO-Adjacents,52
Grewia_baillonii,8,3,5,Points-PointsKO-Adjacents,66
Grewia_balensis,2,2,0,Points-PointsKO-Adjacents,18
Grewia_biloba,204,144,60,Alphahull-PointsKO-Adjacents,18482
Grewia_bilocularis,0,0,0,NA,0
Grewia_botryantha,19,6,13,Points-PointsKO-Adjacents,125
Grewia_bracteata,2,2,0,Points-PointsKO-Adjacents,9
Grewia_breviflora,465,423,42,Alphahull-PointsKO-Adjacents,6685
Grewia_calvata,27,13,14,Points-PointsKO-Adjacents,156
Grewia_chalybaea,3,3,0,Points-PointsKO-Adjacents,27
Grewia_chungii,7,0,7,Points-PointsKO-Adjacents,54
Grewia_cinnamomifolia,5,2,3,Points-PointsKO-Adjacents,33
Grewia_crenata,31,6,25,Points-PointsKO-Adjacents,157
Grewia_cuneifolia,101,82,19,Alphahull-PointsKO-Adjacents,1637
Grewia_cyclea,28,0,28,Points-PointsKO-Adjacents,155
Grewia_cyclopetala,3,3,0,Points-PointsKO-Adjacents,27
Grewia_damine,11,0,11,Points-PointsKO-Adjacents,93
Grewia_densa,15,9,6,Points-PointsKO-Adjacents,96
Grewia_diversipes,4,4,0,Points-PointsKO-Adjacents,20
Grewia_eriocarpa,50,0,50,Points-PointsKO-Adjacents,425
Grewia_falcata,1,1,0,Points-PointsKO-Adjacents,9
Grewia_ferruginea,25,18,7,Points-PointsKO-Adjacents,166
Grewia_filipes,4,3,1,Points-PointsKO-Adjacents,36
Grewia_flava,280,252,28,Alphahull-PointsKO-Adjacents,17727
Grewia_flavescens,374,0,374,Points-PointsKO-Adjacents,2885
Grewia_forbesii,41,22,19,Alphahull-PointsKO-Adjacents,904
Grewia_gillettii,3,3,0,Points-PointsKO-Adjacents,23
Grewia_glandulosa,53,15,38,Points-PointsKO-Adjacents,350
Grewia_glyphaeoides,6,2,4,Points-PointsKO-Adjacents,35
Grewia_goetzeana,33,19,14,Points-PointsKO-Adjacents,142
Grewia_gracilis,0,0,0,NA,0
Grewia_grandidieri,11,6,5,Points-PointsKO-Adjacents,87
Grewia_grevei,45,33,12,Alphahull-PointsKO-Adjacents,495
Grewia_henryi,29,14,15,Points-PointsKO-Adjacents,257
Grewia_hexamita,62,47,15,Alphahull-PointsKO-Adjacents,1064
Grewia_hirsuta,15,2,13,Points-PointsKO-Adjacents,117
Grewia_holstii,51,33,18,Alphahull-PointsKO-Adjacents,1233
Grewia_holtzii,4,4,0,Points-PointsKO-Adjacents,30
Grewia_hookeriana,54,34,20,Alphahull-PointsKO-Adjacents,921
Grewia_humblotii,26,10,16,Points-PointsKO-Adjacents,174
Grewia_hypotephra,5,4,1,Points-PointsKO-Adjacents,41
Grewia_inaequilatera,25,6,19,Points-PointsKO-Adjacents,203
Grewia_insularis,3,2,1,Points-PointsKO-Adjacents,7
Grewia_isochroa,NA,NA,NA,NA,NA
Grewia_lacei,2,2,0,Points-PointsKO-Adjacents,18
Grewia_laevigata,77,1,76,Points-PointsKO-Adjacents,570
Grewia_lanceifolia,0,0,0,NA,0
Grewia_lapiazicola,9,2,7,Points-PointsKO-Adjacents,36
Grewia_lasiocarpa,26,0,26,Points-PointsKO-Adjacents,200
Grewia_lasiodiscus,163,139,24,Alphahull-PointsKO-Adjacents,4082
Grewia_lavanalensis,47,28,19,Alphahull-PointsKO-Adjacents,1640
Grewia_lepidopetala,9,0,9,Points-PointsKO-Adjacents,72
Grewia_leptopus,15,6,9,Points-PointsKO-Adjacents,101
Grewia_leucophylla,15,8,7,Points-PointsKO-Adjacents,118
Grewia_limae,0,0,0,NA,0
Grewia_louisii,22,12,10,Points-PointsKO-Adjacents,136
Grewia_luteiflora,4,4,0,Points-PointsKO-Adjacents,30
Grewia_madagascariensis,17,5,12,Points-PointsKO-Adjacents,123
Grewia_meizophylla,3,2,1,Points-PointsKO-Adjacents,27
Grewia_meridionalis,16,10,6,Points-PointsKO-Adjacents,129
Grewia_micrantha,21,4,17,Points-PointsKO-Adjacents,189
Grewia_microcarpa,11,3,8,Points-PointsKO-Adjacents,99
Grewia_microcyclea,22,13,9,Points-PointsKO-Adjacents,144
Grewia_mildbraedii,46,24,22,Alphahull-PointsKO-Adjacents,703
Grewia_mollis,71,43,28,Alphahull-PointsKO-Adjacents,2370
Grewia_monantha,3,3,0,Points-PointsKO-Adjacents,27
Grewia_monticola,147,116,31,Alphahull-PointsKO-Adjacents,5493
Grewia_multiflora,18,0,18,Points-PointsKO-Adjacents,129
Grewia_nitida,10,0,10,Points-PointsKO-Adjacents,37
Grewia_occidentalis,322,254,68,Alphahull-PointsKO-Adjacents,4448
Grewia_oncopetala,0,0,0,NA,0
Grewia_optiva,12,3,9,Points-PointsKO-Adjacents,105
Grewia_orbiculata,0,0,0,NA,0
Grewia_orientalis,9,0,9,Points-PointsKO-Adjacents,71
Grewia_ossea,4,1,3,Points-PointsKO-Adjacents,36
Grewia_oxyphylla,253,198,55,Alphahull-PointsKO-Adjacents,2758
Grewia_pachycalyx,20,2,18,Points-PointsKO-Adjacents,167
Grewia_pandaica,NA,NA,NA,NA,NA
Grewia_permagna,3,3,0,Points-PointsKO-Adjacents,27
Grewia_perrieri,1,1,0,Points-PointsKO-Adjacents,9
Grewia_pervillei,4,4,0,Points-PointsKO-Adjacents,35
Grewia_picta,23,7,16,Points-PointsKO-Adjacents,149
Grewia_piscatorum,11,0,11,Points-PointsKO-Adjacents,80
Grewia_plagiophylla,47,31,16,Alphahull-PointsKO-Adjacents,724
Grewia_polygama,1,1,0,Points-PointsKO-Adjacents,9
Grewia_pondoensis,9,4,5,Points-PointsKO-Adjacents,57
Grewia_praecox,7,3,4,Points-PointsKO-Adjacents,63
Grewia_pubescens,10,0,10,Points-PointsKO-Adjacents,90
Grewia_retinervis,134,113,21,Alphahull-PointsKO-Adjacents,9717
Grewia_retusifolia,2060,0,2060,Points-PointsKO-Adjacents,5476
Grewia_rhomboides,5,5,0,Points-PointsKO-Adjacents,45
Grewia_rothii,4,4,0,Points-PointsKO-Adjacents,36
Grewia_rugosifolia,4,4,0,Points-PointsKO-Adjacents,36
Grewia_sahafariensis,6,2,4,Points-PointsKO-Adjacents,33
Grewia_sambiranensis,31,19,12,Points-PointsKO-Adjacents,137
Grewia_schmitzii,2,2,0,Points-PointsKO-Adjacents,15
Grewia_schweinfurthii,21,11,10,Points-PointsKO-Adjacents,114
Grewia_sely,3,3,0,Points-PointsKO-Adjacents,25
Grewia_serrulata,10,0,10,Points-PointsKO-Adjacents,62
Grewia_similiopsis,5,5,0,Points-PointsKO-Adjacents,33
Grewia_similis,63,39,24,Alphahull-PointsKO-Adjacents,3324
Grewia_speciosa,4,4,0,Points-PointsKO-Adjacents,27
Grewia_stolzii,23,0,23,Points-PointsKO-Adjacents,166
Grewia_suarezensis,18,12,6,Points-PointsKO-Adjacents,69
Grewia_subaequalis,9,3,6,Points-PointsKO-Adjacents,38
Grewia_subspathulata,132,96,36,Alphahull-PointsKO-Adjacents,4533
Grewia_tahitensis,1,1,0,Points-PointsKO-Adjacents,9
Grewia_tannifera,7,2,5,Points-PointsKO-Adjacents,45
Grewia_tenax,150,70,80,Alphahull-PointsKO-Adjacents,1888
Grewia_tephrodermis,5,5,0,Points-PointsKO-Adjacents,43
Grewia_thikaensis,NA,NA,NA,NA,NA
Grewia_thouvenotii,17,0,17,Points-PointsKO-Adjacents,85
Grewia_tiliifolia,10,2,8,Points-PointsKO-Adjacents,90
Grewia_tomentosa,1,0,1,Points-PointsKO-Adjacents,9
Grewia_transzambesica,10,0,10,Points-PointsKO-Adjacents,72
Grewia_trichocarpa,39,7,32,Points-PointsKO-Adjacents,262
Grewia_triflora,43,18,25,Points-PointsKO-Adjacents,281
Grewia_trinervia,21,13,8,Points-PointsKO-Adjacents,132
Grewia_truncata,7,2,5,Points-PointsKO-Adjacents,55
Grewia_tsiandrensis,1,1,0,Points-PointsKO-Adjacents,9
Grewia_tulearensis,9,0,9,Points-PointsKO-Adjacents,57
Grewia_turbinata,4,4,0,Points-PointsKO-Adjacents,10
Grewia_velutina,6,2,4,Points-PointsKO-Adjacents,48
Grewia_villosa,198,0,198,Points-PointsKO-Adjacents,1471
Grewia_vitiensis,1,1,0,Points-PointsKO-Adjacents,9
Grewia_woodiana,13,0,13,Points-PointsKO-Adjacents,117
Greyia_flanaganii,8,4,4,Points-PointsKO-Adjacents,72
Greyia_radlkoferi,46,38,8,Alphahull-PointsKO-Adjacents,912
Greyia_sutherlandii,70,51,19,Alphahull-PointsKO-Adjacents,1294
Grias_cauliflora,150,106,44,Alphahull-PointsKO-Adjacents,1905
Grias_colombiana,5,5,0,Points-PointsKO-Adjacents,42
Grias_haughtii,34,23,11,Alphahull-PointsKO-Adjacents,777
Grias_longirachis,1,1,0,Points-PointsKO-Adjacents,9
Grias_multinervia,18,11,7,Points-PointsKO-Adjacents,88
Grias_neuberthii,259,236,23,Alphahull-PointsKO-Adjacents,3995
Grias_peruviana,206,177,29,Alphahull-PointsKO-Adjacents,5299
Grias_purpuripetala,5,5,0,Points-PointsKO-Adjacents,19
Grias_theobromicarpa,4,4,0,Points-PointsKO-Adjacents,18
Grimmeodendron_eglandulosum,8,2,6,Points-PointsKO-Adjacents,62
Grimmeodendron_jamaicense,2,2,0,Points-PointsKO-Adjacents,18
Griselinia_jodinifolia,9,4,5,Points-PointsKO-Adjacents,48
Griselinia_littoralis,12450,12333,117,Alphahull-PointsKO-Adjacents,4444
Griselinia_lucida,1651,1598,53,Alphahull-PointsKO-Adjacents,3018
Griselinia_racemosa,11,4,7,Points-PointsKO-Adjacents,84
Griselinia_ruscifolia,173,133,40,Alphahull-PointsKO-Adjacents,2436
Grisollea_myriantha,71,47,24,Alphahull-PointsKO-Adjacents,940
Grisollea_thomassetii,4,4,0,Points-PointsKO-Adjacents,15
Grossera_elongata,1,1,0,Points-PointsKO-Adjacents,7
Grossera_macrantha,36,17,19,Points-PointsKO-Adjacents,215
Grossera_major,8,3,5,Points-PointsKO-Adjacents,68
Grossera_multinervis,16,6,10,Points-PointsKO-Adjacents,92
Grossera_paniculata,144,130,14,Alphahull-PointsKO-Adjacents,2787
Grossera_perrieri,28,10,18,Points-PointsKO-Adjacents,190
Grossera_vignei,33,19,14,Points-PointsKO-Adjacents,256
Grosvenoria_campii,3,3,0,Points-PointsKO-Adjacents,27
Grosvenoria_rimbachii,25,15,10,Points-PointsKO-Adjacents,135
Guaiacum_coulteri,391,302,89,Alphahull-PointsKO-Adjacents,3856
Guaiacum_officinale,114,54,60,Alphahull-PointsKO-Adjacents,970
Guaiacum_palmeri,61,0,61,Points-PointsKO-Adjacents,187
Guaiacum_sanctum,329,250,79,Alphahull-PointsKO-Adjacents,4228
Guapira_amacurensis,9,1,8,Points-PointsKO-Adjacents,78
Guapira_areolata,316,265,51,Alphahull-PointsKO-Adjacents,19931
Guapira_asperula,82,36,46,Alphahull-PointsKO-Adjacents,2693
Guapira_bolivarensis,7,2,5,Points-PointsKO-Adjacents,48
Guapira_boliviana,18,7,11,Points-PointsKO-Adjacents,94
Guapira_brevipetiolata,25,19,6,Points-PointsKO-Adjacents,128
Guapira_costaricana,366,315,51,Alphahull-PointsKO-Adjacents,6910
Guapira_cuspidata,98,67,31,Alphahull-PointsKO-Adjacents,4573
Guapira_discolor,84,44,40,Alphahull-PointsKO-Adjacents,2495
Guapira_domingensis,3,3,0,Points-PointsKO-Adjacents,12
Guapira_eggersiana,101,67,34,Alphahull-PointsKO-Adjacents,4439
Guapira_ferruginea,65,35,30,Alphahull-PointsKO-Adjacents,4026
Guapira_fragrans,172,89,83,Alphahull-PointsKO-Adjacents,1899
Guapira_glabriflora,1,1,0,Points-PointsKO-Adjacents,9
Guapira_globosa,0,0,0,NA,0
Guapira_graciliflora,807,737,70,Alphahull-PointsKO-Adjacents,31723
Guapira_guianensis,4,4,0,Points-PointsKO-Adjacents,36
Guapira_hassleriana,9,5,4,Points-PointsKO-Adjacents,74
Guapira_hirsuta,675,545,130,Alphahull-PointsKO-Adjacents,14615
Guapira_kanukuensis,5,4,1,Points-PointsKO-Adjacents,43
Guapira_ligustrifolia,0,0,0,NA,0
Guapira_marcano-bertii,4,4,0,Points-PointsKO-Adjacents,36
Guapira_microphylla,27,15,12,Points-PointsKO-Adjacents,232
Guapira_myrtiflora,47,24,23,Alphahull-PointsKO-Adjacents,394
Guapira_neblinensis,4,4,0,Points-PointsKO-Adjacents,36
Guapira_noxia,615,551,64,Alphahull-PointsKO-Adjacents,26997
Guapira_obtusata,283,192,91,Alphahull-PointsKO-Adjacents,7558
Guapira_opposita,2477,2209,268,Alphahull-PointsKO-Adjacents,58950
Guapira_pacurero,66,0,66,Points-PointsKO-Adjacents,503
Guapira_petenensis,49,25,24,Alphahull-PointsKO-Adjacents,865
Guapira_pubescens,15,4,11,Points-PointsKO-Adjacents,135
Guapira_rotundifolia,4,4,0,Points-PointsKO-Adjacents,27
Guapira_rufescens,8,1,7,Points-PointsKO-Adjacents,56
Guapira_rusbyana,4,4,0,Points-PointsKO-Adjacents,33
Guapira_salicifolia,27,10,17,Points-PointsKO-Adjacents,202
Guapira_sancarlosiana,6,0,6,Points-PointsKO-Adjacents,30
Guapira_sipapoana,4,4,0,Points-PointsKO-Adjacents,36
Guapira_suborbiculata,7,2,5,Points-PointsKO-Adjacents,15
Guapira_tomentosa,106,70,36,Alphahull-PointsKO-Adjacents,3815
Guapira_uberrima,9,2,7,Points-PointsKO-Adjacents,70
Guapira_venosa,143,83,60,Alphahull-PointsKO-Adjacents,5887
Guapira_witsbergeri,9,6,3,Points-PointsKO-Adjacents,35
Guarea_aguilarii,9,6,3,Points-PointsKO-Adjacents,24
Guarea_blanchetii,55,36,19,Alphahull-PointsKO-Adjacents,322
Guarea_bullata,246,182,64,Alphahull-PointsKO-Adjacents,2984
Guarea_carapoides,16,5,11,Points-PointsKO-Adjacents,119
Guarea_carinata,166,104,62,Alphahull-PointsKO-Adjacents,14285
Guarea_cartaguenya,44,28,16,Alphahull-PointsKO-Adjacents,388
Guarea_casimiriana,5,5,0,Points-PointsKO-Adjacents,45
Guarea_caulobotryis,24,6,18,Points-PointsKO-Adjacents,176
Guarea_chiricana,106,72,34,Alphahull-PointsKO-Adjacents,878
Guarea_cinnamomea,110,74,36,Alphahull-PointsKO-Adjacents,5987
Guarea_constricta,8,1,7,Points-PointsKO-Adjacents,53
Guarea_convergens,30,11,19,Points-PointsKO-Adjacents,234
Guarea_corrugata,2,2,0,Points-PointsKO-Adjacents,18
Guarea_corticosa,7,3,4,Points-PointsKO-Adjacents,21
Guarea_costata,14,12,2,Points-PointsKO-Adjacents,97
Guarea_crispa,5,5,0,Points-PointsKO-Adjacents,45
Guarea_cristata,50,35,15,Alphahull-PointsKO-Adjacents,955
Guarea_donnell-smithii,14,7,7,Points-PointsKO-Adjacents,83
Guarea_ecuadoriensis,54,33,21,Alphahull-PointsKO-Adjacents,1411
Guarea_eriorhachis,3,3,0,Points-PointsKO-Adjacents,27
Guarea_fissicalyx,60,38,22,Alphahull-PointsKO-Adjacents,1488
Guarea_fistulosa,58,41,17,Alphahull-PointsKO-Adjacents,1846
Guarea_gentryi,31,22,9,Alphahull-PointsKO-Adjacents,114
Guarea_glabra,1862,1641,221,Alphahull-PointsKO-Adjacents,44810
Guarea_gomma,411,334,77,Alphahull-PointsKO-Adjacents,19327
Guarea_guentheri,42,0,42,Points-PointsKO-Adjacents,304
Guarea_guidonia,2939,2661,278,Alphahull-PointsKO-Adjacents,142962
Guarea_hoffmanniana,95,77,18,Alphahull-PointsKO-Adjacents,762
Guarea_humaitensis,53,31,22,Alphahull-PointsKO-Adjacents,882
Guarea_inesiana,4,4,0,Points-PointsKO-Adjacents,36
Guarea_jamaicensis,3,2,1,Points-PointsKO-Adjacents,24
Guarea_juglandiformis,54,1,53,Points-PointsKO-Adjacents,394
Guarea_kunthiana,2732,2540,192,Alphahull-PointsKO-Adjacents,127749
Guarea_lozanii,4,4,0,Points-PointsKO-Adjacents,27
Guarea_luxii,23,14,9,Points-PointsKO-Adjacents,97
Guarea_macrocalyx,12,9,3,Points-PointsKO-Adjacents,54
Guarea_macrophylla,3115,2867,248,Alphahull-PointsKO-Adjacents,135558
Guarea_mexicana,6,0,6,Points-PointsKO-Adjacents,45
Guarea_michel-moddei,7,6,1,Points-PointsKO-Adjacents,55
Guarea_pendula,7,2,5,Points-PointsKO-Adjacents,54
Guarea_persistens,35,23,12,Alphahull-PointsKO-Adjacents,188
Guarea_polymera,18,9,9,Points-PointsKO-Adjacents,117
Guarea_pterorhachis,604,537,67,Alphahull-PointsKO-Adjacents,22335
Guarea_pubescens,865,799,66,Alphahull-PointsKO-Adjacents,67142
Guarea_purusana,257,192,65,Alphahull-PointsKO-Adjacents,22416
Guarea_pyriformis,7,3,4,Points-PointsKO-Adjacents,49
Guarea_rhopalocarpa,168,146,22,Alphahull-PointsKO-Adjacents,816
Guarea_riparia,11,5,6,Points-PointsKO-Adjacents,43
Guarea_scabra,84,33,51,Alphahull-PointsKO-Adjacents,2630
Guarea_silvatica,509,422,87,Alphahull-PointsKO-Adjacents,42841
Guarea_sphenophylla,4,4,0,Points-PointsKO-Adjacents,36
Guarea_sprucei,4,4,0,Points-PointsKO-Adjacents,36
Guarea_subandina,7,2,5,Points-PointsKO-Adjacents,33
Guarea_subsessilifolia,9,4,5,Points-PointsKO-Adjacents,27
Guarea_tafae-malekui,8,5,3,Points-PointsKO-Adjacents,27
Guarea_talamancana,2,2,0,Points-PointsKO-Adjacents,18
Guarea_tonduzii,38,22,16,Alphahull-PointsKO-Adjacents,339
Guarea_trunciflora,91,55,36,Alphahull-PointsKO-Adjacents,1880
Guarea_velutina,41,11,30,Points-PointsKO-Adjacents,308
Guarea_venenata,9,0,9,Points-PointsKO-Adjacents,79
Guarea_zarceroensis,9,3,6,Points-PointsKO-Adjacents,45
Guatteria_aberrans,24,13,11,Points-PointsKO-Adjacents,149
Guatteria_acrantha,4,4,0,Points-PointsKO-Adjacents,27
Guatteria_aeruginosa,146,126,20,Alphahull-PointsKO-Adjacents,619
Guatteria_alata,36,25,11,Alphahull-PointsKO-Adjacents,134
Guatteria_alta,38,24,14,Alphahull-PointsKO-Adjacents,338
Guatteria_allenii,21,14,7,Points-PointsKO-Adjacents,88
Guatteria_alticola,3,3,0,Points-PointsKO-Adjacents,18
Guatteria_amplifolia,703,628,75,Alphahull-PointsKO-Adjacents,4497
Guatteria_anomala,79,67,12,Alphahull-PointsKO-Adjacents,651
Guatteria_anteridifera,3,3,0,Points-PointsKO-Adjacents,27
Guatteria_arenicola,35,17,18,Points-PointsKO-Adjacents,244
Guatteria_argentea,6,2,4,Points-PointsKO-Adjacents,33
Guatteria_atabapensis,17,6,11,Points-PointsKO-Adjacents,120
Guatteria_augusti,1,1,0,Points-PointsKO-Adjacents,9
Guatteria_australis,1329,0,1329,Points-PointsKO-Adjacents,5223
Guatteria_ayangannae,4,4,0,Points-PointsKO-Adjacents,14
Guatteria_blainii,43,24,19,Alphahull-PointsKO-Adjacents,238
Guatteria_blepharophylla,627,514,113,Alphahull-PointsKO-Adjacents,65268
Guatteria_brevipetiolata,6,0,6,Points-PointsKO-Adjacents,43
Guatteria_calliantha,0,0,0,NA,0
Guatteria_campestris,132,110,22,Alphahull-PointsKO-Adjacents,3267
Guatteria_campinensis,7,1,6,Points-PointsKO-Adjacents,59
Guatteria_candolleana,72,43,29,Alphahull-PointsKO-Adjacents,1281
Guatteria_caribaea,29,14,15,Points-PointsKO-Adjacents,109
Guatteria_chasmantha,12,2,10,Points-PointsKO-Adjacents,81
Guatteria_chiriquiensis,56,48,8,Alphahull-PointsKO-Adjacents,128
Guatteria_chrysophylla,9,2,7,Points-PointsKO-Adjacents,81
Guatteria_citriodora,235,140,95,Alphahull-PointsKO-Adjacents,20185
Guatteria_clusiifolia,2,2,0,Points-PointsKO-Adjacents,18
Guatteria_confusa,5,5,0,Points-PointsKO-Adjacents,45
Guatteria_conspicua,14,4,10,Points-PointsKO-Adjacents,76
Guatteria_costaricensis,87,70,17,Alphahull-PointsKO-Adjacents,276
Guatteria_crassipes,51,32,19,Alphahull-PointsKO-Adjacents,979
Guatteria_cryandra,20,5,15,Points-PointsKO-Adjacents,171
Guatteria_cuatrecasasii,41,29,12,Alphahull-PointsKO-Adjacents,165
Guatteria_darienensis,33,19,14,Points-PointsKO-Adjacents,174
Guatteria_decurrens,86,62,24,Alphahull-PointsKO-Adjacents,3660
Guatteria_denudata,2,2,0,Points-PointsKO-Adjacents,18
Guatteria_discolor,186,132,54,Alphahull-PointsKO-Adjacents,22064
Guatteria_dolichophylla,2,2,0,Points-PointsKO-Adjacents,18
Guatteria_dolichopoda,172,151,21,Alphahull-PointsKO-Adjacents,779
Guatteria_duckeana,21,7,14,Points-PointsKO-Adjacents,148
Guatteria_duodecima,79,37,42,Alphahull-PointsKO-Adjacents,2541
Guatteria_dura,14,10,4,Points-PointsKO-Adjacents,110
Guatteria_ecuadorensis,1,1,0,Points-PointsKO-Adjacents,9
Guatteria_elata,61,37,24,Alphahull-PointsKO-Adjacents,1222
Guatteria_elegans,2,2,0,Points-PointsKO-Adjacents,12
Guatteria_elegantissima,17,0,17,Points-PointsKO-Adjacents,79
Guatteria_elongata,2,2,0,Points-PointsKO-Adjacents,18
Guatteria_emarginata,2,2,0,Points-PointsKO-Adjacents,14
Guatteria_eriopoda,4,4,0,Points-PointsKO-Adjacents,36
Guatteria_eugeniifolia,5,5,0,Points-PointsKO-Adjacents,41
Guatteria_excelsa,2,2,0,Points-PointsKO-Adjacents,18
Guatteria_ferruginea,1,1,0,Points-PointsKO-Adjacents,9
Guatteria_flabellata,36,18,18,Points-PointsKO-Adjacents,282
Guatteria_flagelliflora,3,3,0,Points-PointsKO-Adjacents,22
Guatteria_flexilis,15,8,7,Points-PointsKO-Adjacents,126
Guatteria_foliosa,374,301,73,Alphahull-PointsKO-Adjacents,40448
Guatteria_fractiflexa,9,4,5,Points-PointsKO-Adjacents,81
Guatteria_friesiana,20,14,6,Points-PointsKO-Adjacents,85
Guatteria_galeottiana,57,45,12,Alphahull-PointsKO-Adjacents,326
Guatteria_geminiflora,18,4,14,Points-PointsKO-Adjacents,142
Guatteria_gentryi,35,26,9,Alphahull-PointsKO-Adjacents,169
Guatteria_glauca,92,72,20,Alphahull-PointsKO-Adjacents,641
Guatteria_goudotiana,90,78,12,Alphahull-PointsKO-Adjacents,861
Guatteria_grandiflora,5,0,5,Points-PointsKO-Adjacents,45
Guatteria_grandipes,9,1,8,Points-PointsKO-Adjacents,79
Guatteria_guentheri,37,25,12,Alphahull-PointsKO-Adjacents,422
Guatteria_guianensis,327,246,81,Alphahull-PointsKO-Adjacents,19629
Gasteria_herreana,42,0,42,Points-PointsKO-Adjacents,318
Guatteria_hirsuta,364,298,66,Alphahull-PointsKO-Adjacents,19484
Guatteria_hispida,9,4,5,Points-PointsKO-Adjacents,58
Guatteria_insculpta,42,24,18,Alphahull-PointsKO-Adjacents,1322
Guatteria_intermedia,23,15,8,Points-PointsKO-Adjacents,170
Guatteria_inundata,252,202,50,Alphahull-PointsKO-Adjacents,16099
Guatteria_jamundensis,0,0,0,NA,0
Guatteria_japurensis,0,0,0,NA,0
Guatteria_jefensis,12,8,4,Points-PointsKO-Adjacents,19
Guatteria_juninensis,22,9,13,Points-PointsKO-Adjacents,117
Guatteria_klugii,0,0,0,NA,0
Guatteria_latifolia,29,0,29,Points-PointsKO-Adjacents,139
Guatteria_leucotricha,2,2,0,Points-PointsKO-Adjacents,9
Guatteria_liesneri,24,0,24,Points-PointsKO-Adjacents,114
Guatteria_longicuspis,72,37,35,Alphahull-PointsKO-Adjacents,5765
Guatteria_longipetiolata,0,0,0,NA,0
Guatteria_lucens,92,70,22,Alphahull-PointsKO-Adjacents,555
Guatteria_macropus,85,61,24,Alphahull-PointsKO-Adjacents,1150
Guatteria_maguirei,30,11,19,Points-PointsKO-Adjacents,188
Guatteria_maypurensis,183,137,46,Alphahull-PointsKO-Adjacents,17828
Guatteria_megalophylla,605,558,47,Alphahull-PointsKO-Adjacents,38974
Guatteria_meliodora,51,15,36,Points-PointsKO-Adjacents,421
Guatteria_microcarpa,45,33,12,Alphahull-PointsKO-Adjacents,1021
Guatteria_minutiflora,7,1,6,Points-PointsKO-Adjacents,44
Guatteria_modesta,79,57,22,Alphahull-PointsKO-Adjacents,3567
Guatteria_monticola,7,3,4,Points-PointsKO-Adjacents,48
Guatteria_moralesii,4,4,0,Points-PointsKO-Adjacents,29
Guatteria_myriocarpa,3,3,0,Points-PointsKO-Adjacents,27
Guatteria_notabilis,50,39,11,Alphahull-PointsKO-Adjacents,401
Guatteria_novogranatensis,11,7,4,Points-PointsKO-Adjacents,87
Guatteria_oblonga,1,1,0,Points-PointsKO-Adjacents,9
Guatteria_oblongifolia,43,32,11,Alphahull-PointsKO-Adjacents,291
Guatteria_occidentalis,1,1,0,Points-PointsKO-Adjacents,9
Guatteria_odorata,1,1,0,Points-PointsKO-Adjacents,9
Guatteria_oligocarpa,216,173,43,Alphahull-PointsKO-Adjacents,2146
Guatteria_oliviformis,117,102,15,Alphahull-PointsKO-Adjacents,294
Guatteria_ouregou,55,45,10,Alphahull-PointsKO-Adjacents,222
Guatteria_pacifica,33,23,10,Alphahull-PointsKO-Adjacents,304
Guatteria_pakaraimae,4,4,0,Points-PointsKO-Adjacents,27
Guatteria_paludosa,8,3,5,Points-PointsKO-Adjacents,57
Guatteria_panamensis,14,7,7,Points-PointsKO-Adjacents,114
Guatteria_pannosa,7,0,7,Points-PointsKO-Adjacents,63
Guatteria_partangensis,1,1,0,Points-PointsKO-Adjacents,9
Guatteria_pastazae,23,15,8,Points-PointsKO-Adjacents,136
Guatteria_persicifolia,6,0,6,Points-PointsKO-Adjacents,54
Guatteria_peruviana,6,0,6,Points-PointsKO-Adjacents,48
Guatteria_pittieri,44,31,13,Alphahull-PointsKO-Adjacents,322
Guatteria_pogonopus,367,293,74,Alphahull-PointsKO-Adjacents,4166
Guatteria_pohliana,80,55,25,Alphahull-PointsKO-Adjacents,2691
Guatteria_polyantha,2,2,0,Points-PointsKO-Adjacents,18
Guatteria_procera,43,1,42,Points-PointsKO-Adjacents,325
Guatteria_pudica,39,35,4,Alphahull-PointsKO-Adjacents,41
Guatteria_punctata,1407,1314,93,Alphahull-PointsKO-Adjacents,83593
Guatteria_ramiflora,38,14,24,Points-PointsKO-Adjacents,287
Guatteria_reinaldii,2,2,0,Points-PointsKO-Adjacents,9
Guatteria_richardii,17,9,8,Points-PointsKO-Adjacents,115
Guatteria_rigida,125,87,38,Alphahull-PointsKO-Adjacents,13210
Guatteria_rostrata,26,19,7,Points-PointsKO-Adjacents,35
Guatteria_rotundata,15,8,7,Points-PointsKO-Adjacents,54
Guatteria_rubrinervis,22,9,13,Points-PointsKO-Adjacents,162
Guatteria_rufotomentosa,2,2,0,Points-PointsKO-Adjacents,18
Guatteria_rupestris,43,30,13,Alphahull-PointsKO-Adjacents,730
Guatteria_sabuletorum,3,3,0,Points-PointsKO-Adjacents,27
Guatteria_saffordiana,49,33,16,Alphahull-PointsKO-Adjacents,245
Guatteria_sanctaecrucis,25,6,19,Points-PointsKO-Adjacents,185
Guatteria_scalarinervia,14,7,7,Points-PointsKO-Adjacents,114
Guatteria_schomburgkiana,874,772,102,Alphahull-PointsKO-Adjacents,70978
Guatteria_schunkevigoi,1,1,0,Points-PointsKO-Adjacents,9
Guatteria_scytophylla,159,112,47,Alphahull-PointsKO-Adjacents,23019
Guatteria_sellowiana,526,462,64,Alphahull-PointsKO-Adjacents,15539
Guatteria_sessilicarpa,25,17,8,Points-PointsKO-Adjacents,76
Guatteria_slateri,34,23,11,Alphahull-PointsKO-Adjacents,105
Guatteria_sodiroi,1,1,0,Points-PointsKO-Adjacents,9
Guatteria_spectabilis,13,3,10,Points-PointsKO-Adjacents,111
Guatteria_stenocarpa,10,5,5,Points-PointsKO-Adjacents,39
Guatteria_stenopetala,6,0,6,Points-PointsKO-Adjacents,32
Guettarda_stenophylla,2,1,1,Points-PointsKO-Adjacents,18
Guatteria_stipitata,64,32,32,Alphahull-PointsKO-Adjacents,4080
Guatteria_subsessilis,50,22,28,Alphahull-PointsKO-Adjacents,1384
Guatteria_talamancana,28,15,13,Points-PointsKO-Adjacents,113
Guatteria_tenera,4,4,0,Points-PointsKO-Adjacents,34
Guatteria_terminalis,14,7,7,Points-PointsKO-Adjacents,106
Guatteria_tomentosa,302,219,83,Alphahull-PointsKO-Adjacents,13972
Guatteria_trichocarpa,26,6,20,Points-PointsKO-Adjacents,166
Guatteria_trichostemon,5,0,5,Points-PointsKO-Adjacents,45
Guatteria_ucayalina,773,653,120,Alphahull-PointsKO-Adjacents,56974
Guatteria_venezuelana,9,1,8,Points-PointsKO-Adjacents,66
Guatteria_venosa,14,0,14,Points-PointsKO-Adjacents,60
Guatteria_verrucosa,87,73,14,Alphahull-PointsKO-Adjacents,295
Guatteria_verruculosa,2,2,0,Points-PointsKO-Adjacents,18
Guatteria_villosissima,215,188,27,Alphahull-PointsKO-Adjacents,2598
Guatteria_wachenheimii,50,0,50,Points-PointsKO-Adjacents,313
Guatteria_wokomungensis,4,4,0,Points-PointsKO-Adjacents,23
Guatteria_zamorae,9,3,6,Points-PointsKO-Adjacents,47
Guazuma_crinita,111,58,53,Alphahull-PointsKO-Adjacents,4660
Guazuma_ulmifolia,6639,5930,709,Alphahull-PointsKO-Adjacents,136468
Guettarda_abbottii,7,4,3,Points-PointsKO-Adjacents,34
Guettarda_aculeolata,1,0,1,Points-PointsKO-Adjacents,9
Guettarda_adulterina,2,2,0,Points-PointsKO-Adjacents,16
Guettarda_amblyophylla,1,1,0,Points-PointsKO-Adjacents,9
Guettarda_andamanica,NA,NA,NA,NA,NA
Guettarda_angelica,485,433,52,Alphahull-PointsKO-Adjacents,10699
Guettarda_angustata,5,5,0,Points-PointsKO-Adjacents,41
Guettarda_apiculata,0,0,0,NA,0
Guettarda_argentea,30,12,18,Points-PointsKO-Adjacents,147
Guettarda_aromatica,83,24,59,Alphahull-PointsKO-Adjacents,3292
Guettarda_artensis,1,1,0,Points-PointsKO-Adjacents,6
Guettarda_baladensis,6,1,5,Points-PointsKO-Adjacents,39
Guettarda_baltenweckii,0,0,0,NA,0
Guettarda_baracoensis,NA,NA,NA,NA,NA
Guettarda_barahonensis,4,3,1,Points-PointsKO-Adjacents,36
Guettarda_bernardii,1,1,0,Points-PointsKO-Adjacents,9
Guettarda_blanchetiana,3,2,1,Points-PointsKO-Adjacents,27
Guettarda_boliviana,3,3,0,Points-PointsKO-Adjacents,27
Guettarda_brenesii,10,5,5,Points-PointsKO-Adjacents,66
Guettarda_brevinodis,2,2,0,Points-PointsKO-Adjacents,9
Guettarda_caatingae,NA,NA,NA,NA,NA
Guettarda_cahosiana,0,0,0,NA,0
Guettarda_calcicola,1,1,0,Points-PointsKO-Adjacents,9
Guettarda_calyptrata,31,10,21,Points-PointsKO-Adjacents,213
Guettarda_camagueyensis,0,0,0,NA,0
Guettarda_clarensis,1,1,0,Points-PointsKO-Adjacents,9
Guettarda_cobrensis,1,1,0,Points-PointsKO-Adjacents,9
Guettarda_comata,12,0,12,Points-PointsKO-Adjacents,104
Guettarda_combsii,416,371,45,Alphahull-PointsKO-Adjacents,3848
Guettarda_cordata,0,0,0,NA,0
Guettarda_coxiana,1,1,0,Points-PointsKO-Adjacents,8
Guettarda_crassifolia,4,4,0,Points-PointsKO-Adjacents,36
Guettarda_crassipes,8,3,5,Points-PointsKO-Adjacents,50
Guettarda_crenulata,1,1,0,Points-PointsKO-Adjacents,9
Guettarda_crispiflora,727,619,108,Alphahull-PointsKO-Adjacents,13478
Guettarda_cueroensis,5,3,2,Points-PointsKO-Adjacents,39
Guettarda_dealbata,NA,NA,NA,NA,NA
Guettarda_deamii,52,33,19,Alphahull-PointsKO-Adjacents,1183
Guettarda_dependens,19,8,11,Points-PointsKO-Adjacents,156
Guettarda_dictyophylla,7,4,3,Points-PointsKO-Adjacents,50
Guettarda_divaricata,180,1,179,Points-PointsKO-Adjacents,1358
Guettarda_duckei,3,2,1,Points-PointsKO-Adjacents,27
Guettarda_ekmanii,NA,NA,NA,NA,NA
Guettarda_elegans,1,1,0,Points-PointsKO-Adjacents,9
Guettarda_elliptica,668,526,142,Alphahull-PointsKO-Adjacents,9903
Guettarda_erosa,0,0,0,NA,0
Guettarda_excisa,0,0,0,NA,0
Guettarda_fanshawei,2,2,0,Points-PointsKO-Adjacents,18
Guettarda_ferox,4,4,0,Points-PointsKO-Adjacents,36
Guettarda_ferruginea,11,5,6,Points-PointsKO-Adjacents,59
Guettarda_filipes,31,14,17,Points-PointsKO-Adjacents,154
Guettarda_foliacea,134,104,30,Alphahull-PointsKO-Adjacents,1385
Guettarda_fontanesii,NA,NA,NA,NA,NA
Guettarda_frangulifolia,1,1,0,Points-PointsKO-Adjacents,9
Guettarda_frondosa,4,4,0,Points-PointsKO-Adjacents,24
Guettarda_fusca,0,0,0,NA,0
Guettarda_gaumeri,185,171,14,Alphahull-PointsKO-Adjacents,2177
Guettarda_grazielae,37,18,19,Points-PointsKO-Adjacents,241
Guettarda_guerrerensis,NA,NA,NA,NA,NA
Guettarda_hermosa,NA,NA,NA,NA,NA
Guettarda_heterosepala,13,9,4,Points-PointsKO-Adjacents,68
Guettarda_hirsuta,34,14,20,Points-PointsKO-Adjacents,266
Guettarda_hoffmannseggii,1,1,0,Points-PointsKO-Adjacents,9
Guettarda_humboldtensis,7,2,5,Points-PointsKO-Adjacents,30
Guettarda_hypoglauca,1,1,0,Points-PointsKO-Adjacents,9
Guettarda_hypolasia,2,2,0,Points-PointsKO-Adjacents,17
Guettarda_inaequipes,1,1,0,Points-PointsKO-Adjacents,8
Guettarda_insularis,9,3,6,Points-PointsKO-Adjacents,16
Guettarda_krugii,21,9,12,Points-PointsKO-Adjacents,56
Guettarda_lacornea,0,0,0,NA,0
Guettarda_lamprophylla,0,0,0,NA,0
Guettarda_lanuginosa,0,0,0,NA,0
Guettarda_leai,1,1,0,Points-PointsKO-Adjacents,3
Guettarda_leonis,NA,NA,NA,NA,NA
Guettarda_lindeniana,24,8,16,Points-PointsKO-Adjacents,189
Guettarda_longiflora,2,2,0,Points-PointsKO-Adjacents,15
Guettarda_macrantha,83,35,48,Alphahull-PointsKO-Adjacents,3934
Guettarda_macrocarpa,3,3,0,Points-PointsKO-Adjacents,26
Guettarda_macrosperma,353,303,50,Alphahull-PointsKO-Adjacents,4646
Guettarda_malacophylla,16,0,16,Points-PointsKO-Adjacents,123
Guettarda_membranacea,0,0,0,NA,0
Guettarda_mephitica,NA,NA,NA,NA,NA
Guettarda_mollis,21,16,5,Points-PointsKO-Adjacents,51
Guettarda_monocarpa,7,1,6,Points-PointsKO-Adjacents,50
Guettarda_multinervis,1,1,0,Points-PointsKO-Adjacents,9
Guettarda_munizii,NA,NA,NA,NA,NA
Guettarda_nannocarpa,4,3,1,Points-PointsKO-Adjacents,33
Guettarda_nashii,1,1,0,Points-PointsKO-Adjacents,5
Guettarda_nervosa,3,3,0,Points-PointsKO-Adjacents,15
Guettarda_ocoana,2,2,0,Points-PointsKO-Adjacents,9
Guettarda_ocoteifolia,7,0,7,Points-PointsKO-Adjacents,60
Guettarda_odorata,65,26,39,Alphahull-PointsKO-Adjacents,657
Guettarda_organosia,1,1,0,Points-PointsKO-Adjacents,9
Guettarda_orhreata,NA,NA,NA,NA,NA
Guettarda_ovalifolia,45,34,11,Alphahull-PointsKO-Adjacents,153
Guettarda_oxyphylla,2,2,0,Points-PointsKO-Adjacents,16
Guettarda_paludosa,1,1,0,Points-PointsKO-Adjacents,9
Guettarda_parallelineura,0,0,0,NA,0
Guettarda_pinariona,0,0,0,NA,0
Guettarda_platypoda,331,228,103,Alphahull-PointsKO-Adjacents,6079
Guettarda_pohliana,350,0,350,Points-PointsKO-Adjacents,2491
Guettarda_polytheca,1,1,0,Points-PointsKO-Adjacents,9
Guettarda_preneloupii,8,2,6,Points-PointsKO-Adjacents,35
Guettarda_psiloclada,2,2,0,Points-PointsKO-Adjacents,16
Guettarda_punctata,0,0,0,NA,0
Guettarda_pungens,45,34,11,Alphahull-PointsKO-Adjacents,373
Guettarda_quadrifida,1,1,0,Points-PointsKO-Adjacents,9
Guettarda_ramuliflora,31,22,9,Alphahull-PointsKO-Adjacents,346
Guettarda_retusa,NA,NA,NA,NA,NA
Guettarda_rhabdocalyx,4,4,0,Points-PointsKO-Adjacents,27
Guettarda_rhamnifolia,1,1,0,Points-PointsKO-Adjacents,9
Guettarda_rigida,1,1,0,Points-PointsKO-Adjacents,9
Guettarda_roigiana,NA,NA,NA,NA,NA
Guettarda_rotundifolia,0,0,0,NA,0
Guettarda_roupaliifolia,30,12,18,Points-PointsKO-Adjacents,225
Guettarda_rusbyi,6,1,5,Points-PointsKO-Adjacents,54
Guettarda_sageretioides,5,5,0,Points-PointsKO-Adjacents,44
Guettarda_sanblasensis,87,53,34,Alphahull-PointsKO-Adjacents,956
Guettarda_saxicola,NA,NA,NA,NA,NA
Guettarda_scabra,83,38,45,Alphahull-PointsKO-Adjacents,1017
Guettarda_sciaphila,1,1,0,Points-PointsKO-Adjacents,9
Guettarda_shaferi,9,4,5,Points-PointsKO-Adjacents,56
Guettarda_speciosa,347,187,160,Alphahull-PointsKO-Adjacents,2598
Guettarda_spinifera,1,1,0,Points-PointsKO-Adjacents,9
Guettarda_splendens,1,1,0,Points-PointsKO-Adjacents,9
Guettarda_spruceana,56,16,40,Points-PointsKO-Adjacents,439
Guettarda_subcapitata,45,29,16,Alphahull-PointsKO-Adjacents,433
Guettarda_tenuiramis,0,0,0,NA,0
Guettarda_tikalana,57,46,11,Alphahull-PointsKO-Adjacents,513
Guettarda_tobagensis,4,3,1,Points-PointsKO-Adjacents,36
Guettarda_torbeciana,0,0,0,NA,0
Guettarda_tortuensis,1,1,0,Points-PointsKO-Adjacents,9
Guettarda_tournefortiopsis,106,62,44,Alphahull-PointsKO-Adjacents,1541
Guettarda_trimera,6,1,5,Points-PointsKO-Adjacents,42
Guettarda_turpinii,0,0,0,NA,0
Guettarda_umbellata,NA,NA,NA,NA,NA
Guettarda_undulata,0,0,0,NA,0
Guettarda_urbanii,4,4,0,Points-PointsKO-Adjacents,32
Guettarda_uruguensis,575,499,76,Alphahull-PointsKO-Adjacents,21722
Guettarda_valenzuelana,64,38,26,Alphahull-PointsKO-Adjacents,371
Guettarda_velutina,1,1,0,Points-PointsKO-Adjacents,9
Guettarda_viburnoides,1956,1685,271,Alphahull-PointsKO-Adjacents,47919
Guettarda_vieillardii,0,0,0,NA,0
Guettarda_wagapensis,1,1,0,Points-PointsKO-Adjacents,9
Guianodendron_praeclarum,7,1,6,Points-PointsKO-Adjacents,63
Guibourtia_arnoldiana,12,4,8,Points-PointsKO-Adjacents,104
Guibourtia_carrissoana,5,5,0,Points-PointsKO-Adjacents,36
Guibourtia_coleosperma,59,37,22,Alphahull-PointsKO-Adjacents,1793
Guibourtia_confertiflora,1,1,0,Points-PointsKO-Adjacents,9
Guibourtia_conjugata,33,22,11,Alphahull-PointsKO-Adjacents,922
Guibourtia_copallifera,21,3,18,Points-PointsKO-Adjacents,175
Guibourtia_demeusei,56,35,21,Alphahull-PointsKO-Adjacents,2454
Guibourtia_dinklagei,4,4,0,Points-PointsKO-Adjacents,34
Guibourtia_ehie,140,116,24,Alphahull-PointsKO-Adjacents,1665
Guibourtia_hymenaeifolia,12,3,9,Points-PointsKO-Adjacents,83
Guibourtia_leonensis,25,15,10,Points-PointsKO-Adjacents,154
Guibourtia_pellegriniana,41,25,16,Alphahull-PointsKO-Adjacents,172
Guibourtia_schliebenii,18,6,12,Points-PointsKO-Adjacents,120
Guibourtia_sousae,1,1,0,Points-PointsKO-Adjacents,9
Guibourtia_tessmannii,58,43,15,Alphahull-PointsKO-Adjacents,2020
Guiera_senegalensis,269,221,48,Alphahull-PointsKO-Adjacents,8316
Guihaia_grossifibrosa,0,0,0,NA,0
Guilfoylia_monostylis,401,375,26,Alphahull-PointsKO-Adjacents,948
Guioa_acuminata,1,1,0,Points-PointsKO-Adjacents,7
Guioa_acutifolia,309,255,54,Alphahull-PointsKO-Adjacents,819
Guioa_amabilis,0,0,0,NA,0
Guioa_aryterifolia,4,4,0,Points-PointsKO-Adjacents,17
Guioa_asquamosa,1,1,0,Points-PointsKO-Adjacents,9
Guioa_bicolor,5,5,0,Points-PointsKO-Adjacents,17
Guioa_bijuga,9,0,9,Points-PointsKO-Adjacents,59
Guioa_capillacea,1,1,0,Points-PointsKO-Adjacents,9
Guioa_chrysea,4,4,0,Points-PointsKO-Adjacents,25
Guioa_comesperma,42,25,17,Alphahull-PointsKO-Adjacents,294
Guioa_contracta,10,4,6,Points-PointsKO-Adjacents,58
Guioa_coriacea,13,9,4,Points-PointsKO-Adjacents,5
Guioa_crenata,20,13,7,Points-PointsKO-Adjacents,89
Guioa_crenulata,9,0,9,Points-PointsKO-Adjacents,38
Guioa_diplopetala,17,2,15,Points-PointsKO-Adjacents,146
Guioa_discolor,1,1,0,Points-PointsKO-Adjacents,7
Guioa_elegans,NA,NA,NA,NA,NA
Guioa_elliptica,0,0,0,NA,0
Guioa_glauca,239,213,26,Alphahull-PointsKO-Adjacents,293
Guioa_grandifoliola,7,0,7,Points-PointsKO-Adjacents,43
Guioa_hirsuta,7,5,2,Points-PointsKO-Adjacents,47
Guioa_hospita,NA,NA,NA,NA,NA
Guioa_koelreuteria,24,11,13,Points-PointsKO-Adjacents,181
Guioa_koniamboensis,2,2,0,Points-PointsKO-Adjacents,18
Guioa_krempfii,0,0,0,NA,0
Guioa_lasioneura,137,117,20,Alphahull-PointsKO-Adjacents,310
Guioa_lentiscifolia,3,1,2,Points-PointsKO-Adjacents,9
Guioa_malukuensis,4,4,0,Points-PointsKO-Adjacents,16
Guioa_megacarpa,0,0,0,NA,0
Guioa_melanopoda,2,2,0,Points-PointsKO-Adjacents,18
Guioa_membranifolia,4,4,0,Points-PointsKO-Adjacents,30
Guioa_microsepala,66,53,13,Alphahull-PointsKO-Adjacents,127
Guioa_misimaensis,0,0,0,NA,0
Guioa_molliuscula,2,2,0,Points-PointsKO-Adjacents,18
Guioa_montana,59,48,11,Alphahull-PointsKO-Adjacents,159
Guioa_multijuga,1,1,0,Points-PointsKO-Adjacents,8
Guioa_myriadenia,1,1,0,Points-PointsKO-Adjacents,9
Guioa_normanbiensis,1,1,0,Points-PointsKO-Adjacents,8
Guioa_novobritannica,1,1,0,Points-PointsKO-Adjacents,8
Guioa_novoebudaensis,2,2,0,Points-PointsKO-Adjacents,18
Guioa_oligotricha,4,4,0,Points-PointsKO-Adjacents,30
Guioa_ovalis,58,47,11,Alphahull-PointsKO-Adjacents,124
Guioa_palawanica,0,0,0,NA,0
Guioa_parvifoliola,0,0,0,NA,0
Guioa_patentinervis,6,0,6,Points-PointsKO-Adjacents,44
Guioa_pauciflora,3,3,0,Points-PointsKO-Adjacents,21
Guioa_pectinata,22,16,6,Points-PointsKO-Adjacents,77
Guioa_platycarpa,7,3,4,Points-PointsKO-Adjacents,41
Guioa_pleuropteris,39,6,33,Points-PointsKO-Adjacents,288
Guioa_plurinervis,2,2,0,Points-PointsKO-Adjacents,9
Guioa_pseudoamabilis,6,0,6,Points-PointsKO-Adjacents,39
Guioa_pteropoda,3,3,0,Points-PointsKO-Adjacents,27
Guioa_pterorhachis,3,3,0,Points-PointsKO-Adjacents,27
Guioa_pubescens,8,0,8,Points-PointsKO-Adjacents,59
Guioa_punctata,2,2,0,Points-PointsKO-Adjacents,9
Guioa_reticulata,1,1,0,Points-PointsKO-Adjacents,9
Guioa_rhoifolia,7,3,4,Points-PointsKO-Adjacents,39
Guioa_rigidiuscula,9,4,5,Points-PointsKO-Adjacents,59
Guioa_sarcopterifructa,20,14,6,Points-PointsKO-Adjacents,39
Guioa_scalariformis,2,2,0,Points-PointsKO-Adjacents,14
Guioa_semiglauca,2225,2082,143,Alphahull-PointsKO-Adjacents,2022
Guioa_spathulata,2,2,0,Points-PointsKO-Adjacents,18
Guioa_subsericea,24,15,9,Points-PointsKO-Adjacents,174
Guioa_sufusana,0,0,0,NA,0
Guioa_truncata,2,2,0,Points-PointsKO-Adjacents,12
Guioa_unguiculata,5,5,0,Points-PointsKO-Adjacents,32
Guioa_venusta,0,0,0,NA,0
Guioa_villosa,148,133,15,Alphahull-PointsKO-Adjacents,245
Guioa_waigeoensis,2,2,0,Points-PointsKO-Adjacents,6
Gustavia_acuminata,23,12,11,Points-PointsKO-Adjacents,139
Gustavia_angustifolia,41,28,13,Alphahull-PointsKO-Adjacents,444
Gustavia_augusta,1268,1158,110,Alphahull-PointsKO-Adjacents,72271
Gustavia_brachycarpa,38,25,13,Alphahull-PointsKO-Adjacents,132
Gustavia_coriacea,13,6,7,Points-PointsKO-Adjacents,94
Gustavia_dodsonii,17,9,8,Points-PointsKO-Adjacents,117
Gustavia_dubia,78,60,18,Alphahull-PointsKO-Adjacents,1386
Gustavia_elliptica,67,48,19,Alphahull-PointsKO-Adjacents,5084
Gustavia_erythrocarpa,5,5,0,Points-PointsKO-Adjacents,30
Gustavia_excelsa,8,1,7,Points-PointsKO-Adjacents,53
Gustavia_flagellata,12,7,5,Points-PointsKO-Adjacents,57
Gustavia_foliosa,9,3,6,Points-PointsKO-Adjacents,56
Gustavia_fosteri,8,4,4,Points-PointsKO-Adjacents,25
Gustavia_gentryi,12,4,8,Points-PointsKO-Adjacents,98
Gustavia_gigantophylla,7,0,7,Points-PointsKO-Adjacents,57
Gustavia_gracillima,2,2,0,Points-PointsKO-Adjacents,18
Gustavia_gracillipes,0,0,0,NA,0
Gustavia_grandibracteata,46,31,15,Alphahull-PointsKO-Adjacents,443
Gustavia_hexapetala,958,0,958,Points-PointsKO-Adjacents,6377
Gustavia_inakuama,9,4,5,Points-PointsKO-Adjacents,48
Gustavia_latifolia,2,2,0,Points-PointsKO-Adjacents,18
Gustavia_longifolia,14,1,13,Points-PointsKO-Adjacents,105
Gustavia_longifuniculata,13,7,6,Points-PointsKO-Adjacents,48
Gustavia_longipetiolata,NA,NA,NA,NA,NA
Gustavia_macarenensis,87,66,21,Alphahull-PointsKO-Adjacents,3123
Gustavia_monocaulis,6,0,6,Points-PointsKO-Adjacents,34
Gustavia_nana,81,65,16,Alphahull-PointsKO-Adjacents,1283
Gustavia_parviflora,6,0,6,Points-PointsKO-Adjacents,51
Gustavia_petiolata,7,0,7,Points-PointsKO-Adjacents,52
Gustavia_poeppigiana,330,250,80,Alphahull-PointsKO-Adjacents,32179
Gustavia_pubescens,30,18,12,Points-PointsKO-Adjacents,181
Gustavia_pulchra,118,92,26,Alphahull-PointsKO-Adjacents,2767
Gustavia_romeroi,26,19,7,Points-PointsKO-Adjacents,112
Gustavia_santanderiensis,16,4,12,Points-PointsKO-Adjacents,141
Gustavia_serrata,19,13,6,Points-PointsKO-Adjacents,128
Gustavia_sessilis,2,2,0,Points-PointsKO-Adjacents,18
Gustavia_speciosa,119,100,19,Alphahull-PointsKO-Adjacents,2482
Gustavia_superba,215,179,36,Alphahull-PointsKO-Adjacents,3547
Gustavia_tejerae,0,0,0,NA,0
Gustavia_terminaliflora,3,3,0,Points-PointsKO-Adjacents,27
Gustavia_verticillata,13,4,9,Points-PointsKO-Adjacents,116
Gyminda_fimbrillata,2,1,1,Points-PointsKO-Adjacents,15
Gyminda_latifolia,137,0,137,Points-PointsKO-Adjacents,672
Gyminda_orbicularis,3,3,0,Points-PointsKO-Adjacents,26
Gyminda_tonduzii,148,110,38,Alphahull-PointsKO-Adjacents,1661
Gymnacranthera_bancana,3,0,3,Points-PointsKO-Adjacents,18
Gymnacranthera_canarica,0,0,0,NA,0
Gymnacranthera_contracta,9,3,6,Points-PointsKO-Adjacents,79
Gymnacranthera_farquhariana,198,123,75,Alphahull-PointsKO-Adjacents,5099
Gymnacranthera_forbesii,30,15,15,Points-PointsKO-Adjacents,239
Gymnacranthera_maliliensis,4,4,0,Points-PointsKO-Adjacents,30
Gymnacranthera_ocellata,9,1,8,Points-PointsKO-Adjacents,81
Gymnanthemum_bellinghamii,6,0,6,Points-PointsKO-Adjacents,50
Gymnanthemum_coloratum,106,68,38,Alphahull-PointsKO-Adjacents,2547
Gymnanthemum_extensum,1,1,0,Points-PointsKO-Adjacents,9
Gymnanthemum_myrianthum,110,52,58,Alphahull-PointsKO-Adjacents,4803
Gymnanthemum_rueppellii,3,3,0,Points-PointsKO-Adjacents,27
Gymnanthes_actinostemoides,25,12,13,Points-PointsKO-Adjacents,161
Gymnanthes_albicans,12,1,11,Points-PointsKO-Adjacents,86
Gymnanthes_belizensis,4,4,0,Points-PointsKO-Adjacents,31
Gymnanthes_borneensis,4,4,0,Points-PointsKO-Adjacents,36
Gymnanthes_edwalliana,74,51,23,Alphahull-PointsKO-Adjacents,1928
Gymnanthes_farinosa,0,0,0,NA,0
Gymnanthes_gaudichaudii,36,21,15,Alphahull-PointsKO-Adjacents,131
Gymnanthes_glandulosa,3,3,0,Points-PointsKO-Adjacents,25
Gymnanthes_hypoleuca,15,7,8,Points-PointsKO-Adjacents,58
Gymnanthes_inopinata,81,63,18,Alphahull-PointsKO-Adjacents,2566
Gymnanthes_insolita,2,2,0,Points-PointsKO-Adjacents,15
Gymnanthes_integra,2,2,0,Points-PointsKO-Adjacents,15
Gymnanthes_longipes,86,70,16,Alphahull-PointsKO-Adjacents,724
Gymnanthes_lucida,356,268,88,Alphahull-PointsKO-Adjacents,5220
Gymnanthes_nervosa,28,9,19,Points-PointsKO-Adjacents,197
Gymnanthes_pallens,14,2,12,Points-PointsKO-Adjacents,118
Gymnanthes_remota,0,0,0,NA,0
Gymnanthes_riparia,201,146,55,Alphahull-PointsKO-Adjacents,4467
Gymnanthes_widgrenii,3,3,0,Points-PointsKO-Adjacents,27
Gymnocladus_angustifolius,0,0,0,NA,0
Gymnocladus_assamicus,0,0,0,NA,0
Gymnocladus_burmanicus,0,0,0,NA,0
Gymnocladus_chinensis,34,15,19,Points-PointsKO-Adjacents,296
Gymnocladus_dioicus,1009,738,271,Alphahull-PointsKO-Adjacents,25925
Gymnopodium_floribundum,536,0,536,Points-PointsKO-Adjacents,1464
Gymnosporia_addat,5,4,1,Points-PointsKO-Adjacents,41
Gymnosporia_arbutifolia,82,51,31,Alphahull-PointsKO-Adjacents,3233
Gymnosporia_arenicola,23,7,16,Points-PointsKO-Adjacents,180
Gymnosporia_bachmannii,8,2,6,Points-PointsKO-Adjacents,63
Gymnosporia_bailadillana,NA,NA,NA,NA,NA
Gymnosporia_buchananii,83,42,41,Alphahull-PointsKO-Adjacents,385
Gymnosporia_buxifolia,347,280,67,Alphahull-PointsKO-Adjacents,12843
Gymnosporia_chevalieri,2,2,0,Points-PointsKO-Adjacents,18
Gymnosporia_crenata,7,2,5,Points-PointsKO-Adjacents,25
Gymnosporia_devenishii,8,2,6,Points-PointsKO-Adjacents,66
Gymnosporia_dhofarensis,17,0,17,Points-PointsKO-Adjacents,88
Gymnosporia_diversifolia,94,69,25,Alphahull-PointsKO-Adjacents,283
Gymnosporia_drummondii,4,4,0,Points-PointsKO-Adjacents,36
Gymnosporia_falconeri,0,0,0,NA,0
Gymnosporia_glaucophylla,57,27,30,Alphahull-PointsKO-Adjacents,701
Gymnosporia_gracilis,61,43,18,Alphahull-PointsKO-Adjacents,508
Gymnosporia_grandifolia,29,15,14,Points-PointsKO-Adjacents,258
Gymnosporia_gurueensis,2,2,0,Points-PointsKO-Adjacents,18
Gymnosporia_harenensis,NA,NA,NA,NA,NA
Gymnosporia_harveyana,120,80,40,Alphahull-PointsKO-Adjacents,1492
Gymnosporia_hemipterocarpa,6,4,2,Points-PointsKO-Adjacents,54
Gymnosporia_heterophylla,109,76,33,Alphahull-PointsKO-Adjacents,4877
Gymnosporia_heyneana,0,0,0,NA,0
Gymnosporia_keniensis,4,4,0,Points-PointsKO-Adjacents,34
Gymnosporia_linearis,47,23,24,Alphahull-PointsKO-Adjacents,931
Gymnosporia_maranguensis,57,37,20,Alphahull-PointsKO-Adjacents,2590
Gymnosporia_marcanii,1,1,0,Points-PointsKO-Adjacents,9
Gymnosporia_masindei,9,3,6,Points-PointsKO-Adjacents,63
Gymnosporia_matoboensis,0,0,0,NA,0
Gymnosporia_mekongensis,5,5,0,Points-PointsKO-Adjacents,25
Gymnosporia_montana,0,0,0,NA,0
Gymnosporia_mossambicensis,71,36,35,Alphahull-PointsKO-Adjacents,1051
Gymnosporia_nemorosa,85,57,28,Alphahull-PointsKO-Adjacents,1645
Gymnosporia_nguruensis,3,3,0,Points-PointsKO-Adjacents,15
Gymnosporia_nitida,0,0,0,NA,0
Gymnosporia_obscura,15,4,11,Points-PointsKO-Adjacents,131
Gymnosporia_polyacanthus,58,37,21,Alphahull-PointsKO-Adjacents,649
Gymnosporia_pubescens,7,1,6,Points-PointsKO-Adjacents,62
Gymnosporia_putterlickioides,15,5,10,Points-PointsKO-Adjacents,123
Gymnosporia_pyria,9,0,9,Points-PointsKO-Adjacents,74
Gymnosporia_richardsiae,1,1,0,Points-PointsKO-Adjacents,9
Gymnosporia_rubra,31,14,17,Points-PointsKO-Adjacents,263
Gymnosporia_rufa,1,1,0,Points-PointsKO-Adjacents,9
Gymnosporia_schliebenii,10,6,4,Points-PointsKO-Adjacents,51
Gymnosporia_senegalensis,865,696,169,Alphahull-PointsKO-Adjacents,52683
Gymnosporia_serrata,19,10,9,Points-PointsKO-Adjacents,130
Gymnosporia_stylosa,1,1,0,Points-PointsKO-Adjacents,9
Gymnosporia_thompsonii,3,2,1,Points-PointsKO-Adjacents,11
Gymnosporia_variabilis,10,3,7,Points-PointsKO-Adjacents,90
Gymnostemon_zaizou,14,10,4,Points-PointsKO-Adjacents,94
Gymnostoma_australianum,30,0,30,Points-PointsKO-Adjacents,44
Gymnostoma_chamaecyparis,19,8,11,Points-PointsKO-Adjacents,93
Gymnostoma_deplancheanum,28,18,10,Points-PointsKO-Adjacents,71
Gymnostoma_glaucescens,6,0,6,Points-PointsKO-Adjacents,46
Gymnostoma_intermedium,8,4,4,Points-PointsKO-Adjacents,39
Gymnostoma_leucodon,5,5,0,Points-PointsKO-Adjacents,14
Gymnostoma_nobile,5,5,0,Points-PointsKO-Adjacents,45
Gymnostoma_nodiflorum,7,3,4,Points-PointsKO-Adjacents,53
Gymnostoma_papuanum,128,96,32,Alphahull-PointsKO-Adjacents,2719
Gymnostoma_poissonianum,24,17,7,Points-PointsKO-Adjacents,78
Gymnostoma_rumphianum,9,2,7,Points-PointsKO-Adjacents,60
Gymnostoma_sumatranum,24,3,21,Points-PointsKO-Adjacents,157
Gymnostoma_vitiense,1,1,0,Points-PointsKO-Adjacents,9
Gynocardia_odorata,0,0,0,NA,0
Gynochthodes_decipiens,21,10,11,Points-PointsKO-Adjacents,80
Gynochthodes_trimera,4,4,0,Points-PointsKO-Adjacents,29
Gynotroches_axillaris,71,18,53,Points-PointsKO-Adjacents,550
Gynoxys_acostae,47,39,8,Alphahull-PointsKO-Adjacents,127
Gynoxys_asterotricha,32,15,17,Points-PointsKO-Adjacents,176
Gynoxys_azuayensis,5,5,0,Points-PointsKO-Adjacents,45
Gynoxys_baccharoides,12,6,6,Points-PointsKO-Adjacents,77
Gynoxys_callacallana,1,1,0,Points-PointsKO-Adjacents,9
Gynoxys_calyculisolvens,19,7,12,Points-PointsKO-Adjacents,152
Gynoxys_capituliparva,9,3,6,Points-PointsKO-Adjacents,66
Gynoxys_chagalensis,4,4,0,Points-PointsKO-Adjacents,36
Gynoxys_chimborazensis,2,2,0,Points-PointsKO-Adjacents,16
Gynoxys_cochabambensis,8,4,4,Points-PointsKO-Adjacents,70
Gynoxys_colanensis,4,4,0,Points-PointsKO-Adjacents,36
Gynoxys_columbiana,1,1,0,Points-PointsKO-Adjacents,9
Gynoxys_compressissima,15,12,3,Points-PointsKO-Adjacents,39
Gynoxys_congestiflora,9,2,7,Points-PointsKO-Adjacents,75
Gynoxys_cruzensis,5,5,0,Points-PointsKO-Adjacents,45
Gynoxys_cuicochensis,34,23,11,Alphahull-PointsKO-Adjacents,179
Gynoxys_cutervensis,1,1,0,Points-PointsKO-Adjacents,9
Gynoxys_cuzcoensis,8,0,8,Points-PointsKO-Adjacents,72
Gynoxys_dielsiana,8,2,6,Points-PointsKO-Adjacents,68
Gynoxys_florulenta,5,5,0,Points-PointsKO-Adjacents,39
Gynoxys_hallii,99,86,13,Alphahull-PointsKO-Adjacents,431
Gynoxys_hirsuta,26,21,5,Alphahull-PointsKO-Adjacents,139
Gynoxys_hirsutissima,4,4,0,Points-PointsKO-Adjacents,36
Gynoxys_infralanata,1,1,0,Points-PointsKO-Adjacents,9
Gynoxys_jelskii,2,2,0,Points-PointsKO-Adjacents,18
Gynoxys_laurata,6,0,6,Points-PointsKO-Adjacents,36
Gynoxys_laurifolia,8,5,3,Points-PointsKO-Adjacents,54
Gynoxys_lehmannii,14,5,9,Points-PointsKO-Adjacents,99
Gynoxys_malcabalensis,2,2,0,Points-PointsKO-Adjacents,18
Gynoxys_marcapatana,7,1,6,Points-PointsKO-Adjacents,54
Gynoxys_parvifolia,19,13,6,Points-PointsKO-Adjacents,129
Gynoxys_perbracteosa,7,2,5,Points-PointsKO-Adjacents,60
Gynoxys_pillahuatensis,2,2,0,Points-PointsKO-Adjacents,18
Gynoxys_poggeana,6,1,5,Points-PointsKO-Adjacents,50
Gynoxys_psilophylla,28,18,10,Points-PointsKO-Adjacents,170
Gynoxys_pulchella,8,1,7,Points-PointsKO-Adjacents,66
Gynoxys_rimbachii,8,0,8,Points-PointsKO-Adjacents,66
Gynoxys_sancti-antonii,28,15,13,Points-PointsKO-Adjacents,178
Gynoxys_sorataensis,1,1,0,Points-PointsKO-Adjacents,9
Gynoxys_stuebelii,9,3,6,Points-PointsKO-Adjacents,69
Gynoxys_tablaensis,2,2,0,Points-PointsKO-Adjacents,18
Gynoxys_tetroici,0,0,0,NA,0
Gynoxys_tolimensis,43,32,11,Alphahull-PointsKO-Adjacents,882
Gynoxys_tomentosissima,4,4,0,Points-PointsKO-Adjacents,24
Gynoxys_trianae,32,19,13,Points-PointsKO-Adjacents,186
Gynoxys_vacana,1,1,0,Points-PointsKO-Adjacents,9
Gynoxys_visoensis,5,5,0,Points-PointsKO-Adjacents,36
Gyranthera_caribensis,15,7,8,Points-PointsKO-Adjacents,101
Gyranthera_darienensis,6,2,4,Points-PointsKO-Adjacents,37
Gyrinops_caudata,2,2,0,Points-PointsKO-Adjacents,18
Gyrinops_decipiens,3,3,0,Points-PointsKO-Adjacents,27
Gyrinops_ledermannii,13,8,5,Points-PointsKO-Adjacents,74
Gyrinops_podocarpa,8,5,3,Points-PointsKO-Adjacents,36
Gyrinops_versteegii,1,1,0,Points-PointsKO-Adjacents,9
Gyrinops_vidalii,2,2,0,Points-PointsKO-Adjacents,18
Gyrinops_walla,7,0,7,Points-PointsKO-Adjacents,61
Gyrocarpus_americanus,1228,0,1228,Points-PointsKO-Adjacents,5035
Gyrocarpus_angustifolius,9,0,9,Points-PointsKO-Adjacents,60
Gyrocarpus_hababensis,9,1,8,Points-PointsKO-Adjacents,73
Gyrocarpus_jatrophifolius,201,154,47,Alphahull-PointsKO-Adjacents,5360
Gyrocarpus_mocinoi,37,21,16,Alphahull-PointsKO-Adjacents,328
Gyrostemon_ramulosus,621,562,59,Alphahull-PointsKO-Adjacents,24862
Gyrostipula_comorensis,3,3,0,Points-PointsKO-Adjacents,19
Gyrostipula_foveolata,26,11,15,Points-PointsKO-Adjacents,169
Gyrostipula_obtusa,1,1,0,Points-PointsKO-Adjacents,9
Gyrotaenia_crassifolia,2,2,0,Points-PointsKO-Adjacents,13
Gyrotaenia_microcarpa,1,1,0,Points-PointsKO-Adjacents,9
Gyrotaenia_myriocarpa,21,8,13,Points-PointsKO-Adjacents,121
Gyrotaenia_spicata,2,2,0,Points-PointsKO-Adjacents,17
Gyrotaenia_trujilloana,1,1,0,Points-PointsKO-Adjacents,9
Haematodendron_glabrum,22,12,10,Points-PointsKO-Adjacents,117
Haematostaphis_barteri,140,117,23,Alphahull-PointsKO-Adjacents,660
Haematostemon_coriaceus,2,2,0,Points-PointsKO-Adjacents,18
Haematoxylum_brasiletto,654,545,109,Alphahull-PointsKO-Adjacents,11341
Haematoxylum_campechianum,570,508,62,Alphahull-PointsKO-Adjacents,3247
Haenianthus_incrassatus,2,1,1,Points-PointsKO-Adjacents,14
Haenianthus_salicifolius,47,30,17,Alphahull-PointsKO-Adjacents,234
Haenianthus_variifolius,4,4,0,Points-PointsKO-Adjacents,27
Hakea_suaveolens,79,41,38,Alphahull-PointsKO-Adjacents,356
Hakea_multilineata,250,230,20,Alphahull-PointsKO-Adjacents,2489
Hakea_salicifolia,24,7,17,Points-PointsKO-Adjacents,163
Hakea_sulcata,187,147,40,Alphahull-PointsKO-Adjacents,1787
Hakea_sericea,2175,1807,368,Alphahull-PointsKO-Adjacents,4493
Hakea_kippistiana,59,38,21,Alphahull-PointsKO-Adjacents,1484
Haldina_cordifolia,20,0,20,Points-PointsKO-Adjacents,180
Halesia_carolina,418,345,73,Alphahull-PointsKO-Adjacents,7969
Halesia_diptera,270,215,55,Alphahull-PointsKO-Adjacents,4831
Halesia_macgregorii,15,9,6,Points-PointsKO-Adjacents,135
Halesia_tetraptera,617,564,53,Alphahull-PointsKO-Adjacents,4124
Halfordia_kendack,494,0,494,Points-PointsKO-Adjacents,1227
Halleria_ligustrifolia,75,54,21,Alphahull-PointsKO-Adjacents,872
Halleria_lucida,297,199,98,Alphahull-PointsKO-Adjacents,6473
Halocarpus_biformis,1628,1577,51,Alphahull-PointsKO-Adjacents,3047
Halocarpus_kirkii,104,72,32,Alphahull-PointsKO-Adjacents,455
Haloragis_racemosa,54,36,18,Alphahull-PointsKO-Adjacents,162
Halostachys_belangeriana,3,3,0,Points-PointsKO-Adjacents,27
Haloxylon_ammodendron,11,1,10,Points-PointsKO-Adjacents,99
Haloxylon_persicum,1,1,0,Points-PointsKO-Adjacents,6
Hamamelis_mollis,14,1,13,Points-PointsKO-Adjacents,116
Hamamelis_vernalis,159,110,49,Alphahull-PointsKO-Adjacents,1939
Hamamelis_virginiana,3060,2488,572,Alphahull-PointsKO-Adjacents,39542
Hamelia_axillaris,715,577,138,Alphahull-PointsKO-Adjacents,20436
Hamelia_barbata,21,8,13,Points-PointsKO-Adjacents,152
Hamelia_calycosa,173,126,47,Alphahull-PointsKO-Adjacents,2315
Hamelia_cuprea,1,1,0,Points-PointsKO-Adjacents,9
Hamelia_longipes,133,106,27,Alphahull-PointsKO-Adjacents,1602
Hamelia_macrantha,190,151,39,Alphahull-PointsKO-Adjacents,2468
Hamelia_magnifolia,116,97,19,Alphahull-PointsKO-Adjacents,588
Hamelia_papillosa,2,2,0,Points-PointsKO-Adjacents,18
Hamelia_patens,4341,3772,569,Alphahull-PointsKO-Adjacents,97129
Hamelia_rostrata,205,156,49,Alphahull-PointsKO-Adjacents,3515
Hamelia_rovirosae,175,146,29,Alphahull-PointsKO-Adjacents,2044
Hamelia_sanguinea,24,16,8,Points-PointsKO-Adjacents,118
Hamelia_ventricosa,4,4,0,Points-PointsKO-Adjacents,36
Hamelia_xerocarpa,112,82,30,Alphahull-PointsKO-Adjacents,1430
Hamelia_xorullensis,95,73,22,Alphahull-PointsKO-Adjacents,1293
Hamilcoa_zenkeri,21,16,5,Points-PointsKO-Adjacents,78
Hampea_albipetala,27,17,10,Points-PointsKO-Adjacents,124
Hampea_appendiculata,254,223,31,Alphahull-PointsKO-Adjacents,967
Hampea_breedlovei,9,4,5,Points-PointsKO-Adjacents,39
Hampea_dukei,1,1,0,Points-PointsKO-Adjacents,8
Hampea_integerrima,148,0,148,Points-PointsKO-Adjacents,380
Hampea_longipes,59,43,16,Alphahull-PointsKO-Adjacents,454
Hampea_micrantha,28,23,5,Alphahull-PointsKO-Adjacents,35
Hampea_montebellensis,31,23,8,Alphahull-PointsKO-Adjacents,51
Hampea_platanifolia,53,34,19,Alphahull-PointsKO-Adjacents,251
Hampea_punctulata,41,26,15,Alphahull-PointsKO-Adjacents,796
Hampea_reynae,5,5,0,Points-PointsKO-Adjacents,30
Hampea_sphaerocarpa,8,1,7,Points-PointsKO-Adjacents,56
Hampea_stipitata,202,179,23,Alphahull-PointsKO-Adjacents,2611
Hampea_thespesioides,23,17,6,Points-PointsKO-Adjacents,138
Hampea_tomentosa,37,17,20,Points-PointsKO-Adjacents,232
Hampea_trilobata,635,602,33,Alphahull-PointsKO-Adjacents,2696
Hancea_acuminata,77,50,27,Alphahull-PointsKO-Adjacents,486
Hancea_capuronii,79,52,27,Alphahull-PointsKO-Adjacents,825
Hancea_cordatifolia,1,1,0,Points-PointsKO-Adjacents,8
Hancea_eucausta,15,6,9,Points-PointsKO-Adjacents,108
Hancea_grandistipularis,3,3,0,Points-PointsKO-Adjacents,27
Hancea_griffithiana,47,23,24,Alphahull-PointsKO-Adjacents,1495
Hancea_hirsuta,2,2,0,Points-PointsKO-Adjacents,16
Hancea_hookeriana,20,7,13,Points-PointsKO-Adjacents,171
Hancea_integrifolia,0,0,0,NA,0
Hancea_kingii,11,5,6,Points-PointsKO-Adjacents,88
Hancea_longistyla,2,2,0,Points-PointsKO-Adjacents,17
Hancea_papuana,2,2,0,Points-PointsKO-Adjacents,11
Hancea_penangensis,143,80,63,Alphahull-PointsKO-Adjacents,7229
Hancea_spinulosa,65,40,25,Alphahull-PointsKO-Adjacents,700
Hancea_stipularis,11,1,10,Points-PointsKO-Adjacents,90
Hancea_subpeltata,38,9,29,Points-PointsKO-Adjacents,273
Hancea_wenzeliana,0,0,0,NA,0
Hancornia_speciosa,1188,1050,138,Alphahull-PointsKO-Adjacents,48464
Handeliodendron_bodinieri,5,5,0,Points-PointsKO-Adjacents,45
Handroanthus_albus,348,1,347,Points-PointsKO-Adjacents,2376
Handroanthus_arianeae,22,9,13,Points-PointsKO-Adjacents,152
Handroanthus_barbatus,282,227,55,Alphahull-PointsKO-Adjacents,14392
Handroanthus_billbergii,139,104,35,Alphahull-PointsKO-Adjacents,3889
Handroanthus_botelhensis,5,5,0,Points-PointsKO-Adjacents,39
Handroanthus_bureavii,78,54,24,Alphahull-PointsKO-Adjacents,3188
Handroanthus_capitatus,193,114,79,Alphahull-PointsKO-Adjacents,21744
Handroanthus_catarinensis,31,24,7,Alphahull-PointsKO-Adjacents,153
Handroanthus_chrysanthus,888,713,175,Alphahull-PointsKO-Adjacents,35958
Handroanthus_chrysotrichus,564,461,103,Alphahull-PointsKO-Adjacents,20480
Handroanthus_coralibe,15,9,6,Points-PointsKO-Adjacents,96
Handroanthus_cristatus,7,2,5,Points-PointsKO-Adjacents,49
Handroanthus_guayacan,238,175,63,Alphahull-PointsKO-Adjacents,7107
Handroanthus_heptaphyllus,644,545,99,Alphahull-PointsKO-Adjacents,29945
Handroanthus_impetiginosus,1704,1455,249,Alphahull-PointsKO-Adjacents,62691
Handroanthus_incanus,107,59,48,Alphahull-PointsKO-Adjacents,4829
Handroanthus_lapacho,36,21,15,Alphahull-PointsKO-Adjacents,212
Handroanthus_obscurus,80,0,80,Points-PointsKO-Adjacents,650
Handroanthus_ochraceus,1665,1458,207,Alphahull-PointsKO-Adjacents,76867
Handroanthus_pedicellatus,52,35,17,Alphahull-PointsKO-Adjacents,1864
Handroanthus_pulcherrimus,133,93,40,Alphahull-PointsKO-Adjacents,4921
Handroanthus_riodocensis,28,13,15,Points-PointsKO-Adjacents,203
Handroanthus_selachidentatus,120,89,31,Alphahull-PointsKO-Adjacents,4110
Handroanthus_serratifolius,1656,1495,161,Alphahull-PointsKO-Adjacents,128445
Handroanthus_spongiosus,218,192,26,Alphahull-PointsKO-Adjacents,6140
Handroanthus_subtilis,29,18,11,Points-PointsKO-Adjacents,202
Handroanthus_uleanus,45,23,22,Alphahull-PointsKO-Adjacents,1540
Handroanthus_umbellatus,312,237,75,Alphahull-PointsKO-Adjacents,12520
Handroanthus_vellosoi,176,137,39,Alphahull-PointsKO-Adjacents,5024
Haploclathra_cordata,9,8,1,Points-PointsKO-Adjacents,54
Haploclathra_grandiflora,7,0,7,Points-PointsKO-Adjacents,60
Haploclathra_leiantha,43,0,43,Points-PointsKO-Adjacents,333
Haploclathra_paniculata,69,36,33,Alphahull-PointsKO-Adjacents,1520
Haplocoelopsis_africana,26,11,15,Points-PointsKO-Adjacents,180
Haplocoelum_acuminatum,11,2,9,Points-PointsKO-Adjacents,91
Haplocoelum_foliolosum,80,0,80,Points-PointsKO-Adjacents,539
Haplocoelum_gallaense,34,15,19,Points-PointsKO-Adjacents,229
Haplocoelum_intermedium,13,3,10,Points-PointsKO-Adjacents,99
Haplolobus_floribundus,74,35,39,Alphahull-PointsKO-Adjacents,691
Haplorhus_peruviana,10,1,9,Points-PointsKO-Adjacents,90
Haplormosia_monophylla,32,14,18,Points-PointsKO-Adjacents,198
Haplospondias_haplophylla,1,1,0,Points-PointsKO-Adjacents,9
Haptanthus_hazlettii,1,1,0,Points-PointsKO-Adjacents,9
Hardwickia_binata,6,1,5,Points-PointsKO-Adjacents,54
Harleyodendron_unifoliolatum,32,24,8,Alphahull-PointsKO-Adjacents,74
Harmsiopanax_aculeatus,0,0,0,NA,0
Harmsiopanax_harmsii,31,22,9,Alphahull-PointsKO-Adjacents,430
Harmsiopanax_ingens,74,53,21,Alphahull-PointsKO-Adjacents,502
Harpalyce_acunae,NA,NA,NA,NA,NA
Harpalyce_angustiflora,1,1,0,Points-PointsKO-Adjacents,9
Harpalyce_arborescens,136,113,23,Alphahull-PointsKO-Adjacents,1172
Harpalyce_baracoensis,NA,NA,NA,NA,NA
Harpalyce_borhidii,NA,NA,NA,NA,NA
Harpalyce_cubensis,5,4,1,Points-PointsKO-Adjacents,36
Harpalyce_ekmanii,1,1,0,Points-PointsKO-Adjacents,9
Harpalyce_flexuosa,NA,NA,NA,NA,NA
Harpalyce_foliosa,NA,NA,NA,NA,NA
Harpalyce_macrocarpa,2,2,0,Points-PointsKO-Adjacents,18
Harpalyce_maisiana,1,1,0,Points-PointsKO-Adjacents,9
Harpalyce_mexicana,7,3,4,Points-PointsKO-Adjacents,55
Harpalyce_moana,NA,NA,NA,NA,NA
Harpalyce_nipensis,0,0,0,NA,0
Harpalyce_rupicola,17,9,8,Points-PointsKO-Adjacents,120
Harpalyce_sousai,16,11,5,Points-PointsKO-Adjacents,97
Harpalyce_toaensis,NA,NA,NA,NA,NA
Harpalyce_villosa,2,2,0,Points-PointsKO-Adjacents,9
Harpephyllum_caffrum,54,30,24,Alphahull-PointsKO-Adjacents,2085
Harpullia_arborea,140,53,87,Alphahull-PointsKO-Adjacents,1389
Harpullia_cupanioides,71,12,59,Points-PointsKO-Adjacents,483
Harpullia_pendula,351,296,55,Alphahull-PointsKO-Adjacents,1853
Harpullia_ramiflora,174,123,51,Alphahull-PointsKO-Adjacents,3456
Harrisia_divaricata,6,2,4,Points-PointsKO-Adjacents,36
Harrisia_gracilis,3,3,0,Points-PointsKO-Adjacents,23
Harrisia_tetracantha,12,10,2,Points-PointsKO-Adjacents,80
Harrisonia_abyssinica,247,171,76,Alphahull-PointsKO-Adjacents,6880
Harrisonia_perforata,38,13,25,Points-PointsKO-Adjacents,297
Hartleya_inopinata,4,4,0,Points-PointsKO-Adjacents,27
Harungana_madagascariensis,605,454,151,Alphahull-PointsKO-Adjacents,36753
Harungana_montana,11,0,11,Points-PointsKO-Adjacents,83
Hasseltia_allenii,33,31,2,Alphahull-PointsKO-Adjacents,244
Hasseltia_floribunda,1341,1228,113,Alphahull-PointsKO-Adjacents,52736
Hasseltia_guatemalensis,108,0,108,Points-PointsKO-Adjacents,447
Hasseltia_lateriflora,7,0,7,Points-PointsKO-Adjacents,57
Hasseltiopsis_dioica,66,37,29,Alphahull-PointsKO-Adjacents,316
Hauya_elegans,356,305,51,Alphahull-PointsKO-Adjacents,3235
Havardia_albicans,358,311,47,Alphahull-PointsKO-Adjacents,2092
Havardia_campylacantha,109,78,31,Alphahull-PointsKO-Adjacents,349
Havardia_mexicana,91,0,91,Points-PointsKO-Adjacents,387
Havardia_pallens,398,345,53,Alphahull-PointsKO-Adjacents,6929
Havardia_sonorae,57,37,20,Alphahull-PointsKO-Adjacents,466
Havetiopsis_glauca,9,4,5,Points-PointsKO-Adjacents,66
Havetiopsis_hippocrateoides,13,1,12,Points-PointsKO-Adjacents,105
Hawkesiophyton_klugii,0,0,0,NA,0
Haydenoxylon_gentryi,64,44,20,Alphahull-PointsKO-Adjacents,1550
Haydenoxylon_haberianum,28,11,17,Points-PointsKO-Adjacents,84
Haydenoxylon_urbanianum,190,160,30,Alphahull-PointsKO-Adjacents,4923
Hazomalania_voyronii,27,15,12,Points-PointsKO-Adjacents,148
Veronica_barkeri,12,5,7,Points-PointsKO-Adjacents,66
Hebeclinium_costaricense,16,9,7,Points-PointsKO-Adjacents,97
Hebepetalum_humiriifolia,141,63,78,Alphahull-PointsKO-Adjacents,10115
Hebepetalum_neblinae,15,8,7,Points-PointsKO-Adjacents,121
Hebepetalum_roraimense,34,13,21,Points-PointsKO-Adjacents,264
Ardisia_excelsa,0,0,0,NA,0
Hebestigma_cubense,14,7,7,Points-PointsKO-Adjacents,77
Hecatostemon_completus,125,91,34,Alphahull-PointsKO-Adjacents,5419
Heckeldora_staudtii,155,0,155,Points-PointsKO-Adjacents,655
Heckeldora_zenkeri,44,35,9,Alphahull-PointsKO-Adjacents,1444
Hedstromia_latifolia,0,0,0,NA,0
Hedycarya_arborea,6531,6427,104,Alphahull-PointsKO-Adjacents,3312
Hedycarya_dorstenioides,30,0,30,Points-PointsKO-Adjacents,144
Hedyosmum_angustifolium,160,107,53,Alphahull-PointsKO-Adjacents,1659
Hedyosmum_anisodorum,83,57,26,Alphahull-PointsKO-Adjacents,413
Hedyosmum_arborescens,50,21,29,Alphahull-PointsKO-Adjacents,227
Hedyosmum_bonplandianum,468,424,44,Alphahull-PointsKO-Adjacents,3657
Hedyosmum_brasiliense,738,664,74,Alphahull-PointsKO-Adjacents,26083
Hedyosmum_brenesii,95,73,22,Alphahull-PointsKO-Adjacents,960
Hedyosmum_burgerianum,6,2,4,Points-PointsKO-Adjacents,34
Hedyosmum_colombianum,75,63,12,Alphahull-PointsKO-Adjacents,1753
Hedyosmum_correanum,15,8,7,Points-PointsKO-Adjacents,48
Hedyosmum_costaricense,126,111,15,Alphahull-PointsKO-Adjacents,317
Hedyosmum_crenatum,148,124,24,Alphahull-PointsKO-Adjacents,2395
Hedyosmum_cuatrecazanum,248,194,54,Alphahull-PointsKO-Adjacents,4127
Hedyosmum_cumbalense,193,157,36,Alphahull-PointsKO-Adjacents,1653
Hedyosmum_dombeyanum,76,53,23,Alphahull-PointsKO-Adjacents,611
Hedyosmum_gentryi,39,15,24,Points-PointsKO-Adjacents,257
Hedyosmum_goudotianum,439,388,51,Alphahull-PointsKO-Adjacents,4651
Hedyosmum_intermedium,15,7,8,Points-PointsKO-Adjacents,103
Hedyosmum_lechleri,59,38,21,Alphahull-PointsKO-Adjacents,328
Hedyosmum_luteynii,89,69,20,Alphahull-PointsKO-Adjacents,1136
Hedyosmum_maximum,10,4,6,Points-PointsKO-Adjacents,73
Hedyosmum_mexicanum,410,370,40,Alphahull-PointsKO-Adjacents,5012
Hedyosmum_narinoense,9,6,3,Points-PointsKO-Adjacents,48
Hedyosmum_neblinae,8,0,8,Points-PointsKO-Adjacents,23
Hedyosmum_nutans,29,18,11,Points-PointsKO-Adjacents,139
Hedyosmum_parvifolium,67,57,10,Alphahull-PointsKO-Adjacents,353
Hedyosmum_peruvianum,19,10,9,Points-PointsKO-Adjacents,143
Hedyosmum_pseudoandromeda,8,4,4,Points-PointsKO-Adjacents,39
Hedyosmum_pungens,6,2,4,Points-PointsKO-Adjacents,42
Hedyosmum_purpurascens,12,6,6,Points-PointsKO-Adjacents,45
Hedyosmum_racemosum,746,655,91,Alphahull-PointsKO-Adjacents,15763
Hedyosmum_scaberrimum,233,199,34,Alphahull-PointsKO-Adjacents,2528
Hedyosmum_scabrum,186,141,45,Alphahull-PointsKO-Adjacents,2454
Hedyosmum_spectabile,33,0,33,Points-PointsKO-Adjacents,215
Hedyosmum_sprucei,158,134,24,Alphahull-PointsKO-Adjacents,2146
Hedyosmum_steinii,8,4,4,Points-PointsKO-Adjacents,68
Hedyosmum_strigosum,52,40,12,Alphahull-PointsKO-Adjacents,508
Hedyosmum_tepuiense,40,23,17,Alphahull-PointsKO-Adjacents,822
Hedyosmum_translucidum,200,161,39,Alphahull-PointsKO-Adjacents,2576
Hedyotis_articularis,0,0,0,NA,0
Hedyotis_cornifolia,3,3,0,Points-PointsKO-Adjacents,10
Hedyotis_dendroides,0,0,0,NA,0
Hedyotis_fruticosa,1,1,0,Points-PointsKO-Adjacents,9
Hedyotis_lessertiana,1,1,0,Points-PointsKO-Adjacents,9
Hedyotis_trimenii,2,2,0,Points-PointsKO-Adjacents,18
Hedysarum_scoparium,2,2,0,Points-PointsKO-Adjacents,18
Hedyscepe_canterburyana,10,5,5,Points-PointsKO-Adjacents,5
Heeria_argentea,45,34,11,Alphahull-PointsKO-Adjacents,371
Heinsenia_diervilleoides,95,52,43,Alphahull-PointsKO-Adjacents,8131
Heinsia_bussei,7,6,1,Points-PointsKO-Adjacents,17
Heinsia_crinita,491,373,118,Alphahull-PointsKO-Adjacents,18874
Heinsia_myrmoecia,19,11,8,Points-PointsKO-Adjacents,95
Heinsia_zanzibarica,44,30,14,Alphahull-PointsKO-Adjacents,174
Heisteria_acuminata,1429,1308,121,Alphahull-PointsKO-Adjacents,63042
Heisteria_amazonica,5,5,0,Points-PointsKO-Adjacents,36
Heisteria_amphoricarpa,9,0,9,Points-PointsKO-Adjacents,59
Heisteria_asplundii,25,14,11,Points-PointsKO-Adjacents,169
Heisteria_barbata,155,84,71,Alphahull-PointsKO-Adjacents,10788
Heisteria_blanchetiana,64,49,15,Alphahull-PointsKO-Adjacents,994
Heisteria_cauliflora,139,111,28,Alphahull-PointsKO-Adjacents,3629
Heisteria_citrifolia,98,62,36,Alphahull-PointsKO-Adjacents,4880
Heisteria_coccinea,18,6,12,Points-PointsKO-Adjacents,104
Heisteria_concinna,175,137,38,Alphahull-PointsKO-Adjacents,2513
Heisteria_cyathiformis,5,5,0,Points-PointsKO-Adjacents,39
Heisteria_densifrons,232,158,74,Alphahull-PointsKO-Adjacents,21854
Heisteria_duckei,85,53,32,Alphahull-PointsKO-Adjacents,8846
Heisteria_huberiana,6,0,6,Points-PointsKO-Adjacents,39
Heisteria_insculpta,33,14,19,Points-PointsKO-Adjacents,238
Heisteria_latifolia,98,65,33,Alphahull-PointsKO-Adjacents,1454
Heisteria_laxiflora,104,67,37,Alphahull-PointsKO-Adjacents,5795
Heisteria_macrophylla,123,97,26,Alphahull-PointsKO-Adjacents,946
Heisteria_maguirei,27,10,17,Points-PointsKO-Adjacents,222
Heisteria_maytenoides,7,1,6,Points-PointsKO-Adjacents,53
Heisteria_media,57,40,17,Alphahull-PointsKO-Adjacents,619
Heisteria_ovata,686,586,100,Alphahull-PointsKO-Adjacents,66221
Heisteria_pacifica,40,31,9,Alphahull-PointsKO-Adjacents,310
Heisteria_parvifolia,440,378,62,Alphahull-PointsKO-Adjacents,11645
Heisteria_pentandra,16,4,12,Points-PointsKO-Adjacents,132
Heisteria_perianthomega,243,172,71,Alphahull-PointsKO-Adjacents,7186
Heisteria_povedae,165,131,34,Alphahull-PointsKO-Adjacents,898
Heisteria_salicifolia,1,1,0,Points-PointsKO-Adjacents,9
Heisteria_scandens,231,134,97,Alphahull-PointsKO-Adjacents,3661
Heisteria_silvianii,519,447,72,Alphahull-PointsKO-Adjacents,7269
Heisteria_skutchii,5,5,0,Points-PointsKO-Adjacents,45
Heisteria_spruceana,286,225,61,Alphahull-PointsKO-Adjacents,25601
Heisteria_trillesiana,36,0,36,Points-PointsKO-Adjacents,227
Heisteria_zimmereri,64,0,64,Points-PointsKO-Adjacents,426
Helianthostylis_sprucei,280,226,54,Alphahull-PointsKO-Adjacents,24576
Helianthostylis_steyermarkii,20,12,8,Points-PointsKO-Adjacents,112
Helicia_attenuata,12,1,11,Points-PointsKO-Adjacents,89
Helicia_clivicola,5,2,3,Points-PointsKO-Adjacents,45
Helicia_cochinchinensis,134,0,134,Points-PointsKO-Adjacents,1103
Helicia_dongxingensis,2,2,0,Points-PointsKO-Adjacents,18
Helicia_excelsa,11,0,11,Points-PointsKO-Adjacents,88
Helicia_formosana,255,216,39,Alphahull-PointsKO-Adjacents,411
Helicia_fuscotomentosa,7,0,7,Points-PointsKO-Adjacents,45
Helicia_lauterbachiana,2,2,0,Points-PointsKO-Adjacents,18
Helicia_grandis,5,1,4,Points-PointsKO-Adjacents,45
Helicia_hainanensis,22,10,12,Points-PointsKO-Adjacents,191
Helicia_kwangtungensis,24,0,24,Points-PointsKO-Adjacents,216
Hollandaea_lamingtoniana,34,26,8,Alphahull-PointsKO-Adjacents,73
Helicia_longipetiolata,8,2,6,Points-PointsKO-Adjacents,72
Helicia_maxwelliana,2,2,0,Points-PointsKO-Adjacents,18
Helicia_nilagirica,52,22,30,Alphahull-PointsKO-Adjacents,1202
Helicia_obovatifolia,13,2,11,Points-PointsKO-Adjacents,116
Helicia_petiolaris,12,5,7,Points-PointsKO-Adjacents,90
Helicia_pterygota,6,1,5,Points-PointsKO-Adjacents,30
Helicia_pyrrhobotrya,5,0,5,Points-PointsKO-Adjacents,45
Helicia_rengetiensis,61,46,15,Alphahull-PointsKO-Adjacents,117
Helicia_reticulata,63,45,18,Alphahull-PointsKO-Adjacents,3388
Helicia_robusta,23,0,23,Points-PointsKO-Adjacents,180
Helicia_shweliensis,7,4,3,Points-PointsKO-Adjacents,45
Helicia_silvicola,10,3,7,Points-PointsKO-Adjacents,90
Helicia_tibetensis,NA,NA,NA,NA,NA
Helicia_tsaii,4,4,0,Points-PointsKO-Adjacents,36
Helicia_vestita,5,0,5,Points-PointsKO-Adjacents,34
Helicia_yangchunensis,1,1,0,Points-PointsKO-Adjacents,9
Helicia_artocarpoides,17,6,11,Points-PointsKO-Adjacents,146
Heliciopsis_henryi,7,1,6,Points-PointsKO-Adjacents,63
Helicia_incisa,0,0,0,NA,0
Helicia_lanceolata,0,0,0,NA,0
Heliciopsis_lobata,7,1,6,Points-PointsKO-Adjacents,63
Heliciopsis_terminalis,19,4,15,Points-PointsKO-Adjacents,156
Heliciopsis_velutina,0,0,0,NA,0
Helicostylis_elegans,126,70,56,Alphahull-PointsKO-Adjacents,14370
Helicostylis_heterotricha,2,2,0,Points-PointsKO-Adjacents,18
Helicostylis_pedunculata,113,62,51,Alphahull-PointsKO-Adjacents,5990
Helicostylis_scabra,272,214,58,Alphahull-PointsKO-Adjacents,28836
Helicostylis_tomentosa,1119,993,126,Alphahull-PointsKO-Adjacents,75279
Helicostylis_tovarensis,345,278,67,Alphahull-PointsKO-Adjacents,5384
Helicostylis_turbinata,46,19,27,Points-PointsKO-Adjacents,357
Helicteres_baruensis,1001,855,146,Alphahull-PointsKO-Adjacents,16263
Helicteres_brevispira,540,465,75,Alphahull-PointsKO-Adjacents,39111
Helicteres_carthagenensis,9,2,7,Points-PointsKO-Adjacents,47
Helicteres_gardneriana,57,29,28,Alphahull-PointsKO-Adjacents,1405
Helicteres_isora,179,101,78,Alphahull-PointsKO-Adjacents,1762
Helicteres_jamaicensis,48,27,21,Alphahull-PointsKO-Adjacents,313
Helicteres_macropetala,84,40,44,Alphahull-PointsKO-Adjacents,2648
Helicteres_pentandra,188,106,82,Alphahull-PointsKO-Adjacents,16003
Helicteres_semitriloba,21,9,12,Points-PointsKO-Adjacents,148
Helicteres_vuarame,40,1,39,Points-PointsKO-Adjacents,306
Helietta_apiculata,636,597,39,Alphahull-PointsKO-Adjacents,10726
Helietta_glaziovii,36,19,17,Points-PointsKO-Adjacents,213
Helietta_lottiae,13,0,13,Points-PointsKO-Adjacents,24
Helietta_parvifolia,258,238,20,Alphahull-PointsKO-Adjacents,2485
Helietta_plaeana,13,6,7,Points-PointsKO-Adjacents,101
Helietta_puberula,48,0,48,Points-PointsKO-Adjacents,243
Helietta_trifoliata,39,24,15,Alphahull-PointsKO-Adjacents,219
Heliocarpus_americanus,979,813,166,Alphahull-PointsKO-Adjacents,24092
Heliocarpus_appendiculatus,490,449,41,Alphahull-PointsKO-Adjacents,5863
Heliocarpus_donnellsmithii,143,118,25,Alphahull-PointsKO-Adjacents,4473
Heliocarpus_mexicanus,272,214,58,Alphahull-PointsKO-Adjacents,6084
Heliocarpus_occidentalis,154,124,30,Alphahull-PointsKO-Adjacents,2599
Heliocarpus_pallidus,201,168,33,Alphahull-PointsKO-Adjacents,2988
Heliocarpus_palmeri,49,34,15,Alphahull-PointsKO-Adjacents,406
Heliocarpus_popayanensis,308,246,62,Alphahull-PointsKO-Adjacents,13584
Heliocarpus_terebinthinaceus,386,351,35,Alphahull-PointsKO-Adjacents,3862
Heliocarpus_velutinus,27,22,5,Alphahull-PointsKO-Adjacents,393
Heliotropium_rufipilum,291,212,79,Alphahull-PointsKO-Adjacents,3590
Helmiopsiella_ctenostegia,7,1,6,Points-PointsKO-Adjacents,44
Helmiopsiella_leandrii,3,3,0,Points-PointsKO-Adjacents,25
Helmiopsiella_madagascariensis,43,34,9,Alphahull-PointsKO-Adjacents,400
Helmiopsiella_poissonii,3,3,0,Points-PointsKO-Adjacents,11
Helmiopsis_bernieri,11,0,11,Points-PointsKO-Adjacents,33
Helmiopsis_boivinii,24,13,11,Points-PointsKO-Adjacents,141
Helmiopsis_glaberrima,2,2,0,Points-PointsKO-Adjacents,9
Helmiopsis_hily,17,8,9,Points-PointsKO-Adjacents,96
Helmiopsis_linearifolia,11,7,4,Points-PointsKO-Adjacents,63
Helmiopsis_polyandra,5,5,0,Points-PointsKO-Adjacents,25
Helmiopsis_rigida,22,0,22,Points-PointsKO-Adjacents,94
Helmiopsis_sphaerocarpa,7,1,6,Points-PointsKO-Adjacents,41
Helwingia_chinensis,83,59,24,Alphahull-PointsKO-Adjacents,9715
Helwingia_himalaica,129,103,26,Alphahull-PointsKO-Adjacents,9286
Helwingia_japonica,848,0,848,Points-PointsKO-Adjacents,3049
Helwingia_omeiensis,30,8,22,Points-PointsKO-Adjacents,269
Hemandradenia_chevalieri,7,4,3,Points-PointsKO-Adjacents,31
Hemandradenia_mannii,68,40,28,Alphahull-PointsKO-Adjacents,2010
Hemiptelea_davidii,20,3,17,Points-PointsKO-Adjacents,174
Scolopia_trimera,0,0,0,NA,0
Hemithrinax_compacta,3,3,0,Points-PointsKO-Adjacents,22
Hemithrinax_ekmaniana,2,1,1,Points-PointsKO-Adjacents,12
Hemithrinax_rivularis,3,3,0,Points-PointsKO-Adjacents,24
Hennecartia_omphalandra,321,284,37,Alphahull-PointsKO-Adjacents,7101
Henonia_scoparia,8,4,4,Points-PointsKO-Adjacents,62
Henriettea_barkeri,3,3,0,Points-PointsKO-Adjacents,27
Henriettea_boliviensis,5,5,0,Points-PointsKO-Adjacents,45
Henriettea_caudata,109,73,36,Alphahull-PointsKO-Adjacents,5856
Henriettea_ciliata,6,0,6,Points-PointsKO-Adjacents,53
Henriettea_cuabae,2,2,0,Points-PointsKO-Adjacents,18
Henriettea_duckeana,32,6,26,Points-PointsKO-Adjacents,236
Henriettea_ekmanii,5,5,0,Points-PointsKO-Adjacents,23
Henriettea_fissanthera,63,41,22,Alphahull-PointsKO-Adjacents,2330
Henriettea_flavescens,36,24,12,Alphahull-PointsKO-Adjacents,338
Henriettea_gibberosa,3,3,0,Points-PointsKO-Adjacents,22
Henriettea_glabra,84,53,31,Alphahull-PointsKO-Adjacents,604
Henriettea_goudotiana,83,62,21,Alphahull-PointsKO-Adjacents,1750
Henriettea_granularis,2,2,0,Points-PointsKO-Adjacents,18
Henriettea_granulata,198,152,46,Alphahull-PointsKO-Adjacents,14196
Henriettea_horridula,44,0,44,Points-PointsKO-Adjacents,304
Henriettea_hotteana,2,2,0,Points-PointsKO-Adjacents,18
Henriettea_ininiensis,1,1,0,Points-PointsKO-Adjacents,9
Henriettea_lasiostylis,55,37,18,Alphahull-PointsKO-Adjacents,2808
Henriettea_lawrancei,49,32,17,Alphahull-PointsKO-Adjacents,1130
Henriettea_loretensis,37,27,10,Alphahull-PointsKO-Adjacents,1652
Henriettea_macfadyenii,9,6,3,Points-PointsKO-Adjacents,57
Henriettea_maguirei,6,1,5,Points-PointsKO-Adjacents,24
Henriettea_maroniensis,92,66,26,Alphahull-PointsKO-Adjacents,7435
Henriettea_martiusii,118,91,27,Alphahull-PointsKO-Adjacents,3579
Henriettea_megaloclada,1,1,0,Points-PointsKO-Adjacents,9
Henriettea_membranifolia,2,1,1,Points-PointsKO-Adjacents,17
Henriettea_multiflora,105,81,24,Alphahull-PointsKO-Adjacents,3484
Henriettea_odorata,40,19,21,Points-PointsKO-Adjacents,255
Henriettea_ovata,317,248,69,Alphahull-PointsKO-Adjacents,27194
Henriettea_patrisiana,66,40,26,Alphahull-PointsKO-Adjacents,3997
Henriettea_ramiflora,74,49,25,Alphahull-PointsKO-Adjacents,3268
Henriettea_reflexa,3,3,0,Points-PointsKO-Adjacents,26
Henriettea_spruceana,213,165,48,Alphahull-PointsKO-Adjacents,13563
Henriettea_squamata,8,4,4,Points-PointsKO-Adjacents,47
Henriettea_squamulosa,14,9,5,Points-PointsKO-Adjacents,38
Henriettea_stellaris,238,176,62,Alphahull-PointsKO-Adjacents,20233
Henriettea_steyermarkii,29,10,19,Points-PointsKO-Adjacents,227
Henriettea_strigosa,13,2,11,Points-PointsKO-Adjacents,101
Henriettea_succosa,604,463,141,Alphahull-PointsKO-Adjacents,10341
Henriettea_sylvestris,130,84,46,Alphahull-PointsKO-Adjacents,13594
Henriettea_tovarensis,29,8,21,Points-PointsKO-Adjacents,224
Henriettea_trachyphylla,127,96,31,Alphahull-PointsKO-Adjacents,2563
Henriettea_triflora,5,5,0,Points-PointsKO-Adjacents,28
Henriettea_tuberculosa,233,192,41,Alphahull-PointsKO-Adjacents,3852
Henriettea_verrucosa,77,51,26,Alphahull-PointsKO-Adjacents,3116
Henriettella_cuneata,124,94,30,Alphahull-PointsKO-Adjacents,1252
Henriettella_fascicularis,97,59,38,Alphahull-PointsKO-Adjacents,2082
Henriettella_seemannii,132,101,31,Alphahull-PointsKO-Adjacents,2610
Henriettella_sessilifolia,2,2,0,Points-PointsKO-Adjacents,18
Henriquezia_jenmanii,3,2,1,Points-PointsKO-Adjacents,27
Henriquezia_nitida,98,75,23,Alphahull-PointsKO-Adjacents,2381
Henriquezia_verticillata,50,33,17,Alphahull-PointsKO-Adjacents,1076
Heptacodium_miconioides,2,2,0,Points-PointsKO-Adjacents,18
Heritiera_actinophylla,760,724,36,Alphahull-PointsKO-Adjacents,1035
Tarrietia_albiflora,1,0,1,Points-PointsKO-Adjacents,9
Heritiera_angustata,4,4,0,Points-PointsKO-Adjacents,36
Tarrietia_borneensis,2,0,2,Points-PointsKO-Adjacents,18
Tarrietia_densiflora,9,1,8,Points-PointsKO-Adjacents,76
Heritiera_fomes,1,1,0,Points-PointsKO-Adjacents,9
Heritiera_javanica,5,1,4,Points-PointsKO-Adjacents,34
Heritiera_littoralis,268,136,132,Alphahull-PointsKO-Adjacents,2639
Heritiera_longipetiolata,0,0,0,NA,0
Heritiera_macrophylla,0,0,0,NA,0
Heritiera_ornithocephala,4,4,0,Points-PointsKO-Adjacents,24
Heritiera_parvifolia,5,5,0,Points-PointsKO-Adjacents,45
Tarrietia_peralata,33,27,6,Alphahull-PointsKO-Adjacents,75
Heritiera_simplicifolia,5,1,4,Points-PointsKO-Adjacents,36
Heritiera_sumatrana,6,2,4,Points-PointsKO-Adjacents,48
Argyrodendron_trifoliolatum,405,0,405,Points-PointsKO-Adjacents,765
Hernandia_didymantha,131,106,25,Alphahull-PointsKO-Adjacents,1812
Hernandia_drakeana,0,0,0,NA,0
Hernandia_guianensis,40,19,21,Points-PointsKO-Adjacents,296
Hernandia_labyrinthica,1,1,0,Points-PointsKO-Adjacents,6
Hernandia_lychnifera,7,2,5,Points-PointsKO-Adjacents,54
Hernandia_mascarenensis,0,0,0,NA,0
Hernandia_moerenhoutiana,24,11,13,Points-PointsKO-Adjacents,75
Hernandia_nymphaeifolia,213,76,137,Alphahull-PointsKO-Adjacents,2697
Hernandia_olivacea,0,0,0,NA,0
Hernandia_sonora,17,3,14,Points-PointsKO-Adjacents,119
Hernandia_stenura,99,74,25,Alphahull-PointsKO-Adjacents,1097
Hernandia_stokesii,1,0,1,Points-PointsKO-Adjacents,2
Hernandia_temarii,NA,NA,NA,NA,NA
Herrania_albiflora,42,31,11,Alphahull-PointsKO-Adjacents,1613
Herrania_balaensis,22,15,7,Points-PointsKO-Adjacents,163
Herrania_breviligulata,6,0,6,Points-PointsKO-Adjacents,42
Herrania_camargoana,6,2,4,Points-PointsKO-Adjacents,48
Herrania_dugandii,5,5,0,Points-PointsKO-Adjacents,45
Herrania_kanukuensis,27,8,19,Points-PointsKO-Adjacents,209
Herrania_kofanorum,2,2,0,Points-PointsKO-Adjacents,18
Herrania_laciniifolia,2,1,1,Points-PointsKO-Adjacents,18
Herrania_lemniscata,45,23,22,Alphahull-PointsKO-Adjacents,4375
Herrania_mariae,152,95,57,Alphahull-PointsKO-Adjacents,13678
Herrania_nitida,17,3,14,Points-PointsKO-Adjacents,147
Herrania_nycterodendron,53,30,23,Alphahull-PointsKO-Adjacents,4545
Herrania_pulcherrima,37,23,14,Alphahull-PointsKO-Adjacents,2063
Herrania_purpurea,226,184,42,Alphahull-PointsKO-Adjacents,2245
Herrania_umbratica,0,0,0,NA,0
Hesperelaea_palmeri,3,3,0,Points-PointsKO-Adjacents,17
Hesperolaburnum_platycarpum,8,5,3,Points-PointsKO-Adjacents,32
Hesperomannia_arborescens,5,2,3,Points-PointsKO-Adjacents,30
Hesperomannia_arbuscula,0,0,0,NA,0
Hesperomannia_lydgatei,3,3,0,Points-PointsKO-Adjacents,12
Hesperomeles_cuneata,53,28,25,Alphahull-PointsKO-Adjacents,616
Hesperomeles_ferruginea,394,321,73,Alphahull-PointsKO-Adjacents,4912
Hesperomeles_gayana,8,1,7,Points-PointsKO-Adjacents,72
Hesperomeles_obtusifolia,731,639,92,Alphahull-PointsKO-Adjacents,5190
Hesperomeles_weberbaueri,25,10,15,Points-PointsKO-Adjacents,199
Heterocoma_ekmaniana,22,14,8,Points-PointsKO-Adjacents,115
Heterocoma_erecta,12,1,11,Points-PointsKO-Adjacents,43
Heterocoma_lanuginosa,13,1,12,Points-PointsKO-Adjacents,97
Heteroflorum_sclerocarpum,14,7,7,Points-PointsKO-Adjacents,55
Heteromeles_arbutifolia,2392,1859,533,Alphahull-PointsKO-Adjacents,3364
Heteromorpha_arborescens,455,144,311,Alphahull-PointsKO-Adjacents,14518
Heteromorpha_involucrata,35,21,14,Alphahull-PointsKO-Adjacents,268
Heteromorpha_stenophylla,10,5,5,Points-PointsKO-Adjacents,90
Heteromorpha_trifoliata,235,48,187,Alphahull-PointsKO-Adjacents,6936
Heteropanax_balanseanus,NA,NA,NA,NA,NA
Heteropanax_brevipedicellatus,27,12,15,Points-PointsKO-Adjacents,243
Heteropanax_chinensis,7,2,5,Points-PointsKO-Adjacents,63
Heteropanax_fragrans,28,6,22,Points-PointsKO-Adjacents,234
Heteropanax_hainanensis,3,3,0,Points-PointsKO-Adjacents,27
Heteropanax_nitentifolius,0,0,0,NA,0
Heteropanax_phanrangensis,0,0,0,NA,0
Heteropanax_yunnanensis,2,2,0,Points-PointsKO-Adjacents,18
Heterophragma_quadriloculare,0,0,0,NA,0
Heterophragma_sulfureum,0,0,0,NA,0
Heterophyllaea_fiebrigii,3,3,0,Points-PointsKO-Adjacents,27
Heterophyllaea_lycioides,24,13,11,Points-PointsKO-Adjacents,148
Heteropterys_atabapensis,28,21,7,Alphahull-PointsKO-Adjacents,150
Heteropterys_coriacea,78,48,30,Alphahull-PointsKO-Adjacents,3916
Heteropterys_eglandulosa,139,76,63,Alphahull-PointsKO-Adjacents,13361
Heteropterys_huberi,1,1,0,Points-PointsKO-Adjacents,9
Heteropterys_laurifolia,585,452,133,Alphahull-PointsKO-Adjacents,10190
Heteropterys_leona,91,54,37,Alphahull-PointsKO-Adjacents,1855
Heteropterys_nervosa,202,96,106,Alphahull-PointsKO-Adjacents,19874
Heteropterys_oblongifolia,14,7,7,Points-PointsKO-Adjacents,90
Heteropterys_palmeri,77,39,38,Alphahull-PointsKO-Adjacents,623
Heteropterys_quetepensis,5,5,0,Points-PointsKO-Adjacents,45
Heteropterys_riparia,7,0,7,Points-PointsKO-Adjacents,50
Heteropterys_sincorensis,50,36,14,Alphahull-PointsKO-Adjacents,271
Heteropterys_steyermarkii,3,3,0,Points-PointsKO-Adjacents,27
Heteropyxis_canescens,9,6,3,Points-PointsKO-Adjacents,72
Heteropyxis_dehniae,30,9,21,Points-PointsKO-Adjacents,248
Heteropyxis_natalensis,124,95,29,Alphahull-PointsKO-Adjacents,2277
Heterosavia_bahamensis,32,16,16,Points-PointsKO-Adjacents,194
Heterosavia_erythroxyloides,16,4,12,Points-PointsKO-Adjacents,128
Heterosavia_laurifolia,7,2,5,Points-PointsKO-Adjacents,62
Heterosavia_maculata,11,3,8,Points-PointsKO-Adjacents,72
Heterospathe_annectens,1,1,0,Points-PointsKO-Adjacents,9
Heterospathe_arfakiana,0,0,0,NA,0
Heterospathe_brevicaulis,0,0,0,NA,0
Heterospathe_cagayanensis,0,0,0,NA,0
Heterospathe_califrons,NA,NA,NA,NA,NA
Heterospathe_clemensiae,NA,NA,NA,NA,NA
Heterospathe_compsoclada,2,2,0,Points-PointsKO-Adjacents,9
Heterospathe_dransfieldii,0,0,0,NA,0
Heterospathe_elata,0,0,0,NA,0
Heterospathe_elegans,28,17,11,Points-PointsKO-Adjacents,196
Heterospathe_elmeri,1,1,0,Points-PointsKO-Adjacents,9
Heterospathe_glabra,1,1,0,Points-PointsKO-Adjacents,9
Heterospathe_glauca,0,0,0,NA,0
Heterospathe_intermedia,0,0,0,NA,0
Heterospathe_kajewskii,0,0,0,NA,0
Heterospathe_ledermanniana,NA,NA,NA,NA,NA
Heterospathe_lepidota,2,2,0,Points-PointsKO-Adjacents,16
Heterospathe_longipes,0,0,0,NA,0
Heterospathe_macgregorii,7,0,7,Points-PointsKO-Adjacents,38
Heterospathe_minor,4,4,0,Points-PointsKO-Adjacents,33
Heterospathe_muelleriana,5,2,3,Points-PointsKO-Adjacents,45
Heterospathe_negrosensis,1,1,0,Points-PointsKO-Adjacents,9
Heterospathe_obriensis,5,5,0,Points-PointsKO-Adjacents,45
Heterospathe_parviflora,2,2,0,Points-PointsKO-Adjacents,15
Heterospathe_philippinensis,1,1,0,Points-PointsKO-Adjacents,9
Heterospathe_phillipsii,NA,NA,NA,NA,NA
Heterospathe_pilosa,NA,NA,NA,NA,NA
Heterospathe_pulchra,2,2,0,Points-PointsKO-Adjacents,16
Heterospathe_pullenii,1,1,0,Points-PointsKO-Adjacents,9
Heterospathe_ramulosa,0,0,0,NA,0
Heterospathe_salomonensis,0,0,0,NA,0
Heterospathe_scitula,NA,NA,NA,NA,NA
Heterospathe_sensisi,0,0,0,NA,0
Heterospathe_sibuyanensis,1,1,0,Points-PointsKO-Adjacents,8
Heterospathe_sphaerocarpa,2,2,0,Points-PointsKO-Adjacents,18
Heterospathe_trispatha,NA,NA,NA,NA,NA
Heterospathe_uniformis,0,0,0,NA,0
Heterospathe_woodfordiana,1,1,0,Points-PointsKO-Adjacents,9
Heterostemon_conjugatus,61,42,19,Alphahull-PointsKO-Adjacents,3010
Heterostemon_ellipticus,34,18,16,Points-PointsKO-Adjacents,178
Heterostemon_impar,3,3,0,Points-PointsKO-Adjacents,21
Heterostemon_ingifolius,3,2,1,Points-PointsKO-Adjacents,27
Heterostemon_mazarunensis,4,3,1,Points-PointsKO-Adjacents,30
Heterostemon_mimosoides,261,225,36,Alphahull-PointsKO-Adjacents,14961
Heterostemon_otophorus,5,0,5,Points-PointsKO-Adjacents,36
Hevea_benthamiana,229,193,36,Alphahull-PointsKO-Adjacents,13269
Hevea_brasiliensis,475,387,88,Alphahull-PointsKO-Adjacents,40852
Hevea_camporum,19,10,9,Points-PointsKO-Adjacents,117
Hevea_guianensis,713,640,73,Alphahull-PointsKO-Adjacents,51692
Hevea_microphylla,33,0,33,Points-PointsKO-Adjacents,279
Hevea_nitida,142,115,27,Alphahull-PointsKO-Adjacents,3978
Hevea_pauciflora,294,245,49,Alphahull-PointsKO-Adjacents,18759
Hevea_rigidifolia,17,3,14,Points-PointsKO-Adjacents,142
Hevea_spruceana,143,110,33,Alphahull-PointsKO-Adjacents,7816
Hexalobus_bussei,12,7,5,Points-PointsKO-Adjacents,49
Hexalobus_crispiflorus,367,274,93,Alphahull-PointsKO-Adjacents,22031
Hexalobus_monopetalus,870,722,148,Alphahull-PointsKO-Adjacents,35196
Hexalobus_mossambicensis,9,2,7,Points-PointsKO-Adjacents,69
Hexalobus_salicifolius,13,0,13,Points-PointsKO-Adjacents,95
Micropora_curtisii,0,0,0,NA,0
Hexaspora_pubescens,11,8,3,Points-PointsKO-Adjacents,31
Heynea_trijuga,78,46,32,Alphahull-PointsKO-Adjacents,4667
Heywoodia_lucens,16,1,15,Points-PointsKO-Adjacents,136
Hibbertia_pancheri,167,147,20,Alphahull-PointsKO-Adjacents,230
Hibbertia_pulchella,24,18,6,Points-PointsKO-Adjacents,45
Trisema_vieillardii,32,24,8,Alphahull-PointsKO-Adjacents,65
Hibiscadelphus_bombycinus,1,1,0,Points-PointsKO-Adjacents,9
Hibiscadelphus_crucibracteatus,1,1,0,Points-PointsKO-Adjacents,8
Hibiscadelphus_distans,0,0,0,NA,0
Hibiscadelphus_giffardianus,4,4,0,Points-PointsKO-Adjacents,15
Hibiscadelphus_hualalaiensis,1,1,0,Points-PointsKO-Adjacents,9
Hibiscadelphus_wilderianus,1,1,0,Points-PointsKO-Adjacents,8
Hibiscadelphus_woodii,0,0,0,NA,0
Hibiscus_arnottianus,8,0,8,Points-PointsKO-Adjacents,41
Hibiscus_bojerianus,32,18,14,Points-PointsKO-Adjacents,216
Hibiscus_boryanus,2,2,0,Points-PointsKO-Adjacents,15
Hibiscus_brackenridgei,5,0,5,Points-PointsKO-Adjacents,32
Hibiscus_burtt-davyi,9,5,4,Points-PointsKO-Adjacents,36
Hibiscus_calyphyllus,105,52,53,Alphahull-PointsKO-Adjacents,5867
Hibiscus_clypeatus,167,127,40,Alphahull-PointsKO-Adjacents,1935
Hibiscus_columnaris,1,1,0,Points-PointsKO-Adjacents,9
Hibiscus_diplocrater,83,59,24,Alphahull-PointsKO-Adjacents,1441
Hibiscus_diversifolius,1,1,0,Points-PointsKO-Adjacents,9
Hibiscus_elatus,5,2,3,Points-PointsKO-Adjacents,45
Hibiscus_ellisii,24,6,18,Points-PointsKO-Adjacents,174
Hibiscus_erlangeri,3,3,0,Points-PointsKO-Adjacents,18
Hibiscus_fragrans,0,0,0,NA,0
Hibiscus_grandistipulatus,1,1,0,Points-PointsKO-Adjacents,9
Hibiscus_grewiifolius,9,2,7,Points-PointsKO-Adjacents,66
Hibiscus_hamabo,4,3,1,Points-PointsKO-Adjacents,34
Hibiscus_heterophyllus,501,430,71,Alphahull-PointsKO-Adjacents,3435
Hibiscus_kochii,26,15,11,Points-PointsKO-Adjacents,103
Hibiscus_kokio,15,0,15,Points-PointsKO-Adjacents,70
Hibiscus_lasiococcus,19,7,12,Points-PointsKO-Adjacents,118
Hibiscus_liliiflorus,1,1,0,Points-PointsKO-Adjacents,9
Hibiscus_macrogonus,35,19,16,Points-PointsKO-Adjacents,202
Hibiscus_macrophyllus,4,0,4,Points-PointsKO-Adjacents,36
Hibiscus_mandrarensis,19,9,10,Points-PointsKO-Adjacents,104
Hibiscus_megistanthus,7,1,6,Points-PointsKO-Adjacents,42
Hibiscus_mutabilis,1,0,1,Points-PointsKO-Adjacents,9
Hibiscus_nelsonii,0,0,0,NA,0
Hibiscus_palmatifidus,32,19,13,Points-PointsKO-Adjacents,238
Papuodendron_lepidotum,16,9,7,Points-PointsKO-Adjacents,90
Hibiscus_paramutabilis,11,3,8,Points-PointsKO-Adjacents,99
Hibiscus_rosa-sinensis,1188,599,589,Alphahull-PointsKO-Adjacents,28690
Hibiscus_schizopetalus,19,6,13,Points-PointsKO-Adjacents,114
Hibiscus_sterculiifolius,82,50,32,Alphahull-PointsKO-Adjacents,3615
Hibiscus_syriacus,798,0,798,Points-PointsKO-Adjacents,5355
Hibiscus_taiwanensis,82,70,12,Alphahull-PointsKO-Adjacents,364
Hibiscus_thespesianus,40,24,16,Alphahull-PointsKO-Adjacents,503
Hibiscus_verbasciformis,47,19,28,Points-PointsKO-Adjacents,254
Hibiscus_waimeae,9,0,9,Points-PointsKO-Adjacents,23
Hieronyma_alchorneoides,2199,2002,197,Alphahull-PointsKO-Adjacents,133782
Hieronyma_antioquensis,55,45,10,Alphahull-PointsKO-Adjacents,160
Hieronyma_asperifolia,51,33,18,Alphahull-PointsKO-Adjacents,535
Hieronyma_boliviana,2,2,0,Points-PointsKO-Adjacents,18
Hieronyma_clusioides,17,14,3,Points-PointsKO-Adjacents,52
Hieronyma_crassistipula,0,0,0,NA,0
Hieronyma_cubana,3,3,0,Points-PointsKO-Adjacents,26
Hieronyma_domingensis,3,3,0,Points-PointsKO-Adjacents,27
Hieronyma_duquei,162,123,39,Alphahull-PointsKO-Adjacents,3107
Hieronyma_fendleri,207,155,52,Alphahull-PointsKO-Adjacents,4357
Hieronyma_havanensis,1,1,0,Points-PointsKO-Adjacents,9
Hieronyma_huilensis,113,92,21,Alphahull-PointsKO-Adjacents,1832
Hieronyma_jamaicensis,4,3,1,Points-PointsKO-Adjacents,27
Hieronyma_macrocarpa,233,194,39,Alphahull-PointsKO-Adjacents,2686
Hieronyma_nipensis,8,4,4,Points-PointsKO-Adjacents,54
Hieronyma_oblonga,1115,935,180,Alphahull-PointsKO-Adjacents,38300
Hieronyma_ovata,1,1,0,Points-PointsKO-Adjacents,9
Hieronyma_paucinervis,0,0,0,NA,0
Hieronyma_rufa,14,9,5,Points-PointsKO-Adjacents,107
Hieronyma_scabra,3,3,0,Points-PointsKO-Adjacents,27
Hieronyma_scabrida,89,64,25,Alphahull-PointsKO-Adjacents,2228
Hildegardia_ankaranensis,15,13,2,Points-PointsKO-Adjacents,62
Hildegardia_barteri,68,53,15,Alphahull-PointsKO-Adjacents,979
Hildegardia_cubensis,1,0,1,Points-PointsKO-Adjacents,9
Hildegardia_erythrosiphon,49,26,23,Alphahull-PointsKO-Adjacents,325
Hildegardia_migeodii,3,3,0,Points-PointsKO-Adjacents,25
Hildegardia_perrieri,20,9,11,Points-PointsKO-Adjacents,115
Sterculia_populifolia,0,0,0,NA,0
Hillia_illustris,232,131,101,Alphahull-PointsKO-Adjacents,9821
Hillia_longifilamentosa,25,14,11,Points-PointsKO-Adjacents,127
Hillia_macromeris,30,9,21,Points-PointsKO-Adjacents,246
Hillia_macrophylla,75,42,33,Alphahull-PointsKO-Adjacents,2607
Hillia_maxonii,102,73,29,Alphahull-PointsKO-Adjacents,617
Hillia_palmana,146,124,22,Alphahull-PointsKO-Adjacents,692
Hillia_panamensis,58,40,18,Alphahull-PointsKO-Adjacents,344
Hillia_parasitica,945,744,201,Alphahull-PointsKO-Adjacents,27760
Hillia_tetrandra,130,94,36,Alphahull-PointsKO-Adjacents,1615
Hillia_wurdackii,23,8,15,Points-PointsKO-Adjacents,112
Hilsenbergia_angustifolia,1,1,0,Points-PointsKO-Adjacents,9
Hilsenbergia_apetala,9,2,7,Points-PointsKO-Adjacents,61
Hilsenbergia_bosseri,34,22,12,Alphahull-PointsKO-Adjacents,330
Hilsenbergia_capuronii,10,4,6,Points-PointsKO-Adjacents,79
Hilsenbergia_croatii,6,2,4,Points-PointsKO-Adjacents,16
Hilsenbergia_darcyana,9,0,9,Points-PointsKO-Adjacents,79
Hilsenbergia_labatii,8,3,5,Points-PointsKO-Adjacents,60
Hilsenbergia_leslieae,10,5,5,Points-PointsKO-Adjacents,51
Hilsenbergia_lowryana,13,8,5,Points-PointsKO-Adjacents,78
Hilsenbergia_lyciacea,28,16,12,Points-PointsKO-Adjacents,166
Hilsenbergia_moratiana,5,5,0,Points-PointsKO-Adjacents,39
Hilsenbergia_nemoralis,27,11,16,Points-PointsKO-Adjacents,200
Hilsenbergia_orbicularis,2,2,0,Points-PointsKO-Adjacents,18
Hilsenbergia_petiolaris,16,2,14,Points-PointsKO-Adjacents,113
Hilsenbergia_randrianasoloana,3,3,0,Points-PointsKO-Adjacents,22
Hilsenbergia_schatziana,6,0,6,Points-PointsKO-Adjacents,45
Himatanthus_articulatus,1267,1167,100,Alphahull-PointsKO-Adjacents,98136
Himatanthus_attenuatus,245,208,37,Alphahull-PointsKO-Adjacents,13096
Himatanthus_bracteatus,640,540,100,Alphahull-PointsKO-Adjacents,7106
Himatanthus_drasticus,627,553,74,Alphahull-PointsKO-Adjacents,28414
Himatanthus_obovatus,925,833,92,Alphahull-PointsKO-Adjacents,36853
Himatanthus_phagedaenicus,147,66,81,Alphahull-PointsKO-Adjacents,3147
Himatanthus_revolutus,118,71,47,Alphahull-PointsKO-Adjacents,12567
Himatanthus_semilunatus,73,46,27,Alphahull-PointsKO-Adjacents,2689
Himatanthus_tarapotensis,161,106,55,Alphahull-PointsKO-Adjacents,20183
Hindsia_longiflora,9,1,8,Points-PointsKO-Adjacents,54
Hintonia_latiflora,558,479,79,Alphahull-PointsKO-Adjacents,6115
Hintonia_lumana,13,0,13,Points-PointsKO-Adjacents,70
Hintonia_octomera,153,0,153,Points-PointsKO-Adjacents,525
Hippobromus_pauciflorus,113,85,28,Alphahull-PointsKO-Adjacents,2146
Hippocratea_volubilis,1434,1115,319,Alphahull-PointsKO-Adjacents,127504
Hippomane_mancinella,266,150,116,Alphahull-PointsKO-Adjacents,7650
Hippomane_spinosa,6,2,4,Points-PointsKO-Adjacents,37
Hippophae_goniocarpa,1,1,0,Points-PointsKO-Adjacents,9
Hippophae_gyantsensis,6,1,5,Points-PointsKO-Adjacents,48
Hippophae_litangensis,NA,NA,NA,NA,NA
Hippophae_neurocarpa,8,0,8,Points-PointsKO-Adjacents,61
Hippophae_salicifolia,22,4,18,Points-PointsKO-Adjacents,182
Hippophae_tibetana,79,49,30,Alphahull-PointsKO-Adjacents,733
Hippotis_albiflora,113,83,30,Alphahull-PointsKO-Adjacents,4116
Hippotis_brevipes,171,144,27,Alphahull-PointsKO-Adjacents,6071
Hippotis_comosa,9,6,3,Points-PointsKO-Adjacents,43
Hippotis_grandiflora,1,1,0,Points-PointsKO-Adjacents,9
Hippotis_lasseri,9,0,9,Points-PointsKO-Adjacents,48
Hippotis_mollis,21,10,11,Points-PointsKO-Adjacents,169
Hippotis_panamensis,79,60,19,Alphahull-PointsKO-Adjacents,602
Hippotis_stellata,35,22,13,Alphahull-PointsKO-Adjacents,218
Hippotis_triflora,36,19,17,Points-PointsKO-Adjacents,222
Hippotis_tubiflora,27,15,12,Points-PointsKO-Adjacents,179
Hiptage_benghalensis,182,99,83,Alphahull-PointsKO-Adjacents,1766
Hiptage_candicans,15,2,13,Points-PointsKO-Adjacents,132
Hiptage_myrtifolia,1,1,0,Points-PointsKO-Adjacents,9
Hiptage_yunnanensis,NA,NA,NA,NA,NA
Hiraea_barclayana,34,10,24,Points-PointsKO-Adjacents,226
Hiraea_fagifolia,354,215,139,Alphahull-PointsKO-Adjacents,15413
Hiraea_reclinata,286,223,63,Alphahull-PointsKO-Adjacents,6864
Hiraea_ternifolia,24,8,16,Points-PointsKO-Adjacents,193
Hirtella_adenophora,6,2,4,Points-PointsKO-Adjacents,47
Hirtella_aequatoriensis,7,3,4,Points-PointsKO-Adjacents,62
Hirtella_americana,442,356,86,Alphahull-PointsKO-Adjacents,11551
Hirtella_angustissima,7,6,1,Points-PointsKO-Adjacents,33
Hirtella_araguariensis,19,5,14,Points-PointsKO-Adjacents,156
Hirtella_aramangensis,1,1,0,Points-PointsKO-Adjacents,9
Hirtella_bahiensis,36,19,17,Points-PointsKO-Adjacents,179
Hirtella_barrosoi,3,2,1,Points-PointsKO-Adjacents,21
Hirtella_beckii,2,2,0,Points-PointsKO-Adjacents,18
Hirtella_bicornis,409,287,122,Alphahull-PointsKO-Adjacents,62138
Hirtella_brachystachys,3,3,0,Points-PointsKO-Adjacents,27
Hirtella_bullata,287,216,71,Alphahull-PointsKO-Adjacents,15222
Hirtella_burchellii,215,158,57,Alphahull-PointsKO-Adjacents,18320
Hirtella_caduca,10,3,7,Points-PointsKO-Adjacents,57
Hirtella_carbonaria,26,12,14,Points-PointsKO-Adjacents,186
Hirtella_castillana,1,1,0,Points-PointsKO-Adjacents,9
Hirtella_ciliata,604,499,105,Alphahull-PointsKO-Adjacents,23284
Hirtella_conduplicata,4,4,0,Points-PointsKO-Adjacents,27
Hirtella_confertiflora,3,3,0,Points-PointsKO-Adjacents,27
Hirtella_couepiiflora,6,1,5,Points-PointsKO-Adjacents,50
Hirtella_davisii,34,12,22,Points-PointsKO-Adjacents,255
Hirtella_deflexa,10,3,7,Points-PointsKO-Adjacents,74
Hirtella_dorvalii,21,8,13,Points-PointsKO-Adjacents,165
Hirtella_duckei,136,107,29,Alphahull-PointsKO-Adjacents,16613
Hirtella_elongata,349,296,53,Alphahull-PointsKO-Adjacents,19621
Hirtella_enneandra,1,1,0,Points-PointsKO-Adjacents,9
Hirtella_eriandra,193,118,75,Alphahull-PointsKO-Adjacents,11172
Hirtella_excelsa,219,168,51,Alphahull-PointsKO-Adjacents,9371
Hirtella_fasciculata,21,0,21,Points-PointsKO-Adjacents,123
Hirtella_floribunda,11,4,7,Points-PointsKO-Adjacents,99
Hirtella_glabrata,56,31,25,Alphahull-PointsKO-Adjacents,2424
Hirtella_glandulistipula,0,0,0,NA,0
Hirtella_glandulosa,1047,949,98,Alphahull-PointsKO-Adjacents,48766
Hirtella_glaziovii,13,2,11,Points-PointsKO-Adjacents,78
Hirtella_gracilipes,992,895,97,Alphahull-PointsKO-Adjacents,41056
Hirtella_guainiae,130,100,30,Alphahull-PointsKO-Adjacents,5750
Hirtella_guatemalensis,91,71,20,Alphahull-PointsKO-Adjacents,2474
Hirtella_guyanensis,4,4,0,Points-PointsKO-Adjacents,36
Hirtella_hebeclada,504,432,72,Alphahull-PointsKO-Adjacents,7500
Hirtella_hispidula,156,89,67,Alphahull-PointsKO-Adjacents,21734
Hirtella_hoehnei,88,55,33,Alphahull-PointsKO-Adjacents,9082
Hirtella_insignis,50,25,25,Alphahull-PointsKO-Adjacents,520
Hirtella_juruenensis,0,0,0,NA,0
Hirtella_kuhlmannii,18,4,14,Points-PointsKO-Adjacents,162
Hirtella_lancifolia,9,0,9,Points-PointsKO-Adjacents,81
Hirtella_latifolia,73,51,22,Alphahull-PointsKO-Adjacents,886
Hirtella_lemsii,68,56,12,Alphahull-PointsKO-Adjacents,303
Hirtella_leonotis,16,4,12,Points-PointsKO-Adjacents,113
Hirtella_liesneri,7,1,6,Points-PointsKO-Adjacents,63
Hirtella_lightioides,78,68,10,Alphahull-PointsKO-Adjacents,1405
Hirtella_longifolia,3,3,0,Points-PointsKO-Adjacents,25
Hirtella_longipedicellata,15,9,6,Points-PointsKO-Adjacents,95
Hirtella_macrophylla,68,17,51,Points-PointsKO-Adjacents,535
Hirtella_macrosepala,14,5,9,Points-PointsKO-Adjacents,112
Hirtella_magnifolia,9,2,7,Points-PointsKO-Adjacents,68
Hirtella_maguirei,4,4,0,Points-PointsKO-Adjacents,30
Hirtella_margae,7,1,6,Points-PointsKO-Adjacents,44
Hirtella_martiana,143,116,27,Alphahull-PointsKO-Adjacents,7669
Hirtella_mucronata,21,7,14,Points-PointsKO-Adjacents,124
Hirtella_mutisii,75,58,17,Alphahull-PointsKO-Adjacents,2286
Hirtella_myrmecophila,58,34,24,Alphahull-PointsKO-Adjacents,880
Hirtella_obidensis,51,17,34,Points-PointsKO-Adjacents,400
Hirtella_orbicularis,4,4,0,Points-PointsKO-Adjacents,36
Hirtella_paniculata,400,350,50,Alphahull-PointsKO-Adjacents,23030
Hirtella_papillata,13,9,4,Points-PointsKO-Adjacents,41
Hirtella_paraensis,40,14,26,Points-PointsKO-Adjacents,303
Hirtella_parviunguis,4,4,0,Points-PointsKO-Adjacents,33
Hirtella_pauciflora,1,1,0,Points-PointsKO-Adjacents,9
Hirtella_pendula,9,6,3,Points-PointsKO-Adjacents,15
Hirtella_physophora,185,140,45,Alphahull-PointsKO-Adjacents,26199
Hirtella_pilosissima,155,86,69,Alphahull-PointsKO-Adjacents,10331
Hirtella_pimichina,14,0,14,Points-PointsKO-Adjacents,124
Hirtella_piresii,65,24,41,Alphahull-PointsKO-Adjacents,530
Hirtella_punctillata,78,0,78,Points-PointsKO-Adjacents,565
Hirtella_racemosa,2299,2040,259,Alphahull-PointsKO-Adjacents,117329
Hirtella_rasa,25,7,18,Points-PointsKO-Adjacents,224
Hirtella_recurva,8,2,6,Points-PointsKO-Adjacents,58
Hirtella_revillae,16,10,6,Points-PointsKO-Adjacents,80
Hirtella_rodriguesii,61,24,37,Alphahull-PointsKO-Adjacents,779
Hirtella_rugosa,23,18,5,Points-PointsKO-Adjacents,57
Hirtella_santosii,15,5,10,Points-PointsKO-Adjacents,96
Hirtella_scaberula,4,4,0,Points-PointsKO-Adjacents,26
Hirtella_schultesii,118,89,29,Alphahull-PointsKO-Adjacents,7136
Hirtella_silicea,95,76,19,Alphahull-PointsKO-Adjacents,4643
Hirtella_sprucei,77,24,53,Alphahull-PointsKO-Adjacents,1849
Hirtella_standleyi,7,2,5,Points-PointsKO-Adjacents,54
Hirtella_subglanduligera,3,3,0,Points-PointsKO-Adjacents,27
Hirtella_suffulta,23,0,23,Points-PointsKO-Adjacents,130
Hirtella_tentaculata,27,6,21,Points-PointsKO-Adjacents,225
Hirtella_tenuifolia,30,15,15,Points-PointsKO-Adjacents,245
Hirtella_thouarsiana,12,5,7,Points-PointsKO-Adjacents,77
Hirtella_tocantina,25,4,21,Points-PointsKO-Adjacents,213
Hirtella_triandra,1343,1104,239,Alphahull-PointsKO-Adjacents,59969
Hirtella_trichotoma,9,3,6,Points-PointsKO-Adjacents,49
Hirtella_tubiflora,67,44,23,Alphahull-PointsKO-Adjacents,1510
Hirtella_ulei,67,0,67,Points-PointsKO-Adjacents,473
Hirtella_vesiculosa,4,4,0,Points-PointsKO-Adjacents,33
Hirtella_zanzibarica,74,43,31,Alphahull-PointsKO-Adjacents,3329
Hispaniolanthus_dolichopodus,1,1,0,Points-PointsKO-Adjacents,5
Hodgkinsonia_ovatiflora,351,319,32,Alphahull-PointsKO-Adjacents,1346
Hoffmannia_arborescens,111,99,12,Alphahull-PointsKO-Adjacents,253
Hoffmannia_aroensis,9,4,5,Points-PointsKO-Adjacents,72
Hoffmannia_cauliflora,8,0,8,Points-PointsKO-Adjacents,40
Hoffmannia_ixtlanensis,19,13,6,Points-PointsKO-Adjacents,63
Hoffmannia_josefina,22,15,7,Points-PointsKO-Adjacents,34
Hoffmannia_macrosiphon,7,1,6,Points-PointsKO-Adjacents,36
Hoffmannia_micrantha,24,15,9,Points-PointsKO-Adjacents,62
Hoheria_angustifolia,252,202,50,Alphahull-PointsKO-Adjacents,2916
Hoheria_equitum,3,3,0,Points-PointsKO-Adjacents,11
Hoheria_glabrata,1393,1362,31,Alphahull-PointsKO-Adjacents,1382
Hoheria_lyallii,240,221,19,Alphahull-PointsKO-Adjacents,1191
Hoheria_populnea,412,332,80,Alphahull-PointsKO-Adjacents,2468
Hoheria_sexstylosa,389,342,47,Alphahull-PointsKO-Adjacents,2723
Holarrhena_congolensis,0,0,0,NA,0
Holarrhena_floribunda,811,734,77,Alphahull-PointsKO-Adjacents,13502
Holarrhena_mitis,1,1,0,Points-PointsKO-Adjacents,9
Holarrhena_pubescens,132,69,63,Alphahull-PointsKO-Adjacents,9548
Holigarna_arnottiana,0,0,0,NA,0
Holigarna_beddomei,1,1,0,Points-PointsKO-Adjacents,9
Holigarna_caustica,0,0,0,NA,0
Holigarna_ferruginea,0,0,0,NA,0
Holigarna_grahamii,2,0,2,Points-PointsKO-Adjacents,18
Holigarna_kurzii,0,0,0,NA,0
Holigarna_nigra,0,0,0,NA,0
Hollandaea_sayeriana,60,52,8,Alphahull-PointsKO-Adjacents,57
Holocalyx_balansae,548,476,72,Alphahull-PointsKO-Adjacents,17808
Holodiscus_argenteus,295,226,69,Alphahull-PointsKO-Adjacents,4430
Holodiscus_fissus,3,3,0,Points-PointsKO-Adjacents,27
Hololepis_hatschbachii,0,0,0,NA,0
Hololepis_pedunculata,83,0,83,Points-PointsKO-Adjacents,327
Holoptelea_grandis,117,75,42,Alphahull-PointsKO-Adjacents,1407
Homalanthus_acuminatus,0,0,0,NA,0
Homalanthus_arfakiensis,31,0,31,Points-PointsKO-Adjacents,218
Homalanthus_caloneurus,2,2,0,Points-PointsKO-Adjacents,18
Homalanthus_ebracteatua,NA,NA,NA,NA,NA
Homalanthus_fastuosus,16,5,11,Points-PointsKO-Adjacents,70
Homalanthus_giganteus,3,3,0,Points-PointsKO-Adjacents,27
Homalanthus_grandifolius,3,3,0,Points-PointsKO-Adjacents,27
Homalanthus_longipes,1,1,0,Points-PointsKO-Adjacents,9
Homalanthus_longistylus,9,1,8,Points-PointsKO-Adjacents,62
Homalanthus_macradenius,5,0,5,Points-PointsKO-Adjacents,43
Homalanthus_nervosus,50,33,17,Alphahull-PointsKO-Adjacents,863
Homalanthus_novoguineensis,407,318,89,Alphahull-PointsKO-Adjacents,5217
Homalanthus_nutans,66,21,45,Alphahull-PointsKO-Adjacents,395
Homalanthus_polyadenius,NA,NA,NA,NA,NA
Homalanthus_polyandrus,5,2,3,Points-PointsKO-Adjacents,5
Homalanthus_populifolius,1612,1249,363,Alphahull-PointsKO-Adjacents,3767
Homalanthus_populneus,69,29,40,Alphahull-PointsKO-Adjacents,1060
Homalanthus_remotus,1,1,0,Points-PointsKO-Adjacents,9
Homalanthus_repandus,8,3,5,Points-PointsKO-Adjacents,50
Homalanthus_schlechteri,20,13,7,Points-PointsKO-Adjacents,92
Homalanthus_stokesii,2,2,0,Points-PointsKO-Adjacents,4
Homalanthus_trivalvis,0,0,0,NA,0
Homalium_abdessammadii,35,6,29,Points-PointsKO-Adjacents,303
Homalium_africanum,185,116,69,Alphahull-PointsKO-Adjacents,3977
Homalium_albiflorum,98,67,31,Alphahull-PointsKO-Adjacents,4119
Homalium_axillare,76,49,27,Alphahull-PointsKO-Adjacents,762
Homalium_boinense,4,4,0,Points-PointsKO-Adjacents,36
Homalium_brachyrhachis,2,2,0,Points-PointsKO-Adjacents,18
Homalium_brachystylum,13,3,10,Points-PointsKO-Adjacents,98
Homalium_brevipedunculatum,23,11,12,Points-PointsKO-Adjacents,74
Homalium_capuronii,9,2,7,Points-PointsKO-Adjacents,63
Homalium_cauliflorum,12,5,7,Points-PointsKO-Adjacents,74
Homalium_ceylanicum,20,0,20,Points-PointsKO-Adjacents,180
Homalium_cochinchinense,2,1,1,Points-PointsKO-Adjacents,18
Homalium_decaryanum,1,1,0,Points-PointsKO-Adjacents,9
Homalium_dentatum,57,28,29,Alphahull-PointsKO-Adjacents,755
Pierrea_dictyoneura,7,3,4,Points-PointsKO-Adjacents,56
Homalium_erianthum,8,0,8,Points-PointsKO-Adjacents,65
Homalium_graciliflorum,2,2,0,Points-PointsKO-Adjacents,14
Homalium_guianense,430,334,96,Alphahull-PointsKO-Adjacents,61909
Homalium_intercedens,2,2,0,Points-PointsKO-Adjacents,12
Homalium_involucratum,81,52,29,Alphahull-PointsKO-Adjacents,733
Homalium_kainantense,3,3,0,Points-PointsKO-Adjacents,27
Homalium_kwangsiense,1,1,0,Points-PointsKO-Adjacents,9
Homalium_lastoursvillense,5,5,0,Points-PointsKO-Adjacents,36
Homalium_laurifolium,0,0,0,NA,0
Homalium_laxiflorum,38,0,38,Points-PointsKO-Adjacents,182
Homalium_le-testui,124,80,44,Alphahull-PointsKO-Adjacents,2528
Homalium_longistaminum,5,5,0,Points-PointsKO-Adjacents,27
Homalium_longistylum,2,2,0,Points-PointsKO-Adjacents,18
Homalium_lucidum,27,14,13,Points-PointsKO-Adjacents,163
Homalium_micranthum,24,13,11,Points-PointsKO-Adjacents,123
Homalium_microphyllum,4,4,0,Points-PointsKO-Adjacents,25
Homalium_mollissimum,9,0,9,Points-PointsKO-Adjacents,75
Homalium_moniliforme,24,10,14,Points-PointsKO-Adjacents,130
Homalium_myrtifolium,2,2,0,Points-PointsKO-Adjacents,9
Homalium_nitens,1,1,0,Points-PointsKO-Adjacents,9
Homalium_nobile,18,4,14,Points-PointsKO-Adjacents,88
Homalium_nudiflorum,88,64,24,Alphahull-PointsKO-Adjacents,1630
Homalium_oppositifolium,28,8,20,Points-PointsKO-Adjacents,196
Homalium_pallidum,0,0,0,NA,0
Homalium_paniculatum,0,0,0,NA,0
Homalium_paniculiflorum,7,0,7,Points-PointsKO-Adjacents,54
Homalium_parkeri,39,29,10,Alphahull-PointsKO-Adjacents,945
Homalium_perrieri,5,3,2,Points-PointsKO-Adjacents,15
Homalium_planiflorum,56,37,19,Alphahull-PointsKO-Adjacents,561
Homalium_pulchrum,8,0,8,Points-PointsKO-Adjacents,57
Homalium_racemosum,958,772,186,Alphahull-PointsKO-Adjacents,67897
Homalium_retivenium,8,2,6,Points-PointsKO-Adjacents,61
Homalium_rubriflorum,5,5,0,Points-PointsKO-Adjacents,36
Homalium_rufescens,16,2,14,Points-PointsKO-Adjacents,128
Homalium_sabiifolium,NA,NA,NA,NA,NA
Homalium_sanguineum,5,1,4,Points-PointsKO-Adjacents,26
Homalium_smythei,37,24,13,Alphahull-PointsKO-Adjacents,1070
Homalium_stelliferum,6,0,6,Points-PointsKO-Adjacents,52
Homalium_stenophyllum,5,4,1,Points-PointsKO-Adjacents,45
Homalium_stipulaceum,50,18,32,Points-PointsKO-Adjacents,368
Homalium_thuarsianum,19,9,10,Points-PointsKO-Adjacents,84
Homalium_trigynum,10,3,7,Points-PointsKO-Adjacents,74
Homalium_viguieri,10,4,6,Points-PointsKO-Adjacents,80
Homalium_viridflorum,0,0,0,NA,0
Homalium_vitiense,0,0,0,NA,0
Homalospermum_firmum,251,224,27,Alphahull-PointsKO-Adjacents,826
Homonoia_intermedia,NA,NA,NA,NA,NA
Homonoia_riparia,113,55,58,Alphahull-PointsKO-Adjacents,7186
Hoodia_parviflora,6,0,6,Points-PointsKO-Adjacents,53
Hopea_brachyptera,0,0,0,NA,0
Shorea_brevipetiolaris,0,0,0,NA,0
Hopea_chinensis,3,1,2,Points-PointsKO-Adjacents,27
Hopea_microptera,1,1,0,Points-PointsKO-Adjacents,9
Hopea_erosa,1,1,0,Points-PointsKO-Adjacents,9
Shorea_forbesii,18,10,8,Points-PointsKO-Adjacents,88
Hopea_foxworthyi,3,3,0,Points-PointsKO-Adjacents,24
Hopea_hainanensis,6,0,6,Points-PointsKO-Adjacents,45
Vatica_helferi,NA,NA,NA,NA,NA
Hopea_micrantha,1,1,0,Points-PointsKO-Adjacents,7
Hopea_odorata,19,3,16,Points-PointsKO-Adjacents,152
Hopea_polyalthioides,0,0,0,NA,0
Artocarpus_ponga,5,0,5,Points-PointsKO-Adjacents,33
Hopea_reticulata,0,0,0,NA,0
Hopea_shingkeng,0,0,0,NA,0
Hoplestigma_klaineanum,23,13,10,Points-PointsKO-Adjacents,154
Hornschuchia_bryotrophe,95,0,95,Points-PointsKO-Adjacents,483
Hornschuchia_cauliflora,10,0,10,Points-PointsKO-Adjacents,50
Hornschuchia_citriodora,18,6,12,Points-PointsKO-Adjacents,126
Hornschuchia_leptandra,7,1,6,Points-PointsKO-Adjacents,47
Hornschuchia_lianarum,17,12,5,Points-PointsKO-Adjacents,122
Hornschuchia_myrtillus,38,22,16,Alphahull-PointsKO-Adjacents,544
Hornschuchia_obliqua,10,7,3,Points-PointsKO-Adjacents,40
Hornschuchia_polyantha,25,15,10,Points-PointsKO-Adjacents,114
Hornschuchia_santosii,10,2,8,Points-PointsKO-Adjacents,68
Horovitzia_cnidoscoloides,12,7,5,Points-PointsKO-Adjacents,35
Horsfieldia_amplomontana,0,0,0,NA,0
Horsfieldia_amygdalina,9,2,7,Points-PointsKO-Adjacents,81
Horsfieldia_ardisiifolia,4,4,0,Points-PointsKO-Adjacents,35
Horsfieldia_brachiata,6,2,4,Points-PointsKO-Adjacents,45
Myristica_carnosa,3,3,0,Points-PointsKO-Adjacents,27
Myristica_costulata,13,0,13,Points-PointsKO-Adjacents,106
Horsfieldia_crassifolia,9,0,9,Points-PointsKO-Adjacents,76
Horsfieldia_endertii,1,1,0,Points-PointsKO-Adjacents,9
Myristica_flocculosa,1,1,0,Points-PointsKO-Adjacents,9
Horsfieldia_glabra,1,0,1,Points-PointsKO-Adjacents,9
Horsfieldia_grandis,9,4,5,Points-PointsKO-Adjacents,75
Myristica_hellwigii,55,36,19,Alphahull-PointsKO-Adjacents,719
Horsfieldia_irya,34,1,33,Points-PointsKO-Adjacents,265
Horsfieldia_iryaghedhi,2,1,1,Points-PointsKO-Adjacents,18
Horsfieldia_kingii,8,0,8,Points-PointsKO-Adjacents,72
Myristica_laevigata,48,21,27,Alphahull-PointsKO-Adjacents,1564
Myristica_macrothyrsa,1,1,0,Points-PointsKO-Adjacents,9
Myristica_majuscula,4,4,0,Points-PointsKO-Adjacents,34
Horsfieldia_montana,0,0,0,NA,0
Myristica_motleyi,2,0,2,Points-PointsKO-Adjacents,18
Myristica_oligocarpa,1,1,0,Points-PointsKO-Adjacents,9
Horsfieldia_palauensis,2,2,0,Points-PointsKO-Adjacents,8
Horsfieldia_pallidicaula,6,0,6,Points-PointsKO-Adjacents,54
Myristica_parviflora,16,0,16,Points-PointsKO-Adjacents,122
Myristica_paucinervis,1,1,0,Points-PointsKO-Adjacents,9
Myristica_polyantha,6,0,6,Points-PointsKO-Adjacents,53
Horsfieldia_polyspherula,37,19,18,Points-PointsKO-Adjacents,242
Myristica_pulverulenta,9,4,5,Points-PointsKO-Adjacents,80
Horsfieldia_punctatifolia,11,4,7,Points-PointsKO-Adjacents,87
Myristica_reticulata,9,3,6,Points-PointsKO-Adjacents,79
Myristica_ridleyana,3,3,0,Points-PointsKO-Adjacents,27
Horsfieldia_rufolanata,NA,NA,NA,NA,NA
Horsfieldia_sparsa,2,2,0,Points-PointsKO-Adjacents,18
Horsfieldia_spicata,43,18,25,Points-PointsKO-Adjacents,305
Horsfieldia_splendida,3,2,1,Points-PointsKO-Adjacents,27
Myristica_subtilis,57,31,26,Alphahull-PointsKO-Adjacents,1833
Myristica_superba,5,2,3,Points-PointsKO-Adjacents,39
Horsfieldia_sylvestris,62,25,37,Alphahull-PointsKO-Adjacents,2404
Horsfieldia_tomentosa,4,4,0,Points-PointsKO-Adjacents,36
Myristica_tuberculata,26,7,19,Points-PointsKO-Adjacents,194
Myristica_valida,58,13,45,Points-PointsKO-Adjacents,419
Myristica_wallichii,13,0,13,Points-PointsKO-Adjacents,105
Hortia_brasiliana,423,328,95,Alphahull-PointsKO-Adjacents,9376
Hortia_coccinea,27,13,14,Points-PointsKO-Adjacents,237
Hortia_excelsa,17,5,12,Points-PointsKO-Adjacents,153
Hortia_longifolia,43,16,27,Points-PointsKO-Adjacents,344
Hortia_neblinensis,1,1,0,Points-PointsKO-Adjacents,9
Hortia_regia,9,2,7,Points-PointsKO-Adjacents,81
Hortia_superba,21,0,21,Points-PointsKO-Adjacents,137
Hortia_vandelliana,7,1,6,Points-PointsKO-Adjacents,53
Hottea_crispula,0,0,0,NA,0
Hottea_ekmanii,1,1,0,Points-PointsKO-Adjacents,9
Hottea_malangensis,0,0,0,NA,0
Hottea_miragoanae,1,1,0,Points-PointsKO-Adjacents,7
Hottea_moana,3,3,0,Points-PointsKO-Adjacents,17
Hovea_elliptica,347,0,347,Points-PointsKO-Adjacents,570
Hovenia_acerba,130,95,35,Alphahull-PointsKO-Adjacents,15078
Hovenia_dulcis,257,135,122,Alphahull-PointsKO-Adjacents,3531
Hovenia_trichocarpa,47,21,26,Alphahull-PointsKO-Adjacents,1852
Howea_belmoreana,18,13,5,Points-PointsKO-Adjacents,5
Howea_forsteriana,44,19,25,Points-PointsKO-Adjacents,94
Huberia_carvalhoi,13,4,9,Points-PointsKO-Adjacents,93
Huberia_consimilis,59,38,21,Alphahull-PointsKO-Adjacents,687
Huberia_espiritosantensis,39,30,9,Alphahull-PointsKO-Adjacents,196
Huberia_glazioviana,21,11,10,Points-PointsKO-Adjacents,107
Huberia_laurina,30,17,13,Points-PointsKO-Adjacents,238
Huberia_minor,8,0,8,Points-PointsKO-Adjacents,61
Huberia_nettoana,37,23,14,Alphahull-PointsKO-Adjacents,248
Huberia_ovalifolia,119,0,119,Points-PointsKO-Adjacents,610
Huberia_semiserrata,76,49,27,Alphahull-PointsKO-Adjacents,468
Huberia_triplinervis,3,3,0,Points-PointsKO-Adjacents,27
Huberodendron_allenii,16,12,4,Points-PointsKO-Adjacents,38
Huberodendron_patinoi,69,54,15,Alphahull-PointsKO-Adjacents,1134
Huberodendron_swietenioides,192,136,56,Alphahull-PointsKO-Adjacents,13161
Hubertia_hypargyrea,39,22,17,Alphahull-PointsKO-Adjacents,386
Hubertia_myricifolia,75,58,17,Alphahull-PointsKO-Adjacents,1196
Huertea_cubensis,18,3,15,Points-PointsKO-Adjacents,142
Huertea_glandulosa,273,219,54,Alphahull-PointsKO-Adjacents,7149
Huertea_granadina,22,8,14,Points-PointsKO-Adjacents,174
Huertea_putumayensis,2,2,0,Points-PointsKO-Adjacents,18
Hugonia_afzelii,37,27,10,Alphahull-PointsKO-Adjacents,722
Hugonia_orientalis,45,18,27,Points-PointsKO-Adjacents,377
Hugonia_planchonii,166,111,55,Alphahull-PointsKO-Adjacents,5111
Hugonia_platysepala,164,106,58,Alphahull-PointsKO-Adjacents,5710
Hugonia_villosa,3,1,2,Points-PointsKO-Adjacents,21
Huilaea_ecuadorensis,4,4,0,Points-PointsKO-Adjacents,23
Huilaea_minor,1,1,0,Points-PointsKO-Adjacents,9
Humbertia_madagascariensis,44,29,15,Alphahull-PointsKO-Adjacents,105
Humbertiella_decaryi,57,43,14,Alphahull-PointsKO-Adjacents,1078
Humbertiella_foliosa,4,4,0,Points-PointsKO-Adjacents,31
Humbertiella_henricii,20,12,8,Points-PointsKO-Adjacents,103
Humbertiodendron_saboureaui,4,4,0,Points-PointsKO-Adjacents,15
Humbertioturraea_grandidieri,7,0,7,Points-PointsKO-Adjacents,63
Humbertioturraea_maculata,5,5,0,Points-PointsKO-Adjacents,36
Humboldtia_bourdillonii,0,0,0,NA,0
Humboldtia_brunonis,0,0,0,NA,0
Humboldtia_decurrens,0,0,0,NA,0
Humboldtia_laurifolia,3,3,0,Points-PointsKO-Adjacents,27
Humboldtia_trijuga,NA,NA,NA,NA,NA
Humboldtia_unijuga,0,0,0,NA,0
Humboldtia_vahliana,1,1,0,Points-PointsKO-Adjacents,9
Humiria_balsamifera,1493,1332,161,Alphahull-PointsKO-Adjacents,75842
Humiria_crassifolia,35,16,19,Points-PointsKO-Adjacents,240
Humiriastrum_colombianum,16,0,16,Points-PointsKO-Adjacents,134
Humiriastrum_cuspidatum,116,68,48,Alphahull-PointsKO-Adjacents,3675
Humiriastrum_dentatum,83,62,21,Alphahull-PointsKO-Adjacents,1949
Humiriastrum_diguense,119,90,29,Alphahull-PointsKO-Adjacents,884
Humiriastrum_excelsum,48,18,30,Points-PointsKO-Adjacents,338
Humiriastrum_glaziovii,82,0,82,Points-PointsKO-Adjacents,509
Humiriastrum_liesneri,3,3,0,Points-PointsKO-Adjacents,21
Humiriastrum_mapiriense,12,7,5,Points-PointsKO-Adjacents,61
Humiriastrum_melanocarpum,4,1,3,Points-PointsKO-Adjacents,36
Humiriastrum_obovatum,15,4,11,Points-PointsKO-Adjacents,132
Humiriastrum_ottohuberi,5,5,0,Points-PointsKO-Adjacents,45
Humiriastrum_piraparanense,43,27,16,Alphahull-PointsKO-Adjacents,2142
Humiriastrum_procerum,36,25,11,Alphahull-PointsKO-Adjacents,164
Humiriastrum_spiritu-sancti,28,12,16,Points-PointsKO-Adjacents,145
Humiriastrum_subcrenatum,7,4,3,Points-PointsKO-Adjacents,42
Humiriastrum_villosum,10,1,9,Points-PointsKO-Adjacents,90
Hunga_cordata,6,1,5,Points-PointsKO-Adjacents,9
Hunga_gerontogea,8,1,7,Points-PointsKO-Adjacents,41
Hunga_guillauminii,2,2,0,Points-PointsKO-Adjacents,9
Hunga_lifouana,2,2,0,Points-PointsKO-Adjacents,10
Hunga_longifolia,2,2,0,Points-PointsKO-Adjacents,15
Hunga_mackeeana,9,3,6,Points-PointsKO-Adjacents,47
Hunga_minutiflora,5,0,5,Points-PointsKO-Adjacents,24
Hunga_novoguineensis,3,3,0,Points-PointsKO-Adjacents,15
Hunga_papuana,8,4,4,Points-PointsKO-Adjacents,38
Hunga_rhamnoides,24,14,10,Points-PointsKO-Adjacents,100
Hunteria_ballayi,26,18,8,Points-PointsKO-Adjacents,118
Hunteria_congolana,25,12,13,Points-PointsKO-Adjacents,169
Hunteria_densiflora,1,1,0,Points-PointsKO-Adjacents,9
Hunteria_ghanensis,6,3,3,Points-PointsKO-Adjacents,42
Hunteria_macrosiphon,9,4,5,Points-PointsKO-Adjacents,67
Hunteria_myriantha,3,3,0,Points-PointsKO-Adjacents,27
Hunteria_oxyantha,10,5,5,Points-PointsKO-Adjacents,57
Hunteria_simii,57,46,11,Alphahull-PointsKO-Adjacents,1221
Hunteria_umbellata,165,112,53,Alphahull-PointsKO-Adjacents,4054
Hunteria_zeylanica,30,6,24,Points-PointsKO-Adjacents,246
Huodendron_biaristatum,52,25,27,Alphahull-PointsKO-Adjacents,1732
Huodendron_tibeticum,17,5,12,Points-PointsKO-Adjacents,101
Huodendron_tomentosum,2,2,0,Points-PointsKO-Adjacents,18
Hura_crepitans,976,801,175,Alphahull-PointsKO-Adjacents,31039
Hura_polyandra,176,108,68,Alphahull-PointsKO-Adjacents,7374
Hyaenanche_globosa,10,0,10,Points-PointsKO-Adjacents,54
Hyaloseris_camataquiensis,7,1,6,Points-PointsKO-Adjacents,63
Hybanthus_denticulatus,65,45,20,Alphahull-PointsKO-Adjacents,1121
Hybanthus_mexicanus,164,106,58,Alphahull-PointsKO-Adjacents,1654
Hybanthus_phyllanthoides,5,5,0,Points-PointsKO-Adjacents,45
Hybanthus_yucatanensis,241,212,29,Alphahull-PointsKO-Adjacents,1474
Hybosema_ehrenbergii,93,70,23,Alphahull-PointsKO-Adjacents,1237
Hybosema_robustum,11,1,10,Points-PointsKO-Adjacents,47
Hydnocarpus_annamensis,6,1,5,Points-PointsKO-Adjacents,54
Hydnocarpus_anthelminthicus,8,1,7,Points-PointsKO-Adjacents,68
Taraktogenos_calophyllum,3,0,3,Points-PointsKO-Adjacents,27
Hydnocarpus_hainanensis,10,1,9,Points-PointsKO-Adjacents,81
Taraktogenos_kunstleri,12,2,10,Points-PointsKO-Adjacents,107
Hydnocarpus_kurzii,0,0,0,NA,0
Hydnocarpus_pentandrus,1,0,1,Points-PointsKO-Adjacents,9
Hydnocarpus_kingii,8,0,8,Points-PointsKO-Adjacents,71
Ryparosa_sumatrana,24,7,17,Points-PointsKO-Adjacents,201
Hydrangea_aspera,76,39,37,Alphahull-PointsKO-Adjacents,2909
Hydrangea_diplostemona,38,0,38,Points-PointsKO-Adjacents,223
Hydrangea_heteromalla,93,53,40,Alphahull-PointsKO-Adjacents,1292
Hydrangea_macrocarpa,8,2,6,Points-PointsKO-Adjacents,66
Hydrangea_paniculata,581,459,122,Alphahull-PointsKO-Adjacents,10109
Hydrangea_peruviana,339,287,52,Alphahull-PointsKO-Adjacents,3140
Hydrangea_preslii,56,29,27,Alphahull-PointsKO-Adjacents,1109
Hydrangea_robusta,50,32,18,Alphahull-PointsKO-Adjacents,234
Hydrangea_sungpanensis,57,42,15,Alphahull-PointsKO-Adjacents,559
Hydrangea_xanthoneura,49,30,19,Alphahull-PointsKO-Adjacents,2920
Hydriastele_affinis,0,0,0,NA,0
Hydriastele_aprica,NA,NA,NA,NA,NA
Hydriastele_beccariana,5,5,0,Points-PointsKO-Adjacents,45
Hydriastele_beguinii,5,5,0,Points-PointsKO-Adjacents,28
Hydriastele_boumae,0,0,0,NA,0
Hydriastele_brassii,4,4,0,Points-PointsKO-Adjacents,36
Hydriastele_cariosa,2,2,0,Points-PointsKO-Adjacents,18
Hydriastele_carrii,NA,NA,NA,NA,NA
Hydriastele_chaunostachys,8,4,4,Points-PointsKO-Adjacents,51
Hydriastele_costata,33,4,29,Points-PointsKO-Adjacents,262
Hydriastele_cyclopensis,NA,NA,NA,NA,NA
Hydriastele_cylindrocarpa,6,1,5,Points-PointsKO-Adjacents,35
Hydriastele_dransfieldii,4,4,0,Points-PointsKO-Adjacents,26
Hydriastele_flabellata,0,0,0,NA,0
Hydriastele_geelvinkiana,0,0,0,NA,0
Hydriastele_gibbsiana,3,3,0,Points-PointsKO-Adjacents,27
Hydriastele_gracilis,1,1,0,Points-PointsKO-Adjacents,9
Hydriastele_hombronii,2,2,0,Points-PointsKO-Adjacents,16
Hydriastele_kasesa,1,1,0,Points-PointsKO-Adjacents,9
Hydriastele_kjellbergii,0,0,0,NA,0
Hydriastele_ledermanniana,NA,NA,NA,NA,NA
Hydriastele_lepidota,1,1,0,Points-PointsKO-Adjacents,9
Hydriastele_longispatha,4,4,0,Points-PointsKO-Adjacents,36
Hydriastele_lurida,1,1,0,Points-PointsKO-Adjacents,9
Hydriastele_macrospadix,0,0,0,NA,0
Hydriastele_manusii,1,1,0,Points-PointsKO-Adjacents,9
Hydriastele_mayrii,0,0,0,NA,0
Hydriastele_micrantha,1,1,0,Points-PointsKO-Adjacents,9
Hydriastele_microcarpa,0,0,0,NA,0
Hydriastele_microspadix,59,41,18,Alphahull-PointsKO-Adjacents,2472
Hydriastele_moluccana,3,3,0,Points-PointsKO-Adjacents,26
Hydriastele_montana,0,0,0,NA,0
Hydriastele_nannostachys,1,1,0,Points-PointsKO-Adjacents,9
Hydriastele_oxypetala,0,0,0,NA,0
Hydriastele_palauensis,0,0,0,NA,0
Hydriastele_pinangoides,12,6,6,Points-PointsKO-Adjacents,84
Hydriastele_pleurocarpa,NA,NA,NA,NA,NA
Hydriastele_procera,1,1,0,Points-PointsKO-Adjacents,9
Hydriastele_ramsayi,166,156,10,Alphahull-PointsKO-Adjacents,802
Hydriastele_rheophytica,0,0,0,NA,0
Hydriastele_rhopalocarpa,3,3,0,Points-PointsKO-Adjacents,27
Hydriastele_rostrata,0,0,0,NA,0
Hydriastele_sarasinorum,0,0,0,NA,0
Hydriastele_selebica,0,0,0,NA,0
Hydriastele_valida,2,2,0,Points-PointsKO-Adjacents,16
Hydriastele_variabilis,2,2,0,Points-PointsKO-Adjacents,18
Hydriastele_vitiensis,0,0,0,NA,0
Hydriastele_wendlandiana,370,321,49,Alphahull-PointsKO-Adjacents,1265
Hydrochorea_corymbosa,606,523,83,Alphahull-PointsKO-Adjacents,59725
Hydrochorea_gonggrijpii,79,0,79,Points-PointsKO-Adjacents,580
Hydrochorea_marginata,258,219,39,Alphahull-PointsKO-Adjacents,16244
Hydrogaster_trinervis,77,0,77,Points-PointsKO-Adjacents,489
Hylaea_arborescens,1,1,0,Points-PointsKO-Adjacents,9
Hylandia_dockrillii,94,83,11,Alphahull-PointsKO-Adjacents,112
Hylenaea_comosa,48,14,34,Points-PointsKO-Adjacents,359
Hylocarpa_heterocarpa,9,3,6,Points-PointsKO-Adjacents,68
Hylocereus_undatus,0,0,0,NA,0
Hylodendron_gabunense,107,77,30,Alphahull-PointsKO-Adjacents,3246
Hymenaea_aurea,68,35,33,Alphahull-PointsKO-Adjacents,473
Hymenaea_courbaril,3057,2767,290,Alphahull-PointsKO-Adjacents,141594
Hymenaea_eriogyne,284,252,32,Alphahull-PointsKO-Adjacents,13319
Hymenaea_intermedia,143,69,74,Alphahull-PointsKO-Adjacents,8344
Hymenaea_longifolia,185,129,56,Alphahull-PointsKO-Adjacents,8892
Hymenaea_maranhensis,42,30,12,Alphahull-PointsKO-Adjacents,2535
Hymenaea_martiana,666,4,662,Points-PointsKO-Adjacents,4715
Hymenaea_oblongifolia,366,268,98,Alphahull-PointsKO-Adjacents,26005
Hymenaea_parvifolia,361,291,70,Alphahull-PointsKO-Adjacents,31930
Hymenaea_reticulata,29,10,19,Points-PointsKO-Adjacents,198
Hymenaea_rubriflora,138,0,138,Points-PointsKO-Adjacents,547
Hymenaea_stigonocarpa,1212,1135,77,Alphahull-PointsKO-Adjacents,38344
Hymenaea_torrei,2,2,0,Points-PointsKO-Adjacents,18
Hymenaea_velutina,155,137,18,Alphahull-PointsKO-Adjacents,5913
Hymenaea_verrucosa,147,93,54,Alphahull-PointsKO-Adjacents,2049
Hymenandra_acutissima,4,4,0,Points-PointsKO-Adjacents,36
Hymenandra_callejasii,3,3,0,Points-PointsKO-Adjacents,21
Hymenandra_pittieri,130,114,16,Alphahull-PointsKO-Adjacents,527
Hymenandra_stenophylla,55,43,12,Alphahull-PointsKO-Adjacents,282
Hymenandra_wilburiana,25,17,8,Points-PointsKO-Adjacents,93
Hymenocardia_acida,962,843,119,Alphahull-PointsKO-Adjacents,22070
Hymenocardia_heudelotii,36,17,19,Points-PointsKO-Adjacents,305
Hymenocardia_lyrata,45,30,15,Alphahull-PointsKO-Adjacents,1309
Hymenocardia_punctata,23,12,11,Points-PointsKO-Adjacents,191
Hymenocardia_ripicola,7,1,6,Points-PointsKO-Adjacents,45
Hymenocardia_ulmoides,126,61,65,Alphahull-PointsKO-Adjacents,2685
Hymenodictyon_antakaranensis,9,3,6,Points-PointsKO-Adjacents,24
Hymenodictyon_berivotrense,18,7,11,Points-PointsKO-Adjacents,133
Hymenodictyon_biafranum,81,60,21,Alphahull-PointsKO-Adjacents,1693
Hymenodictyon_embergeri,7,0,7,Points-PointsKO-Adjacents,55
Hymenodictyon_flaccidum,10,1,9,Points-PointsKO-Adjacents,84
Hymenodictyon_floribundum,234,135,99,Alphahull-PointsKO-Adjacents,7025
Hymenodictyon_glabrum,7,0,7,Points-PointsKO-Adjacents,59
Hymenodictyon_horsfieldii,2,2,0,Points-PointsKO-Adjacents,16
Hymenodictyon_leandrii,9,3,6,Points-PointsKO-Adjacents,49
Hymenodictyon_louhavate,18,6,12,Points-PointsKO-Adjacents,121
Hymenodictyon_madagascaricum,16,9,7,Points-PointsKO-Adjacents,46
Hymenodictyon_obovatum,1,1,0,Points-PointsKO-Adjacents,9
Hymenodictyon_orixense,17,1,16,Points-PointsKO-Adjacents,135
Hymenodictyon_pachyantha,1,1,0,Points-PointsKO-Adjacents,9
Hymenodictyon_parvifolium,65,28,37,Alphahull-PointsKO-Adjacents,2727
Hymenodictyon_perrieri,24,19,5,Points-PointsKO-Adjacents,146
Hymenodictyon_septentrionale,13,8,5,Points-PointsKO-Adjacents,51
Hymenodictyon_timoranum,0,0,0,NA,0
Hymenodictyon_tsingy,7,2,5,Points-PointsKO-Adjacents,33
Hymenolobium_alagoanum,106,68,38,Alphahull-PointsKO-Adjacents,1992
Hymenolobium_elatum,2,2,0,Points-PointsKO-Adjacents,18
Hymenolobium_excelsum,102,44,58,Alphahull-PointsKO-Adjacents,4817
Hymenolobium_flavum,46,0,46,Points-PointsKO-Adjacents,334
Hymenolobium_grazielanum,6,1,5,Points-PointsKO-Adjacents,54
Hymenolobium_heringeranum,42,27,15,Alphahull-PointsKO-Adjacents,974
Hymenolobium_heterocarpum,60,29,31,Alphahull-PointsKO-Adjacents,686
Hymenolobium_janeirense,180,139,41,Alphahull-PointsKO-Adjacents,4379
Hymenolobium_mesoamericanum,39,25,14,Alphahull-PointsKO-Adjacents,401
Hymenolobium_modestum,49,24,25,Alphahull-PointsKO-Adjacents,2428
Hymenolobium_nitidum,51,17,34,Points-PointsKO-Adjacents,415
Hymenolobium_petraeum,114,73,41,Alphahull-PointsKO-Adjacents,14734
Hymenolobium_pulcherrimum,78,30,48,Alphahull-PointsKO-Adjacents,716
Hymenolobium_sericeum,38,14,24,Points-PointsKO-Adjacents,278
Hymenolobium_velutinum,22,11,11,Points-PointsKO-Adjacents,184
Hymenosporum_flavum,972,880,92,Alphahull-PointsKO-Adjacents,2344
Hymenostegia_bakeriana,13,9,4,Points-PointsKO-Adjacents,39
Hymenostegia_brachyura,14,6,8,Points-PointsKO-Adjacents,117
Hymenostegia_felicis,18,11,7,Points-PointsKO-Adjacents,97
Hymenostegia_floribunda,52,39,13,Alphahull-PointsKO-Adjacents,418
Hymenostegia_gracilipes,15,13,2,Points-PointsKO-Adjacents,80
Hymenostegia_klainei,55,44,11,Alphahull-PointsKO-Adjacents,787
Hymenostegia_mundungu,13,4,9,Points-PointsKO-Adjacents,95
Hymenostegia_neoaubrevillei,9,6,3,Points-PointsKO-Adjacents,63
Hymenostegia_normandii,20,6,14,Points-PointsKO-Adjacents,110
Hymenostegia_pellegrinii,92,79,13,Alphahull-PointsKO-Adjacents,1198
Hymenostegia_talbotii,1,1,0,Points-PointsKO-Adjacents,9
Hyophorbe_amaricaulis,1,0,1,Points-PointsKO-Adjacents,9
Hyophorbe_indica,3,3,0,Points-PointsKO-Adjacents,21
Hyophorbe_lagenicaulis,1,0,1,Points-PointsKO-Adjacents,9
Hyophorbe_vaughanii,0,0,0,NA,0
Hyophorbe_verschaffeltii,0,0,0,NA,0
Hyospathe_elegans,1127,1026,101,Alphahull-PointsKO-Adjacents,47893
Hyospathe_frontinensis,9,3,6,Points-PointsKO-Adjacents,31
Hyospathe_peruviana,5,5,0,Points-PointsKO-Adjacents,21
Hypelate_trifoliata,77,46,31,Alphahull-PointsKO-Adjacents,2367
Hyperacanthus_ambovombensis,27,19,8,Points-PointsKO-Adjacents,166
Hyperacanthus_amoenus,91,62,29,Alphahull-PointsKO-Adjacents,1952
Hyperacanthus_grevei,22,13,9,Points-PointsKO-Adjacents,145
Hyperacanthus_madagascariensis,4,4,0,Points-PointsKO-Adjacents,26
Hyperacanthus_mandenensis,33,1,32,Points-PointsKO-Adjacents,72
Hyperacanthus_microphyllus,8,2,6,Points-PointsKO-Adjacents,72
Hyperacanthus_perrieri,22,10,12,Points-PointsKO-Adjacents,156
Hyperacanthus_pervillei,3,3,0,Points-PointsKO-Adjacents,26
Hyperacanthus_poivrei,28,17,11,Points-PointsKO-Adjacents,110
Hyperacanthus_ravinensis,6,0,6,Points-PointsKO-Adjacents,54
Hyperacanthus_talangninia,22,11,11,Points-PointsKO-Adjacents,126
Hyperbaena_allenii,8,1,7,Points-PointsKO-Adjacents,61
Hyperbaena_eladioana,19,12,7,Points-PointsKO-Adjacents,71
Hyperbaena_jalcomulcensis,15,1,14,Points-PointsKO-Adjacents,62
Hyperbaena_laurifolia,15,9,6,Points-PointsKO-Adjacents,46
Hyperbaena_leptobotryosa,87,70,17,Alphahull-PointsKO-Adjacents,457
Hyperbaena_mexicana,203,165,38,Alphahull-PointsKO-Adjacents,5163
Hyperbaena_tonduzii,72,53,19,Alphahull-PointsKO-Adjacents,586
Hyperbaena_domingensis,107,22,85,Alphahull-PointsKO-Adjacents,890
Hyperbaena_winzerlingii,129,116,13,Alphahull-PointsKO-Adjacents,1452
Hypericum_balfourii,5,5,0,Points-PointsKO-Adjacents,21
Hypericum_bequaertii,9,7,2,Points-PointsKO-Adjacents,35
Hypericum_chapmanii,20,14,6,Points-PointsKO-Adjacents,115
Hypericum_gnidiifolium,0,0,0,NA,0
Hypericum_hircinum,355,0,355,Points-PointsKO-Adjacents,1646
Hypericum_irazuense,57,51,6,Alphahull-PointsKO-Adjacents,68
Hypericum_lanceolatum,9,3,6,Points-PointsKO-Adjacents,38
Hypericum_lancifolium,12,5,7,Points-PointsKO-Adjacents,82
Hypericum_laricifolium,163,129,34,Alphahull-PointsKO-Adjacents,1132
Hypericum_paramitanum,0,0,0,NA,0
Hypericum_phellos,14,9,5,Points-PointsKO-Adjacents,57
Hypericum_quartinianum,46,24,22,Alphahull-PointsKO-Adjacents,476
Hypericum_revolutum,170,98,72,Alphahull-PointsKO-Adjacents,2775
Hypericum_roeperianum,49,18,31,Points-PointsKO-Adjacents,327
Hypericum_socotranum,3,3,0,Points-PointsKO-Adjacents,23
Hypericum_stenopetalum,8,0,8,Points-PointsKO-Adjacents,72
Hypericum_styphelioides,31,16,15,Points-PointsKO-Adjacents,134
Hyphaene_compressa,62,34,28,Alphahull-PointsKO-Adjacents,1624
Hyphaene_coriacea,114,51,63,Alphahull-PointsKO-Adjacents,952
Hyphaene_dichotoma,0,0,0,NA,0
Hyphaene_guineensis,20,3,17,Points-PointsKO-Adjacents,127
Hyphaene_macrosperma,NA,NA,NA,NA,NA
Hyphaene_petersiana,149,101,48,Alphahull-PointsKO-Adjacents,3972
Hyphaene_reptans,8,0,8,Points-PointsKO-Adjacents,59
Hyphaene_thebaica,220,154,66,Alphahull-PointsKO-Adjacents,2911
Hypobathrum_coniferum,NA,NA,NA,NA,NA
Hypobathrum_glabrum,NA,NA,NA,NA,NA
Hypobathrum_hirtum,1,1,0,Points-PointsKO-Adjacents,9
Hypobathrum_longifolium,1,1,0,Points-PointsKO-Adjacents,9
Hypobathrum_microcarpum,4,4,0,Points-PointsKO-Adjacents,36
Hypobathrum_multibracteatum,NA,NA,NA,NA,NA
Hypobathrum_parviflorum,0,0,0,NA,0
Hypobathrum_racemosum,6,0,6,Points-PointsKO-Adjacents,54
Hypobathrum_venulosum,1,1,0,Points-PointsKO-Adjacents,9
Hypocalymma_angustifolium,824,728,96,Alphahull-PointsKO-Adjacents,2179
Hypocalyptus_sophoroides,68,59,9,Alphahull-PointsKO-Adjacents,549
Hypodaphnis_zenkeri,61,47,14,Alphahull-PointsKO-Adjacents,738
Hyptianthera_stricta,10,0,10,Points-PointsKO-Adjacents,90
Hyptidendron_arboreum,169,128,41,Alphahull-PointsKO-Adjacents,1314
Hyptidendron_arbusculum,4,4,0,Points-PointsKO-Adjacents,34
Hyptidendron_asperrimum,166,136,30,Alphahull-PointsKO-Adjacents,2627
Hyptidendron_canum,294,239,55,Alphahull-PointsKO-Adjacents,9730
Hyptidendron_claussenii,12,4,8,Points-PointsKO-Adjacents,108
Hyptidendron_conspersum,19,12,7,Points-PointsKO-Adjacents,166
Hyptidendron_glutinosum,20,7,13,Points-PointsKO-Adjacents,169
Hyptis_pachyphylla,20,12,8,Points-PointsKO-Adjacents,103
Hyptis_penaeoides,2,2,0,Points-PointsKO-Adjacents,18
Icuria_dunensis,8,2,6,Points-PointsKO-Adjacents,37
Idertia_axillaris,72,40,32,Alphahull-PointsKO-Adjacents,1129
Idesia_polycarpa,318,218,100,Alphahull-PointsKO-Adjacents,16088
Idiopappus_saloyensis,3,3,0,Points-PointsKO-Adjacents,27
Idiospermum_australiense,53,44,9,Alphahull-PointsKO-Adjacents,76
Idiothamnus_lilloi,19,4,15,Points-PointsKO-Adjacents,152
Ilex_abscondita,6,0,6,Points-PointsKO-Adjacents,35
Ilex_acutidenticulata,7,1,6,Points-PointsKO-Adjacents,38
Ilex_affinis,672,597,75,Alphahull-PointsKO-Adjacents,30327
Ilex_aggregata,53,36,17,Alphahull-PointsKO-Adjacents,387
Ilex_altiplana,4,4,0,Points-PointsKO-Adjacents,30
Ilex_amazonensis,4,4,0,Points-PointsKO-Adjacents,32
Ilex_ambigua,381,297,84,Alphahull-PointsKO-Adjacents,11835
Ilex_amboroica,15,7,8,Points-PointsKO-Adjacents,89
Ilex_amelanchier,72,45,27,Alphahull-PointsKO-Adjacents,837
Ilex_amplifolia,26,15,11,Points-PointsKO-Adjacents,153
Ilex_amygdalina,1,1,0,Points-PointsKO-Adjacents,9
Ilex_andicola,52,0,52,Points-PointsKO-Adjacents,386
Ilex_angulata,9,1,8,Points-PointsKO-Adjacents,81
Ilex_anomala,46,23,23,Alphahull-PointsKO-Adjacents,196
Ilex_anonoides,9,2,7,Points-PointsKO-Adjacents,66
Ilex_aquifolium,42532,34971,7561,Alphahull-PointsKO-Adjacents,50478
Ilex_aracamuniana,4,4,0,Points-PointsKO-Adjacents,24
Ilex_ardisiifrons,4,4,0,Points-PointsKO-Adjacents,27
Ilex_argentina,84,62,22,Alphahull-PointsKO-Adjacents,837
Ilex_arimensis,1,1,0,Points-PointsKO-Adjacents,9
Ilex_arisanensis,19,10,9,Points-PointsKO-Adjacents,94
Ilex_atrata,5,1,4,Points-PointsKO-Adjacents,41
Ilex_austrosinensis,NA,NA,NA,NA,NA
Ilex_bahiahondica,2,2,0,Points-PointsKO-Adjacents,18
Ilex_bidens,1,1,0,Points-PointsKO-Adjacents,9
Ilex_bioritsensis,82,57,25,Alphahull-PointsKO-Adjacents,1563
Ilex_biserrulata,1,1,0,Points-PointsKO-Adjacents,9
Ilex_boliviana,28,0,28,Points-PointsKO-Adjacents,182
Ilex_brachyphylla,6,1,5,Points-PointsKO-Adjacents,54
Ilex_brandegeeana,158,124,34,Alphahull-PointsKO-Adjacents,3552
Ilex_brasiliensis,208,167,41,Alphahull-PointsKO-Adjacents,11224
Ilex_brevicuspis,511,465,46,Alphahull-PointsKO-Adjacents,6967
Ilex_brevipedicellata,2,2,0,Points-PointsKO-Adjacents,16
Ilex_buergeri,31,13,18,Points-PointsKO-Adjacents,259
Ilex_buxoides,4,4,0,Points-PointsKO-Adjacents,36
Ilex_casiquiarensis,12,8,4,Points-PointsKO-Adjacents,98
Ilex_cassine,353,267,86,Alphahull-PointsKO-Adjacents,4392
Ilex_cerasifolia,220,174,46,Alphahull-PointsKO-Adjacents,6298
Ilex_chamaebuxus,1,1,0,Points-PointsKO-Adjacents,9
Ilex_championii,21,10,11,Points-PointsKO-Adjacents,184
Ilex_chapaensis,32,12,20,Points-PointsKO-Adjacents,278
Ilex_chengbuensis,NA,NA,NA,NA,NA
Ilex_chengkouensis,1,1,0,Points-PointsKO-Adjacents,9
Ilex_cheniana,3,3,0,Points-PointsKO-Adjacents,27
Ilex_chinensis,206,9,197,Points-PointsKO-Adjacents,1569
Ilex_chingiana,13,4,9,Points-PointsKO-Adjacents,117
Ilex_chiriquensis,37,27,10,Alphahull-PointsKO-Adjacents,154
Ilex_chuniana,2,2,0,Points-PointsKO-Adjacents,18
Ilex_ciliolata,3,3,0,Points-PointsKO-Adjacents,21
Ilex_ciliospinosa,16,6,10,Points-PointsKO-Adjacents,144
Ilex_cinerea,1,1,0,Points-PointsKO-Adjacents,9
Ilex_clementis,2,2,0,Points-PointsKO-Adjacents,12
Ilex_cochinchinensis,44,30,14,Alphahull-PointsKO-Adjacents,91
Ilex_colchica,15,1,14,Points-PointsKO-Adjacents,108
Ilex_colombiana,27,0,27,Points-PointsKO-Adjacents,173
Ilex_condensata,33,17,16,Points-PointsKO-Adjacents,148
Ilex_confertiflora,16,6,10,Points-PointsKO-Adjacents,144
Ilex_conocarpa,154,118,36,Alphahull-PointsKO-Adjacents,6881
Ilex_cookii,1,1,0,Points-PointsKO-Adjacents,9
Ilex_corallina,71,50,21,Alphahull-PointsKO-Adjacents,5108
Ilex_cornuta,51,26,25,Alphahull-PointsKO-Adjacents,1761
Ilex_costaricensis,84,60,24,Alphahull-PointsKO-Adjacents,253
Ilex_cowanii,4,4,0,Points-PointsKO-Adjacents,27
Ilex_crassifolioides,10,0,10,Points-PointsKO-Adjacents,78
Ilex_crenata,561,359,202,Alphahull-PointsKO-Adjacents,3791
Ilex_cupreonitens,1,0,1,Points-PointsKO-Adjacents,9
Ilex_cuthbertii,1,0,1,Points-PointsKO-Adjacents,9
Ilex_cuzcoana,18,5,13,Points-PointsKO-Adjacents,145
Ilex_cyrtura,24,9,15,Points-PointsKO-Adjacents,119
Ilex_dabieshanensis,NA,NA,NA,NA,NA
Ilex_danielis,57,45,12,Alphahull-PointsKO-Adjacents,240
Ilex_daphnogenea,13,5,8,Points-PointsKO-Adjacents,90
Ilex_dasyphylla,20,7,13,Points-PointsKO-Adjacents,180
Ilex_davidsei,3,3,0,Points-PointsKO-Adjacents,24
Ilex_decidua,1560,1241,319,Alphahull-PointsKO-Adjacents,21754
Ilex_dehongensis,1,1,0,Points-PointsKO-Adjacents,9
Ilex_delavayi,19,10,9,Points-PointsKO-Adjacents,156
Ilex_denticulata,3,3,0,Points-PointsKO-Adjacents,27
Ilex_dianguiensis,NA,NA,NA,NA,NA
Ilex_dicarpa,NA,NA,NA,NA,NA
Ilex_dioica,9,1,8,Points-PointsKO-Adjacents,58
Ilex_diospyroides,9,2,7,Points-PointsKO-Adjacents,72
Ilex_dipyrena,53,27,26,Alphahull-PointsKO-Adjacents,1293
Ilex_discolor,398,332,66,Alphahull-PointsKO-Adjacents,7357
Ilex_diuretica,0,0,0,NA,0
Ilex_divaricata,187,140,47,Alphahull-PointsKO-Adjacents,8159
Ilex_dolichopoda,1,1,0,Points-PointsKO-Adjacents,9
Ilex_dugesii,7,0,7,Points-PointsKO-Adjacents,61
Ilex_dumosa,819,729,90,Alphahull-PointsKO-Adjacents,11044
Ilex_dunniana,22,7,15,Points-PointsKO-Adjacents,186
Ilex_editicostata,32,12,20,Points-PointsKO-Adjacents,288
Ilex_elliptica,4,4,0,Points-PointsKO-Adjacents,36
Ilex_elmerrilliana,28,8,20,Points-PointsKO-Adjacents,252
Ilex_embelioides,0,0,0,NA,0
Ilex_ericoides,8,1,7,Points-PointsKO-Adjacents,32
Ilex_euryoides,1,1,0,Points-PointsKO-Adjacents,9
Ilex_excelsa,12,0,12,Points-PointsKO-Adjacents,108
Ilex_fanshawei,6,2,4,Points-PointsKO-Adjacents,30
Ilex_fargesii,33,10,23,Points-PointsKO-Adjacents,293
Ilex_fengqingensis,2,2,0,Points-PointsKO-Adjacents,18
Ilex_ferruginea,4,4,0,Points-PointsKO-Adjacents,36
Ilex_ficifolia,18,8,10,Points-PointsKO-Adjacents,162
Ilex_ficoidea,255,193,62,Alphahull-PointsKO-Adjacents,8286
Ilex_floribunda,103,68,35,Alphahull-PointsKO-Adjacents,1686
Ilex_formosana,278,221,57,Alphahull-PointsKO-Adjacents,3758
Ilex_forrestii,26,18,8,Points-PointsKO-Adjacents,169
Ilex_fragilis,43,23,20,Alphahull-PointsKO-Adjacents,1803
Ilex_franchetiana,36,13,23,Points-PointsKO-Adjacents,323
Ilex_friburgensis,3,3,0,Points-PointsKO-Adjacents,27
Ilex_gabinetensis,34,15,19,Points-PointsKO-Adjacents,202
Ilex_gabrielleana,48,27,21,Alphahull-PointsKO-Adjacents,2198
Ilex_gardneriana,0,0,0,NA,0
Ilex_georgei,13,6,7,Points-PointsKO-Adjacents,89
Ilex_gintungensis,1,1,0,Points-PointsKO-Adjacents,9
Ilex_glabella,2,2,0,Points-PointsKO-Adjacents,15
Ilex_glaucophylla,5,5,0,Points-PointsKO-Adjacents,42
Ilex_gleasoniana,8,1,7,Points-PointsKO-Adjacents,60
Ilex_glomerata,15,0,15,Points-PointsKO-Adjacents,102
Ilex_godajam,9,1,8,Points-PointsKO-Adjacents,72
Ilex_goshiensis,153,126,27,Alphahull-PointsKO-Adjacents,409
Ilex_gotardensis,6,2,4,Points-PointsKO-Adjacents,50
Ilex_goudotii,39,15,24,Points-PointsKO-Adjacents,190
Ilex_graciliflora,0,0,0,NA,0
Ilex_gracilis,NA,NA,NA,NA,NA
Ilex_grandis,5,5,0,Points-PointsKO-Adjacents,45
Ilex_guaiquinimae,1,1,0,Points-PointsKO-Adjacents,9
Ilex_guangnanensis,1,1,0,Points-PointsKO-Adjacents,9
Ilex_guayusa,140,98,42,Alphahull-PointsKO-Adjacents,3505
Ilex_guianensis,345,241,104,Alphahull-PointsKO-Adjacents,15478
Ilex_guizhouensis,NA,NA,NA,NA,NA
Ilex_gundlachiana,8,3,5,Points-PointsKO-Adjacents,51
Ilex_haberi,17,0,17,Points-PointsKO-Adjacents,50
Ilex_hainanensis,28,0,28,Points-PointsKO-Adjacents,237
Ilex_hanceana,1,1,0,Points-PointsKO-Adjacents,9
Ilex_hayatana,16,15,1,Points-PointsKO-Adjacents,89
Ilex_hemiepiphytica,30,19,11,Points-PointsKO-Adjacents,124
Ilex_hippocrateoides,70,45,25,Alphahull-PointsKO-Adjacents,468
Ilex_hirsuta,7,0,7,Points-PointsKO-Adjacents,63
Ilex_holstii,3,3,0,Points-PointsKO-Adjacents,17
Ilex_hookeri,6,1,5,Points-PointsKO-Adjacents,51
Ilex_huachamacariana,6,0,6,Points-PointsKO-Adjacents,39
Ilex_hualgayoca,31,15,16,Points-PointsKO-Adjacents,202
Ilex_hylonoma,18,2,16,Points-PointsKO-Adjacents,162
Ilex_hypaneura,5,5,0,Points-PointsKO-Adjacents,42
Prinos_hypoglaucus,2,2,0,Points-PointsKO-Adjacents,18
Ilex_ignicola,4,4,0,Points-PointsKO-Adjacents,27
Ilex_integerrima,110,51,59,Alphahull-PointsKO-Adjacents,1630
Ilex_integra,330,171,159,Alphahull-PointsKO-Adjacents,3409
Ilex_intermedia,9,1,8,Points-PointsKO-Adjacents,81
Ilex_intricata,8,2,6,Points-PointsKO-Adjacents,45
Ilex_inundata,256,181,75,Alphahull-PointsKO-Adjacents,31899
Ilex_jauaensis,1,1,0,Points-PointsKO-Adjacents,9
Ilex_jelskii,2,2,0,Points-PointsKO-Adjacents,18
Ilex_jenmanii,111,90,21,Alphahull-PointsKO-Adjacents,3929
Ilex_jiaolingensis,NA,NA,NA,NA,NA
Ilex_jinyunensis,NA,NA,NA,NA,NA
Ilex_julianii,1,1,0,Points-PointsKO-Adjacents,9
Ilex_juttana,30,10,20,Points-PointsKO-Adjacents,224
Ilex_karuaiana,2,2,0,Points-PointsKO-Adjacents,18
Ilex_kaushue,9,1,8,Points-PointsKO-Adjacents,81
Ilex_kengii,11,2,9,Points-PointsKO-Adjacents,99
Ilex_khasiana,0,0,0,NA,0
Ilex_kiangsiensis,1,1,0,Points-PointsKO-Adjacents,9
Ilex_insignis,3,3,0,Points-PointsKO-Adjacents,25
Ilex_kobuskiana,3,3,0,Points-PointsKO-Adjacents,27
Ilex_krugiana,11,1,10,Points-PointsKO-Adjacents,74
Ilex_kunthiana,112,89,23,Alphahull-PointsKO-Adjacents,1584
Ilex_kusanoi,20,13,7,Points-PointsKO-Adjacents,37
Ilex_kwangtungensis,54,35,19,Alphahull-PointsKO-Adjacents,3120
Ilex_laevigata,202,142,60,Alphahull-PointsKO-Adjacents,2856
Ilex_lamprophylla,122,97,25,Alphahull-PointsKO-Adjacents,476
Ilex_lancilimba,8,2,6,Points-PointsKO-Adjacents,72
Ilex_lasseri,1,1,0,Points-PointsKO-Adjacents,9
Ilex_latifolia,98,40,58,Alphahull-PointsKO-Adjacents,1128
Ilex_latifrons,1,1,0,Points-PointsKO-Adjacents,9
Ilex_laureola,9,0,9,Points-PointsKO-Adjacents,81
Ilex_laurina,267,211,56,Alphahull-PointsKO-Adjacents,4917
Ilex_liana,3,3,0,Points-PointsKO-Adjacents,27
Ilex_liangii,4,4,0,Points-PointsKO-Adjacents,36
Ilex_liebmannii,29,14,15,Points-PointsKO-Adjacents,182
Ilex_linii,NA,NA,NA,NA,NA
Ilex_litseifolia,0,0,0,NA,0
Ilex_lohfauensis,43,27,16,Alphahull-PointsKO-Adjacents,1854
Ilex_longicaudata,2,2,0,Points-PointsKO-Adjacents,18
Ilex_longipes,104,77,27,Alphahull-PointsKO-Adjacents,5865
Ilex_longipetiolata,7,0,7,Points-PointsKO-Adjacents,57
Ilex_longzhouensis,2,2,0,Points-PointsKO-Adjacents,18
Ilex_lonicerifolia,90,78,12,Alphahull-PointsKO-Adjacents,231
Ilex_loretoica,2,2,0,Points-PointsKO-Adjacents,18
Ilex_lundii,84,52,32,Alphahull-PointsKO-Adjacents,1898
Ilex_maasiana,9,4,5,Points-PointsKO-Adjacents,54
Ilex_macarenensis,24,9,15,Points-PointsKO-Adjacents,173
Ilex_macfadyenii,110,80,30,Alphahull-PointsKO-Adjacents,888
Ilex_machilifolia,1,1,0,Points-PointsKO-Adjacents,9
Ilex_maclurei,0,0,0,NA,0
Ilex_macrocarpa,87,57,30,Alphahull-PointsKO-Adjacents,9709
Ilex_macropoda,420,305,115,Alphahull-PointsKO-Adjacents,3027
Ilex_magnifructa,8,4,4,Points-PointsKO-Adjacents,63
Ilex_malabarica,2,2,0,Points-PointsKO-Adjacents,18
Ilex_mamillata,NA,NA,NA,NA,NA
Ilex_mandonii,16,7,9,Points-PointsKO-Adjacents,90
Ilex_manneiensis,3,3,0,Points-PointsKO-Adjacents,27
Ilex_marahuacae,4,4,0,Points-PointsKO-Adjacents,23
Ilex_marginata,6,2,4,Points-PointsKO-Adjacents,36
Ilex_marlipoensis,2,2,0,Points-PointsKO-Adjacents,18
Ilex_martiniana,31,18,13,Points-PointsKO-Adjacents,242
Ilex_mathewsii,8,1,7,Points-PointsKO-Adjacents,66
Ilex_maxima,77,49,28,Alphahull-PointsKO-Adjacents,786
Ilex_maximowicziana,115,96,19,Alphahull-PointsKO-Adjacents,218
Ilex_medogensis,1,1,0,Points-PointsKO-Adjacents,9
Ilex_melanotricha,12,8,4,Points-PointsKO-Adjacents,71
Ilex_memecylifolia,10,0,10,Points-PointsKO-Adjacents,90
Ilex_metabaptista,11,5,6,Points-PointsKO-Adjacents,99
Ilex_micrantha,10,5,5,Points-PointsKO-Adjacents,87
Ilex_micrococca,224,163,61,Alphahull-PointsKO-Adjacents,15406
Ilex_microdonta,306,274,32,Alphahull-PointsKO-Adjacents,3860
Ilex_microphylla,28,15,13,Points-PointsKO-Adjacents,167
Ilex_microstricta,1,1,0,Points-PointsKO-Adjacents,9
Ilex_mitis,491,358,133,Alphahull-PointsKO-Adjacents,14410
Ilex_mucronata,770,609,161,Alphahull-PointsKO-Adjacents,27152
Ilex_myricoides,118,70,48,Alphahull-PointsKO-Adjacents,2187
Ilex_myrtifolia,204,161,43,Alphahull-PointsKO-Adjacents,2681
Ilex_nanningensis,5,5,0,Points-PointsKO-Adjacents,45
Ilex_nayana,6,0,6,Points-PointsKO-Adjacents,54
Ilex_neblinensis,9,3,6,Points-PointsKO-Adjacents,32
Ilex_nervosa,97,57,40,Alphahull-PointsKO-Adjacents,1612
Ilex_ningdeensis,NA,NA,NA,NA,NA
Ilex_nitida,44,27,17,Alphahull-PointsKO-Adjacents,172
Ilex_nitidissima,4,4,0,Points-PointsKO-Adjacents,36
Ilex_nothofagifolia,8,2,6,Points-PointsKO-Adjacents,66
Ilex_nubicola,NA,NA,NA,NA,NA
Ilex_nuculicava,4,4,0,Points-PointsKO-Adjacents,36
Ilex_obcordata,14,2,12,Points-PointsKO-Adjacents,56
Ilex_oblonga,1,1,0,Points-PointsKO-Adjacents,9
Ilex_obtusata,52,35,17,Alphahull-PointsKO-Adjacents,830
Ilex_odorata,2,2,0,Points-PointsKO-Adjacents,18
Ilex_oliveriana,9,4,5,Points-PointsKO-Adjacents,71
Ilex_omeiensis,0,0,0,NA,0
Ilex_opaca,11279,10345,934,Alphahull-PointsKO-Adjacents,23634
Ilex_ovalifolia,8,3,5,Points-PointsKO-Adjacents,68
Ilex_ovalis,31,15,16,Points-PointsKO-Adjacents,247
Ilex_pallida,114,99,15,Alphahull-PointsKO-Adjacents,193
Ilex_paraguariensis,948,851,97,Alphahull-PointsKO-Adjacents,18408
Ilex_parvifructa,6,0,6,Points-PointsKO-Adjacents,50
Ilex_paujiensis,8,5,3,Points-PointsKO-Adjacents,56
Ilex_pedunculosa,355,247,108,Alphahull-PointsKO-Adjacents,3276
Ilex_pentagona,3,3,0,Points-PointsKO-Adjacents,27
Ilex_perado,59,35,24,Alphahull-PointsKO-Adjacents,178
Ilex_perlata,1,1,0,Points-PointsKO-Adjacents,9
Ilex_pernervata,68,52,16,Alphahull-PointsKO-Adjacents,1350
Ilex_pernyi,49,29,20,Alphahull-PointsKO-Adjacents,3116
Ilex_petiolaris,31,5,26,Points-PointsKO-Adjacents,254
Ilex_pingnanensis,2,2,0,Points-PointsKO-Adjacents,18
Ilex_polita,20,12,8,Points-PointsKO-Adjacents,149
Ilex_polyneura,95,63,32,Alphahull-PointsKO-Adjacents,8464
Ilex_polypyrena,2,2,0,Points-PointsKO-Adjacents,12
Ilex_psammophila,76,43,33,Alphahull-PointsKO-Adjacents,947
Ilex_pseudobuxus,199,152,47,Alphahull-PointsKO-Adjacents,5604
Ilex_pseudoebenacea,6,6,0,Points-PointsKO-Adjacents,18
Ilex_pseudomachilifolia,1,1,0,Points-PointsKO-Adjacents,9
Ilex_pseudo-odorata,0,0,0,NA,0
Ilex_ptariana,4,4,0,Points-PointsKO-Adjacents,18
Ilex_ptarima,NA,NA,NA,NA,NA
Ilex_pubescens,231,191,40,Alphahull-PointsKO-Adjacents,8138
Ilex_pubigera,NA,NA,NA,NA,NA
Ilex_pubilimba,6,0,6,Points-PointsKO-Adjacents,45
Ilex_punctatilimba,2,2,0,Points-PointsKO-Adjacents,18
Ilex_pustulosa,19,10,9,Points-PointsKO-Adjacents,108
Ilex_pyrifolia,NA,NA,NA,NA,NA
Ilex_qianlingshanensis,NA,NA,NA,NA,NA
Ilex_qingyuanensis,NA,NA,NA,NA,NA
Ilex_quercetorum,54,32,22,Alphahull-PointsKO-Adjacents,985
Ilex_quitensis,1,1,0,Points-PointsKO-Adjacents,9
Ilex_retusa,136,121,15,Alphahull-PointsKO-Adjacents,2009
Ilex_rimbachii,14,4,10,Points-PointsKO-Adjacents,93
Ilex_robustinervosa,NA,NA,NA,NA,NA
Ilex_rotunda,388,267,121,Alphahull-PointsKO-Adjacents,10954
Ilex_rubra,59,37,22,Alphahull-PointsKO-Adjacents,553
Ilex_rugulosa,0,0,0,NA,0
Ilex_sapiiformis,21,0,21,Points-PointsKO-Adjacents,151
Ilex_sapotifolia,47,25,22,Alphahull-PointsKO-Adjacents,731
Ilex_savannarum,19,10,9,Points-PointsKO-Adjacents,130
Ilex_schwackeana,4,4,0,Points-PointsKO-Adjacents,36
Ilex_scopulorum,43,25,18,Alphahull-PointsKO-Adjacents,342
Ilex_sessiliflora,35,1,34,Points-PointsKO-Adjacents,196
Ilex_sessilifructa,6,1,5,Points-PointsKO-Adjacents,43
Ilex_shennongjiaensis,2,2,0,Points-PointsKO-Adjacents,18
Ilex_shimeica,NA,NA,NA,NA,NA
Ilex_sideroxyloides,51,27,24,Alphahull-PointsKO-Adjacents,192
Ilex_sikkimensis,8,1,7,Points-PointsKO-Adjacents,64
Ilex_sinica,9,2,7,Points-PointsKO-Adjacents,81
Ilex_sintenisii,7,2,5,Points-PointsKO-Adjacents,13
Ilex_sipapoana,8,3,5,Points-PointsKO-Adjacents,51
Ilex_skutchii,70,56,14,Alphahull-PointsKO-Adjacents,401
Ilex_socorroensis,15,0,15,Points-PointsKO-Adjacents,26
Ilex_soderstromii,7,3,4,Points-PointsKO-Adjacents,42
Ilex_solida,4,4,0,Points-PointsKO-Adjacents,15
Ilex_spinulosa,5,5,0,Points-PointsKO-Adjacents,45
Ilex_spruceana,11,2,9,Points-PointsKO-Adjacents,85
Ilex_stellata,5,5,0,Points-PointsKO-Adjacents,41
Ilex_sterrophylla,5,5,0,Points-PointsKO-Adjacents,45
Ilex_stewardii,10,5,5,Points-PointsKO-Adjacents,90
Ilex_steyermarkii,9,4,5,Points-PointsKO-Adjacents,63
Ilex_strigillosa,NA,NA,NA,NA,NA
Ilex_suaveolens,46,26,20,Alphahull-PointsKO-Adjacents,4150
Ilex_subficoidea,8,0,8,Points-PointsKO-Adjacents,72
Ilex_subodorata,2,2,0,Points-PointsKO-Adjacents,18
Ilex_subrotundifolia,13,6,7,Points-PointsKO-Adjacents,88
Ilex_subrugosa,7,1,6,Points-PointsKO-Adjacents,62
Ilex_sugerokii,264,210,54,Alphahull-PointsKO-Adjacents,2487
Ilex_suichangensis,NA,NA,NA,NA,NA
Ilex_suprema,7,1,6,Points-PointsKO-Adjacents,46
Ilex_suzukii,12,6,6,Points-PointsKO-Adjacents,65
Ilex_syzygiophylla,2,2,0,Points-PointsKO-Adjacents,18
Ilex_szechwanensis,59,27,32,Alphahull-PointsKO-Adjacents,3282
Ilex_tadiandamolensis,NA,NA,NA,NA,NA
Ilex_tamii,0,0,0,NA,0
Ilex_tarapotina,9,1,8,Points-PointsKO-Adjacents,81
Ilex_tateana,8,0,8,Points-PointsKO-Adjacents,60
Ilex_taubertiana,138,109,29,Alphahull-PointsKO-Adjacents,2471
Ilex_tectonica,11,5,6,Points-PointsKO-Adjacents,97
Ilex_tenuis,1,1,0,Points-PointsKO-Adjacents,9
Ilex_tepuiana,4,4,0,Points-PointsKO-Adjacents,33
Ilex_teratopis,63,36,27,Alphahull-PointsKO-Adjacents,404
Ilex_tetramera,5,5,0,Points-PointsKO-Adjacents,45
Ilex_theizans,45,16,29,Points-PointsKO-Adjacents,372
Ilex_tiricae,9,5,4,Points-PointsKO-Adjacents,45
Ilex_trachyphylla,0,0,0,NA,0
Ilex_trichocarpa,1,1,0,Points-PointsKO-Adjacents,9
Ilex_triflora,177,108,69,Alphahull-PointsKO-Adjacents,10598
Ilex_truxillensis,9,3,6,Points-PointsKO-Adjacents,39
Ilex_tsangii,5,5,0,Points-PointsKO-Adjacents,45
Ilex_tsiangiana,2,2,0,Points-PointsKO-Adjacents,18
Ilex_tsoi,30,0,30,Points-PointsKO-Adjacents,267
Ilex_tugitakayamensis,38,30,8,Alphahull-PointsKO-Adjacents,139
Ilex_tutcheri,13,6,7,Points-PointsKO-Adjacents,117
Ilex_uaramae,0,0,0,NA,0
Ilex_uleana,1,1,0,Points-PointsKO-Adjacents,9
Ilex_umbellata,4,4,0,Points-PointsKO-Adjacents,36
Ilex_umbellulata,7,0,7,Points-PointsKO-Adjacents,63
Ilex_uniflora,60,30,30,Alphahull-PointsKO-Adjacents,448
Ilex_uraiensis,114,86,28,Alphahull-PointsKO-Adjacents,125
Ilex_urbaniana,17,10,7,Points-PointsKO-Adjacents,73
Ilex_vacciniifolia,7,2,5,Points-PointsKO-Adjacents,57
Ilex_valenzuelana,1,1,0,Points-PointsKO-Adjacents,8
Ilex_velutina,35,21,14,Alphahull-PointsKO-Adjacents,127
Ilex_venezuelensis,8,0,8,Points-PointsKO-Adjacents,51
Ilex_venosa,NA,NA,NA,NA,NA
Ilex_venulosa,2,2,0,Points-PointsKO-Adjacents,18
Ilex_verisimilis,2,2,0,Points-PointsKO-Adjacents,18
Ilex_verticillata,2228,1758,470,Alphahull-PointsKO-Adjacents,41309
Ilex_vesparum,3,3,0,Points-PointsKO-Adjacents,27
Ilex_victorinii,6,3,3,Points-PointsKO-Adjacents,31
Ilex_villosula,12,2,10,Points-PointsKO-Adjacents,89
Ilex_viridis,36,14,22,Points-PointsKO-Adjacents,324
Ilex_vismiifolia,52,17,35,Points-PointsKO-Adjacents,437
Ilex_vitiensis,0,0,0,NA,0
Ilex_volkensiana,3,1,2,Points-PointsKO-Adjacents,12
Ilex_vomitoria,1200,937,263,Alphahull-PointsKO-Adjacents,12798
Ilex_vulcanicola,51,37,14,Alphahull-PointsKO-Adjacents,215
Ilex_walkeri,0,0,0,NA,0
Ilex_tavoyensis,NA,NA,NA,NA,NA
Ilex_wattii,5,5,0,Points-PointsKO-Adjacents,45
Ilex_wightiana,2,2,0,Points-PointsKO-Adjacents,18
Ilex_williamsii,1,1,0,Points-PointsKO-Adjacents,9
Ilex_wilsonii,38,16,22,Points-PointsKO-Adjacents,342
Ilex_yunnanensis,124,88,36,Alphahull-PointsKO-Adjacents,2241
Ilex_yurumanguinis,197,142,55,Alphahull-PointsKO-Adjacents,4929
Ilex_zhejiangensis,0,0,0,NA,0
Illicium_angustisepalum,4,4,0,Points-PointsKO-Adjacents,36
Illicium_arborescens,234,221,13,Alphahull-PointsKO-Adjacents,264
Illicium_brevistylum,3,3,0,Points-PointsKO-Adjacents,27
Illicium_burmanicum,15,10,5,Points-PointsKO-Adjacents,92
Illicium_floridanum,268,213,55,Alphahull-PointsKO-Adjacents,2624
Illicium_griffithii,1,1,0,Points-PointsKO-Adjacents,9
Illicium_henryi,20,6,14,Points-PointsKO-Adjacents,180
Illicium_jiadifengpi,14,6,8,Points-PointsKO-Adjacents,126
Illicium_lanceolatum,48,29,19,Alphahull-PointsKO-Adjacents,3145
Illicium_macranthum,6,0,6,Points-PointsKO-Adjacents,39
Illicium_majus,54,31,23,Alphahull-PointsKO-Adjacents,1828
Illicium_merrillianum,5,5,0,Points-PointsKO-Adjacents,43
Illicium_mexicanum,7,2,5,Points-PointsKO-Adjacents,58
Illicium_micranthum,34,9,25,Points-PointsKO-Adjacents,306
Illicium_modestum,1,1,0,Points-PointsKO-Adjacents,9
Illicium_parviflorum,8,1,7,Points-PointsKO-Adjacents,55
Illicium_parvifolium,8,2,6,Points-PointsKO-Adjacents,63
Illicium_petelotii,7,0,7,Points-PointsKO-Adjacents,60
Illicium_philippinense,54,43,11,Alphahull-PointsKO-Adjacents,211
Illicium_simonsii,49,37,12,Alphahull-PointsKO-Adjacents,1872
Illicium_tashiroi,21,11,10,Points-PointsKO-Adjacents,82
Illicium_tenuifolium,8,3,5,Points-PointsKO-Adjacents,54
Illicium_ternstroemioides,8,0,8,Points-PointsKO-Adjacents,63
Illicium_tsaii,2,2,0,Points-PointsKO-Adjacents,18
Illicium_verum,33,19,14,Points-PointsKO-Adjacents,282
Illicium_wardii,1,1,0,Points-PointsKO-Adjacents,9
Indigofera_ammoxylum,3,2,1,Points-PointsKO-Adjacents,8
Indigofera_atropurpurea,55,1,54,Points-PointsKO-Adjacents,470
Indigofera_cassioides,28,2,26,Points-PointsKO-Adjacents,234
Indigofera_conzattii,49,38,11,Alphahull-PointsKO-Adjacents,120
Indigofera_cuernavacana,45,29,16,Alphahull-PointsKO-Adjacents,828
Indigofera_esquirolii,14,5,9,Points-PointsKO-Adjacents,126
Indigofera_filicaulis,46,0,46,Points-PointsKO-Adjacents,213
Indigofera_galegoides,30,0,30,Points-PointsKO-Adjacents,249
Indigofera_heterantha,59,17,42,Points-PointsKO-Adjacents,434
Indigofera_himalayensis,3,2,1,Points-PointsKO-Adjacents,27
Indigofera_lancifolia,21,0,21,Points-PointsKO-Adjacents,58
Indigofera_lyallii,72,41,31,Alphahull-PointsKO-Adjacents,368
Indigofera_mahafalensis,22,19,3,Points-PointsKO-Adjacents,55
Indigofera_mangokyensis,13,9,4,Points-PointsKO-Adjacents,67
Indigofera_platycarpa,53,33,20,Alphahull-PointsKO-Adjacents,404
Indigofera_rothii,7,1,6,Points-PointsKO-Adjacents,36
Indigofera_sokotrana,4,4,0,Points-PointsKO-Adjacents,13
Indigofera_thibaudiana,158,103,55,Alphahull-PointsKO-Adjacents,6838
Indigofera_zollingeriana,48,18,30,Points-PointsKO-Adjacents,269
Indopiptadenia_oudhensis,0,0,0,NA,0
Inga_acicularis,7,1,6,Points-PointsKO-Adjacents,63
Inga_acreana,175,108,67,Alphahull-PointsKO-Adjacents,8482
Inga_acrocephala,400,290,110,Alphahull-PointsKO-Adjacents,19847
Inga_acuminata,243,171,72,Alphahull-PointsKO-Adjacents,12435
Inga_adenophylla,179,145,34,Alphahull-PointsKO-Adjacents,2417
Inga_affinis,102,70,32,Alphahull-PointsKO-Adjacents,2034
Inga_alata,49,26,23,Alphahull-PointsKO-Adjacents,658
Inga_alatocarpa,6,0,6,Points-PointsKO-Adjacents,46
Inga_alba,1550,1440,110,Alphahull-PointsKO-Adjacents,102528
Inga_albicoria,11,6,5,Points-PointsKO-Adjacents,78
Inga_aliena,7,2,5,Points-PointsKO-Adjacents,63
Inga_amboroensis,4,4,0,Points-PointsKO-Adjacents,33
Inga_andersonii,2,2,0,Points-PointsKO-Adjacents,17
Inga_appendiculata,1,1,0,Points-PointsKO-Adjacents,9
Inga_approximata,21,12,9,Points-PointsKO-Adjacents,136
Inga_aptera,30,21,9,Alphahull-PointsKO-Adjacents,214
Inga_arenicola,3,2,1,Points-PointsKO-Adjacents,19
Inga_aria,5,1,4,Points-PointsKO-Adjacents,45
Inga_auristellae,306,0,306,Points-PointsKO-Adjacents,1896
Inga_balsapambensis,8,0,8,Points-PointsKO-Adjacents,64
Inga_barbata,118,92,26,Alphahull-PointsKO-Adjacents,1905
Inga_barbourii,62,37,25,Alphahull-PointsKO-Adjacents,320
Inga_belizensis,16,8,8,Points-PointsKO-Adjacents,115
Inga_bella,24,16,8,Points-PointsKO-Adjacents,56
Inga_bicoloriflora,28,14,14,Points-PointsKO-Adjacents,174
Inga_bijuga,2,2,0,Points-PointsKO-Adjacents,18
Inga_blanchetiana,26,10,16,Points-PointsKO-Adjacents,180
Inga_bollandii,35,17,18,Points-PointsKO-Adjacents,197
Inga_bonplandiana,2,2,0,Points-PointsKO-Adjacents,18
Inga_brachyrhachis,138,106,32,Alphahull-PointsKO-Adjacents,13364
Inga_brachystachys,85,0,85,Points-PointsKO-Adjacents,668
Inga_bracteifera,5,5,0,Points-PointsKO-Adjacents,18
Inga_brevipes,36,16,20,Points-PointsKO-Adjacents,283
Inga_bullata,34,0,34,Points-PointsKO-Adjacents,218
Inga_bullatorugosa,14,1,13,Points-PointsKO-Adjacents,120
Inga_cabelo,6,1,5,Points-PointsKO-Adjacents,54
Inga_cabrerae,4,4,0,Points-PointsKO-Adjacents,36
Inga_calantha,41,14,27,Points-PointsKO-Adjacents,353
Inga_calanthoides,5,5,0,Points-PointsKO-Adjacents,30
Inga_calcicola,3,3,0,Points-PointsKO-Adjacents,27
Inga_calderonii,44,30,14,Alphahull-PointsKO-Adjacents,179
Inga_canonegrensis,5,5,0,Points-PointsKO-Adjacents,31
Inga_capitata,1674,1479,195,Alphahull-PointsKO-Adjacents,96695
Inga_cardozana,7,2,5,Points-PointsKO-Adjacents,63
Inga_carinata,13,5,8,Points-PointsKO-Adjacents,99
Inga_caudata,1,1,0,Points-PointsKO-Adjacents,9
Inga_cayennensis,458,316,142,Alphahull-PointsKO-Adjacents,30295
Inga_cecropietorum,46,12,34,Points-PointsKO-Adjacents,396
Inga_chartacea,86,44,42,Alphahull-PointsKO-Adjacents,9532
Inga_chiapensis,2,2,0,Points-PointsKO-Adjacents,18
Inga_chocoensis,82,51,31,Alphahull-PointsKO-Adjacents,375
Inga_chrysantha,52,15,37,Points-PointsKO-Adjacents,408
Inga_ciliata,265,178,87,Alphahull-PointsKO-Adjacents,7151
Inga_cinnamomea,342,262,80,Alphahull-PointsKO-Adjacents,35841
Inga_cocleensis,165,116,49,Alphahull-PointsKO-Adjacents,3508
Inga_colombiana,6,0,6,Points-PointsKO-Adjacents,51
Inga_colonchensis,2,2,0,Points-PointsKO-Adjacents,18
Inga_conferta,1,1,0,Points-PointsKO-Adjacents,9
Inga_congesta,36,12,24,Points-PointsKO-Adjacents,268
Inga_cookii,9,4,5,Points-PointsKO-Adjacents,66
Inga_coragypsea,1,1,0,Points-PointsKO-Adjacents,9
Inga_cordatoalata,154,97,57,Alphahull-PointsKO-Adjacents,4789
Inga_cordistipula,36,21,15,Alphahull-PointsKO-Adjacents,300
Inga_coruscans,174,115,59,Alphahull-PointsKO-Adjacents,8044
Inga_cuspidata,6,1,5,Points-PointsKO-Adjacents,41
Inga_cylindrica,650,510,140,Alphahull-PointsKO-Adjacents,42042
Inga_cynometrifolia,5,5,0,Points-PointsKO-Adjacents,43
Inga_dasycarpa,10,5,5,Points-PointsKO-Adjacents,77
Inga_davidsei,14,8,6,Points-PointsKO-Adjacents,106
Inga_davidsoniae,1,0,1,Points-PointsKO-Adjacents,7
Inga_densiflora,547,444,103,Alphahull-PointsKO-Adjacents,14536
Inga_disticha,251,176,75,Alphahull-PointsKO-Adjacents,38034
Inga_dominicensis,3,3,0,Points-PointsKO-Adjacents,16
Inga_duckei,20,3,17,Points-PointsKO-Adjacents,170
Inga_dwyeri,10,5,5,Points-PointsKO-Adjacents,58
Inga_edulis,826,610,216,Alphahull-PointsKO-Adjacents,69199
Inga_edwallii,72,0,72,Points-PointsKO-Adjacents,443
Inga_enterolobioides,1,1,0,Points-PointsKO-Adjacents,9
Inga_eriocarpoides,0,0,0,NA,0
Inga_exalata,62,43,19,Alphahull-PointsKO-Adjacents,301
Inga_exfoliata,22,14,8,Points-PointsKO-Adjacents,122
Inga_exilis,3,3,0,Points-PointsKO-Adjacents,27
Inga_expansa,20,13,7,Points-PointsKO-Adjacents,135
Inga_extra-nodis,22,13,9,Points-PointsKO-Adjacents,99
Inga_fanchoniana,3,0,3,Points-PointsKO-Adjacents,27
Inga_fastuosa,183,128,55,Alphahull-PointsKO-Adjacents,13098
Inga_fendleriana,76,37,39,Alphahull-PointsKO-Adjacents,537
Inga_feuillei,35,10,25,Points-PointsKO-Adjacents,266
Inga_filiformis,30,17,13,Points-PointsKO-Adjacents,171
Inga_flagelliformis,238,158,80,Alphahull-PointsKO-Adjacents,5787
Inga_flexuosa,17,6,11,Points-PointsKO-Adjacents,107
Inga_fosteriana,6,0,6,Points-PointsKO-Adjacents,46
Inga_gereauana,9,0,9,Points-PointsKO-Adjacents,66
Inga_globularis,6,1,5,Points-PointsKO-Adjacents,47
Inga_glomeriflora,30,0,30,Points-PointsKO-Adjacents,225
Inga_goldmanii,122,91,31,Alphahull-PointsKO-Adjacents,1664
Inga_golfodulcensis,14,11,3,Points-PointsKO-Adjacents,22
Inga_goniocalyx,0,0,0,NA,0
Inga_graciliflora,70,27,43,Alphahull-PointsKO-Adjacents,3134
Inga_gracilifolia,139,69,70,Alphahull-PointsKO-Adjacents,5096
Inga_gracilior,188,143,45,Alphahull-PointsKO-Adjacents,7336
Inga_grandis,19,12,7,Points-PointsKO-Adjacents,165
Inga_grazielae,34,0,34,Points-PointsKO-Adjacents,166
Inga_hayesii,91,47,44,Alphahull-PointsKO-Adjacents,1131
Inga_herrerae,6,3,3,Points-PointsKO-Adjacents,33
Inga_heterophylla,850,726,124,Alphahull-PointsKO-Adjacents,84780
Inga_hintonii,49,29,20,Alphahull-PointsKO-Adjacents,531
Inga_hispida,73,48,25,Alphahull-PointsKO-Adjacents,868
Inga_huastecana,14,6,8,Points-PointsKO-Adjacents,72
Inga_huberi,73,30,43,Alphahull-PointsKO-Adjacents,1953
Inga_ilta,31,18,13,Points-PointsKO-Adjacents,166
Inga_inflata,27,13,14,Points-PointsKO-Adjacents,180
Inga_ingoides,1413,1235,178,Alphahull-PointsKO-Adjacents,124423
Inga_insignis,62,36,26,Alphahull-PointsKO-Adjacents,474
Inga_interfluminensis,10,4,6,Points-PointsKO-Adjacents,74
Inga_interrupta,22,12,10,Points-PointsKO-Adjacents,159
Inga_involucrata,6,1,5,Points-PointsKO-Adjacents,47
Inga_ismaelis,8,2,6,Points-PointsKO-Adjacents,42
Inga_japurensis,8,1,7,Points-PointsKO-Adjacents,51
Inga_jaunechensis,8,2,6,Points-PointsKO-Adjacents,59
Inga_jefensis,46,25,21,Alphahull-PointsKO-Adjacents,319
Inga_jimenezii,20,14,6,Points-PointsKO-Adjacents,76
Inga_jinicuil,155,123,32,Alphahull-PointsKO-Adjacents,1829
Inga_killipiana,10,4,6,Points-PointsKO-Adjacents,90
Inga_klugii,11,7,4,Points-PointsKO-Adjacents,50
Inga_lactifera,2,2,0,Points-PointsKO-Adjacents,18
Inga_lacustris,4,4,0,Points-PointsKO-Adjacents,17
Inga_lallensis,42,28,14,Alphahull-PointsKO-Adjacents,396
Inga_lanceifolia,22,0,22,Points-PointsKO-Adjacents,143
Inga_lateriflora,265,195,70,Alphahull-PointsKO-Adjacents,32881
Inga_latipes,9,6,3,Points-PointsKO-Adjacents,45
Inga_laurina,1904,1601,303,Alphahull-PointsKO-Adjacents,138538
Inga_laxiflora,2,2,0,Points-PointsKO-Adjacents,18
Inga_leiocalycina,563,426,137,Alphahull-PointsKO-Adjacents,54127
Inga_lenticellata,79,0,79,Points-PointsKO-Adjacents,441
Inga_lentiscifolia,146,1,145,Points-PointsKO-Adjacents,948
Inga_leonis,56,42,14,Alphahull-PointsKO-Adjacents,293
Inga_leptantha,108,81,27,Alphahull-PointsKO-Adjacents,1783
Inga_leptingoides,6,1,5,Points-PointsKO-Adjacents,36
Inga_leptocarpa,9,1,8,Points-PointsKO-Adjacents,79
Inga_lineata,37,23,14,Alphahull-PointsKO-Adjacents,1952
Inga_litoralis,30,22,8,Alphahull-PointsKO-Adjacents,96
Inga_lomatophylla,86,47,39,Alphahull-PointsKO-Adjacents,5659
Inga_longiflora,57,18,39,Points-PointsKO-Adjacents,458
Inga_longifoliola,12,9,3,Points-PointsKO-Adjacents,68
Inga_longipes,13,3,10,Points-PointsKO-Adjacents,113
Inga_longispica,46,33,13,Alphahull-PointsKO-Adjacents,195
Inga_loretana,10,4,6,Points-PointsKO-Adjacents,90
Inga_macarenensis,4,4,0,Points-PointsKO-Adjacents,27
Inga_macrantha,3,3,0,Points-PointsKO-Adjacents,27
Inga_macrophylla,382,297,85,Alphahull-PointsKO-Adjacents,47807
Inga_manabiensis,13,5,8,Points-PointsKO-Adjacents,105
Inga_marginata,2383,2161,222,Alphahull-PointsKO-Adjacents,137941
Inga_maritima,26,12,14,Points-PointsKO-Adjacents,98
Inga_martinicensis,3,1,2,Points-PointsKO-Adjacents,20
Inga_maynensis,11,5,6,Points-PointsKO-Adjacents,77
Inga_megalobotrys,6,1,5,Points-PointsKO-Adjacents,47
Inga_megaphylla,63,38,25,Alphahull-PointsKO-Adjacents,1944
Inga_mendoncaei,10,0,10,Points-PointsKO-Adjacents,90
Inga_mexicana,6,2,4,Points-PointsKO-Adjacents,54
Inga_microcalyx,18,0,18,Points-PointsKO-Adjacents,153
Inga_mortoniana,77,65,12,Alphahull-PointsKO-Adjacents,242
Inga_mucuna,58,40,18,Alphahull-PointsKO-Adjacents,1070
Inga_multicaulis,16,9,7,Points-PointsKO-Adjacents,90
Inga_multijuga,219,159,60,Alphahull-PointsKO-Adjacents,7960
Inga_multinervis,75,61,14,Alphahull-PointsKO-Adjacents,932
Inga_neblinensis,10,3,7,Points-PointsKO-Adjacents,53
Inga_nobilis,1961,1843,118,Alphahull-PointsKO-Adjacents,103248
Inga_nouragensis,5,2,3,Points-PointsKO-Adjacents,33
Inga_nubium,5,3,2,Points-PointsKO-Adjacents,36
Inga_nuda,3,0,3,Points-PointsKO-Adjacents,27
Inga_obidensis,80,36,44,Alphahull-PointsKO-Adjacents,6450
Inga_obscura,4,4,0,Points-PointsKO-Adjacents,36
Inga_obtusata,27,15,12,Points-PointsKO-Adjacents,191
Inga_oerstediana,911,800,111,Alphahull-PointsKO-Adjacents,23525
Inga_ornata,40,13,27,Points-PointsKO-Adjacents,256
Inga_pachyphylla,1,1,0,Points-PointsKO-Adjacents,9
Inga_pallida,7,1,6,Points-PointsKO-Adjacents,57
Inga_panurensis,59,28,31,Alphahull-PointsKO-Adjacents,3293
Inga_paraensis,181,131,50,Alphahull-PointsKO-Adjacents,21425
Inga_paterno,171,126,45,Alphahull-PointsKO-Adjacents,3805
Inga_pauciflora,41,25,16,Alphahull-PointsKO-Adjacents,97
Inga_pavoniana,206,0,206,Points-PointsKO-Adjacents,1095
Inga_peduncularis,73,0,73,Points-PointsKO-Adjacents,506
Inga_pedunculata,1,1,0,Points-PointsKO-Adjacents,9
Inga_pezizifera,627,523,104,Alphahull-PointsKO-Adjacents,59397
Inga_pilosula,1106,957,149,Alphahull-PointsKO-Adjacents,110949
Inga_pinetorum,52,28,24,Alphahull-PointsKO-Adjacents,968
Inga_platyptera,30,19,11,Points-PointsKO-Adjacents,228
Inga_pleiogyna,87,57,30,Alphahull-PointsKO-Adjacents,342
Inga_plumifera,21,11,10,Points-PointsKO-Adjacents,166
Inga_pluricarpellata,4,4,0,Points-PointsKO-Adjacents,36
Inga_poeppigiana,55,25,30,Alphahull-PointsKO-Adjacents,1298
Inga_polita,82,51,31,Alphahull-PointsKO-Adjacents,1984
Inga_polyantha,4,4,0,Points-PointsKO-Adjacents,36
Inga_porcata,14,8,6,Points-PointsKO-Adjacents,64
Inga_portobellensis,12,8,4,Points-PointsKO-Adjacents,39
Inga_praegnans,8,2,6,Points-PointsKO-Adjacents,60
Inga_pruriens,76,50,26,Alphahull-PointsKO-Adjacents,5748
Inga_pseudofastuosa,0,0,0,NA,0
Inga_pseudoinvolucrata,6,0,6,Points-PointsKO-Adjacents,42
Inga_psittacorum,42,22,20,Alphahull-PointsKO-Adjacents,2132
Inga_punctata,2133,1923,210,Alphahull-PointsKO-Adjacents,70971
Inga_retinocarpa,10,0,10,Points-PointsKO-Adjacents,87
Inga_rhynchocalyx,19,0,19,Points-PointsKO-Adjacents,153
Inga_ricardorum,4,0,4,Points-PointsKO-Adjacents,36
Inga_rubiginosa,249,149,100,Alphahull-PointsKO-Adjacents,17482
Inga_ruiziana,685,584,101,Alphahull-PointsKO-Adjacents,17914
Inga_rusbyi,58,32,26,Alphahull-PointsKO-Adjacents,715
Inga_saffordiana,17,11,6,Points-PointsKO-Adjacents,123
Inga_salicifolia,1,1,0,Points-PointsKO-Adjacents,9
Inga_saltensis,66,46,20,Alphahull-PointsKO-Adjacents,860
Inga_samanensis,113,80,33,Alphahull-PointsKO-Adjacents,1173
Inga_santaremnensis,9,3,6,Points-PointsKO-Adjacents,75
Inga_sapindoides,782,649,133,Alphahull-PointsKO-Adjacents,24428
Inga_sarayacuensis,17,12,5,Points-PointsKO-Adjacents,96
Inga_schinifolia,36,22,14,Alphahull-PointsKO-Adjacents,704
Inga_sellowiana,36,0,36,Points-PointsKO-Adjacents,272
Inga_sertulifera,329,262,67,Alphahull-PointsKO-Adjacents,23400
Inga_sessilis,736,670,66,Alphahull-PointsKO-Adjacents,10764
Inga_setosa,121,83,38,Alphahull-PointsKO-Adjacents,3651
Inga_sierrae,138,103,35,Alphahull-PointsKO-Adjacents,1852
Inga_silanchensis,41,30,11,Alphahull-PointsKO-Adjacents,495
Inga_sinacae,10,7,3,Points-PointsKO-Adjacents,39
Inga_skutchii,40,35,5,Alphahull-PointsKO-Adjacents,88
Inga_spectabilis,563,499,64,Alphahull-PointsKO-Adjacents,18895
Inga_spiralis,8,5,3,Points-PointsKO-Adjacents,29
Inga_splendens,443,381,62,Alphahull-PointsKO-Adjacents,54060
Inga_standleyana,0,0,0,NA,0
Inga_steinbachii,45,34,11,Alphahull-PointsKO-Adjacents,547
Inga_stenocalyx,11,0,11,Points-PointsKO-Adjacents,99
Inga_stenophylla,10,6,4,Points-PointsKO-Adjacents,58
Inga_stenopoda,76,56,20,Alphahull-PointsKO-Adjacents,2603
Inga_stenoptera,440,0,440,Points-PointsKO-Adjacents,3396
Inga_stipulacea,119,82,37,Alphahull-PointsKO-Adjacents,9698
Inga_stipularis,392,0,392,Points-PointsKO-Adjacents,2728
Inga_striata,1088,917,171,Alphahull-PointsKO-Adjacents,33106
Inga_striolata,73,44,29,Alphahull-PointsKO-Adjacents,2561
Inga_suaveolens,40,0,40,Points-PointsKO-Adjacents,263
Inga_suberosa,7,1,6,Points-PointsKO-Adjacents,51
Inga_subnuda,501,418,83,Alphahull-PointsKO-Adjacents,7823
Inga_suborbicularis,23,9,14,Points-PointsKO-Adjacents,146
Inga_tarapotensis,8,4,4,Points-PointsKO-Adjacents,59
Inga_tenuicalyx,8,2,6,Points-PointsKO-Adjacents,63
Inga_tenuiloba,3,3,0,Points-PointsKO-Adjacents,11
Inga_tenuipedunculata,8,2,6,Points-PointsKO-Adjacents,41
Inga_tenuis,129,96,33,Alphahull-PointsKO-Adjacents,1293
Inga_tenuistipula,242,193,49,Alphahull-PointsKO-Adjacents,17740
Inga_tessmannii,46,21,25,Alphahull-PointsKO-Adjacents,1949
Inga_thibaudiana,2110,1924,186,Alphahull-PointsKO-Adjacents,114729
Inga_tocacheana,53,34,19,Alphahull-PointsKO-Adjacents,2849
Inga_tomentosa,101,63,38,Alphahull-PointsKO-Adjacents,2297
Inga_tonduzii,64,51,13,Alphahull-PointsKO-Adjacents,284
Inga_tubaeformis,3,1,2,Points-PointsKO-Adjacents,27
Inga_ulei,58,37,21,Alphahull-PointsKO-Adjacents,3009
Inga_umbellifera,857,769,88,Alphahull-PointsKO-Adjacents,74181
Inga_umbilicata,38,27,11,Alphahull-PointsKO-Adjacents,93
Inga_umbratica,238,170,68,Alphahull-PointsKO-Adjacents,25158
Inga_unica,24,14,10,Points-PointsKO-Adjacents,133
Inga_uraguensis,21,7,14,Points-PointsKO-Adjacents,186
Inga_urceolata,16,10,6,Points-PointsKO-Adjacents,54
Inga_ursi,6,1,5,Points-PointsKO-Adjacents,54
Inga_uruguensis,40,32,8,Alphahull-PointsKO-Adjacents,410
Inga_velutina,259,0,259,Points-PointsKO-Adjacents,1933
Inga_venusta,240,190,50,Alphahull-PointsKO-Adjacents,7238
Inga_vera,4308,3916,392,Alphahull-PointsKO-Adjacents,153155
Inga_vestita,4,3,1,Points-PointsKO-Adjacents,36
Inga_villosissima,181,124,57,Alphahull-PointsKO-Adjacents,3154
Inga_virescens,241,205,36,Alphahull-PointsKO-Adjacents,4774
Inga_virgultosa,34,23,11,Alphahull-PointsKO-Adjacents,1088
Inga_vismiifolia,86,51,35,Alphahull-PointsKO-Adjacents,6468
Inga_vulpina,165,133,32,Alphahull-PointsKO-Adjacents,3029
Inga_xalapensis,189,91,98,Alphahull-PointsKO-Adjacents,4602
Inga_xinguensis,8,0,8,Points-PointsKO-Adjacents,72
Inga_yacoana,54,30,24,Alphahull-PointsKO-Adjacents,4344
Inga_yasuniana,6,1,5,Points-PointsKO-Adjacents,46
Inhambanella_guereensis,15,11,4,Points-PointsKO-Adjacents,93
Inhambanella_henriquezii,21,0,21,Points-PointsKO-Adjacents,185
Inocarpus_fagifer,63,13,50,Points-PointsKO-Adjacents,375
Inocarpus_papuanus,4,4,0,Points-PointsKO-Adjacents,29
Intsia_bijuga,279,146,133,Alphahull-PointsKO-Adjacents,4176
Intsia_palembanica,34,7,27,Points-PointsKO-Adjacents,246
Iochroma_albianthum,NA,NA,NA,NA,NA
Iochroma_confertiflorum,24,11,13,Points-PointsKO-Adjacents,182
Iochroma_gesnerioides,82,65,17,Alphahull-PointsKO-Adjacents,666
Iochroma_grandiflorum,52,31,21,Alphahull-PointsKO-Adjacents,821
Iochroma_lehmannii,7,3,4,Points-PointsKO-Adjacents,44
Iochroma_longipes,6,2,4,Points-PointsKO-Adjacents,42
Iochroma_nitidum,8,3,5,Points-PointsKO-Adjacents,43
Iochroma_squamosum,3,3,0,Points-PointsKO-Adjacents,18
Iochroma_umbellatum,55,43,12,Alphahull-PointsKO-Adjacents,699
Iochroma_warscewiczii,0,0,0,NA,0
Ipomoea_arborescens,275,229,46,Alphahull-PointsKO-Adjacents,4840
Ipomoea_eximia,2,2,0,Points-PointsKO-Adjacents,18
Ipomoea_intrapilosa,164,137,27,Alphahull-PointsKO-Adjacents,1682
Ipomoea_murucoides,333,276,57,Alphahull-PointsKO-Adjacents,3228
Ipomoea_pauciflora,270,215,55,Alphahull-PointsKO-Adjacents,2889
Ipomoea_pulcherrima,5,5,0,Points-PointsKO-Adjacents,45
Ipomoea_teotitlanica,3,3,0,Points-PointsKO-Adjacents,15
Ipomoea_wolcottiana,144,105,39,Alphahull-PointsKO-Adjacents,2037
Iresine_arbuscula,127,96,31,Alphahull-PointsKO-Adjacents,1691
Iresine_diffusa,3157,2678,479,Alphahull-PointsKO-Adjacents,59702
Iriartea_deltoidea,1127,1043,84,Alphahull-PointsKO-Adjacents,38372
Iriartella_setigera,415,369,46,Alphahull-PointsKO-Adjacents,27359
Iriartella_stenocarpa,205,175,30,Alphahull-PointsKO-Adjacents,4443
Iridosma_letestui,2,2,0,Points-PointsKO-Adjacents,18
Irvingbaileya_australis,104,90,14,Alphahull-PointsKO-Adjacents,137
Irvingia_excelsa,91,67,24,Alphahull-PointsKO-Adjacents,2096
Irvingia_gabonensis,71,36,35,Alphahull-PointsKO-Adjacents,1356
Irvingia_grandifolia,114,87,27,Alphahull-PointsKO-Adjacents,4244
Irvingia_malayana,28,8,20,Points-PointsKO-Adjacents,216
Irvingia_robur,56,23,33,Alphahull-PointsKO-Adjacents,923
Irvingia_tenuinucleata,42,21,21,Alphahull-PointsKO-Adjacents,356
Iryanthera_campinae,8,4,4,Points-PointsKO-Adjacents,41
Iryanthera_coriacea,81,43,38,Alphahull-PointsKO-Adjacents,1491
Iryanthera_crassifolia,130,103,27,Alphahull-PointsKO-Adjacents,9023
Iryanthera_dialyandra,32,21,11,Alphahull-PointsKO-Adjacents,132
Iryanthera_elliptica,207,163,44,Alphahull-PointsKO-Adjacents,17966
Iryanthera_grandis,64,35,29,Alphahull-PointsKO-Adjacents,1472
Iryanthera_hostmannii,813,744,69,Alphahull-PointsKO-Adjacents,58269
Iryanthera_inpae,8,1,7,Points-PointsKO-Adjacents,64
Iryanthera_juruensis,1183,1105,78,Alphahull-PointsKO-Adjacents,67785
Iryanthera_laevis,610,551,59,Alphahull-PointsKO-Adjacents,46884
Iryanthera_lancifolia,335,267,68,Alphahull-PointsKO-Adjacents,29921
Iryanthera_macrophylla,219,161,58,Alphahull-PointsKO-Adjacents,20617
Iryanthera_megistocarpa,13,6,7,Points-PointsKO-Adjacents,36
Iryanthera_megistophylla,47,36,11,Alphahull-PointsKO-Adjacents,356
Iryanthera_obovata,11,3,8,Points-PointsKO-Adjacents,97
Iryanthera_olacoides,79,45,34,Alphahull-PointsKO-Adjacents,3644
Iryanthera_paradoxa,139,92,47,Alphahull-PointsKO-Adjacents,13296
Iryanthera_paraensis,447,368,79,Alphahull-PointsKO-Adjacents,43963
Iryanthera_polyneura,132,94,38,Alphahull-PointsKO-Adjacents,5981
Iryanthera_sagotiana,185,128,57,Alphahull-PointsKO-Adjacents,13377
Iryanthera_tessmannii,198,147,51,Alphahull-PointsKO-Adjacents,15640
Iryanthera_tricornis,202,161,41,Alphahull-PointsKO-Adjacents,10319
Isertia_coccinea,103,0,103,Points-PointsKO-Adjacents,659
Isertia_haenkeana,518,446,72,Alphahull-PointsKO-Adjacents,7566
Isertia_hypoleuca,539,483,56,Alphahull-PointsKO-Adjacents,42089
Isertia_krausei,10,3,7,Points-PointsKO-Adjacents,72
Isertia_laevis,598,524,74,Alphahull-PointsKO-Adjacents,19823
Isertia_longifolia,37,22,15,Alphahull-PointsKO-Adjacents,680
Isertia_parviflora,300,255,45,Alphahull-PointsKO-Adjacents,15438
Isertia_pittieri,165,147,18,Alphahull-PointsKO-Adjacents,1668
Isertia_reticulata,38,24,14,Alphahull-PointsKO-Adjacents,349
Isertia_rosea,210,172,38,Alphahull-PointsKO-Adjacents,14199
Isertia_scorpioides,9,2,7,Points-PointsKO-Adjacents,55
Isertia_spiciformis,108,66,42,Alphahull-PointsKO-Adjacents,3503
Isertia_verrucosa,28,18,10,Points-PointsKO-Adjacents,169
Isertia_wilhelminensis,2,2,0,Points-PointsKO-Adjacents,18
Isidodendron_tripterocarpum,14,8,6,Points-PointsKO-Adjacents,81
Isidorea_brachyantha,3,3,0,Points-PointsKO-Adjacents,25
Isoberlinia_angolensis,60,32,28,Alphahull-PointsKO-Adjacents,3705
Isoberlinia_doka,1229,0,1229,Points-PointsKO-Adjacents,2110
Isoberlinia_paradoxa,NA,NA,NA,NA,NA
Isoberlinia_scheffleri,14,8,6,Points-PointsKO-Adjacents,50
Isoberlinia_tomentosa,121,79,42,Alphahull-PointsKO-Adjacents,1500
Isodendrion_laurifolium,0,0,0,NA,0
Isodendrion_pyrifolium,1,1,0,Points-PointsKO-Adjacents,9
Isolona_campanulata,99,66,33,Alphahull-PointsKO-Adjacents,2406
Isolona_congolana,27,10,17,Points-PointsKO-Adjacents,203
Isolona_cooperi,69,47,22,Alphahull-PointsKO-Adjacents,874
Isolona_deightonii,7,1,6,Points-PointsKO-Adjacents,59
Isolona_dewevrei,10,0,10,Points-PointsKO-Adjacents,43
Isolona_hexaloba,153,106,47,Alphahull-PointsKO-Adjacents,8520
Isolona_lebrunii,19,8,11,Points-PointsKO-Adjacents,119
Isolona_le-testui,4,3,1,Points-PointsKO-Adjacents,33
Isolona_madagascariensis,29,13,16,Points-PointsKO-Adjacents,169
Isolona_perrieri,25,10,15,Points-PointsKO-Adjacents,130
Isolona_pilosa,14,0,14,Points-PointsKO-Adjacents,120
Isolona_thonneri,43,21,22,Alphahull-PointsKO-Adjacents,1067
Isolona_zenkeri,53,32,21,Alphahull-PointsKO-Adjacents,2386
Isomacrolobium_explicans,13,5,8,Points-PointsKO-Adjacents,96
Isomacrolobium_graciliflorum,10,1,9,Points-PointsKO-Adjacents,77
Isomacrolobium_hallei,11,7,4,Points-PointsKO-Adjacents,34
Isomacrolobium_isopetalum,24,14,10,Points-PointsKO-Adjacents,189
Isomacrolobium_lebrunii,1,1,0,Points-PointsKO-Adjacents,9
Isomacrolobium_leptorrhachis,16,11,5,Points-PointsKO-Adjacents,118
Isomacrolobium_nigericum,7,0,7,Points-PointsKO-Adjacents,62
Isomacrolobium_obanense,46,18,28,Points-PointsKO-Adjacents,319
Isomacrolobium_sargosii,3,3,0,Points-PointsKO-Adjacents,27
Isomacrolobium_triplisomere,13,7,6,Points-PointsKO-Adjacents,97
Isomacrolobium_vignei,75,48,27,Alphahull-PointsKO-Adjacents,1058
Isonandra_alloneura,0,0,0,NA,0
Isonandra_borneensis,NA,NA,NA,NA,NA
Isonandra_compta,0,0,0,NA,0
Isonandra_lanceolata,6,0,6,Points-PointsKO-Adjacents,51
Isonandra_montana,0,0,0,NA,0
Isonandra_perakensis,1,1,0,Points-PointsKO-Adjacents,9
Isonandra_perrottetiana,2,1,1,Points-PointsKO-Adjacents,18
Isonandra_stocksii,0,0,0,NA,0
Isonandra_villosa,0,0,0,NA,0
Isonandra_zeylanica,1,1,0,Points-PointsKO-Adjacents,9
Trigoniastrum_hypoleucum,24,10,14,Points-PointsKO-Adjacents,208
Itaya_amicorum,46,29,17,Alphahull-PointsKO-Adjacents,934
Itea_chinensis,151,105,46,Alphahull-PointsKO-Adjacents,11950
Itea_coriacea,17,5,12,Points-PointsKO-Adjacents,153
Itea_glutinosa,13,7,6,Points-PointsKO-Adjacents,117
Itea_indochinensis,36,16,20,Points-PointsKO-Adjacents,318
Itea_kiukiangensis,6,2,4,Points-PointsKO-Adjacents,42
Itea_macrophylla,8,0,8,Points-PointsKO-Adjacents,63
Itea_oldhamii,137,91,46,Alphahull-PointsKO-Adjacents,202
Itea_omeiensis,0,0,0,NA,0
Itea_parviflora,331,287,44,Alphahull-PointsKO-Adjacents,375
Itea_riparia,7,1,6,Points-PointsKO-Adjacents,63
Itea_yangchunensis,1,1,0,Points-PointsKO-Adjacents,9
Itea_yunnanensis,49,32,17,Alphahull-PointsKO-Adjacents,2812
Iteadaphne_caudata,9,0,9,Points-PointsKO-Adjacents,72
Itoa_orientalis,32,15,17,Points-PointsKO-Adjacents,287
Ixerba_brexioides,1740,1719,21,Alphahull-PointsKO-Adjacents,1001
Ixonanthes_chinensis,2,2,0,Points-PointsKO-Adjacents,9
Ixonanthes_reticulata,28,2,26,Points-PointsKO-Adjacents,218
Ixora_accedens,NA,NA,NA,NA,NA
Ixora_acuminatissima,98,0,98,Points-PointsKO-Adjacents,668
Ixora_agostiniana,2,2,0,Points-PointsKO-Adjacents,15
Ixora_albersii,12,7,5,Points-PointsKO-Adjacents,47
Ixora_amplexicaulis,1,1,0,Points-PointsKO-Adjacents,9
Ixora_amplexifolia,4,4,0,Points-PointsKO-Adjacents,35
Ixora_aneityensis,4,4,0,Points-PointsKO-Adjacents,32
Ixora_archboldii,1,1,0,Points-PointsKO-Adjacents,9
Ixora_arestantha,0,0,0,NA,0
Ixora_asme,21,14,7,Points-PointsKO-Adjacents,93
Ixora_athroantha,0,0,0,NA,0
Ixora_auricularis,2,2,0,Points-PointsKO-Adjacents,18
Ixora_bahiensis,13,2,11,Points-PointsKO-Adjacents,102
Ixora_balinensis,0,0,0,NA,0
Ixora_batesii,6,0,6,Points-PointsKO-Adjacents,44
Ixora_bauchiensis,80,62,18,Alphahull-PointsKO-Adjacents,4057
Ixora_beckleri,208,181,27,Alphahull-PointsKO-Adjacents,736
Ixora_blumei,4,4,0,Points-PointsKO-Adjacents,36
Ixora_borboniae,0,0,0,NA,0
Ixora_borneensis,0,0,0,NA,0
Ixora_brachiata,0,0,0,NA,0
Ixora_brachyantha,9,0,9,Points-PointsKO-Adjacents,70
Ixora_brachyanthera,0,0,0,NA,0
Ixora_brachycotyla,0,0,0,NA,0
Ixora_brachypoda,514,430,84,Alphahull-PointsKO-Adjacents,42879
Ixora_brachypogon,0,0,0,NA,0
Ixora_brachyura,NA,NA,NA,NA,NA
Ixora_brevicaudata,7,4,3,Points-PointsKO-Adjacents,48
Ixora_brevifolia,543,460,83,Alphahull-PointsKO-Adjacents,23638
Ixora_brevipedunculata,0,0,0,NA,0
Ixora_brunnescens,1,1,0,Points-PointsKO-Adjacents,9
Ixora_brunonis,9,4,5,Points-PointsKO-Adjacents,67
Ixora_bullata,0,0,0,NA,0
Ixora_calcicola,0,0,0,NA,0
Ixora_calycina,0,0,0,NA,0
Ixora_capillaris,0,0,0,NA,0
Ixora_carewii,0,0,0,NA,0
Ixora_caudata,0,0,0,NA,0
Ixora_cauliflora,10,5,5,Points-PointsKO-Adjacents,59
Ixora_celebica,0,0,0,NA,0
Ixora_ceramensis,0,0,0,NA,0
Ixora_chinensis,28,11,17,Points-PointsKO-Adjacents,234
Ixora_cibdela,8,0,8,Points-PointsKO-Adjacents,56
Ixora_clerodendron,0,0,0,NA,0
Ixora_collina,12,5,7,Points-PointsKO-Adjacents,79
Ixora_comptonii,6,0,6,Points-PointsKO-Adjacents,41
Ixora_concinna,2,2,0,Points-PointsKO-Adjacents,18
Ixora_conferta,NA,NA,NA,NA,NA
Ixora_cordifolia,NA,NA,NA,NA,NA
Ixora_coriifolia,0,0,0,NA,0
Ixora_cowanii,13,2,11,Points-PointsKO-Adjacents,117
Ixora_cuneifolia,5,3,2,Points-PointsKO-Adjacents,31
Ixora_curtisii,0,0,0,NA,0
Ixora_deciduiflora,NA,NA,NA,NA,NA
Ixora_delpyana,0,0,0,NA,0
Ixora_diversifolia,1,1,0,Points-PointsKO-Adjacents,9
Ixora_dolichothyrsa,2,2,0,Points-PointsKO-Adjacents,18
Ixora_elegans,0,0,0,NA,0
Ixora_elongata,0,0,0,NA,0
Ixora_endertii,0,0,0,NA,0
Ixora_euosmia,26,16,10,Points-PointsKO-Adjacents,148
Ixora_fallax,0,0,0,NA,0
Ixora_farinosa,NA,NA,NA,NA,NA
Ixora_ferrea,103,58,45,Alphahull-PointsKO-Adjacents,573
Ixora_filiflora,0,0,0,NA,0
Ixora_filipendula,1,1,0,Points-PointsKO-Adjacents,9
Ixora_finlaysoniana,7,0,7,Points-PointsKO-Adjacents,61
Ixora_flavescens,0,0,0,NA,0
Ixora_floribunda,112,67,45,Alphahull-PointsKO-Adjacents,3200
Ixora_foliicalyx,39,19,20,Points-PointsKO-Adjacents,197
Ixora_foliosa,69,59,10,Alphahull-PointsKO-Adjacents,124
Ixora_francii,19,5,14,Points-PointsKO-Adjacents,100
Ixora_fucosa,16,6,10,Points-PointsKO-Adjacents,129
Ixora_fulgida,1,1,0,Points-PointsKO-Adjacents,9
Ixora_fulviflora,1,1,0,Points-PointsKO-Adjacents,9
Ixora_funckii,4,4,0,Points-PointsKO-Adjacents,36
Ixora_fuscescens,NA,NA,NA,NA,NA
Ixora_gardneriana,149,101,48,Alphahull-PointsKO-Adjacents,2947
Ixora_glomeruliflora,2,2,0,Points-PointsKO-Adjacents,9
Ixora_grandifolia,54,37,17,Alphahull-PointsKO-Adjacents,1341
Ixora_greenwoodiana,0,0,0,NA,0
Ixora_gyropogon,1,1,0,Points-PointsKO-Adjacents,5
Ixora_hallieri,1,1,0,Points-PointsKO-Adjacents,9
Ixora_hartiana,6,0,6,Points-PointsKO-Adjacents,48
Ixora_harveyi,1,1,0,Points-PointsKO-Adjacents,9
Ixora_havilandii,5,4,1,Points-PointsKO-Adjacents,45
Ixora_henryi,50,24,26,Alphahull-PointsKO-Adjacents,2435
Ixora_hiernii,49,29,20,Alphahull-PointsKO-Adjacents,953
Ixora_hippoperifera,103,84,19,Alphahull-PointsKO-Adjacents,911
Ixora_homolleae,23,7,16,Points-PointsKO-Adjacents,106
Ixora_hookeri,17,8,9,Points-PointsKO-Adjacents,104
Ixora_insignis,0,0,0,NA,0
Ixora_insularum,NA,NA,NA,NA,NA
Ixora_intensa,60,38,22,Alphahull-PointsKO-Adjacents,777
Ixora_iteaphylla,0,0,0,NA,0
Ixora_javanica,36,6,30,Points-PointsKO-Adjacents,275
Ixora_johnsonii,0,0,0,NA,0
Ixora_jourdanii,0,0,0,NA,0
Ixora_jucunda,1,1,0,Points-PointsKO-Adjacents,9
Ixora_kaniensis,0,0,0,NA,0
Ixora_kerstingii,1,1,0,Points-PointsKO-Adjacents,9
Ixora_keyensis,NA,NA,NA,NA,NA
Ixora_killipii,111,84,27,Alphahull-PointsKO-Adjacents,3996
Ixora_kinabaluensis,2,2,0,Points-PointsKO-Adjacents,12
Ixora_kingdon-wardii,1,1,0,Points-PointsKO-Adjacents,9
Ixora_kingstoni,0,0,0,NA,0
Ixora_krewanhensis,0,0,0,NA,0
Ixora_labuanensis,0,0,0,NA,0
Ixora_laurentii,26,16,10,Points-PointsKO-Adjacents,174
Ixora_lawsonii,NA,NA,NA,NA,NA
Ixora_laxiflora,109,72,37,Alphahull-PointsKO-Adjacents,3437
Ixora_lebangharae,1,1,0,Points-PointsKO-Adjacents,9
Ixora_lobbii,9,1,8,Points-PointsKO-Adjacents,70
Ixora_longhanensis,0,0,0,NA,0
Ixora_lunutica,0,0,0,NA,0
Ixora_macrantha,0,0,0,NA,0
Ixora_macrocotyla,NA,NA,NA,NA,NA
Ixora_makassarica,1,1,0,Points-PointsKO-Adjacents,9
Ixora_malabarica,1,0,1,Points-PointsKO-Adjacents,9
Ixora_margaretae,4,4,0,Points-PointsKO-Adjacents,25
Ixora_marquesensis,0,0,0,NA,0
Ixora_martinsii,10,0,10,Points-PointsKO-Adjacents,77
Ixora_maxima,0,0,0,NA,0
Ixora_membranifolia,NA,NA,NA,NA,NA
Ixora_merguensis,1,1,0,Points-PointsKO-Adjacents,9
Ixora_mildbraedii,43,24,19,Alphahull-PointsKO-Adjacents,3708
Ixora_moluccana,2,2,0,Points-PointsKO-Adjacents,15
Ixora_mooreensis,3,3,0,Points-PointsKO-Adjacents,6
Ixora_moszkowskii,3,3,0,Points-PointsKO-Adjacents,12
Ixora_myitkyinensis,NA,NA,NA,NA,NA
Ixora_myrsinoides,0,0,0,NA,0
Ixora_namatanaica,NA,NA,NA,NA,NA
Ixora_nandarivatensis,0,0,0,NA,0
Ixora_narcissodora,108,69,39,Alphahull-PointsKO-Adjacents,3258
Ixora_nicaraguensis,120,95,25,Alphahull-PointsKO-Adjacents,1254
Ixora_nigerica,3,3,0,Points-PointsKO-Adjacents,27
Ixora_nigricans,17,0,17,Points-PointsKO-Adjacents,140
Ixora_nitens,2,2,0,Points-PointsKO-Adjacents,12
Ixora_nitidula,0,0,0,NA,0
Ixora_nonantha,0,0,0,NA,0
Ixora_notoniana,0,0,0,NA,0
Ixora_novoguineensis,31,15,16,Points-PointsKO-Adjacents,176
Ixora_odoratiflora,0,0,0,NA,0
Ixora_oligantha,3,0,3,Points-PointsKO-Adjacents,22
Ixora_ooumuensis,1,1,0,Points-PointsKO-Adjacents,9
Ixora_opaca,3,2,1,Points-PointsKO-Adjacents,27
Ixora_orohenensis,NA,NA,NA,NA,NA
Ixora_otophora,8,4,4,Points-PointsKO-Adjacents,38
Ixora_panurensis,206,137,69,Alphahull-PointsKO-Adjacents,10442
Ixora_parviflora,2,2,0,Points-PointsKO-Adjacents,15
Ixora_patens,0,0,0,NA,0
Ixora_patula,1,1,0,Points-PointsKO-Adjacents,9
Ixora_pauciflora,0,0,0,NA,0
Ixora_pavetta,3,1,2,Points-PointsKO-Adjacents,27
Ixora_pelagica,1,1,0,Points-PointsKO-Adjacents,9
Ixora_pendula,7,3,4,Points-PointsKO-Adjacents,62
Ixora_peruviana,174,148,26,Alphahull-PointsKO-Adjacents,5875
Ixora_philippinensis,15,1,14,Points-PointsKO-Adjacents,100
Ixora_polyantha,0,0,0,NA,0
Ixora_praetermissa,68,50,18,Alphahull-PointsKO-Adjacents,1672
Ixora_prolixa,0,0,0,NA,0
Ixora_pubescens,5,0,5,Points-PointsKO-Adjacents,45
Ixora_pubifolia,0,0,0,NA,0
Ixora_pudica,0,0,0,NA,0
Ixora_pyrantha,12,4,8,Points-PointsKO-Adjacents,71
Ixora_pyrrhostaura,1,1,0,Points-PointsKO-Adjacents,9
Ixora_raiateensis,0,0,0,NA,0
Ixora_raivavaensis,0,0,0,NA,0
Ixora_rakotonasoloi,9,3,6,Points-PointsKO-Adjacents,60
Ixora_reticulata,1,1,0,Points-PointsKO-Adjacents,9
Ixora_robinsonii,2,2,0,Points-PointsKO-Adjacents,18
Ixora_roemeri,NA,NA,NA,NA,NA
Ixora_rubrinervis,1,1,0,Points-PointsKO-Adjacents,9
Ixora_rufa,8,0,8,Points-PointsKO-Adjacents,48
Ixora_samoensis,2,2,0,Points-PointsKO-Adjacents,18
Ixora_saulierei,0,0,0,NA,0
Ixora_scheffleri,82,56,26,Alphahull-PointsKO-Adjacents,2332
Ixora_schomburgkiana,22,12,10,Points-PointsKO-Adjacents,150
Ixora_seretii,16,6,10,Points-PointsKO-Adjacents,113
Ixora_setchellii,4,4,0,Points-PointsKO-Adjacents,11
Ixora_simalurensis,0,0,0,NA,0
Ixora_siphonantha,43,26,17,Alphahull-PointsKO-Adjacents,256
Ixora_sivarajiana,0,0,0,NA,0
Ixora_solomonensis,0,0,0,NA,0
Ixora_somosomaensis,0,0,0,NA,0
Ixora_sparsifolia,101,0,101,Points-PointsKO-Adjacents,708
Ixora_spathoidea,1,1,0,Points-PointsKO-Adjacents,6
Ixora_spectabilis,1,1,0,Points-PointsKO-Adjacents,9
Ixora_stenophylla,0,0,0,NA,0
Ixora_stenura,0,0,0,NA,0
Ixora_st-johnii,2,2,0,Points-PointsKO-Adjacents,4
Ixora_stokesii,1,1,0,Points-PointsKO-Adjacents,4
Ixora_subauriculata,17,9,8,Points-PointsKO-Adjacents,110
Ixora_subsessilis,0,0,0,NA,0
Ixora_temehaniensis,0,0,0,NA,0
Ixora_tenelliflora,2,2,0,Points-PointsKO-Adjacents,18
Ixora_thwaitesii,2,2,0,Points-PointsKO-Adjacents,18
Ixora_tibetana,NA,NA,NA,NA,NA
Ixora_timorensis,804,734,70,Alphahull-PointsKO-Adjacents,5011
Ixora_triantha,0,0,0,NA,0
Ixora_trichandra,1,1,0,Points-PointsKO-Adjacents,6
Ixora_trichocalyx,32,26,6,Alphahull-PointsKO-Adjacents,240
Ixora_trilocularis,1,1,0,Points-PointsKO-Adjacents,9
Ixora_trimera,1,1,0,Points-PointsKO-Adjacents,9
Ixora_tubiflora,0,0,0,NA,0
Ixora_uahukaensis,0,0,0,NA,0
Ixora_uapouensis,1,1,0,Points-PointsKO-Adjacents,5
Ixora_umbellata,1,1,0,Points-PointsKO-Adjacents,9
Ixora_undulata,0,0,0,NA,0
Ixora_venulosa,364,298,66,Alphahull-PointsKO-Adjacents,6744
Ixora_vitiensis,1,1,0,Points-PointsKO-Adjacents,3
Ixora_whitei,3,3,0,Points-PointsKO-Adjacents,23
Ixora_yavitensis,8,1,7,Points-PointsKO-Adjacents,66
Izozogia_nellii,6,0,6,Points-PointsKO-Adjacents,30
Jablonskia_congesta,189,131,58,Alphahull-PointsKO-Adjacents,20805
Jacaranda_acutifolia,24,12,12,Points-PointsKO-Adjacents,179
Jacaranda_arborea,11,7,4,Points-PointsKO-Adjacents,39
Jacaranda_bracteata,34,0,34,Points-PointsKO-Adjacents,195
Jacaranda_brasiliana,719,664,55,Alphahull-PointsKO-Adjacents,26885
Jacaranda_bullata,0,0,0,NA,0
Jacaranda_caerulea,33,6,27,Points-PointsKO-Adjacents,195
Jacaranda_carajasensis,1,1,0,Points-PointsKO-Adjacents,9
Jacaranda_caroba,386,330,56,Alphahull-PointsKO-Adjacents,12872
Jacaranda_caucana,235,184,51,Alphahull-PointsKO-Adjacents,8749
Jacaranda_copaia,1387,1277,110,Alphahull-PointsKO-Adjacents,88844
Jacaranda_cowellii,2,2,0,Points-PointsKO-Adjacents,18
Jacaranda_crassifolia,3,3,0,Points-PointsKO-Adjacents,24
Jacaranda_cuspidifolia,515,452,63,Alphahull-PointsKO-Adjacents,30503
Jacaranda_decurrens,100,69,31,Alphahull-PointsKO-Adjacents,7505
Jacaranda_ekmanii,4,4,0,Points-PointsKO-Adjacents,19
Jacaranda_glabra,243,196,47,Alphahull-PointsKO-Adjacents,15178
Jacaranda_grandifoliolata,10,1,9,Points-PointsKO-Adjacents,54
Jacaranda_hesperia,138,118,20,Alphahull-PointsKO-Adjacents,2142
Jacaranda_jasminoides,253,207,46,Alphahull-PointsKO-Adjacents,10259
Jacaranda_macrantha,228,179,49,Alphahull-PointsKO-Adjacents,4996
Jacaranda_macrocarpa,8,2,6,Points-PointsKO-Adjacents,56
Jacaranda_micrantha,556,507,49,Alphahull-PointsKO-Adjacents,9542
Jacaranda_microcalyx,27,8,19,Points-PointsKO-Adjacents,217
Jacaranda_mimosifolia,74,40,34,Alphahull-PointsKO-Adjacents,1534
Jacaranda_montana,28,15,13,Points-PointsKO-Adjacents,203
Jacaranda_mutabilis,16,2,14,Points-PointsKO-Adjacents,125
Jacaranda_obovata,177,121,56,Alphahull-PointsKO-Adjacents,1752
Jacaranda_obtusifolia,73,0,73,Points-PointsKO-Adjacents,588
Jacaranda_orinocensis,21,15,6,Points-PointsKO-Adjacents,187
Jacaranda_poitaei,37,26,11,Alphahull-PointsKO-Adjacents,245
Jacaranda_praetermissa,84,65,19,Alphahull-PointsKO-Adjacents,3105
Jacaranda_puberula,1078,966,112,Alphahull-PointsKO-Adjacents,23187
Jacaranda_pulcherrima,21,12,9,Points-PointsKO-Adjacents,145
Jacaranda_rufa,140,100,40,Alphahull-PointsKO-Adjacents,15951
Jacaranda_selleana,0,0,0,NA,0
Jacaranda_sparrei,7,3,4,Points-PointsKO-Adjacents,54
Jacaranda_subalpina,17,11,6,Points-PointsKO-Adjacents,108
Jacaratia_chocoensis,8,1,7,Points-PointsKO-Adjacents,54
Jacaratia_corumbensis,342,273,69,Alphahull-PointsKO-Adjacents,14162
Jacaratia_digitata,412,0,412,Points-PointsKO-Adjacents,2760
Jacaratia_dolichaula,159,142,17,Alphahull-PointsKO-Adjacents,938
Jacaratia_heptaphylla,198,158,40,Alphahull-PointsKO-Adjacents,4569
Jacaratia_mexicana,295,248,47,Alphahull-PointsKO-Adjacents,7453
Jacaratia_spinosa,348,254,94,Alphahull-PointsKO-Adjacents,6980
Jackiopsis_ornata,7,0,7,Points-PointsKO-Adjacents,56
Jacksonia_cupulifera,59,47,12,Alphahull-PointsKO-Adjacents,138
Jacksonia_furcellata,275,212,63,Alphahull-PointsKO-Adjacents,1433
Jacksonia_scoparia,2555,2436,119,Alphahull-PointsKO-Adjacents,8126
Jacksonia_sternbergiana,337,241,96,Alphahull-PointsKO-Adjacents,1283
Jacquemontia_eastwoodiana,74,1,73,Points-PointsKO-Adjacents,379
Jacqueshuberia_amplifoliola,6,1,5,Points-PointsKO-Adjacents,36
Jacqueshuberia_loretensis,9,4,5,Points-PointsKO-Adjacents,56
Jacqueshuberia_purpurea,16,0,16,Points-PointsKO-Adjacents,107
Jacqueshuberia_pustulata,2,2,0,Points-PointsKO-Adjacents,18
Jacqueshuberia_quinquangulata,4,4,0,Points-PointsKO-Adjacents,32
Jacqueshuberia_splendens,3,3,0,Points-PointsKO-Adjacents,21
Jacquinia_arborea,74,39,35,Alphahull-PointsKO-Adjacents,326
Jacquinia_armillaris,49,18,31,Points-PointsKO-Adjacents,295
Jacquinia_berteroi,65,32,33,Alphahull-PointsKO-Adjacents,421
Jacquinia_comosa,1,1,0,Points-PointsKO-Adjacents,9
Jacquinia_keyensis,35,0,35,Points-PointsKO-Adjacents,232
Jacquinia_macrantha,1,1,0,Points-PointsKO-Adjacents,9
Jacquinia_proctorii,0,0,0,NA,0
Jagera_javanica,50,22,28,Alphahull-PointsKO-Adjacents,892
Jagera_pseudorhus,1156,1056,100,Alphahull-PointsKO-Adjacents,2689
Jailoloa_halmaherensis,1,1,0,Points-PointsKO-Adjacents,9
Janotia_macrostipula,4,4,0,Points-PointsKO-Adjacents,27
Jaramilloa_hylibates,6,2,4,Points-PointsKO-Adjacents,50
Brownlowia_clemensiae,NA,NA,NA,NA,NA
Brownlowia_purseglovei,NA,NA,NA,NA,NA
Jasminocereus_thouarsii,20,11,9,Points-PointsKO-Adjacents,72
Jasminum_brachyscyphum,3,3,0,Points-PointsKO-Adjacents,27
Jasminum_brevipetiolatum,1,1,0,Points-PointsKO-Adjacents,9
Jatropha_alamanii,29,18,11,Points-PointsKO-Adjacents,129
Jatropha_andrieuxii,11,4,7,Points-PointsKO-Adjacents,87
Jatropha_bartlettii,9,6,3,Points-PointsKO-Adjacents,45
Jatropha_bullockii,17,0,17,Points-PointsKO-Adjacents,37
Jatropha_calcarea,2,2,0,Points-PointsKO-Adjacents,15
Jatropha_catingae,7,0,7,Points-PointsKO-Adjacents,50
Jatropha_chamelensis,16,0,16,Points-PointsKO-Adjacents,30
Jatropha_cinerea,178,159,19,Alphahull-PointsKO-Adjacents,2509
Jatropha_conzattii,3,3,0,Points-PointsKO-Adjacents,27
Jatropha_cordata,147,122,25,Alphahull-PointsKO-Adjacents,2776
Jatropha_costaricensis,24,15,9,Points-PointsKO-Adjacents,90
Jatropha_curcas,912,632,280,Alphahull-PointsKO-Adjacents,50696
Jatropha_decipiens,0,0,0,NA,0
Jatropha_dioica,350,303,47,Alphahull-PointsKO-Adjacents,8626
Jatropha_divaricata,6,6,0,Points-PointsKO-Adjacents,26
Jatropha_elbae,12,8,4,Points-PointsKO-Adjacents,46
Jatropha_galvanii,6,2,4,Points-PointsKO-Adjacents,54
Jatropha_gaumeri,201,172,29,Alphahull-PointsKO-Adjacents,2149
Jatropha_glauca,9,2,7,Points-PointsKO-Adjacents,72
Jatropha_gossypiifolia,657,379,278,Alphahull-PointsKO-Adjacents,21354
Jatropha_grossidentata,48,35,13,Alphahull-PointsKO-Adjacents,2198
Jatropha_hernandiifolia,29,11,18,Points-PointsKO-Adjacents,140
Jatropha_hieronymi,87,66,21,Alphahull-PointsKO-Adjacents,3724
Jatropha_humboldtiana,8,3,5,Points-PointsKO-Adjacents,72
Jatropha_integerrima,25,8,17,Points-PointsKO-Adjacents,160
Jatropha_macrantha,11,3,8,Points-PointsKO-Adjacents,90
Jatropha_mahafalensis,46,0,46,Points-PointsKO-Adjacents,196
Jatropha_malacophylla,49,29,20,Alphahull-PointsKO-Adjacents,424
Jatropha_mcvaughii,15,7,8,Points-PointsKO-Adjacents,93
Jatropha_mollissima,1083,1009,74,Alphahull-PointsKO-Adjacents,13805
Jatropha_multifida,48,8,40,Points-PointsKO-Adjacents,270
Jatropha_ortegae,7,0,7,Points-PointsKO-Adjacents,36
Jatropha_peltata,64,44,20,Alphahull-PointsKO-Adjacents,924
Jatropha_pereziae,3,3,0,Points-PointsKO-Adjacents,26
Jatropha_pseudocurcas,26,8,18,Points-PointsKO-Adjacents,164
Jatropha_purpurea,3,0,3,Points-PointsKO-Adjacents,27
Jatropha_riojae,3,2,1,Points-PointsKO-Adjacents,27
Jatropha_rufescens,7,3,4,Points-PointsKO-Adjacents,54
Jatropha_sotoi-nunyezii,3,3,0,Points-PointsKO-Adjacents,12
Jatropha_spinosa,45,31,14,Alphahull-PointsKO-Adjacents,1138
Jatropha_standleyi,33,22,11,Alphahull-PointsKO-Adjacents,90
Jatropha_stephani,8,7,1,Points-PointsKO-Adjacents,47
Jatropha_stevensii,8,2,6,Points-PointsKO-Adjacents,46
Jatropha_sympetala,25,15,10,Points-PointsKO-Adjacents,103
Jatropha_tehuantepecana,1,1,0,Points-PointsKO-Adjacents,9
Jatropha_tlalcozotitlanensis,0,0,0,NA,0
Jatropha_unicostata,11,5,6,Points-PointsKO-Adjacents,33
Jatropha_vernicosa,48,31,17,Alphahull-PointsKO-Adjacents,144
Jatropha_weberbaueri,16,6,10,Points-PointsKO-Adjacents,132
Jessea_multivenia,84,76,8,Alphahull-PointsKO-Adjacents,156
Joannesia_heveoides,43,14,29,Points-PointsKO-Adjacents,362
Joannesia_princeps,241,182,59,Alphahull-PointsKO-Adjacents,6041
Jodina_rhombifolia,183,135,48,Alphahull-PointsKO-Adjacents,13127
Jollydora_duparquetiana,223,201,22,Alphahull-PointsKO-Adjacents,3517
Jollydora_glandulosa,2,2,0,Points-PointsKO-Adjacents,18
Jollydora_pierrei,3,2,1,Points-PointsKO-Adjacents,18
Joosia_aequatoria,6,0,6,Points-PointsKO-Adjacents,44
Joosia_antioquiana,8,4,4,Points-PointsKO-Adjacents,43
Joosia_dichotoma,38,0,38,Points-PointsKO-Adjacents,182
Joosia_dielsiana,22,14,8,Points-PointsKO-Adjacents,137
Joosia_longisepala,4,4,0,Points-PointsKO-Adjacents,36
Joosia_macrocalyx,7,0,7,Points-PointsKO-Adjacents,48
Joosia_multiflora,8,4,4,Points-PointsKO-Adjacents,69
Joosia_obtusa,8,0,8,Points-PointsKO-Adjacents,60
Joosia_pulcherrima,52,31,21,Alphahull-PointsKO-Adjacents,504
Joosia_standleyana,3,3,0,Points-PointsKO-Adjacents,27
Joosia_umbellifera,187,144,43,Alphahull-PointsKO-Adjacents,3157
Joseanthus_chimborazensis,3,3,0,Points-PointsKO-Adjacents,27
Joseanthus_cuatrecasasii,4,4,0,Points-PointsKO-Adjacents,36
Joseanthus_sparrei,4,4,0,Points-PointsKO-Adjacents,30
Joseanthus_trichotomus,9,3,6,Points-PointsKO-Adjacents,45
Juania_australis,2,2,0,Points-PointsKO-Adjacents,5
Juanulloa_ochracea,152,117,35,Alphahull-PointsKO-Adjacents,4259
Jubaea_chilensis,13,0,13,Points-PointsKO-Adjacents,90
Jubaeopsis_caffra,12,7,5,Points-PointsKO-Adjacents,41
Juglans_ailantifolia,42,16,26,Points-PointsKO-Adjacents,270
Juglans_australis,70,49,21,Alphahull-PointsKO-Adjacents,716
Juglans_boliviana,61,40,21,Alphahull-PointsKO-Adjacents,589
Juglans_californica,713,0,713,Points-PointsKO-Adjacents,903
Juglans_cinerea,2060,1688,372,Alphahull-PointsKO-Adjacents,33125
Juglans_hindsii,369,279,90,Alphahull-PointsKO-Adjacents,2689
Juglans_jamaicensis,10,3,7,Points-PointsKO-Adjacents,77
Juglans_major,613,547,66,Alphahull-PointsKO-Adjacents,18019
Juglans_mandshurica,5,4,1,Points-PointsKO-Adjacents,45
Juglans_microcarpa,217,1,216,Points-PointsKO-Adjacents,1304
Juglans_mollis,198,180,18,Alphahull-PointsKO-Adjacents,2025
Juglans_neotropica,178,129,49,Alphahull-PointsKO-Adjacents,2304
Juglans_nigra,9938,8762,1176,Alphahull-PointsKO-Adjacents,51031
Juglans_regia,5963,4784,1179,Alphahull-PointsKO-Adjacents,28471
Juglans_sigillata,47,33,14,Alphahull-PointsKO-Adjacents,1352
Juglans_soratensis,4,4,0,Points-PointsKO-Adjacents,32
Juglans_steyermarkii,11,8,3,Points-PointsKO-Adjacents,41
Juglans_venezuelensis,3,3,0,Points-PointsKO-Adjacents,18
Julbernardia_baumii,0,0,0,NA,0
Julbernardia_brieyi,51,38,13,Alphahull-PointsKO-Adjacents,937
Julbernardia_globiflora,211,166,45,Alphahull-PointsKO-Adjacents,16562
Julbernardia_hochreutineri,23,15,8,Points-PointsKO-Adjacents,158
Julbernardia_letouzeyi,8,5,3,Points-PointsKO-Adjacents,54
Julbernardia_magnistipulata,35,0,35,Points-PointsKO-Adjacents,202
Julbernardia_paniculata,44,19,25,Points-PointsKO-Adjacents,328
Julbernardia_pellegriniana,80,62,18,Alphahull-PointsKO-Adjacents,1098
Julbernardia_seretii,88,59,29,Alphahull-PointsKO-Adjacents,2366
Julbernardia_unijugata,10,5,5,Points-PointsKO-Adjacents,49
Julostylis_angustifolia,0,0,0,NA,0
Juniperus_angosturana,82,66,16,Alphahull-PointsKO-Adjacents,2124
Juniperus_arizonica,31,18,13,Points-PointsKO-Adjacents,183
Juniperus_ashei,1503,1416,87,Alphahull-PointsKO-Adjacents,8460
Juniperus_barbadensis,33,14,19,Points-PointsKO-Adjacents,212
Juniperus_bermudiana,4,0,4,Points-PointsKO-Adjacents,25
Juniperus_blancoi,25,9,16,Points-PointsKO-Adjacents,127
Juniperus_brevifolia,33,22,11,Alphahull-PointsKO-Adjacents,68
Juniperus_californica,1429,0,1429,Points-PointsKO-Adjacents,2375
Juniperus_cedrus,134,119,15,Alphahull-PointsKO-Adjacents,134
Juniperus_chinensis,185,102,83,Alphahull-PointsKO-Adjacents,17604
Juniperus_coahuilensis,753,710,43,Alphahull-PointsKO-Adjacents,12354
Juniperus_comitana,33,0,33,Points-PointsKO-Adjacents,121
Juniperus_communis,73050,68679,4371,Alphahull-PointsKO-Adjacents,249762
Juniperus_convallium,44,28,16,Alphahull-PointsKO-Adjacents,1522
Juniperus_coxii,24,18,6,Points-PointsKO-Adjacents,144
Juniperus_deltoides,221,143,78,Alphahull-PointsKO-Adjacents,4552
Juniperus_deppeana,4282,4204,78,Alphahull-PointsKO-Adjacents,17453
Juniperus_drupacea,47,36,11,Alphahull-PointsKO-Adjacents,622
Juniperus_durangensis,78,62,16,Alphahull-PointsKO-Adjacents,868
Juniperus_excelsa,205,119,86,Alphahull-PointsKO-Adjacents,6933
Juniperus_flaccida,783,720,63,Alphahull-PointsKO-Adjacents,11098
Juniperus_foetidissima,86,48,38,Alphahull-PointsKO-Adjacents,2529
Juniperus_formosana,257,202,55,Alphahull-PointsKO-Adjacents,12367
Juniperus_gamboana,59,54,5,Alphahull-PointsKO-Adjacents,69
Juniperus_gracilior,15,10,5,Points-PointsKO-Adjacents,95
Juniperus_grandis,253,227,26,Alphahull-PointsKO-Adjacents,4763
Juniperus_indica,103,70,33,Alphahull-PointsKO-Adjacents,668
Juniperus_jaliscana,9,7,2,Points-PointsKO-Adjacents,51
Juniperus_komarovii,14,6,8,Points-PointsKO-Adjacents,111
Juniperus_macrocarpa,383,273,110,Alphahull-PointsKO-Adjacents,7543
Juniperus_monosperma,4436,4391,45,Alphahull-PointsKO-Adjacents,12651
Juniperus_monticola,178,156,22,Alphahull-PointsKO-Adjacents,2598
Juniperus_morrisonicola,7,5,2,Points-PointsKO-Adjacents,30
Juniperus_mucronata,20,5,15,Points-PointsKO-Adjacents,91
Juniperus_occidentalis,2173,2130,43,Alphahull-PointsKO-Adjacents,11476
Juniperus_osteosperma,13866,13812,54,Alphahull-PointsKO-Adjacents,20113
Juniperus_oxycedrus,19886,18392,1494,Alphahull-PointsKO-Adjacents,28500
Juniperus_phoenicea,9605,9050,555,Alphahull-PointsKO-Adjacents,14288
Juniperus_pinchotii,741,695,46,Alphahull-PointsKO-Adjacents,12902
Juniperus_pingii,84,54,30,Alphahull-PointsKO-Adjacents,3617
Juniperus_poblana,82,64,18,Alphahull-PointsKO-Adjacents,1364
Juniperus_polycarpos,125,73,52,Alphahull-PointsKO-Adjacents,2691
Juniperus_procera,138,80,58,Alphahull-PointsKO-Adjacents,8923
Juniperus_przewalskii,25,15,10,Points-PointsKO-Adjacents,173
Juniperus_pseudosabina,68,46,22,Alphahull-PointsKO-Adjacents,3071
Juniperus_recurva,93,59,34,Alphahull-PointsKO-Adjacents,1179
Juniperus_rigida,220,0,220,Points-PointsKO-Adjacents,1203
Juniperus_saltillensis,42,30,12,Alphahull-PointsKO-Adjacents,250
Juniperus_saltuaria,69,52,17,Alphahull-PointsKO-Adjacents,3554
Juniperus_saxicola,5,5,0,Points-PointsKO-Adjacents,23
Juniperus_scopulorum,5298,5161,137,Alphahull-PointsKO-Adjacents,42249
Juniperus_semiglobosa,61,37,24,Alphahull-PointsKO-Adjacents,3634
Juniperus_seravschanica,9,0,9,Points-PointsKO-Adjacents,69
Juniperus_standleyi,14,8,6,Points-PointsKO-Adjacents,31
Juniperus_taxifolia,5,1,4,Points-PointsKO-Adjacents,34
Juniperus_thurifera,3760,3677,83,Alphahull-PointsKO-Adjacents,4256
Juniperus_tibetica,83,57,26,Alphahull-PointsKO-Adjacents,3548
Juniperus_virginiana,19074,17442,1632,Alphahull-PointsKO-Adjacents,63636
Juniperus_zanonii,74,56,18,Alphahull-PointsKO-Adjacents,1140
Justicia_maxima,9,1,8,Points-PointsKO-Adjacents,77
Kadua_affinis,40,30,10,Alphahull-PointsKO-Adjacents,150
Kadua_axillaris,11,5,6,Points-PointsKO-Adjacents,61
Kadua_lichtlei,1,1,0,Points-PointsKO-Adjacents,6
Kadua_nukuhivensis,2,2,0,Points-PointsKO-Adjacents,8
Kageneckia_angustifolia,14,8,6,Points-PointsKO-Adjacents,113
Kageneckia_lanceolata,95,49,46,Alphahull-PointsKO-Adjacents,1435
Kageneckia_oblonga,25,10,15,Points-PointsKO-Adjacents,181
Kailarsenia_campanula,1,1,0,Points-PointsKO-Adjacents,9
Kailarsenia_hygrophila,0,0,0,NA,0
Kairothamnus_phyllanthoides,5,5,0,Points-PointsKO-Adjacents,27
Kajewskiella_polyantha,0,0,0,NA,0
Kajewskiella_trichantha,0,0,0,NA,0
Kalanchoe_beharensis,28,15,13,Points-PointsKO-Adjacents,196
Kalappia_celebica,2,2,0,Points-PointsKO-Adjacents,18
Kaliphora_madagascariensis,145,128,17,Alphahull-PointsKO-Adjacents,707
Kalmia_latifolia,2631,2298,333,Alphahull-PointsKO-Adjacents,15089
Kalopanax_septemlobus,464,256,208,Alphahull-PointsKO-Adjacents,9413
Kanakomyrtus_dawsoniana,NA,NA,NA,NA,NA
Kanakomyrtus_longipetiolata,8,3,5,Points-PointsKO-Adjacents,51
Kanakomyrtus_mcphersonii,4,4,0,Points-PointsKO-Adjacents,15
Kanakomyrtus_myrtopsidoides,9,6,3,Points-PointsKO-Adjacents,23
Kanakomyrtus_prominens,7,4,3,Points-PointsKO-Adjacents,35
Kanakomyrtus_revoluta,1,1,0,Points-PointsKO-Adjacents,8
Kandelia_candel,5,5,0,Points-PointsKO-Adjacents,36
Kandelia_obovata,17,0,17,Points-PointsKO-Adjacents,67
Kania_eugenioides,71,1,70,Points-PointsKO-Adjacents,389
Kania_hirsutula,4,4,0,Points-PointsKO-Adjacents,36
Kania_microphylla,0,0,0,NA,0
Kania_nettotensis,1,1,0,Points-PointsKO-Adjacents,9
Kania_platyphylla,0,0,0,NA,0
Kania_urdanetensis,0,0,0,NA,0
Karomia_gigas,3,2,1,Points-PointsKO-Adjacents,18
Karomia_humbertii,8,3,5,Points-PointsKO-Adjacents,52
Karomia_macrocalyx,20,4,16,Points-PointsKO-Adjacents,117
Karomia_madagascariensis,4,4,0,Points-PointsKO-Adjacents,34
Karomia_microphylla,35,25,10,Alphahull-PointsKO-Adjacents,395
Karomia_mira,18,9,9,Points-PointsKO-Adjacents,135
Karomia_speciosa,47,36,11,Alphahull-PointsKO-Adjacents,764
Karomia_tettensis,1,1,0,Points-PointsKO-Adjacents,9
Karwinskia_calderonii,397,1,396,Points-PointsKO-Adjacents,1236
Karwinskia_humboldtiana,1331,1193,138,Alphahull-PointsKO-Adjacents,19187
Karwinskia_pluvialis,13,6,7,Points-PointsKO-Adjacents,80
Karwinskia_venturae,24,15,9,Points-PointsKO-Adjacents,134
Kaunia_camataguiensis,6,3,3,Points-PointsKO-Adjacents,54
Kaunia_endyta,7,2,5,Points-PointsKO-Adjacents,59
Kaunia_eucosmoides,1,1,0,Points-PointsKO-Adjacents,9
Kaunia_gynoximorpha,29,16,13,Points-PointsKO-Adjacents,144
Kaunia_lasiophthalma,55,35,20,Alphahull-PointsKO-Adjacents,906
Kaunia_longipetiolata,37,13,24,Points-PointsKO-Adjacents,262
Kaunia_rufescens,135,91,44,Alphahull-PointsKO-Adjacents,3768
Kayea_coriacea,7,2,5,Points-PointsKO-Adjacents,45
Calophyllum_hexapetalum,6,1,5,Points-PointsKO-Adjacents,50
Kayea_paniculata,3,3,0,Points-PointsKO-Adjacents,20
Keayodendron_bridelioides,46,18,28,Points-PointsKO-Adjacents,336
Keetia_angustifolia,10,5,5,Points-PointsKO-Adjacents,50
Keetia_gueinzii,240,148,92,Alphahull-PointsKO-Adjacents,12069
Keetia_koritschoneri,8,0,8,Points-PointsKO-Adjacents,51
Keetia_lukei,4,4,0,Points-PointsKO-Adjacents,22
Keetia_multiflora,261,199,62,Alphahull-PointsKO-Adjacents,6074
Keetia_purpurascens,7,5,2,Points-PointsKO-Adjacents,57
Keetia_purseglovei,1,1,0,Points-PointsKO-Adjacents,9
Keetia_venosa,369,261,108,Alphahull-PointsKO-Adjacents,21649
Keetia_zanzibarica,154,87,67,Alphahull-PointsKO-Adjacents,2372
Kentiopsis_magnifica,5,5,0,Points-PointsKO-Adjacents,10
Kentiopsis_oliviformis,7,4,3,Points-PointsKO-Adjacents,31
Kentiopsis_piersoniorum,2,2,0,Points-PointsKO-Adjacents,7
Kentiopsis_pyriformis,5,1,4,Points-PointsKO-Adjacents,14
Kerianthera_longiflora,7,3,4,Points-PointsKO-Adjacents,54
Kerianthera_preclara,8,5,3,Points-PointsKO-Adjacents,48
Kermadecia_pronyensis,7,1,6,Points-PointsKO-Adjacents,35
Kerriodoxa_elegans,2,2,0,Points-PointsKO-Adjacents,9
Keteleeria_davidiana,76,42,34,Alphahull-PointsKO-Adjacents,4321
Keteleeria_evelyniana,78,51,27,Alphahull-PointsKO-Adjacents,2515
Keteleeria_fortunei,32,13,19,Points-PointsKO-Adjacents,264
Khasiaclunea_oligocephala,0,0,0,NA,0
Khaya_anthotheca,140,73,67,Alphahull-PointsKO-Adjacents,3599
Khaya_grandifoliola,119,0,119,Points-PointsKO-Adjacents,516
Khaya_ivorensis,74,43,31,Alphahull-PointsKO-Adjacents,1771
Khaya_madagascariensis,20,4,16,Points-PointsKO-Adjacents,142
Khaya_senegalensis,563,495,68,Alphahull-PointsKO-Adjacents,9358
Kibara_coriacea,18,1,17,Points-PointsKO-Adjacents,134
Kibara_macrophylla,29,8,21,Points-PointsKO-Adjacents,164
Kibaropsis_caledonica,30,21,9,Alphahull-PointsKO-Adjacents,60
Kibatalia_arborea,3,2,1,Points-PointsKO-Adjacents,24
Kibatalia_blancoi,1,1,0,Points-PointsKO-Adjacents,9
Kibatalia_borneensis,1,1,0,Points-PointsKO-Adjacents,9
Kibatalia_elmeri,3,3,0,Points-PointsKO-Adjacents,18
Kibatalia_gitingensis,10,4,6,Points-PointsKO-Adjacents,82
Kibatalia_laurifolia,5,0,5,Points-PointsKO-Adjacents,36
Kibatalia_longifolia,0,0,0,NA,0
Kibatalia_macgregorii,1,1,0,Points-PointsKO-Adjacents,8
Kibatalia_macrophylla,12,0,12,Points-PointsKO-Adjacents,97
Kibatalia_maingayi,8,1,7,Points-PointsKO-Adjacents,65
Kibatalia_merrilliana,0,0,0,NA,0
Kibatalia_puberula,0,0,0,NA,0
Kibatalia_stenopetala,1,1,0,Points-PointsKO-Adjacents,9
Kibatalia_villosa,2,2,0,Points-PointsKO-Adjacents,18
Kibatalia_wigmanii,3,3,0,Points-PointsKO-Adjacents,27
Kielmeyera_albopunctata,56,0,56,Points-PointsKO-Adjacents,266
Kielmeyera_coriacea,1094,1011,83,Alphahull-PointsKO-Adjacents,32985
Kielmeyera_divergens,1,1,0,Points-PointsKO-Adjacents,9
Kielmeyera_excelsa,50,37,13,Alphahull-PointsKO-Adjacents,603
Kielmeyera_gracilis,9,0,9,Points-PointsKO-Adjacents,59
Kielmeyera_grandiflora,140,95,45,Alphahull-PointsKO-Adjacents,7981
Kielmeyera_itacarensis,11,6,5,Points-PointsKO-Adjacents,39
Kielmeyera_lathrophyton,414,376,38,Alphahull-PointsKO-Adjacents,14080
Kielmeyera_marauensis,14,8,6,Points-PointsKO-Adjacents,64
Kielmeyera_membranacea,92,0,92,Points-PointsKO-Adjacents,475
Kielmeyera_neglecta,81,52,29,Alphahull-PointsKO-Adjacents,834
Kielmeyera_occhioniana,20,7,13,Points-PointsKO-Adjacents,150
Kielmeyera_paniculata,38,25,13,Alphahull-PointsKO-Adjacents,299
Kielmeyera_peruviana,5,2,3,Points-PointsKO-Adjacents,32
Kielmeyera_petiolaris,204,176,28,Alphahull-PointsKO-Adjacents,7174
Kielmeyera_rizziniana,12,0,12,Points-PointsKO-Adjacents,85
Kielmeyera_rubriflora,686,638,48,Alphahull-PointsKO-Adjacents,24654
Kielmeyera_rufotomentosa,2,2,0,Points-PointsKO-Adjacents,18
Kielmeyera_rupestris,7,4,3,Points-PointsKO-Adjacents,36
Kielmeyera_sigillata,6,0,6,Points-PointsKO-Adjacents,52
Kielmeyera_speciosa,246,208,38,Alphahull-PointsKO-Adjacents,9772
Kielmeyera_tomentosa,107,90,17,Alphahull-PointsKO-Adjacents,4042
Kigelia_africana,595,444,151,Alphahull-PointsKO-Adjacents,29680
Kiggelaria_africana,251,181,70,Alphahull-PointsKO-Adjacents,7126
Killipia_pedunculata,4,4,0,Points-PointsKO-Adjacents,27
Killipia_quadrangularis,7,5,2,Points-PointsKO-Adjacents,41
Kingia_australis,105,78,27,Alphahull-PointsKO-Adjacents,830
Kingiodendron_alternifolium,19,5,14,Points-PointsKO-Adjacents,114
Kingiodendron_novoguineense,9,2,7,Points-PointsKO-Adjacents,64
Kingiodendron_pinnatum,0,0,0,NA,0
Kingiodendron_platycarpum,0,0,0,NA,0
Kingiodendron_tenuicarpum,0,0,0,NA,0
Kirkia_acuminata,96,57,39,Alphahull-PointsKO-Adjacents,2189
Kirkia_dewinteri,3,2,1,Points-PointsKO-Adjacents,27
Kirkia_leandrii,9,7,2,Points-PointsKO-Adjacents,33
Kirkia_tenuifolia,8,2,6,Points-PointsKO-Adjacents,72
Kirkia_wilmsii,47,39,8,Alphahull-PointsKO-Adjacents,890
Kjellbergiodendron_celebicum,12,2,10,Points-PointsKO-Adjacents,89
Klaineanthus_gaboniae,51,38,13,Alphahull-PointsKO-Adjacents,1044
Klaineanthus_gabonii,174,151,23,Alphahull-PointsKO-Adjacents,3644
Klainedoxa_gabonensis,268,205,63,Alphahull-PointsKO-Adjacents,18757
Klainedoxa_trillesii,52,27,25,Alphahull-PointsKO-Adjacents,1345
Klarobelia_anomala,77,60,17,Alphahull-PointsKO-Adjacents,774
Klarobelia_candida,21,13,8,Points-PointsKO-Adjacents,122
Klarobelia_cauliflora,12,5,7,Points-PointsKO-Adjacents,92
Klarobelia_inundata,12,3,9,Points-PointsKO-Adjacents,108
Klarobelia_lucida,14,8,6,Points-PointsKO-Adjacents,75
Klarobelia_megalocarpa,8,3,5,Points-PointsKO-Adjacents,60
Klarobelia_napoensis,47,32,15,Alphahull-PointsKO-Adjacents,2461
Klarobelia_pandoensis,7,1,6,Points-PointsKO-Adjacents,54
Klarobelia_pumila,27,10,17,Points-PointsKO-Adjacents,214
Klarobelia_stipitata,17,9,8,Points-PointsKO-Adjacents,49
Klarobelia_subglobosa,2,2,0,Points-PointsKO-Adjacents,15
Kleinhovia_hospita,204,100,104,Alphahull-PointsKO-Adjacents,1855
Kleinia_neriifolia,489,465,24,Alphahull-PointsKO-Adjacents,242
Klugiodendron_umbrianum,3,3,0,Points-PointsKO-Adjacents,27
Myristica_attenuata,0,0,0,NA,0
Knema_cinerea,21,6,15,Points-PointsKO-Adjacents,168
Knema_conferta,7,2,5,Points-PointsKO-Adjacents,54
Knema_elegans,9,3,6,Points-PointsKO-Adjacents,69
Knema_erratica,8,1,7,Points-PointsKO-Adjacents,71
Knema_furfuracea,11,4,7,Points-PointsKO-Adjacents,89
Knema_globularia,45,14,31,Points-PointsKO-Adjacents,355
Myristica_hookeriana,6,2,4,Points-PointsKO-Adjacents,53
Myristica_intermedia,8,0,8,Points-PointsKO-Adjacents,70
Myristica_kunstleri,16,0,16,Points-PointsKO-Adjacents,123
Knema_lenta,6,0,6,Points-PointsKO-Adjacents,54
Knema_linifolia,4,0,4,Points-PointsKO-Adjacents,30
Myristica_mandaharan,3,1,2,Points-PointsKO-Adjacents,27
Myristica_oblongifolia,6,1,5,Points-PointsKO-Adjacents,46
Myristica_pectinata,2,0,2,Points-PointsKO-Adjacents,18
Myristica_pulchra,13,0,13,Points-PointsKO-Adjacents,91
Myristica_retusa,NA,NA,NA,NA,NA
Myristica_rufa,0,0,0,NA,0
Myristica_scortechinii,4,0,4,Points-PointsKO-Adjacents,36
Myristica_stenocarpa,2,2,0,Points-PointsKO-Adjacents,10
Myristica_sumatrana,8,0,8,Points-PointsKO-Adjacents,70
Knema_tenuinervia,10,1,9,Points-PointsKO-Adjacents,84
Knema_tomentella,31,15,16,Points-PointsKO-Adjacents,205
Knema_tonkinensis,3,3,0,Points-PointsKO-Adjacents,27
Knightia_strobilina,3,3,0,Points-PointsKO-Adjacents,26
Koanophyllon_albicaule,145,100,45,Alphahull-PointsKO-Adjacents,2731
Koanophyllon_breviflorum,0,0,0,NA,0
Koanophyllon_celtidifolia,8,2,6,Points-PointsKO-Adjacents,45
Koanophyllon_galeottii,50,31,19,Alphahull-PointsKO-Adjacents,1316
Koanophyllon_hotteanum,0,0,0,NA,0
Koanophyllon_hylonoma,86,74,12,Alphahull-PointsKO-Adjacents,248
Koanophyllon_microchaetum,1,1,0,Points-PointsKO-Adjacents,9
Koanophyllon_nervosum,3,3,0,Points-PointsKO-Adjacents,27
Koanophyllon_oligadenium,NA,NA,NA,NA,NA
Koanophyllon_panamensis,2,2,0,Points-PointsKO-Adjacents,16
Koanophyllon_pittieri,269,233,36,Alphahull-PointsKO-Adjacents,2124
Koanophyllon_polyodon,22,13,9,Points-PointsKO-Adjacents,74
Koanophyllon_quisqueyanum,NA,NA,NA,NA,NA
Koanophyllon_wetmorei,22,11,11,Points-PointsKO-Adjacents,125
Kochummenia_stenopetala,NA,NA,NA,NA,NA
Koeberlinia_spinosa,441,390,51,Alphahull-PointsKO-Adjacents,12990
Koelreuteria_bipinnata,43,11,32,Points-PointsKO-Adjacents,383
Koelreuteria_elegans,0,0,0,NA,0
Koelreuteria_paniculata,41,11,30,Points-PointsKO-Adjacents,353
Koilodepas_bantamense,1,1,0,Points-PointsKO-Adjacents,9
Koilodepas_brevipes,7,0,7,Points-PointsKO-Adjacents,57
Koilodepas_calycinum,0,0,0,NA,0
Koilodepas_ferrugineum,0,0,0,NA,0
Koilodepas_hainanense,5,1,4,Points-PointsKO-Adjacents,30
Koilodepas_homaliifolium,1,1,0,Points-PointsKO-Adjacents,9
Koilodepas_laevigatum,2,2,0,Points-PointsKO-Adjacents,18
Koilodepas_longifolium,11,1,10,Points-PointsKO-Adjacents,85
Koilodepas_pectinatum,0,0,0,NA,0
Koilodepas_wallichianum,0,0,0,NA,0
Kokia_cookei,1,1,0,Points-PointsKO-Adjacents,6
Kokia_drynarioides,1,1,0,Points-PointsKO-Adjacents,9
Kokia_kauaiensis,1,1,0,Points-PointsKO-Adjacents,8
Kokia_lanceolata,0,0,0,NA,0
Lophopetalum_filiforme,1,1,0,Points-PointsKO-Adjacents,9
Ardisia_ochracea,7,1,6,Points-PointsKO-Adjacents,60
Lophopetalum_reflexum,4,0,4,Points-PointsKO-Adjacents,36
Koompassia_excelsa,9,4,5,Points-PointsKO-Adjacents,75
Koompassia_grandiflora,8,3,5,Points-PointsKO-Adjacents,50
Koompassia_malaccensis,7,2,5,Points-PointsKO-Adjacents,48
Kopsia_angustipetala,3,3,0,Points-PointsKO-Adjacents,27
Kopsia_arborea,74,1,73,Points-PointsKO-Adjacents,317
Kopsia_dasyrachis,1,1,0,Points-PointsKO-Adjacents,9
Kopsia_deverrei,0,0,0,NA,0
Kopsia_flavida,32,6,26,Points-PointsKO-Adjacents,188
Kopsia_fruticosa,2,2,0,Points-PointsKO-Adjacents,18
Kopsia_grandifolia,0,0,0,NA,0
Kopsia_griffithii,1,0,1,Points-PointsKO-Adjacents,9
Kopsia_hainanensis,3,3,0,Points-PointsKO-Adjacents,27
Kopsia_harmandiana,0,0,0,NA,0
Kopsia_lapidilecta,0,0,0,NA,0
Kopsia_larutensis,1,1,0,Points-PointsKO-Adjacents,9
Kopsia_macrophylla,0,0,0,NA,0
Kopsia_pauciflora,16,0,16,Points-PointsKO-Adjacents,132
Kopsia_profunda,0,0,0,NA,0
Kopsia_rajangensis,1,1,0,Points-PointsKO-Adjacents,9
Kopsia_rosea,6,2,4,Points-PointsKO-Adjacents,43
Kopsia_singapurensis,2,2,0,Points-PointsKO-Adjacents,18
Kopsia_sleeseniana,0,0,0,NA,0
Kopsia_sumatrana,1,1,0,Points-PointsKO-Adjacents,9
Kopsia_tenuis,0,0,0,NA,0
Kopsia_teoi,0,0,0,NA,0
Kopsia_tonkinensis,1,1,0,Points-PointsKO-Adjacents,9
Korupodendron_songweanum,6,0,6,Points-PointsKO-Adjacents,27
Kosteletzkya_grantii,12,1,11,Points-PointsKO-Adjacents,89
Kostermanthus_heteropetalus,27,3,24,Points-PointsKO-Adjacents,207
Kostermanthus_malayanus,1,1,0,Points-PointsKO-Adjacents,9
Kostermanthus_robustus,5,5,0,Points-PointsKO-Adjacents,45
Kotschya_bullockii,3,3,0,Points-PointsKO-Adjacents,27
Kotschya_platyphylla,8,2,6,Points-PointsKO-Adjacents,52
Kotschya_recurvifolia,62,33,29,Alphahull-PointsKO-Adjacents,1114
Kotschya_suberifera,1,1,0,Points-PointsKO-Adjacents,9
Kraussia_floribunda,88,64,24,Alphahull-PointsKO-Adjacents,1052
Kraussia_kirkii,67,47,20,Alphahull-PointsKO-Adjacents,558
Kraussia_speciosa,38,24,14,Alphahull-PointsKO-Adjacents,191
Krugiodendron_acuminatum,6,3,3,Points-PointsKO-Adjacents,38
Krugiodendron_ferreum,404,311,93,Alphahull-PointsKO-Adjacents,6690
Krukoviella_disticha,18,0,18,Points-PointsKO-Adjacents,130
Kubitzkia_macrantha,6,0,6,Points-PointsKO-Adjacents,54
Kunzea_clavata,6,5,1,Points-PointsKO-Adjacents,26
Kunzea_ericoides,3078,2897,181,Alphahull-PointsKO-Adjacents,8211
Kunzea_montana,19,17,2,Points-PointsKO-Adjacents,53
Kunzea_sulphurea,100,84,16,Alphahull-PointsKO-Adjacents,253
Kutchubaea_duckei,4,4,0,Points-PointsKO-Adjacents,30
Kutchubaea_insignis,45,15,30,Points-PointsKO-Adjacents,361
Kutchubaea_longiloba,4,4,0,Points-PointsKO-Adjacents,36
Kutchubaea_micrantha,10,2,8,Points-PointsKO-Adjacents,80
Kutchubaea_montana,3,3,0,Points-PointsKO-Adjacents,27
Kutchubaea_morilloi,6,0,6,Points-PointsKO-Adjacents,45
Kutchubaea_neblinensis,3,3,0,Points-PointsKO-Adjacents,25
Kutchubaea_oocarpa,9,2,7,Points-PointsKO-Adjacents,77
Kutchubaea_palustris,4,3,1,Points-PointsKO-Adjacents,36
Kutchubaea_semisericea,54,25,29,Alphahull-PointsKO-Adjacents,1087
Kutchubaea_sericantha,69,34,35,Alphahull-PointsKO-Adjacents,1657
Kutchubaea_surinamensis,11,1,10,Points-PointsKO-Adjacents,91
Kutchubaea_urophylla,7,0,7,Points-PointsKO-Adjacents,60
Kydia_calycina,34,8,26,Points-PointsKO-Adjacents,285
Kydia_glabrescens,9,0,9,Points-PointsKO-Adjacents,75
Labordia_cyrtandrae,2,1,1,Points-PointsKO-Adjacents,13
Labordia_fagraeoidea,2,1,1,Points-PointsKO-Adjacents,13
Labordia_hedyosmifolia,19,10,9,Points-PointsKO-Adjacents,80
Labordia_hirtella,17,6,11,Points-PointsKO-Adjacents,81
Labordia_kaalae,0,0,0,NA,0
Labordia_lydgatei,4,4,0,Points-PointsKO-Adjacents,16
Labordia_tinifolia,9,0,9,Points-PointsKO-Adjacents,56
Labordia_triflora,2,2,0,Points-PointsKO-Adjacents,13
Labourdonnaisia_calophylloides,4,3,1,Points-PointsKO-Adjacents,28
Labourdonnaisia_glauca,2,2,0,Points-PointsKO-Adjacents,9
Labourdonnaisia_lecomtei,3,3,0,Points-PointsKO-Adjacents,26
Labourdonnaisia_madagascariensis,3,3,0,Points-PointsKO-Adjacents,15
Labourdonnaisia_revoluta,1,1,0,Points-PointsKO-Adjacents,9
Labourdonnaisia_richardiana,0,0,0,NA,0
Labourdonnaisia_thouarsii,0,0,0,NA,0
Labramia_ankaranaensis,20,0,20,Points-PointsKO-Adjacents,113
Labramia_boivinii,16,1,15,Points-PointsKO-Adjacents,123
Labramia_bojeri,35,18,17,Points-PointsKO-Adjacents,227
Labramia_capuronii,14,1,13,Points-PointsKO-Adjacents,118
Labramia_costata,31,16,15,Points-PointsKO-Adjacents,210
Labramia_louvelii,16,6,10,Points-PointsKO-Adjacents,103
Labramia_mayottensis,3,3,0,Points-PointsKO-Adjacents,12
Labramia_platanoides,18,12,6,Points-PointsKO-Adjacents,99
Labramia_sambiranensis,5,5,0,Points-PointsKO-Adjacents,23
Laburnum_alpinum,345,326,19,Alphahull-PointsKO-Adjacents,3018
Laburnum_anagyroides,2906,2451,455,Alphahull-PointsKO-Adjacents,12192
Laccodiscus_ferrugineus,73,63,10,Alphahull-PointsKO-Adjacents,640
Laccodiscus_klaineanus,56,43,13,Alphahull-PointsKO-Adjacents,910
Laccodiscus_pseudostipularis,43,21,22,Alphahull-PointsKO-Adjacents,916
Laccodiscus_spinulosodentatus,10,3,7,Points-PointsKO-Adjacents,81
Laccospadix_australasicus,57,0,57,Points-PointsKO-Adjacents,155
Lachnostylis_bilocularis,9,6,3,Points-PointsKO-Adjacents,66
Lachnostylis_hirta,19,5,14,Points-PointsKO-Adjacents,146
Lacistema_aggregatum,2844,2630,214,Alphahull-PointsKO-Adjacents,114637
Lacistema_grandifolium,165,109,56,Alphahull-PointsKO-Adjacents,8974
Lacistema_hasslerianum,669,566,103,Alphahull-PointsKO-Adjacents,21179
Lacistema_lucidum,34,16,18,Points-PointsKO-Adjacents,201
Lacistema_macbridei,26,4,22,Points-PointsKO-Adjacents,186
Lacistema_nena,84,57,27,Alphahull-PointsKO-Adjacents,5796
Lacistema_polystachyum,153,93,60,Alphahull-PointsKO-Adjacents,19687
Lacistema_pubescens,450,349,101,Alphahull-PointsKO-Adjacents,8833
Lacistema_robustum,286,233,53,Alphahull-PointsKO-Adjacents,3992
Lacmellea_abbreviata,11,6,5,Points-PointsKO-Adjacents,53
Lacmellea_aculeata,285,232,53,Alphahull-PointsKO-Adjacents,13530
Lacmellea_arborescens,188,141,47,Alphahull-PointsKO-Adjacents,20799
Lacmellea_bahiensis,28,17,11,Points-PointsKO-Adjacents,124
Lacmellea_costanensis,3,3,0,Points-PointsKO-Adjacents,20
Lacmellea_densifoliata,5,5,0,Points-PointsKO-Adjacents,45
Lacmellea_edulis,234,185,49,Alphahull-PointsKO-Adjacents,14805
Lacmellea_floribunda,40,10,30,Points-PointsKO-Adjacents,348
Lacmellea_foxii,0,0,0,NA,0
Lacmellea_gracilis,65,38,27,Alphahull-PointsKO-Adjacents,1191
Lacmellea_guyanensis,2,2,0,Points-PointsKO-Adjacents,18
Lacmellea_klugii,27,18,9,Points-PointsKO-Adjacents,180
Lacmellea_macrantha,19,9,10,Points-PointsKO-Adjacents,140
Lacmellea_microcarpa,75,50,25,Alphahull-PointsKO-Adjacents,3033
Lacmellea_oblongata,67,55,12,Alphahull-PointsKO-Adjacents,2118
Lacmellea_panamensis,302,260,42,Alphahull-PointsKO-Adjacents,3129
Lacmellea_pauciflora,32,19,13,Points-PointsKO-Adjacents,225
Lacmellea_peruviana,38,17,21,Points-PointsKO-Adjacents,298
Lacmellea_ramosissima,90,50,40,Alphahull-PointsKO-Adjacents,8675
Lacmellea_speciosa,132,91,41,Alphahull-PointsKO-Adjacents,3410
Lacmellea_standleyi,23,18,5,Points-PointsKO-Adjacents,174
Lacmellea_utilis,4,4,0,Points-PointsKO-Adjacents,36
Lacmellea_zamorae,48,40,8,Alphahull-PointsKO-Adjacents,53
Lacunaria_crenata,74,49,25,Alphahull-PointsKO-Adjacents,2190
Lacunaria_grandifolia,9,1,8,Points-PointsKO-Adjacents,81
Lacunaria_jenmanii,119,74,45,Alphahull-PointsKO-Adjacents,4355
Lacunaria_oppositifolia,22,4,18,Points-PointsKO-Adjacents,185
Lacunaria_panamensis,38,27,11,Alphahull-PointsKO-Adjacents,320
Lacunaria_sampaioi,4,4,0,Points-PointsKO-Adjacents,36
Lacunaria_umbonata,5,5,0,Points-PointsKO-Adjacents,45
Ladenbergia_acutifolia,33,12,21,Points-PointsKO-Adjacents,235
Ladenbergia_amazonensis,208,158,50,Alphahull-PointsKO-Adjacents,22480
Ladenbergia_brenesii,96,84,12,Alphahull-PointsKO-Adjacents,376
Ladenbergia_bullata,20,14,6,Points-PointsKO-Adjacents,63
Ladenbergia_buntingii,0,0,0,NA,0
Ladenbergia_carua,65,44,21,Alphahull-PointsKO-Adjacents,721
Ladenbergia_chapadensis,5,0,5,Points-PointsKO-Adjacents,45
Ladenbergia_cujabensis,51,23,28,Alphahull-PointsKO-Adjacents,2715
Ladenbergia_discolor,26,15,11,Points-PointsKO-Adjacents,160
Ladenbergia_dwyeri,15,7,8,Points-PointsKO-Adjacents,74
Ladenbergia_epiphytica,6,1,5,Points-PointsKO-Adjacents,48
Ladenbergia_ferruginea,6,1,5,Points-PointsKO-Adjacents,44
Ladenbergia_graciliflora,79,41,38,Alphahull-PointsKO-Adjacents,2775
Ladenbergia_heterophylla,58,44,14,Alphahull-PointsKO-Adjacents,1051
Ladenbergia_hexandra,50,27,23,Alphahull-PointsKO-Adjacents,1356
Ladenbergia_klugii,50,31,19,Alphahull-PointsKO-Adjacents,711
Ladenbergia_lambertiana,201,0,201,Points-PointsKO-Adjacents,1328
Ladenbergia_laurifolia,7,0,7,Points-PointsKO-Adjacents,39
Ladenbergia_lehmanniana,4,4,0,Points-PointsKO-Adjacents,36
Ladenbergia_macrocarpa,359,318,41,Alphahull-PointsKO-Adjacents,4265
Ladenbergia_magdalenae,23,17,6,Points-PointsKO-Adjacents,118
Ladenbergia_moritziana,11,5,6,Points-PointsKO-Adjacents,94
Ladenbergia_muzonensis,104,56,48,Alphahull-PointsKO-Adjacents,6113
Ladenbergia_nubigena,8,4,4,Points-PointsKO-Adjacents,30
Ladenbergia_oblongifolia,517,437,80,Alphahull-PointsKO-Adjacents,17157
Ladenbergia_obovata,10,7,3,Points-PointsKO-Adjacents,60
Ladenbergia_paraensis,3,3,0,Points-PointsKO-Adjacents,27
Ladenbergia_pauciflora,4,4,0,Points-PointsKO-Adjacents,36
Ladenbergia_pavonii,85,68,17,Alphahull-PointsKO-Adjacents,1144
Ladenbergia_pittieri,31,13,18,Points-PointsKO-Adjacents,248
Ladenbergia_riveroana,47,28,19,Alphahull-PointsKO-Adjacents,205
Ladenbergia_rubiginosa,3,3,0,Points-PointsKO-Adjacents,27
Ladenbergia_stenocarpa,13,6,7,Points-PointsKO-Adjacents,102
Ladenbergia_undata,15,9,6,Points-PointsKO-Adjacents,87
Laetia_americana,190,88,102,Alphahull-PointsKO-Adjacents,9287
Laetia_coriacea,101,76,25,Alphahull-PointsKO-Adjacents,4920
Laetia_corymbulosa,109,68,41,Alphahull-PointsKO-Adjacents,3785
Laetia_cupulata,64,1,63,Points-PointsKO-Adjacents,448
Laetia_micrantha,4,4,0,Points-PointsKO-Adjacents,27
Laetia_ovalifolia,19,6,13,Points-PointsKO-Adjacents,140
Laetia_procera,821,691,130,Alphahull-PointsKO-Adjacents,78062
Laetia_suaveolens,398,330,68,Alphahull-PointsKO-Adjacents,35967
Laetia_thamnia,444,388,56,Alphahull-PointsKO-Adjacents,5276
Lafoensia_acuminata,154,105,49,Alphahull-PointsKO-Adjacents,3010
Lafoensia_glyptocarpa,90,59,31,Alphahull-PointsKO-Adjacents,4224
Lafoensia_pacari,1387,1284,103,Alphahull-PointsKO-Adjacents,41346
Lafoensia_punicifolia,190,109,81,Alphahull-PointsKO-Adjacents,3972
Lafoensia_vandelliana,390,290,100,Alphahull-PointsKO-Adjacents,44897
Lagarostrobos_franklinii,388,0,388,Points-PointsKO-Adjacents,381
Lagerstroemia_anhuiensis,NA,NA,NA,NA,NA
Lagerstroemia_balansae,11,3,8,Points-PointsKO-Adjacents,80
Lagerstroemia_caudata,8,1,7,Points-PointsKO-Adjacents,72
Lagerstroemia_excelsa,5,5,0,Points-PointsKO-Adjacents,45
Lagerstroemia_fordii,2,2,0,Points-PointsKO-Adjacents,18
Lagerstroemia_glabra,5,5,0,Points-PointsKO-Adjacents,45
Lagerstroemia_guilinensis,1,1,0,Points-PointsKO-Adjacents,9
Lagerstroemia_indica,192,0,192,Points-PointsKO-Adjacents,1653
Lagerstroemia_intermedia,7,1,6,Points-PointsKO-Adjacents,63
Lagerstroemia_lanceolata,1,1,0,Points-PointsKO-Adjacents,9
Lagerstroemia_limii,8,0,8,Points-PointsKO-Adjacents,72
Lagerstroemia_parviflora,6,0,6,Points-PointsKO-Adjacents,52
Lagerstroemia_siamica,0,0,0,NA,0
Lagerstroemia_speciosa,54,0,54,Points-PointsKO-Adjacents,464
Lagerstroemia_subcostata,353,292,61,Alphahull-PointsKO-Adjacents,3805
Lagerstroemia_suprareticulata,2,2,0,Points-PointsKO-Adjacents,18
Lagerstroemia_tomentosa,15,4,11,Points-PointsKO-Adjacents,122
Lagerstroemia_venusta,12,2,10,Points-PointsKO-Adjacents,106
Lagerstroemia_villosa,13,6,7,Points-PointsKO-Adjacents,108
Lagetta_lagetto,12,5,7,Points-PointsKO-Adjacents,94
Lagetta_valenzuelana,3,3,0,Points-PointsKO-Adjacents,27
Lagetta_wrightiana,1,1,0,Points-PointsKO-Adjacents,9
Lagunaria_patersonia,190,92,98,Alphahull-PointsKO-Adjacents,703
Laguncularia_racemosa,1582,1120,462,Alphahull-PointsKO-Adjacents,24565
Lamanonia_brasiliensis,12,6,6,Points-PointsKO-Adjacents,65
Lamanonia_cuneata,82,46,36,Alphahull-PointsKO-Adjacents,1160
Lamanonia_grandistipularis,44,27,17,Alphahull-PointsKO-Adjacents,766
Lamanonia_ternata,1144,1022,122,Alphahull-PointsKO-Adjacents,18307
Lamiodendron_magnificum,5,0,5,Points-PointsKO-Adjacents,32
Lamprolobium_fruticosum,255,232,23,Alphahull-PointsKO-Adjacents,1413
Lamprothamnus_zanguebaricus,61,45,16,Alphahull-PointsKO-Adjacents,649
Landiopsis_capuronii,7,3,4,Points-PointsKO-Adjacents,36
Landolphia_buchananii,106,51,55,Alphahull-PointsKO-Adjacents,8556
Landolphia_jumellei,22,9,13,Points-PointsKO-Adjacents,182
Landolphia_parvifolia,38,8,30,Points-PointsKO-Adjacents,271
Lannea_acida,790,750,40,Alphahull-PointsKO-Adjacents,16649
Lannea_alata,9,2,7,Points-PointsKO-Adjacents,75
Lannea_antiscorbutica,11,0,11,Points-PointsKO-Adjacents,97
Lannea_asymmetrica,3,2,1,Points-PointsKO-Adjacents,27
Lannea_barteri,357,310,47,Alphahull-PointsKO-Adjacents,3860
Lannea_coromandelica,27,1,26,Points-PointsKO-Adjacents,233
Odina_cotoneaster,5,0,5,Points-PointsKO-Adjacents,45
Lannea_discolor,77,52,25,Alphahull-PointsKO-Adjacents,2353
Lannea_fruticosa,37,15,22,Points-PointsKO-Adjacents,221
Lannea_fulva,32,21,11,Alphahull-PointsKO-Adjacents,980
Lannea_humilis,31,0,31,Points-PointsKO-Adjacents,228
Sorindeia_lagdoensis,0,0,0,NA,0
Lannea_malifolia,4,4,0,Points-PointsKO-Adjacents,36
Lannea_microcarpa,110,84,26,Alphahull-PointsKO-Adjacents,3742
Lannea_nigritana,838,795,43,Alphahull-PointsKO-Adjacents,2742
Lannea_rivae,8,2,6,Points-PointsKO-Adjacents,70
Lannea_schimperi,115,59,56,Alphahull-PointsKO-Adjacents,4783
Lannea_schweinfurthii,207,149,58,Alphahull-PointsKO-Adjacents,5794
Lannea_triphylla,11,1,10,Points-PointsKO-Adjacents,99
Lannea_velutina,77,56,21,Alphahull-PointsKO-Adjacents,2694
Lannea_welwitschii,157,87,70,Alphahull-PointsKO-Adjacents,6134
Lannea_zenkeri,1,1,0,Points-PointsKO-Adjacents,9
Sphaerosacme_decandra,1,1,0,Points-PointsKO-Adjacents,9
Lantana_aristeguietae,0,0,0,NA,0
Lantana_camara,14384,12083,2301,Alphahull-PointsKO-Adjacents,132908
Lantana_caracasana,4,3,1,Points-PointsKO-Adjacents,36
Lantana_horrida,488,286,202,Alphahull-PointsKO-Adjacents,14794
Lantana_involucrata,401,289,112,Alphahull-PointsKO-Adjacents,9347
Lantana_lindmanii,2,2,0,Points-PointsKO-Adjacents,9
Lantana_lockhardtii,0,0,0,NA,0
Lantana_nivea,77,0,77,Points-PointsKO-Adjacents,548
Lantana_viburnoides,93,41,52,Alphahull-PointsKO-Adjacents,2076
Laplacea_haematoxylon,2,2,0,Points-PointsKO-Adjacents,18
Laportea_floribunda,23,14,9,Points-PointsKO-Adjacents,125
Laportea_oligoloba,28,15,13,Points-PointsKO-Adjacents,190
Larix_decidua,12498,11189,1309,Alphahull-PointsKO-Adjacents,23360
Larix_gmelinii,146,53,93,Alphahull-PointsKO-Adjacents,7507
Larix_griffithii,66,0,66,Points-PointsKO-Adjacents,430
Larix_kaempferi,125,86,39,Alphahull-PointsKO-Adjacents,1624
Larix_laricina,4338,3951,387,Alphahull-PointsKO-Adjacents,74437
Larix_lyallii,235,210,25,Alphahull-PointsKO-Adjacents,3638
Larix_mastersiana,7,4,3,Points-PointsKO-Adjacents,61
Larix_occidentalis,3955,3914,41,Alphahull-PointsKO-Adjacents,6461
Larix_potaninii,80,56,24,Alphahull-PointsKO-Adjacents,2077
Larix_sibirica,144,60,84,Alphahull-PointsKO-Adjacents,7796
Larnax_sagasteguii,3,3,0,Points-PointsKO-Adjacents,21
Larrea_divaricata,282,204,78,Alphahull-PointsKO-Adjacents,16963
Larsenaikia_ochreata,342,306,36,Alphahull-PointsKO-Adjacents,3280
Lasianthaea_fruticosa,396,317,79,Alphahull-PointsKO-Adjacents,6605
Lasianthera_africana,255,219,36,Alphahull-PointsKO-Adjacents,5065
Lasianthus_africanus,32,15,17,Points-PointsKO-Adjacents,201
Lasianthus_angustifolius,1,1,0,Points-PointsKO-Adjacents,9
Lasianthus_biermannii,15,10,5,Points-PointsKO-Adjacents,53
Lasianthus_cereiflorus,26,22,4,Alphahull-PointsKO-Adjacents,121
Lasianthus_chinensis,87,45,42,Alphahull-PointsKO-Adjacents,1365
Lasianthus_chrysophyllus,0,0,0,NA,0
Lasianthus_ciliatus,0,0,0,NA,0
Lasianthus_cinereus,0,0,0,NA,0
Lasianthus_euneurus,6,0,6,Points-PointsKO-Adjacents,34
Lasianthus_gardneri,0,0,0,NA,0
Lasianthus_glomeruliflorus,14,11,3,Points-PointsKO-Adjacents,45
Lasianthus_griffithii,14,0,14,Points-PointsKO-Adjacents,112
Lasianthus_hookeri,16,3,13,Points-PointsKO-Adjacents,144
Lasianthus_jackianus,0,0,0,NA,0
Lasianthus_kilimandscharicus,103,67,36,Alphahull-PointsKO-Adjacents,1878
Lasianthus_laevigatus,1,1,0,Points-PointsKO-Adjacents,8
Lasianthus_lanceolatus,51,27,24,Alphahull-PointsKO-Adjacents,405
Lasianthus_laxiflorus,2,2,0,Points-PointsKO-Adjacents,18
Lasianthus_laxinervis,13,4,9,Points-PointsKO-Adjacents,40
Lasianthus_longifolius,6,1,5,Points-PointsKO-Adjacents,54
Lasianthus_macrocalyx,17,13,4,Points-PointsKO-Adjacents,30
Lasianthus_malaccensis,0,0,0,NA,0
Lasianthus_mucronulatus,0,0,0,NA,0
Lasianthus_obliquus,0,0,0,NA,0
Lasianthus_oblongus,1,1,0,Points-PointsKO-Adjacents,9
Lasianthus_oliganthus,0,0,0,NA,0
Lasianthus_parvifolius,0,0,0,NA,0
Lasianthus_pedunculatus,47,34,13,Alphahull-PointsKO-Adjacents,274
Lasianthus_perakensis,6,0,6,Points-PointsKO-Adjacents,54
Lasianthus_pergamaceus,2,2,0,Points-PointsKO-Adjacents,18
Lasianthus_pilosus,3,0,3,Points-PointsKO-Adjacents,27
Lasianthus_politus,0,0,0,NA,0
Lasianthus_purpureus,3,3,0,Points-PointsKO-Adjacents,18
Lasianthus_rhizophyllus,0,0,0,NA,0
Lasianthus_rostratus,0,0,0,NA,0
Lasianthus_scalariformis,0,0,0,NA,0
Lasianthus_stercorarius,14,3,11,Points-PointsKO-Adjacents,104
Lasianthus_strigosus,0,0,0,NA,0
Lasianthus_tomentosus,0,0,0,NA,0
Lasianthus_varians,2,1,1,Points-PointsKO-Adjacents,18
Lasianthus_venosus,8,3,5,Points-PointsKO-Adjacents,57
Lasianthus_venulosus,1,1,0,Points-PointsKO-Adjacents,9
Lasianthus_vulcanicus,0,0,0,NA,0
Lasianthus_wallacei,16,12,4,Points-PointsKO-Adjacents,31
Lasiochlamys_koghiensis,6,1,5,Points-PointsKO-Adjacents,29
Lasiochlamys_reticulata,14,6,8,Points-PointsKO-Adjacents,57
Lasiococca_brevipes,0,0,0,NA,0
Lasiococca_chanii,NA,NA,NA,NA,NA
Lasiococca_comberi,7,1,6,Points-PointsKO-Adjacents,54
Lasiococca_locii,0,0,0,NA,0
Lasiococca_symphyllifolia,0,0,0,NA,0
Lasiocroton_bahamensis,10,3,7,Points-PointsKO-Adjacents,66
Lasiocroton_fawcettii,0,0,0,NA,0
Lasiocroton_harrisii,1,1,0,Points-PointsKO-Adjacents,9
Lasiocroton_macrophyllus,3,3,0,Points-PointsKO-Adjacents,16
Lasiodiscus_fasciculiflorus,91,58,33,Alphahull-PointsKO-Adjacents,3061
Lasiodiscus_gillardinii,5,5,0,Points-PointsKO-Adjacents,30
Lasiodiscus_lebrunii,3,3,0,Points-PointsKO-Adjacents,27
Lasiodiscus_mannii,83,44,39,Alphahull-PointsKO-Adjacents,2399
Lasiodiscus_marmoratus,53,37,16,Alphahull-PointsKO-Adjacents,2265
Lasiodiscus_mildbraedii,48,21,27,Alphahull-PointsKO-Adjacents,586
Lasiodiscus_palustris,10,1,9,Points-PointsKO-Adjacents,83
Lasiodiscus_pervillei,39,10,29,Points-PointsKO-Adjacents,215
Lasiodiscus_rozeirae,0,0,0,NA,0
Lasiodiscus_usambarensis,18,5,13,Points-PointsKO-Adjacents,96
Latania_loddigesii,1,1,0,Points-PointsKO-Adjacents,6
Latania_lontaroides,12,5,7,Points-PointsKO-Adjacents,28
Latania_verschaffeltii,0,0,0,NA,0
Laurelia_sempervirens,46,26,20,Alphahull-PointsKO-Adjacents,944
Laureliopsis_philippiana,48,32,16,Alphahull-PointsKO-Adjacents,1849
Prunus_australis,4,4,0,Points-PointsKO-Adjacents,36
Laurophyllus_capensis,62,43,19,Alphahull-PointsKO-Adjacents,205
Laurus_azorica,26,1,25,Points-PointsKO-Adjacents,86
Laurus_nobilis,2334,1738,596,Alphahull-PointsKO-Adjacents,21224
Lavandula_erythraeae,2,1,1,Points-PointsKO-Adjacents,18
Lavoisiera_harleyi,20,18,2,Points-PointsKO-Adjacents,64
Lavoisiera_nervulosa,25,0,25,Points-PointsKO-Adjacents,102
Lavoisiera_punctata,12,0,12,Points-PointsKO-Adjacents,60
Lawsonia_inermis,36,6,30,Points-PointsKO-Adjacents,287
Laxoplumeria_baehniana,9,0,9,Points-PointsKO-Adjacents,72
Laxoplumeria_tessmannii,54,23,31,Alphahull-PointsKO-Adjacents,977
Leandra_acutiflora,270,232,38,Alphahull-PointsKO-Adjacents,4483
Leandra_amplexicaulis,156,119,37,Alphahull-PointsKO-Adjacents,1958
Leandra_aurea,687,605,82,Alphahull-PointsKO-Adjacents,14071
Leandra_balansae,25,11,14,Points-PointsKO-Adjacents,188
Leandra_barbinervis,179,143,36,Alphahull-PointsKO-Adjacents,1448
Leandra_carassana,498,426,72,Alphahull-PointsKO-Adjacents,6184
Leandra_chaetodon,189,138,51,Alphahull-PointsKO-Adjacents,12940
Leandra_clidemioides,66,44,22,Alphahull-PointsKO-Adjacents,329
Leandra_cuatrecasasii,6,1,5,Points-PointsKO-Adjacents,54
Leandra_cuneata,36,17,19,Points-PointsKO-Adjacents,207
Leandra_dasytricha,285,228,57,Alphahull-PointsKO-Adjacents,2665
Leandra_dentata,7,0,7,Points-PointsKO-Adjacents,30
Leandra_fallacissima,30,0,30,Points-PointsKO-Adjacents,93
Leandra_fragilis,205,174,31,Alphahull-PointsKO-Adjacents,2935
Leandra_francavillana,34,18,16,Points-PointsKO-Adjacents,206
Leandra_glomerata,5,3,2,Points-PointsKO-Adjacents,27
Leandra_granatensis,257,215,42,Alphahull-PointsKO-Adjacents,3568
Leandra_hybophylla,1,1,0,Points-PointsKO-Adjacents,7
Leandra_krugiana,14,11,3,Points-PointsKO-Adjacents,44
Leandra_lancifolia,9,2,7,Points-PointsKO-Adjacents,75
Leandra_limoides,0,0,0,NA,0
Leandra_marigotiana,1,1,0,Points-PointsKO-Adjacents,7
Leandra_melastomoides,840,0,840,Points-PointsKO-Adjacents,3316
Leandra_micropetala,119,1,118,Points-PointsKO-Adjacents,818
Leandra_mouraei,6,2,4,Points-PointsKO-Adjacents,21
Leandra_multiplinervis,126,92,34,Alphahull-PointsKO-Adjacents,1137
Leandra_multisetosa,7,0,7,Points-PointsKO-Adjacents,57
Leandra_nervosa,71,48,23,Alphahull-PointsKO-Adjacents,497
Leandra_pennipilis,9,0,9,Points-PointsKO-Adjacents,54
Leandra_pilonensis,15,0,15,Points-PointsKO-Adjacents,107
Leandra_quinquedentata,242,201,41,Alphahull-PointsKO-Adjacents,2307
Leandra_quinquenodis,21,10,11,Points-PointsKO-Adjacents,149
Leandra_regnellii,546,489,57,Alphahull-PointsKO-Adjacents,7222
Leandra_reitzii,63,50,13,Alphahull-PointsKO-Adjacents,349
Leandra_rhodopogon,58,0,58,Points-PointsKO-Adjacents,331
Leandra_solenifera,150,0,150,Points-PointsKO-Adjacents,1017
Leandra_sphaerocarpa,3,3,0,Points-PointsKO-Adjacents,27
Leandra_subseriata,417,333,84,Alphahull-PointsKO-Adjacents,4105
Leandra_sylvestris,18,0,18,Points-PointsKO-Adjacents,129
Leandra_tetraquetra,10,3,7,Points-PointsKO-Adjacents,83
Leandra_umbellata,27,8,19,Points-PointsKO-Adjacents,165
Leandra_variabilis,481,425,56,Alphahull-PointsKO-Adjacents,5473
Leandriella_oblonga,4,4,0,Points-PointsKO-Adjacents,32
Lebeckia_sericea,2,2,0,Points-PointsKO-Adjacents,18
Lebruniodendron_leptanthum,19,6,13,Points-PointsKO-Adjacents,156
Lecaniodiscus_cupanioides,418,368,50,Alphahull-PointsKO-Adjacents,8015
Lecaniodiscus_fraxinifolia,65,24,41,Alphahull-PointsKO-Adjacents,1307
Lecointea_amazonica,149,73,76,Alphahull-PointsKO-Adjacents,1556
Lecointea_marcano-bertii,5,5,0,Points-PointsKO-Adjacents,41
Lecointea_ovalifolia,2,2,0,Points-PointsKO-Adjacents,18
Lecointea_peruviana,91,65,26,Alphahull-PointsKO-Adjacents,2218
Lecomtedoxa_biraudii,11,8,3,Points-PointsKO-Adjacents,28
Lecomtedoxa_heitzana,12,7,5,Points-PointsKO-Adjacents,58
Lecomtedoxa_klaineana,27,14,13,Points-PointsKO-Adjacents,113
Lecomtedoxa_nogo,20,11,9,Points-PointsKO-Adjacents,98
Lecomtedoxa_plumosa,4,4,0,Points-PointsKO-Adjacents,23
Lecomtedoxa_saint-aubinii,2,2,0,Points-PointsKO-Adjacents,12
Lecythis_alutacea,64,39,25,Alphahull-PointsKO-Adjacents,3098
Lecythis_ampla,111,81,30,Alphahull-PointsKO-Adjacents,2033
Lecythis_barnebyi,36,31,5,Alphahull-PointsKO-Adjacents,142
Lecythis_brancoensis,13,6,7,Points-PointsKO-Adjacents,98
Lecythis_chartacea,378,301,77,Alphahull-PointsKO-Adjacents,31305
Lecythis_confertiflora,100,76,24,Alphahull-PointsKO-Adjacents,4632
Lecythis_corrugata,480,415,65,Alphahull-PointsKO-Adjacents,23489
Lecythis_gracieana,17,10,7,Points-PointsKO-Adjacents,90
Lecythis_holcogyne,52,0,52,Points-PointsKO-Adjacents,320
Lecythis_idatimon,136,103,33,Alphahull-PointsKO-Adjacents,4639
Lecythis_lanceolata,148,95,53,Alphahull-PointsKO-Adjacents,6002
Lecythis_lurida,447,346,101,Alphahull-PointsKO-Adjacents,14700
Lecythis_mesophylla,63,44,19,Alphahull-PointsKO-Adjacents,713
Lecythis_minor,121,94,27,Alphahull-PointsKO-Adjacents,2521
Lecythis_ollaria,29,22,7,Alphahull-PointsKO-Adjacents,863
Lecythis_parvifructa,26,18,8,Points-PointsKO-Adjacents,127
Lecythis_persistens,84,66,18,Alphahull-PointsKO-Adjacents,674
Lecythis_pisonis,639,508,131,Alphahull-PointsKO-Adjacents,18541
Lecythis_pneumatophora,9,8,1,Points-PointsKO-Adjacents,51
Lecythis_poiteaui,120,86,34,Alphahull-PointsKO-Adjacents,5865
Lecythis_prancei,15,12,3,Points-PointsKO-Adjacents,55
Lecythis_retusa,48,31,17,Alphahull-PointsKO-Adjacents,516
Lecythis_schomburgkii,23,13,10,Points-PointsKO-Adjacents,144
Lecythis_schwackei,20,5,15,Points-PointsKO-Adjacents,157
Lecythis_serrata,18,1,17,Points-PointsKO-Adjacents,141
Lecythis_tuyrana,61,42,19,Alphahull-PointsKO-Adjacents,1615
Lecythis_zabucajo,218,144,74,Alphahull-PointsKO-Adjacents,14717
Ledenbergia_seguierioides,23,9,14,Points-PointsKO-Adjacents,177
Ledum_glandulosum,726,661,65,Alphahull-PointsKO-Adjacents,21158
Ledum_palustre,1301,1140,161,Alphahull-PointsKO-Adjacents,48967
Leea_aculeata,7,0,7,Points-PointsKO-Adjacents,37
Leea_aequata,19,0,19,Points-PointsKO-Adjacents,155
Leea_angulata,15,1,14,Points-PointsKO-Adjacents,105
Leea_asiatica,21,2,19,Points-PointsKO-Adjacents,178
Leea_indica,737,526,211,Alphahull-PointsKO-Adjacents,18431
Leea_macrophylla,12,0,12,Points-PointsKO-Adjacents,104
Leea_macropus,28,21,7,Alphahull-PointsKO-Adjacents,206
Leea_philippinensis,16,4,12,Points-PointsKO-Adjacents,47
Leea_setuligera,10,1,9,Points-PointsKO-Adjacents,90
Leea_tetramera,10,1,9,Points-PointsKO-Adjacents,57
Leea_tinctoria,1,1,0,Points-PointsKO-Adjacents,9
Leeuwenbergia_africana,14,0,14,Points-PointsKO-Adjacents,67
Leeuwenbergia_letestui,2,2,0,Points-PointsKO-Adjacents,18
Legrandia_concinna,3,3,0,Points-PointsKO-Adjacents,26
Leiospermum_racemosum,4878,4820,58,Alphahull-PointsKO-Adjacents,2969
Leitneria_floridana,56,34,22,Alphahull-PointsKO-Adjacents,717
Leitneria_pilosa,11,6,5,Points-PointsKO-Adjacents,57
Lemurodendron_capuronii,4,4,0,Points-PointsKO-Adjacents,17
Lemurophoenix_halleuxii,8,4,4,Points-PointsKO-Adjacents,38
Lemyrea_ciliolata,8,1,7,Points-PointsKO-Adjacents,41
Lemyrea_marojejyensis,2,2,0,Points-PointsKO-Adjacents,12
Lennea_melanocarpa,112,89,23,Alphahull-PointsKO-Adjacents,720
Lennea_modesta,60,47,13,Alphahull-PointsKO-Adjacents,625
Lennea_viridiflora,98,57,41,Alphahull-PointsKO-Adjacents,1238
Lenwebbia_lasioclada,76,62,14,Alphahull-PointsKO-Adjacents,221
Lenwebbia_prominens,97,0,97,Points-PointsKO-Adjacents,125
Leonardoxa_africana,148,132,16,Alphahull-PointsKO-Adjacents,1824
Leonardoxa_romii,12,1,11,Points-PointsKO-Adjacents,108
Leonia_crassa,403,348,55,Alphahull-PointsKO-Adjacents,29025
Leonia_cymosa,739,675,64,Alphahull-PointsKO-Adjacents,43808
Leonia_glycycarpa,1194,1100,94,Alphahull-PointsKO-Adjacents,66320
Leonia_occidentalis,42,26,16,Alphahull-PointsKO-Adjacents,463
Leonia_racemosa,238,192,46,Alphahull-PointsKO-Adjacents,15328
Leonia_triandra,142,123,19,Alphahull-PointsKO-Adjacents,2557
Leonotis_decadonta,7,0,7,Points-PointsKO-Adjacents,57
Leonotis_grandis,3,3,0,Points-PointsKO-Adjacents,25
Leopoldinia_piassaba,38,25,13,Alphahull-PointsKO-Adjacents,1278
Leopoldinia_pulchra,123,88,35,Alphahull-PointsKO-Adjacents,2826
Lepechinia_heteromorpha,24,9,15,Points-PointsKO-Adjacents,138
Lepechinia_lancifolia,9,5,4,Points-PointsKO-Adjacents,57
Lepidaploa_aronifolia,2,2,0,Points-PointsKO-Adjacents,16
Lepidaploa_polypleura,87,78,9,Alphahull-PointsKO-Adjacents,427
Lepidaploa_sprengeliana,23,17,6,Points-PointsKO-Adjacents,134
Lepidaploa_yunquensis,1,1,0,Points-PointsKO-Adjacents,8
Lepidobotrys_staudtii,58,35,23,Alphahull-PointsKO-Adjacents,1442
Lepidocaryum_tenue,427,378,49,Alphahull-PointsKO-Adjacents,19532
Lepidocordia_punctata,25,8,17,Points-PointsKO-Adjacents,181
Lepidocordia_williamsii,37,26,11,Alphahull-PointsKO-Adjacents,149
Lepidonia_corae,2,2,0,Points-PointsKO-Adjacents,18
Lepidonia_lankesteri,21,19,2,Points-PointsKO-Adjacents,33
Lepidonia_salvinae,20,0,20,Points-PointsKO-Adjacents,70
Lepidospartum_squamatum,721,576,145,Alphahull-PointsKO-Adjacents,2901
Lepidothamnus_intermedius,1078,1028,50,Alphahull-PointsKO-Adjacents,2085
Lepidotrichilia_ambrensis,16,12,4,Points-PointsKO-Adjacents,50
Lepidotrichilia_convallariiodora,11,2,9,Points-PointsKO-Adjacents,79
Lepidotrichilia_sambiranensis,2,2,0,Points-PointsKO-Adjacents,9
Lepidotrichilia_volkensii,141,93,48,Alphahull-PointsKO-Adjacents,3697
Lepinia_marquisensis,0,0,0,NA,0
Lepinia_ponapensis,0,0,0,NA,0
Lepinia_solomonensis,1,1,0,Points-PointsKO-Adjacents,9
Lepinia_taitensis,2,2,0,Points-PointsKO-Adjacents,15
Lepiniopsis_ternatensis,84,39,45,Alphahull-PointsKO-Adjacents,1819
Lepionurus_sylvestris,29,3,26,Points-PointsKO-Adjacents,255
Lepisanthes_alata,0,0,0,NA,0
Melicocca_amoena,0,0,0,NA,0
Lepisanthes_basicardia,2,2,0,Points-PointsKO-Adjacents,18
Lepisanthes_browniana,2,2,0,Points-PointsKO-Adjacents,18
Lepisanthes_cauliflora,1,1,0,Points-PointsKO-Adjacents,9
Lepisanthes_chrysotricha,3,3,0,Points-PointsKO-Adjacents,21
Otophora_divaricata,4,4,0,Points-PointsKO-Adjacents,36
Hebecoccus_falcatus,5,5,0,Points-PointsKO-Adjacents,41
Hebecoccus_ferrugineus,3,3,0,Points-PointsKO-Adjacents,27
Lepisanthes_fruticosa,50,11,39,Points-PointsKO-Adjacents,386
Lepisanthes_hainanensis,1,1,0,Points-PointsKO-Adjacents,9
Nephelium_multijugum,4,4,0,Points-PointsKO-Adjacents,36
Lepisanthes_oligophylla,5,5,0,Points-PointsKO-Adjacents,36
Lepisanthes_perrieri,55,42,13,Alphahull-PointsKO-Adjacents,389
Lepisanthes_ramiflora,1,1,0,Points-PointsKO-Adjacents,9
Lepisanthes_rubiginosa,87,31,56,Alphahull-PointsKO-Adjacents,1836
Lepisanthes_senegalensis,257,159,98,Alphahull-PointsKO-Adjacents,4407
Lepisanthes_unilocularis,1,1,0,Points-PointsKO-Adjacents,9
Leplaea_adenopunctata,16,4,12,Points-PointsKO-Adjacents,95
Leplaea_cauliflora,11,5,6,Points-PointsKO-Adjacents,65
Leplaea_cedrata,223,149,74,Alphahull-PointsKO-Adjacents,14423
Leplaea_laurentii,80,57,23,Alphahull-PointsKO-Adjacents,6048
Leplaea_mangenotiana,6,1,5,Points-PointsKO-Adjacents,51
Leplaea_mayombensis,73,43,30,Alphahull-PointsKO-Adjacents,682
Leplaea_thompsonii,150,92,58,Alphahull-PointsKO-Adjacents,4563
Leptactina_deblockiae,0,0,0,NA,0
Leptactina_delagoensis,51,25,26,Alphahull-PointsKO-Adjacents,506
Leptactina_formosa,4,3,1,Points-PointsKO-Adjacents,36
Leptactina_involucrata,97,59,38,Alphahull-PointsKO-Adjacents,2033
Leptactina_latifolia,16,1,15,Points-PointsKO-Adjacents,97
Leptactina_oxyloba,7,2,5,Points-PointsKO-Adjacents,45
Leptactina_papyrophloea,5,5,0,Points-PointsKO-Adjacents,15
Leptactina_platyphylla,61,29,32,Alphahull-PointsKO-Adjacents,1133
Leptactina_rheophytica,1,1,0,Points-PointsKO-Adjacents,9
Leptadenia_pyrotechnica,53,11,42,Points-PointsKO-Adjacents,395
Leptaulus_citrioides,6,0,6,Points-PointsKO-Adjacents,50
Leptaulus_congolanus,89,63,26,Alphahull-PointsKO-Adjacents,3897
Leptaulus_daphnoides,196,137,59,Alphahull-PointsKO-Adjacents,5397
Leptaulus_grandifolius,38,28,10,Alphahull-PointsKO-Adjacents,399
Leptaulus_holstii,79,40,39,Alphahull-PointsKO-Adjacents,2549
Leptaulus_madagascariensis,9,2,7,Points-PointsKO-Adjacents,67
Leptocereus_paniculatus,4,4,0,Points-PointsKO-Adjacents,30
Leptocereus_quadricostatus,10,8,2,Points-PointsKO-Adjacents,39
Leptolaena_abrahamii,49,39,10,Alphahull-PointsKO-Adjacents,95
Leptolaena_arenaria,44,32,12,Alphahull-PointsKO-Adjacents,329
Leptolaena_cuspidata,75,0,75,Points-PointsKO-Adjacents,244
Leptolaena_delphinensis,24,21,3,Alphahull-PointsKO-Adjacents,21
Leptolaena_gautieri,69,48,21,Alphahull-PointsKO-Adjacents,451
Leptolaena_multiflora,113,77,36,Alphahull-PointsKO-Adjacents,1430
Leptolaena_pauciflora,276,241,35,Alphahull-PointsKO-Adjacents,2239
Leptolaena_raymondii,5,2,3,Points-PointsKO-Adjacents,22
Leptolobium_bijugum,149,92,57,Alphahull-PointsKO-Adjacents,596
Leptolobium_elegans,522,454,68,Alphahull-PointsKO-Adjacents,28653
Leptolobium_panamense,81,44,37,Alphahull-PointsKO-Adjacents,790
Leptolobium_stirtonii,34,16,18,Points-PointsKO-Adjacents,262
Leptolobium_tenuifolium,15,0,15,Points-PointsKO-Adjacents,113
Leptonychia_batangensis,16,9,7,Points-PointsKO-Adjacents,85
Leptonychia_chrysocarpa,2,2,0,Points-PointsKO-Adjacents,18
Leptonychia_echinocarpa,135,113,22,Alphahull-PointsKO-Adjacents,2926
Leptonychia_lanceolata,0,0,0,NA,0
Leptonychia_lasiogyne,51,34,17,Alphahull-PointsKO-Adjacents,939
Leptonychia_macrantha,16,5,11,Points-PointsKO-Adjacents,125
Leptonychia_mayumbensis,4,3,1,Points-PointsKO-Adjacents,33
Leptonychia_melanocarpa,16,0,16,Points-PointsKO-Adjacents,103
Leptonychia_mildbraedii,25,0,25,Points-PointsKO-Adjacents,112
Leptonychia_multiflora,45,25,20,Alphahull-PointsKO-Adjacents,1281
Leptonychia_occidentalis,22,0,22,Points-PointsKO-Adjacents,167
Leptonychia_pallida,39,32,7,Alphahull-PointsKO-Adjacents,260
Leptonychia_pubescens,53,34,19,Alphahull-PointsKO-Adjacents,721
Leptonychia_tokana,46,30,16,Alphahull-PointsKO-Adjacents,2405
Leptonychia_usambarensis,44,0,44,Points-PointsKO-Adjacents,214
Leptonychia_youngii,1,1,0,Points-PointsKO-Adjacents,9
Leptospermum_brachyandrum,284,244,40,Alphahull-PointsKO-Adjacents,2881
Leptospermum_brevipes,1338,1307,31,Alphahull-PointsKO-Adjacents,4456
Leptospermum_glaucescens,854,827,27,Alphahull-PointsKO-Adjacents,1267
Leptospermum_grandiflorum,216,198,18,Alphahull-PointsKO-Adjacents,507
Leptospermum_grandifolium,1600,1525,75,Alphahull-PointsKO-Adjacents,2586
Leptospermum_javanicum,65,22,43,Alphahull-PointsKO-Adjacents,483
Leptospermum_laevigatum,1992,1652,340,Alphahull-PointsKO-Adjacents,7042
Leptospermum_lamellatum,182,164,18,Alphahull-PointsKO-Adjacents,3160
Leptospermum_lanigerum,4691,0,4691,Points-PointsKO-Adjacents,3910
Leptospermum_madidum,196,156,40,Alphahull-PointsKO-Adjacents,2913
Leptospermum_morrisonii,341,321,20,Alphahull-PointsKO-Adjacents,552
Leptospermum_parviflorum,67,29,38,Alphahull-PointsKO-Adjacents,904
Leptospermum_petersonii,325,253,72,Alphahull-PointsKO-Adjacents,1105
Leptospermum_polyanthum,284,251,33,Alphahull-PointsKO-Adjacents,1714
Leptospermum_recurvum,8,1,7,Points-PointsKO-Adjacents,33
Leptospermum_scoparium,7736,7535,201,Alphahull-PointsKO-Adjacents,8080
Leptospermum_trinervium,4659,4244,415,Alphahull-PointsKO-Adjacents,4468
Leptospermum_variabile,212,194,18,Alphahull-PointsKO-Adjacents,1271
Leptospermum_wooroonooran,45,38,7,Alphahull-PointsKO-Adjacents,52
Leptostigma_pilosum,23,10,13,Points-PointsKO-Adjacents,178
Leptostylis_gatopensis,20,11,9,Points-PointsKO-Adjacents,65
Leptostylis_goroensis,1,1,0,Points-PointsKO-Adjacents,6
Leptostylis_multiflora,20,11,9,Points-PointsKO-Adjacents,65
Leptostylis_petiolata,25,15,10,Points-PointsKO-Adjacents,92
Leptothyrsa_sprucei,25,12,13,Points-PointsKO-Adjacents,156
Leretia_cordata,56,8,48,Points-PointsKO-Adjacents,433
Lessingianthus_gonzalezii,1,1,0,Points-PointsKO-Adjacents,9
Letestua_durissima,8,1,7,Points-PointsKO-Adjacents,61
Lethedon_balansae,79,67,12,Alphahull-PointsKO-Adjacents,174
Lethedon_calleana,13,6,7,Points-PointsKO-Adjacents,80
Lethedon_cernua,36,24,12,Alphahull-PointsKO-Adjacents,147
Lethedon_cordatoretusa,8,4,4,Points-PointsKO-Adjacents,38
Lethedon_le-ratii,54,37,17,Alphahull-PointsKO-Adjacents,164
Lethedon_setosa,105,97,8,Alphahull-PointsKO-Adjacents,112
Lethedon_tannensis,10,4,6,Points-PointsKO-Adjacents,68
Lettowianthus_stellatus,55,41,14,Alphahull-PointsKO-Adjacents,981
Leucadendron_argenteum,53,21,32,Alphahull-PointsKO-Adjacents,142
Leucadendron_conicum,74,61,13,Alphahull-PointsKO-Adjacents,246
Leucadendron_discolor,12,7,5,Points-PointsKO-Adjacents,81
Leucadendron_strobilinum,29,11,18,Points-PointsKO-Adjacents,71
Leucaena_collinsii,70,51,19,Alphahull-PointsKO-Adjacents,486
Leucaena_confertiflora,39,30,9,Alphahull-PointsKO-Adjacents,130
Leucaena_cuspidata,42,21,21,Alphahull-PointsKO-Adjacents,175
Leucaena_diversifolia,332,273,59,Alphahull-PointsKO-Adjacents,2358
Leucaena_esculenta,363,312,51,Alphahull-PointsKO-Adjacents,4117
Leucaena_greggii,69,57,12,Alphahull-PointsKO-Adjacents,411
Leucaena_involucrata,4,4,0,Points-PointsKO-Adjacents,24
Leucaena_lanceolata,346,275,71,Alphahull-PointsKO-Adjacents,6048
Leucaena_lempirana,3,3,0,Points-PointsKO-Adjacents,27
Leucaena_leucocephala,4034,3092,942,Alphahull-PointsKO-Adjacents,74046
Leucaena_macrophylla,241,194,47,Alphahull-PointsKO-Adjacents,4158
Leucaena_magnifica,1,1,0,Points-PointsKO-Adjacents,9
Leucaena_matudae,8,5,3,Points-PointsKO-Adjacents,29
Leucaena_multicapitula,71,42,29,Alphahull-PointsKO-Adjacents,624
Leucaena_pallida,105,84,21,Alphahull-PointsKO-Adjacents,715
Leucaena_pueblana,12,10,2,Points-PointsKO-Adjacents,73
Leucaena_pulverulenta,198,160,38,Alphahull-PointsKO-Adjacents,3301
Leucaena_retusa,95,72,23,Alphahull-PointsKO-Adjacents,1977
Leucaena_salvadorensis,9,6,3,Points-PointsKO-Adjacents,39
Leucaena_shannonii,156,0,156,Points-PointsKO-Adjacents,655
Leucaena_trichandra,154,121,33,Alphahull-PointsKO-Adjacents,2593
Leucaena_trichodes,191,134,57,Alphahull-PointsKO-Adjacents,2976
Leucas_abyssinica,48,28,20,Alphahull-PointsKO-Adjacents,2080
Leucochloron_bolivianum,7,0,7,Points-PointsKO-Adjacents,60
Leucochloron_foederale,8,4,4,Points-PointsKO-Adjacents,62
Leucochloron_incuriale,260,0,260,Points-PointsKO-Adjacents,1531
Leucochloron_limae,39,23,16,Alphahull-PointsKO-Adjacents,1953
Leucochloron_minarum,9,2,7,Points-PointsKO-Adjacents,77
Leucocroton_flavicans,3,3,0,Points-PointsKO-Adjacents,20
Leucomphalos_capparideus,57,43,14,Alphahull-PointsKO-Adjacents,902
Leucopogon_parviflorus,3790,95,3695,Alphahull-PointsKO-Adjacents,4871
Leucosceptrum_canum,53,27,26,Alphahull-PointsKO-Adjacents,1161
Leucosidea_sericea,112,87,25,Alphahull-PointsKO-Adjacents,3206
Leucospermum_conocarpodendron,89,67,22,Alphahull-PointsKO-Adjacents,126
Leucospermum_patersonii,16,9,7,Points-PointsKO-Adjacents,90
Leucospermum_praemorsum,21,14,7,Points-PointsKO-Adjacents,117
Leucostegane_grandis,1,0,1,Points-PointsKO-Adjacents,9
Leucostegane_latistipulata,NA,NA,NA,NA,NA
Leucosyke_quadrinervia,13,5,8,Points-PointsKO-Adjacents,6
Leucothoe_griffithiana,18,0,18,Points-PointsKO-Adjacents,80
Leucothrinax_morrisii,44,18,26,Points-PointsKO-Adjacents,177
Leuenbergeria_bleo,NA,NA,NA,NA,NA
Leuenbergeria_guamacho,0,0,0,NA,0
Leuenbergeria_lychnidiflora,NA,NA,NA,NA,NA
Libanothamnus_divisoriensis,5,5,0,Points-PointsKO-Adjacents,39
Libanothamnus_neriifolius,84,67,17,Alphahull-PointsKO-Adjacents,670
Libanothamnus_occultus,59,46,13,Alphahull-PointsKO-Adjacents,626
Libidibia_coriaria,237,137,100,Alphahull-PointsKO-Adjacents,5600
Libidibia_paraguariensis,167,141,26,Alphahull-PointsKO-Adjacents,5183
Libocedrus_bidwillii,1790,1755,35,Alphahull-PointsKO-Adjacents,3123
Libocedrus_chevalieri,4,4,0,Points-PointsKO-Adjacents,30
Libocedrus_plumosa,223,186,37,Alphahull-PointsKO-Adjacents,1796
Libocedrus_yateensis,9,1,8,Points-PointsKO-Adjacents,24
Librevillea_klainei,76,4,72,Points-PointsKO-Adjacents,353
Licania_adolphoduckei,5,5,0,Points-PointsKO-Adjacents,36
Licania_affinis,64,37,27,Alphahull-PointsKO-Adjacents,343
Licania_alba,105,73,32,Alphahull-PointsKO-Adjacents,3671
Licania_albiflora,7,2,5,Points-PointsKO-Adjacents,63
Licania_amapaensis,7,0,7,Points-PointsKO-Adjacents,56
Licania_angustata,14,0,14,Points-PointsKO-Adjacents,111
Licania_anneae,3,3,0,Points-PointsKO-Adjacents,27
Licania_apetala,1230,1123,107,Alphahull-PointsKO-Adjacents,104449
Licania_aracaensis,3,3,0,Points-PointsKO-Adjacents,14
Licania_arachicarpa,9,1,8,Points-PointsKO-Adjacents,28
Licania_arachnoidea,62,50,12,Alphahull-PointsKO-Adjacents,2551
Licania_araneosa,18,10,8,Points-PointsKO-Adjacents,151
Licania_arborea,427,355,72,Alphahull-PointsKO-Adjacents,8681
Licania_arianeae,9,0,9,Points-PointsKO-Adjacents,65
Licania_bahiensis,4,4,0,Points-PointsKO-Adjacents,22
Licania_belemii,39,0,39,Points-PointsKO-Adjacents,228
Licania_bellingtonii,6,0,6,Points-PointsKO-Adjacents,54
Licania_belloi,24,16,8,Points-PointsKO-Adjacents,136
Licania_blackii,181,100,81,Alphahull-PointsKO-Adjacents,24531
Licania_boliviensis,30,24,6,Alphahull-PointsKO-Adjacents,192
Licania_boyanii,24,10,14,Points-PointsKO-Adjacents,168
Licania_bracteata,52,28,24,Alphahull-PointsKO-Adjacents,346
Licania_brittoniana,170,119,51,Alphahull-PointsKO-Adjacents,12373
Licania_bullata,1,1,0,Points-PointsKO-Adjacents,9
Licania_buxifolia,16,9,7,Points-PointsKO-Adjacents,87
Licania_cabrerae,16,13,3,Points-PointsKO-Adjacents,56
Licania_caldasiana,2,2,0,Points-PointsKO-Adjacents,18
Licania_calvescens,9,2,7,Points-PointsKO-Adjacents,49
Licania_canescens,449,366,83,Alphahull-PointsKO-Adjacents,49895
Licania_cardiophylla,16,9,7,Points-PointsKO-Adjacents,95
Licania_cariae,0,0,0,NA,0
Licania_caudata,134,59,75,Alphahull-PointsKO-Adjacents,3550
Licania_cecidiophora,10,0,10,Points-PointsKO-Adjacents,90
Licania_celiae,18,9,9,Points-PointsKO-Adjacents,113
Licania_chiriquiensis,2,2,0,Points-PointsKO-Adjacents,18
Licania_chocoensis,7,1,6,Points-PointsKO-Adjacents,57
Licania_cidii,12,3,9,Points-PointsKO-Adjacents,61
Licania_compacta,3,2,1,Points-PointsKO-Adjacents,21
Licania_conferruminata,4,4,0,Points-PointsKO-Adjacents,36
Licania_cordata,17,9,8,Points-PointsKO-Adjacents,118
Licania_coriacea,107,68,39,Alphahull-PointsKO-Adjacents,7837
Licania_corniculata,9,4,5,Points-PointsKO-Adjacents,29
Licania_costaricensis,15,6,9,Points-PointsKO-Adjacents,89
Licania_couepiifolia,2,2,0,Points-PointsKO-Adjacents,18
Licania_crassivenia,10,1,9,Points-PointsKO-Adjacents,84
Licania_cruegeriana,16,1,15,Points-PointsKO-Adjacents,125
Licania_cuatrecasasii,8,1,7,Points-PointsKO-Adjacents,67
Licania_cuprea,11,6,5,Points-PointsKO-Adjacents,69
Licania_cuspidata,4,4,0,Points-PointsKO-Adjacents,36
Licania_cuyabenensis,3,3,0,Points-PointsKO-Adjacents,27
Licania_cyathodes,5,2,3,Points-PointsKO-Adjacents,39
Licania_cymosa,17,5,12,Points-PointsKO-Adjacents,98
Licania_dealbata,165,0,165,Points-PointsKO-Adjacents,884
Licania_densiflora,112,76,36,Alphahull-PointsKO-Adjacents,7280
Licania_diegogomezii,4,4,0,Points-PointsKO-Adjacents,25
Licania_discolor,86,56,30,Alphahull-PointsKO-Adjacents,5203
Licania_divaricata,45,29,16,Alphahull-PointsKO-Adjacents,893
Licania_dodsonii,9,6,3,Points-PointsKO-Adjacents,48
Licania_durifolia,30,14,16,Points-PointsKO-Adjacents,247
Licania_egleri,240,158,82,Alphahull-PointsKO-Adjacents,39150
Licania_elliptica,50,13,37,Points-PointsKO-Adjacents,419
Licania_emarginata,49,15,34,Points-PointsKO-Adjacents,382
Licania_espinae,3,3,0,Points-PointsKO-Adjacents,21
Licania_fanshawei,13,2,11,Points-PointsKO-Adjacents,117
Licania_fasciculata,5,2,3,Points-PointsKO-Adjacents,18
Licania_ferreirae,3,3,0,Points-PointsKO-Adjacents,27
Licania_filomenoi,7,0,7,Points-PointsKO-Adjacents,57
Licania_foldatsii,13,8,5,Points-PointsKO-Adjacents,102
Licania_foveolata,3,3,0,Points-PointsKO-Adjacents,27
Licania_fritschii,8,0,8,Points-PointsKO-Adjacents,68
Licania_fuchsii,7,3,4,Points-PointsKO-Adjacents,48
Licania_furfuracea,2,2,0,Points-PointsKO-Adjacents,18
Licania_gardneri,285,249,36,Alphahull-PointsKO-Adjacents,19446
Licania_gentryi,7,4,3,Points-PointsKO-Adjacents,33
Licania_glabriflora,53,17,36,Points-PointsKO-Adjacents,331
Licania_glauca,7,0,7,Points-PointsKO-Adjacents,55
Licania_glazioviana,6,0,6,Points-PointsKO-Adjacents,39
Licania_gonzalezii,7,1,6,Points-PointsKO-Adjacents,54
Licania_gracilipes,62,26,36,Alphahull-PointsKO-Adjacents,1121
Licania_grandibracteata,18,12,6,Points-PointsKO-Adjacents,115
Licania_granvillei,42,19,23,Points-PointsKO-Adjacents,296
Licania_guatemalensis,3,3,0,Points-PointsKO-Adjacents,27
Licania_habantha,2,2,0,Points-PointsKO-Adjacents,18
Licania_harlingii,149,115,34,Alphahull-PointsKO-Adjacents,11588
Licania_hedbergii,3,3,0,Points-PointsKO-Adjacents,27
Licania_heteromorpha,1550,1460,90,Alphahull-PointsKO-Adjacents,75233
Licania_hirsuta,37,11,26,Points-PointsKO-Adjacents,256
Licania_hispida,2,2,0,Points-PointsKO-Adjacents,9
Licania_hitchcockii,5,5,0,Points-PointsKO-Adjacents,45
Licania_hoehnei,211,166,45,Alphahull-PointsKO-Adjacents,6250
Licania_humilis,399,342,57,Alphahull-PointsKO-Adjacents,19037
Licania_hypoleuca,745,610,135,Alphahull-PointsKO-Adjacents,60157
Licania_impressa,59,0,59,Points-PointsKO-Adjacents,368
Licania_incana,189,1,188,Points-PointsKO-Adjacents,1047
Licania_indurata,13,1,12,Points-PointsKO-Adjacents,98
Licania_intrapetiolaris,171,0,171,Points-PointsKO-Adjacents,1194
Licania_irwinii,14,1,13,Points-PointsKO-Adjacents,105
Licania_jaramilloi,2,2,0,Points-PointsKO-Adjacents,18
Licania_jefensis,34,19,15,Points-PointsKO-Adjacents,165
Licania_jimenezii,7,0,7,Points-PointsKO-Adjacents,57
Licania_joseramosii,4,3,1,Points-PointsKO-Adjacents,32
Licania_kallunkiae,42,31,11,Alphahull-PointsKO-Adjacents,278
Licania_klugii,24,10,14,Points-PointsKO-Adjacents,183
Licania_krukovii,56,23,33,Alphahull-PointsKO-Adjacents,666
Licania_kunthiana,755,623,132,Alphahull-PointsKO-Adjacents,67395
Licania_laevigata,64,25,39,Alphahull-PointsKO-Adjacents,2667
Licania_lamentanda,22,0,22,Points-PointsKO-Adjacents,73
Licania_lanceolata,46,0,46,Points-PointsKO-Adjacents,272
Licania_lasseri,41,26,15,Alphahull-PointsKO-Adjacents,385
Licania_lata,120,72,48,Alphahull-PointsKO-Adjacents,7033
Licania_latifolia,210,140,70,Alphahull-PointsKO-Adjacents,23732
Licania_latistipula,4,0,4,Points-PointsKO-Adjacents,36
Licania_laxiflora,142,96,46,Alphahull-PointsKO-Adjacents,13595
Licania_leptostachya,183,136,47,Alphahull-PointsKO-Adjacents,12242
Licania_leucosepala,40,18,22,Points-PointsKO-Adjacents,256
Licania_licaniiflora,221,156,65,Alphahull-PointsKO-Adjacents,22162
Licania_littoralis,107,53,54,Alphahull-PointsKO-Adjacents,533
Licania_longicuspidata,4,1,3,Points-PointsKO-Adjacents,33
Licania_longipedicellata,41,19,22,Points-PointsKO-Adjacents,282
Licania_longistyla,291,193,98,Alphahull-PointsKO-Adjacents,35300
Licania_macrocarpa,109,80,29,Alphahull-PointsKO-Adjacents,6504
Licania_macrophylla,70,38,32,Alphahull-PointsKO-Adjacents,1362
Licania_maguirei,11,3,8,Points-PointsKO-Adjacents,89
Licania_majuscula,101,73,28,Alphahull-PointsKO-Adjacents,2838
Licania_maranhensis,4,4,0,Points-PointsKO-Adjacents,30
Licania_maritima,2,2,0,Points-PointsKO-Adjacents,13
Licania_marleneae,3,3,0,Points-PointsKO-Adjacents,24
Licania_maxima,3,3,0,Points-PointsKO-Adjacents,27
Licania_megalophylla,1,1,0,Points-PointsKO-Adjacents,9
Licania_membranacea,121,68,53,Alphahull-PointsKO-Adjacents,4477
Licania_mexicana,1,1,0,Points-PointsKO-Adjacents,9
Licania_micrantha,470,355,115,Alphahull-PointsKO-Adjacents,32312
Licania_microphylla,2,2,0,Points-PointsKO-Adjacents,18
Licania_miltonii,6,2,4,Points-PointsKO-Adjacents,54
Licania_minuscula,8,2,6,Points-PointsKO-Adjacents,65
Licania_minutiflora,132,64,68,Alphahull-PointsKO-Adjacents,5775
Licania_mollis,206,166,40,Alphahull-PointsKO-Adjacents,14915
Licania_montana,4,4,0,Points-PointsKO-Adjacents,17
Licania_morii,5,2,3,Points-PointsKO-Adjacents,40
Licania_naviculistipula,13,4,9,Points-PointsKO-Adjacents,87
Licania_nelsonii,6,0,6,Points-PointsKO-Adjacents,51
Licania_niloi,32,11,21,Points-PointsKO-Adjacents,243
Licania_nitida,55,24,31,Alphahull-PointsKO-Adjacents,3408
Licania_oblongifolia,105,65,40,Alphahull-PointsKO-Adjacents,7175
Licania_obtusifolia,NA,NA,NA,NA,NA
Licania_occultans,9,3,6,Points-PointsKO-Adjacents,56
Licania_octandra,1076,946,130,Alphahull-PointsKO-Adjacents,120983
Licania_operculipetala,30,22,8,Alphahull-PointsKO-Adjacents,106
Licania_orbicularis,31,17,14,Points-PointsKO-Adjacents,251
Licania_ovalifolia,23,12,11,Points-PointsKO-Adjacents,164
Licania_pakaraimensis,3,3,0,Points-PointsKO-Adjacents,27
Licania_pallida,147,92,55,Alphahull-PointsKO-Adjacents,17142
Licania_paraensis,33,10,23,Points-PointsKO-Adjacents,252
Licania_parviflora,417,354,63,Alphahull-PointsKO-Adjacents,50552
Licania_parvifolia,190,104,86,Alphahull-PointsKO-Adjacents,23746
Licania_parvifructa,83,50,33,Alphahull-PointsKO-Adjacents,2169
Licania_persaudii,19,6,13,Points-PointsKO-Adjacents,138
Licania_piresii,12,2,10,Points-PointsKO-Adjacents,97
Licania_pittieri,6,1,5,Points-PointsKO-Adjacents,54
Licania_platycalyx,52,27,25,Alphahull-PointsKO-Adjacents,854
Licania_platypus,257,197,60,Alphahull-PointsKO-Adjacents,6238
Licania_polita,163,102,61,Alphahull-PointsKO-Adjacents,24271
Licania_prismatocarpa,66,47,19,Alphahull-PointsKO-Adjacents,5328
Licania_pruinosa,11,6,5,Points-PointsKO-Adjacents,93
Licania_pyrifolia,59,38,21,Alphahull-PointsKO-Adjacents,2723
Licania_reticulata,116,72,44,Alphahull-PointsKO-Adjacents,3837
Licania_retifolia,20,9,11,Points-PointsKO-Adjacents,75
Licania_riedelii,25,18,7,Points-PointsKO-Adjacents,173
Licania_rigida,168,123,45,Alphahull-PointsKO-Adjacents,5691
Licania_riverae,31,24,7,Alphahull-PointsKO-Adjacents,73
Licania_robusta,27,0,27,Points-PointsKO-Adjacents,209
Licania_rodriguesii,42,19,23,Points-PointsKO-Adjacents,239
Licania_roraimensis,5,5,0,Points-PointsKO-Adjacents,39
Licania_rufescens,12,0,12,Points-PointsKO-Adjacents,108
Licania_salicifolia,6,2,4,Points-PointsKO-Adjacents,36
Licania_salzmannii,39,16,23,Points-PointsKO-Adjacents,240
Licania_sandwithii,26,15,11,Points-PointsKO-Adjacents,190
Licania_santosii,8,4,4,Points-PointsKO-Adjacents,40
Licania_savannarum,71,47,24,Alphahull-PointsKO-Adjacents,1249
Licania_sclerophylla,313,242,71,Alphahull-PointsKO-Adjacents,30645
Licania_silvae,39,7,32,Points-PointsKO-Adjacents,301
Licania_silvatica,8,1,7,Points-PointsKO-Adjacents,66
Licania_sothersiae,9,3,6,Points-PointsKO-Adjacents,75
Licania_sparsipilis,67,41,26,Alphahull-PointsKO-Adjacents,588
Licania_spicata,53,32,21,Alphahull-PointsKO-Adjacents,943
Licania_sprucei,138,89,49,Alphahull-PointsKO-Adjacents,10230
Licania_stevensii,9,7,2,Points-PointsKO-Adjacents,25
Licania_stewardii,42,28,14,Alphahull-PointsKO-Adjacents,1381
Licania_steyermarkii,36,16,20,Points-PointsKO-Adjacents,280
Licania_stricta,2,2,0,Points-PointsKO-Adjacents,18
Licania_subrotundata,3,3,0,Points-PointsKO-Adjacents,27
Licania_tachirensis,2,2,0,Points-PointsKO-Adjacents,12
Licania_tambopatensis,9,1,8,Points-PointsKO-Adjacents,81
Licania_teixeirae,7,0,7,Points-PointsKO-Adjacents,61
Licania_tepuiensis,2,2,0,Points-PointsKO-Adjacents,14
Licania_ternatensis,23,14,9,Points-PointsKO-Adjacents,59
Licania_tocantina,4,4,0,Points-PointsKO-Adjacents,32
Licania_tomentosa,127,51,76,Alphahull-PointsKO-Adjacents,2406
Licania_triandra,70,35,35,Alphahull-PointsKO-Adjacents,3139
Licania_trigonioides,3,3,0,Points-PointsKO-Adjacents,25
Licania_turbinata,19,5,14,Points-PointsKO-Adjacents,126
Licania_undulata,1,1,0,Points-PointsKO-Adjacents,9
Licania_unguiculata,88,48,40,Alphahull-PointsKO-Adjacents,2751
Licania_urceolaris,84,47,37,Alphahull-PointsKO-Adjacents,5556
Licania_vasquezii,3,3,0,Points-PointsKO-Adjacents,23
Licania_vaupesiana,9,2,7,Points-PointsKO-Adjacents,81
Licania_velata,17,9,8,Points-PointsKO-Adjacents,78
Licania_velutina,9,5,4,Points-PointsKO-Adjacents,53
Licania_veneralensis,23,15,8,Points-PointsKO-Adjacents,106
Licania_wurdackii,71,52,19,Alphahull-PointsKO-Adjacents,2793
Licaria_applanata,55,38,17,Alphahull-PointsKO-Adjacents,399
Licaria_armeniaca,495,398,97,Alphahull-PointsKO-Adjacents,41725
Licaria_aurea,84,22,62,Alphahull-PointsKO-Adjacents,904
Licaria_aureosericea,11,0,11,Points-PointsKO-Adjacents,67
Licaria_bahiana,136,105,31,Alphahull-PointsKO-Adjacents,1647
Licaria_brasiliensis,73,23,50,Alphahull-PointsKO-Adjacents,842
Licaria_brenesii,11,8,3,Points-PointsKO-Adjacents,39
Licaria_brittoniana,10,8,2,Points-PointsKO-Adjacents,39
Licaria_camara,4,4,0,Points-PointsKO-Adjacents,27
Licaria_campechiana,56,38,18,Alphahull-PointsKO-Adjacents,1384
Licaria_cannella,164,104,60,Alphahull-PointsKO-Adjacents,7588
Licaria_capitata,220,192,28,Alphahull-PointsKO-Adjacents,4750
Licaria_caribaea,8,2,6,Points-PointsKO-Adjacents,52
Licaria_carinata,7,0,7,Points-PointsKO-Adjacents,54
Licaria_caudata,71,53,18,Alphahull-PointsKO-Adjacents,1135
Licaria_chinanteca,7,3,4,Points-PointsKO-Adjacents,30
Licaria_chrysophylla,98,64,34,Alphahull-PointsKO-Adjacents,12462
Licaria_crassifolia,111,48,63,Alphahull-PointsKO-Adjacents,2866
Licaria_cufodontisii,46,34,12,Alphahull-PointsKO-Adjacents,203
Licaria_debilis,75,0,75,Points-PointsKO-Adjacents,495
Licaria_dolichantha,9,1,8,Points-PointsKO-Adjacents,65
Licaria_endlicheriifolia,2,2,0,Points-PointsKO-Adjacents,18
Licaria_excelsa,104,72,32,Alphahull-PointsKO-Adjacents,1816
Licaria_exserta,6,0,6,Points-PointsKO-Adjacents,45
Licaria_filiformis,2,2,0,Points-PointsKO-Adjacents,18
Licaria_glaberrima,21,13,8,Points-PointsKO-Adjacents,89
Licaria_guatemalensis,14,8,6,Points-PointsKO-Adjacents,58
Licaria_guianensis,292,169,123,Alphahull-PointsKO-Adjacents,23237
Licaria_hirsuta,6,1,5,Points-PointsKO-Adjacents,46
Licaria_latifolia,6,1,5,Points-PointsKO-Adjacents,54
Licaria_macrophylla,36,15,21,Points-PointsKO-Adjacents,233
Licaria_mexicana,3,2,1,Points-PointsKO-Adjacents,21
Licaria_misantlae,156,126,30,Alphahull-PointsKO-Adjacents,1638
Licaria_multiflora,13,0,13,Points-PointsKO-Adjacents,117
Licaria_multinervis,11,4,7,Points-PointsKO-Adjacents,65
Licaria_oppositifolia,19,6,13,Points-PointsKO-Adjacents,147
Licaria_pachycarpa,43,16,27,Points-PointsKO-Adjacents,355
Licaria_parvifolia,35,19,16,Points-PointsKO-Adjacents,155
Licaria_peckii,202,187,15,Alphahull-PointsKO-Adjacents,2436
Licaria_pergamentacea,25,18,7,Points-PointsKO-Adjacents,78
Licaria_phymatosa,7,5,2,Points-PointsKO-Adjacents,29
Licaria_polyphylla,34,6,28,Points-PointsKO-Adjacents,282
Licaria_pucheri,26,11,15,Points-PointsKO-Adjacents,160
Licaria_quirirafuina,11,3,8,Points-PointsKO-Adjacents,99
Licaria_rodriguesii,29,12,17,Points-PointsKO-Adjacents,197
Licaria_rufotomentosa,2,2,0,Points-PointsKO-Adjacents,18
Licaria_sarapiquensis,32,25,7,Alphahull-PointsKO-Adjacents,110
Licaria_siphonantha,2,2,0,Points-PointsKO-Adjacents,18
Licaria_subbullata,60,25,35,Alphahull-PointsKO-Adjacents,514
Licaria_subsessilis,5,5,0,Points-PointsKO-Adjacents,12
Licaria_tomentosa,3,3,0,Points-PointsKO-Adjacents,27
Licaria_triandra,1480,1287,193,Alphahull-PointsKO-Adjacents,18982
Licaria_trinervis,7,0,7,Points-PointsKO-Adjacents,42
Licaria_velutina,9,6,3,Points-PointsKO-Adjacents,34
Licaria_vernicosa,32,11,21,Points-PointsKO-Adjacents,236
Licuala_acutifida,1,1,0,Points-PointsKO-Adjacents,8
Licuala_adscendens,NA,NA,NA,NA,NA
Licuala_bracteata,9,6,3,Points-PointsKO-Adjacents,60
Licuala_crassiflora,1,1,0,Points-PointsKO-Adjacents,9
Licuala_dakrongensis,4,4,0,Points-PointsKO-Adjacents,30
Licuala_dasyantha,3,3,0,Points-PointsKO-Adjacents,27
Licuala_distans,0,0,0,NA,0
Licuala_grandis,4,4,0,Points-PointsKO-Adjacents,28
Licuala_longispadix,1,1,0,Points-PointsKO-Adjacents,8
Licuala_merguensis,0,0,0,NA,0
Licuala_mirabilis,NA,NA,NA,NA,NA
Licuala_paludosa,3,3,0,Points-PointsKO-Adjacents,15
Licuala_peltata,1,1,0,Points-PointsKO-Adjacents,8
Licuala_poonsakii,NA,NA,NA,NA,NA
Licuala_ramsayi,80,59,21,Alphahull-PointsKO-Adjacents,268
Licuala_spinosa,11,2,9,Points-PointsKO-Adjacents,90
Licuala_tiomanensis,0,0,0,NA,0
Licuala_urciflora,0,0,0,NA,0
Ligustrum_compactum,41,0,41,Points-PointsKO-Adjacents,348
Ligustrum_confusum,56,40,16,Alphahull-PointsKO-Adjacents,1427
Ligustrum_expansum,9,0,9,Points-PointsKO-Adjacents,81
Ligustrum_gamblei,0,0,0,NA,0
Ligustrum_glomeratum,49,17,32,Points-PointsKO-Adjacents,250
Ligustrum_ibota,16,6,10,Points-PointsKO-Adjacents,94
Ligustrum_japonicum,387,162,225,Alphahull-PointsKO-Adjacents,3607
Ligustrum_leucanthum,91,55,36,Alphahull-PointsKO-Adjacents,11326
Ligustrum_lianum,32,17,15,Points-PointsKO-Adjacents,288
Ligustrum_liukiuense,2,2,0,Points-PointsKO-Adjacents,16
Ligustrum_lucidum,2346,1363,983,Alphahull-PointsKO-Adjacents,33160
Ligustrum_nepalense,3,2,1,Points-PointsKO-Adjacents,27
Ligustrum_ovalifolium,144,55,89,Alphahull-PointsKO-Adjacents,422
Ligustrum_perrottetii,2,1,1,Points-PointsKO-Adjacents,18
Ligustrum_pricei,12,5,7,Points-PointsKO-Adjacents,77
Ligustrum_robustum,9,0,9,Points-PointsKO-Adjacents,81
Ligustrum_salicinum,1,1,0,Points-PointsKO-Adjacents,9
Ligustrum_sempervirens,7,2,5,Points-PointsKO-Adjacents,63
Ligustrum_sinense,3915,2792,1123,Alphahull-PointsKO-Adjacents,49070
Ligustrum_stenophyllum,0,0,0,NA,0
Ligustrum_undulatum,NA,NA,NA,NA,NA
Lijndenia_barteri,27,12,15,Points-PointsKO-Adjacents,191
Lijndenia_bequaertii,11,5,6,Points-PointsKO-Adjacents,81
Lijndenia_brenanii,7,1,6,Points-PointsKO-Adjacents,35
Lijndenia_danguyana,3,3,0,Points-PointsKO-Adjacents,27
Lijndenia_fragrans,23,17,6,Points-PointsKO-Adjacents,90
Lijndenia_greenwayi,5,5,0,Points-PointsKO-Adjacents,37
Lijndenia_jasminoides,48,25,23,Alphahull-PointsKO-Adjacents,787
Lijndenia_lutescens,12,0,12,Points-PointsKO-Adjacents,64
Lijndenia_melastomoides,2,2,0,Points-PointsKO-Adjacents,17
Lijndenia_roborea,4,4,0,Points-PointsKO-Adjacents,17
Lijndenia_semseii,9,5,4,Points-PointsKO-Adjacents,39
Limadendron_amazonicum,132,103,29,Alphahull-PointsKO-Adjacents,5247
Limadendron_hostmannii,66,27,39,Alphahull-PointsKO-Adjacents,1157
Limnocitrus_littoralis,0,0,0,NA,0
Limonia_acidissima,5,5,0,Points-PointsKO-Adjacents,45
Feronia_elephantum,16,1,15,Points-PointsKO-Adjacents,135
Lindackeria_fragrans,7,1,6,Points-PointsKO-Adjacents,57
Lindackeria_latifolia,137,93,44,Alphahull-PointsKO-Adjacents,10904
Lindackeria_laurina,365,312,53,Alphahull-PointsKO-Adjacents,7378
Lindackeria_paludosa,971,887,84,Alphahull-PointsKO-Adjacents,64244
Lindackeria_paraensis,55,32,23,Alphahull-PointsKO-Adjacents,3817
Lindackeria_pauciflora,60,33,27,Alphahull-PointsKO-Adjacents,3576
Lindera_aggregata,149,111,38,Alphahull-PointsKO-Adjacents,7515
Lindera_akoensis,90,71,19,Alphahull-PointsKO-Adjacents,255
Lindera_angustifolia,35,0,35,Points-PointsKO-Adjacents,315
Lindera_assamica,3,3,0,Points-PointsKO-Adjacents,27
Lindera_benzoin,2212,1676,536,Alphahull-PointsKO-Adjacents,30766
Lindera_cercidifolia,0,0,0,NA,0
Lindera_chienii,10,0,10,Points-PointsKO-Adjacents,90
Lindera_chunii,23,0,23,Points-PointsKO-Adjacents,195
Lindera_communis,491,413,78,Alphahull-PointsKO-Adjacents,21229
Lindera_erythrocarpa,290,225,65,Alphahull-PointsKO-Adjacents,6503
Lindera_floribunda,17,2,15,Points-PointsKO-Adjacents,153
Lindera_foveolata,4,4,0,Points-PointsKO-Adjacents,34
Lindera_fragrans,20,6,14,Points-PointsKO-Adjacents,180
Lindera_glauca,617,364,253,Alphahull-PointsKO-Adjacents,16571
Lindera_gracilipes,3,3,0,Points-PointsKO-Adjacents,27
Lindera_guangxiensis,2,2,0,Points-PointsKO-Adjacents,18
Lindera_kariensis,8,0,8,Points-PointsKO-Adjacents,63
Lindera_kwangtungensis,31,18,13,Points-PointsKO-Adjacents,270
Lindera_latifolia,42,25,17,Alphahull-PointsKO-Adjacents,827
Lindera_laureola,0,0,0,NA,0
Lindera_limprichtii,14,7,7,Points-PointsKO-Adjacents,123
Lindera_longipedunculata,9,0,9,Points-PointsKO-Adjacents,78
Lindera_lungshengensis,2,2,0,Points-PointsKO-Adjacents,18
Lindera_megaphylla,12,0,12,Points-PointsKO-Adjacents,108
Lindera_melissifolia,20,10,10,Points-PointsKO-Adjacents,152
Lindera_menghaiensis,1,1,0,Points-PointsKO-Adjacents,9
Lindera_metcalfiana,51,29,22,Alphahull-PointsKO-Adjacents,2772
Lindera_motuoensis,1,1,0,Points-PointsKO-Adjacents,9
Lindera_nacusua,82,34,48,Alphahull-PointsKO-Adjacents,1360
Lindera_neesiana,73,34,39,Alphahull-PointsKO-Adjacents,3179
Lindera_obtusiloba,549,398,151,Alphahull-PointsKO-Adjacents,9175
Lindera_prattii,11,5,6,Points-PointsKO-Adjacents,99
Lindera_pulcherrima,135,93,42,Alphahull-PointsKO-Adjacents,10951
Lindera_reflexa,120,87,33,Alphahull-PointsKO-Adjacents,7975
Lindera_robusta,4,4,0,Points-PointsKO-Adjacents,36
Lindera_rubronervia,49,33,16,Alphahull-PointsKO-Adjacents,2612
Lindera_sericea,347,0,347,Points-PointsKO-Adjacents,1000
Lindera_sinensis,0,0,0,NA,0
Lindera_subcoriacea,11,4,7,Points-PointsKO-Adjacents,99
Lindera_supracostata,32,17,15,Points-PointsKO-Adjacents,287
Lindera_thomsonii,79,1,78,Points-PointsKO-Adjacents,384
Lindera_tienchuanensis,2,2,0,Points-PointsKO-Adjacents,18
Lindera_tonkinensis,28,16,12,Points-PointsKO-Adjacents,248
Lindera_villipes,13,7,6,Points-PointsKO-Adjacents,51
Lindsayomyrtus_racemoides,79,51,28,Alphahull-PointsKO-Adjacents,244
Lingelsheimia_abbayesii,2,2,0,Points-PointsKO-Adjacents,18
Lingelsheimia_ambigua,8,2,6,Points-PointsKO-Adjacents,57
Lingelsheimia_fiherenensis,13,4,9,Points-PointsKO-Adjacents,77
Lingelsheimia_manongarivensis,9,3,6,Points-PointsKO-Adjacents,45
Lingelsheimia_sylvestris,3,3,0,Points-PointsKO-Adjacents,9
Linospadix_microcaryus,33,0,33,Points-PointsKO-Adjacents,97
Linospadix_minor,125,106,19,Alphahull-PointsKO-Adjacents,222
Linospadix_monostachyos,784,757,27,Alphahull-PointsKO-Adjacents,905
Lippia_abyssinica,37,10,27,Points-PointsKO-Adjacents,300
Lippia_alba,1135,0,1135,Points-PointsKO-Adjacents,7296
Lippia_americana,43,14,29,Points-PointsKO-Adjacents,298
Lippia_bicolor,11,5,6,Points-PointsKO-Adjacents,78
Lippia_cardiostegia,342,292,50,Alphahull-PointsKO-Adjacents,1945
Lippia_chiapasensis,67,46,21,Alphahull-PointsKO-Adjacents,453
Lippia_hirsuta,65,41,24,Alphahull-PointsKO-Adjacents,737
Lippia_integrifolia,66,0,66,Points-PointsKO-Adjacents,447
Lippia_mcvaughii,15,4,11,Points-PointsKO-Adjacents,57
Lippia_myriocephala,603,517,86,Alphahull-PointsKO-Adjacents,8930
Lippia_oxyphyllaria,57,0,57,Points-PointsKO-Adjacents,213
Lippia_salicifolia,1,1,0,Points-PointsKO-Adjacents,8
Lippia_schlimii,67,49,18,Alphahull-PointsKO-Adjacents,569
Lippia_umbellata,575,502,73,Alphahull-PointsKO-Adjacents,8831
Liquidambar_acalycina,23,9,14,Points-PointsKO-Adjacents,207
Liquidambar_formosana,275,212,63,Alphahull-PointsKO-Adjacents,14764
Liquidambar_orientalis,9,5,4,Points-PointsKO-Adjacents,35
Liquidambar_styraciflua,43732,40892,2840,Alphahull-PointsKO-Adjacents,36299
Liriodendron_chinense,32,5,27,Points-PointsKO-Adjacents,278
Liriodendron_tulipifera,28466,26410,2056,Alphahull-PointsKO-Adjacents,31170
Lisianthius_aurantiacus,19,15,4,Points-PointsKO-Adjacents,43
Lisianthius_umbellatus,0,0,0,NA,0
Lissocarpa_benthamii,89,0,89,Points-PointsKO-Adjacents,693
Lissocarpa_guianensis,20,10,10,Points-PointsKO-Adjacents,138
Lissocarpa_jensonii,4,4,0,Points-PointsKO-Adjacents,32
Lissocarpa_kating,10,1,9,Points-PointsKO-Adjacents,60
Lissocarpa_ronliesneri,7,3,4,Points-PointsKO-Adjacents,48
Lissocarpa_stenocarpa,17,5,12,Points-PointsKO-Adjacents,136
Lissocarpa_tetramera,12,3,9,Points-PointsKO-Adjacents,98
Lissocarpa_uyat,15,0,15,Points-PointsKO-Adjacents,107
Litchi_chinensis,123,27,96,Alphahull-PointsKO-Adjacents,3493
Litchi_philippinensis,0,0,0,NA,0
Lithocarpus_acuminatus,0,0,0,NA,0
Lithocarpus_aggregatus,1,1,0,Points-PointsKO-Adjacents,9
Lithocarpus_ailaoensis,NA,NA,NA,NA,NA
Lithocarpus_amherstianus,0,0,0,NA,0
Lithocarpus_amoenus,1,1,0,Points-PointsKO-Adjacents,9
Lithocarpus_amygdalifolius,189,152,37,Alphahull-PointsKO-Adjacents,1239
Lithocarpus_andersonii,2,2,0,Points-PointsKO-Adjacents,17
Lithocarpus_annamensis,4,4,0,Points-PointsKO-Adjacents,34
Lithocarpus_annamitorus,6,2,4,Points-PointsKO-Adjacents,24
Lithocarpus_apoensis,7,0,7,Points-PointsKO-Adjacents,57
Lithocarpus_apricus,NA,NA,NA,NA,NA
Lithocarpus_arcaulus,1,1,0,Points-PointsKO-Adjacents,9
Lithocarpus_areca,2,2,0,Points-PointsKO-Adjacents,18
Lithocarpus_aspericupulus,2,2,0,Points-PointsKO-Adjacents,17
Lithocarpus_atjehensis,0,0,0,NA,0
Lithocarpus_attenuatus,4,2,2,Points-PointsKO-Adjacents,21
Lithocarpus_auriculatus,3,3,0,Points-PointsKO-Adjacents,18
Lithocarpus_bacgiangensis,8,0,8,Points-PointsKO-Adjacents,72
Lithocarpus_balansae,9,3,6,Points-PointsKO-Adjacents,81
Lithocarpus_bancanus,6,0,6,Points-PointsKO-Adjacents,51
Lithocarpus_bassacensis,NA,NA,NA,NA,NA
Lithocarpus_beccarianus,1,1,0,Points-PointsKO-Adjacents,9
Lithocarpus_bennettii,18,4,14,Points-PointsKO-Adjacents,141
Lithocarpus_bentramensis,NA,NA,NA,NA,NA
Lithocarpus_bicoloratus,2,2,0,Points-PointsKO-Adjacents,7
Lithocarpus_blaoensis,2,2,0,Points-PointsKO-Adjacents,18
Lithocarpus_blumeanus,5,0,5,Points-PointsKO-Adjacents,45
Lithocarpus_bolovenensis,NA,NA,NA,NA,NA
Lithocarpus_bonnetii,2,2,0,Points-PointsKO-Adjacents,18
Lithocarpus_brachystachyus,3,3,0,Points-PointsKO-Adjacents,27
Lithocarpus_braianensis,3,3,0,Points-PointsKO-Adjacents,23
Lithocarpus_brassii,23,9,14,Points-PointsKO-Adjacents,125
Lithocarpus_brevicaudatus,94,0,94,Points-PointsKO-Adjacents,343
Lithocarpus_brochidodromus,1,1,0,Points-PointsKO-Adjacents,9
Lithocarpus_bullatus,7,5,2,Points-PointsKO-Adjacents,39
Lithocarpus_burkillii,0,0,0,NA,0
Lithocarpus_calolepis,1,1,0,Points-PointsKO-Adjacents,9
Lithocarpus_calophyllus,32,21,11,Alphahull-PointsKO-Adjacents,1177
Lithocarpus_cambodiensis,8,1,7,Points-PointsKO-Adjacents,48
Lithocarpus_campylolepis,NA,NA,NA,NA,NA
Lithocarpus_cantleyanus,17,1,16,Points-PointsKO-Adjacents,137
Lithocarpus_carolinae,0,0,0,NA,0
Lithocarpus_castellarnauianus,2,2,0,Points-PointsKO-Adjacents,10
Lithocarpus_caudatifolius,9,0,9,Points-PointsKO-Adjacents,77
Lithocarpus_caudatilimbus,1,1,0,Points-PointsKO-Adjacents,9
Lithocarpus_celebicus,206,152,54,Alphahull-PointsKO-Adjacents,3548
Lithocarpus_cerifer,17,4,13,Points-PointsKO-Adjacents,143
Lithocarpus_chevalieri,2,2,0,Points-PointsKO-Adjacents,12
Lithocarpus_chienchuanensis,NA,NA,NA,NA,NA
Lithocarpus_chifui,NA,NA,NA,NA,NA
Lithocarpus_chittagongus,0,0,0,NA,0
Lithocarpus_chiungchungensis,NA,NA,NA,NA,NA
Lithocarpus_chrysocomus,4,4,0,Points-PointsKO-Adjacents,36
Lithocarpus_cinereus,1,1,0,Points-PointsKO-Adjacents,9
Lithocarpus_clathratus,NA,NA,NA,NA,NA
Lithocarpus_cleistocarpus,71,41,30,Alphahull-PointsKO-Adjacents,5650
Lithocarpus_clementianus,6,1,5,Points-PointsKO-Adjacents,54
Lithocarpus_coalitus,1,1,0,Points-PointsKO-Adjacents,9
Lithocarpus_coinhensis,1,1,0,Points-PointsKO-Adjacents,9
Lithocarpus_concentricus,1,1,0,Points-PointsKO-Adjacents,8
Lithocarpus_confertus,5,5,0,Points-PointsKO-Adjacents,42
Lithocarpus_confinis,17,9,8,Points-PointsKO-Adjacents,153
Lithocarpus_confragosus,7,0,7,Points-PointsKO-Adjacents,63
Lithocarpus_coopertus,29,9,20,Points-PointsKO-Adjacents,232
Lithocarpus_corneri,0,0,0,NA,0
Lithocarpus_corneus,173,0,173,Points-PointsKO-Adjacents,1042
Lithocarpus_cottonii,NA,NA,NA,NA,NA
Lithocarpus_craibianus,14,6,8,Points-PointsKO-Adjacents,125
Lithocarpus_crassifolius,2,2,0,Points-PointsKO-Adjacents,18
Lithocarpus_crassinervius,1,1,0,Points-PointsKO-Adjacents,9
Lithocarpus_cryptocarpus,9,0,9,Points-PointsKO-Adjacents,66
Lithocarpus_cucullatus,NA,NA,NA,NA,NA
Lithocarpus_curtisii,9,6,3,Points-PointsKO-Adjacents,51
Lithocarpus_cyclophorus,2,0,2,Points-PointsKO-Adjacents,18
Lithocarpus_cyrtocarpus,4,4,0,Points-PointsKO-Adjacents,36
Lithocarpus_dalatensis,NA,NA,NA,NA,NA
Lithocarpus_damiaoshanicus,4,4,0,Points-PointsKO-Adjacents,36
Lithocarpus_daphnoideus,3,0,3,Points-PointsKO-Adjacents,27
Lithocarpus_dasystachyus,15,3,12,Points-PointsKO-Adjacents,111
Lithocarpus_dealbatus,117,78,39,Alphahull-PointsKO-Adjacents,5089
Lithocarpus_debaryanus,NA,NA,NA,NA,NA
Lithocarpus_dinhensis,4,4,0,Points-PointsKO-Adjacents,33
Lithocarpus_dodonaeifolius,5,5,0,Points-PointsKO-Adjacents,24
Lithocarpus_dolichostachys,NA,NA,NA,NA,NA
Lithocarpus_ducampii,0,0,0,NA,0
Lithocarpus_echinifer,4,1,3,Points-PointsKO-Adjacents,27
Lithocarpus_echinocarpus,1,1,0,Points-PointsKO-Adjacents,9
Lithocarpus_echinophorus,22,0,22,Points-PointsKO-Adjacents,125
Lithocarpus_echinops,0,0,0,NA,0
Lithocarpus_echinotholus,4,4,0,Points-PointsKO-Adjacents,36
Lithocarpus_echinulatus,4,4,0,Points-PointsKO-Adjacents,27
Lithocarpus_edulis,111,24,87,Alphahull-PointsKO-Adjacents,547
Lithocarpus_eichleri,4,0,4,Points-PointsKO-Adjacents,23
Lithocarpus_elaeagnifolius,3,3,0,Points-PointsKO-Adjacents,27
Lithocarpus_elegans,203,134,69,Alphahull-PointsKO-Adjacents,13347
Lithocarpus_elephantum,15,10,5,Points-PointsKO-Adjacents,61
Lithocarpus_elizabethiae,0,0,0,NA,0
Lithocarpus_elmerrillii,1,1,0,Points-PointsKO-Adjacents,9
Lithocarpus_encleisocarpus,12,0,12,Points-PointsKO-Adjacents,108
Lithocarpus_eriobotryoides,4,4,0,Points-PointsKO-Adjacents,36
Lithocarpus_erythrocarpus,2,2,0,Points-PointsKO-Adjacents,18
Lithocarpus_eucalyptifolius,3,3,0,Points-PointsKO-Adjacents,21
Lithocarpus_ewyckii,19,5,14,Points-PointsKO-Adjacents,165
Lithocarpus_falconeri,10,3,7,Points-PointsKO-Adjacents,80
Lithocarpus_farinulentus,13,0,13,Points-PointsKO-Adjacents,73
Lithocarpus_fenestratus,146,96,50,Alphahull-PointsKO-Adjacents,10555
Lithocarpus_fenzelianus,9,4,5,Points-PointsKO-Adjacents,57
Lithocarpus_ferrugineus,6,2,4,Points-PointsKO-Adjacents,50
Lithocarpus_floccosus,4,4,0,Points-PointsKO-Adjacents,36
Lithocarpus_fohaiensis,7,0,7,Points-PointsKO-Adjacents,63
Lithocarpus_fordianus,10,3,7,Points-PointsKO-Adjacents,90
Lithocarpus_formosanus,28,21,7,Alphahull-PointsKO-Adjacents,36
Lithocarpus_gaoligongensis,NA,NA,NA,NA,NA
Lithocarpus_garrettianus,61,33,28,Alphahull-PointsKO-Adjacents,631
Lithocarpus_gigantophyllus,0,0,0,NA,0
Lithocarpus_glaber,244,179,65,Alphahull-PointsKO-Adjacents,8922
Lithocarpus_glaucus,0,0,0,NA,0
Lithocarpus_glutinosus,1,1,0,Points-PointsKO-Adjacents,7
Lithocarpus_gougerotae,4,4,0,Points-PointsKO-Adjacents,36
Lithocarpus_gracilis,21,6,15,Points-PointsKO-Adjacents,175
Lithocarpus_guinieri,0,0,0,NA,0
Lithocarpus_gymnocarpus,1,1,0,Points-PointsKO-Adjacents,9
Lithocarpus_haipinii,15,3,12,Points-PointsKO-Adjacents,135
Lithocarpus_hallieri,4,4,0,Points-PointsKO-Adjacents,36
Lithocarpus_hancei,478,417,61,Alphahull-PointsKO-Adjacents,13725
Lithocarpus_handelianus,5,2,3,Points-PointsKO-Adjacents,45
Lithocarpus_harlandii,268,230,38,Alphahull-PointsKO-Adjacents,8939
Lithocarpus_harmandii,42,25,17,Alphahull-PointsKO-Adjacents,2865
Lithocarpus_hatusimae,2,2,0,Points-PointsKO-Adjacents,18
Lithocarpus_havilandii,15,6,9,Points-PointsKO-Adjacents,99
Lithocarpus_hendersonianus,0,0,0,NA,0
Lithocarpus_henryi,30,7,23,Points-PointsKO-Adjacents,268
Lithocarpus_himalaicus,NA,NA,NA,NA,NA
Lithocarpus_honbaensis,1,1,0,Points-PointsKO-Adjacents,9
Lithocarpus_howii,3,3,0,Points-PointsKO-Adjacents,27
Lithocarpus_hypoglaucus,27,19,8,Points-PointsKO-Adjacents,187
Lithocarpus_hystrix,2,0,2,Points-PointsKO-Adjacents,18
Lithocarpus_imperialis,37,22,15,Alphahull-PointsKO-Adjacents,347
Lithocarpus_indutus,4,4,0,Points-PointsKO-Adjacents,36
Lithocarpus_irwinii,3,3,0,Points-PointsKO-Adjacents,27
Lithocarpus_iteaphyllus,5,5,0,Points-PointsKO-Adjacents,45
Lithocarpus_ithyphyllus,2,2,0,Points-PointsKO-Adjacents,18
Lithocarpus_jacksonianus,1,1,0,Points-PointsKO-Adjacents,9
Lithocarpus_jacobsii,6,0,6,Points-PointsKO-Adjacents,48
Lithocarpus_javensis,3,0,3,Points-PointsKO-Adjacents,27
Lithocarpus_jenkinsii,0,0,0,NA,0
Lithocarpus_jordanae,8,3,5,Points-PointsKO-Adjacents,54
Lithocarpus_kalkmanii,NA,NA,NA,NA,NA
Lithocarpus_kamengii,NA,NA,NA,NA,NA
Lithocarpus_kawakamii,180,167,13,Alphahull-PointsKO-Adjacents,267
Lithocarpus_kemmaratensis,NA,NA,NA,NA,NA
Lithocarpus_keningauensis,NA,NA,NA,NA,NA
Lithocarpus_kingianus,0,0,0,NA,0
Lithocarpus_kochummenii,NA,NA,NA,NA,NA
Lithocarpus_konishii,120,101,19,Alphahull-PointsKO-Adjacents,288
Lithocarpus_kontumensis,1,1,0,Points-PointsKO-Adjacents,9
Lithocarpus_korthalsii,5,0,5,Points-PointsKO-Adjacents,44
Lithocarpus_kostermansii,1,1,0,Points-PointsKO-Adjacents,9
Lithocarpus_kozlovii,2,1,1,Points-PointsKO-Adjacents,18
Lithocarpus_kunstleri,3,0,3,Points-PointsKO-Adjacents,20
Lithocarpus_laetus,1,1,0,Points-PointsKO-Adjacents,9
Lithocarpus_lampadarius,4,4,0,Points-PointsKO-Adjacents,28
Lithocarpus_laoticus,8,0,8,Points-PointsKO-Adjacents,66
Lithocarpus_laouanensis,1,1,0,Points-PointsKO-Adjacents,9
Lithocarpus_lappaceus,6,0,6,Points-PointsKO-Adjacents,54
Lithocarpus_lauterbachii,54,1,53,Points-PointsKO-Adjacents,288
Lithocarpus_leiocarpus,NA,NA,NA,NA,NA
Lithocarpus_leiophyllus,9,3,6,Points-PointsKO-Adjacents,27
Lithocarpus_leiostachyus,6,0,6,Points-PointsKO-Adjacents,50
Lithocarpus_lemeeanus,6,3,3,Points-PointsKO-Adjacents,40
Lithocarpus_lepidocarpus,77,66,11,Alphahull-PointsKO-Adjacents,219
Lithocarpus_leptogyne,7,0,7,Points-PointsKO-Adjacents,57
Lithocarpus_leucodermis,1,1,0,Points-PointsKO-Adjacents,9
Lithocarpus_levis,NA,NA,NA,NA,NA
Lithocarpus_licentii,NA,NA,NA,NA,NA
Lithocarpus_lindleyanus,14,6,8,Points-PointsKO-Adjacents,102
Lithocarpus_listeri,1,0,1,Points-PointsKO-Adjacents,9
Lithocarpus_lithocarpaeus,2,2,0,Points-PointsKO-Adjacents,14
Lithocarpus_litseifolius,109,81,28,Alphahull-PointsKO-Adjacents,12505
Lithocarpus_longanoides,8,4,4,Points-PointsKO-Adjacents,72
Lithocarpus_longipedicellatus,14,2,12,Points-PointsKO-Adjacents,122
Lithocarpus_longzhouicus,1,1,0,Points-PointsKO-Adjacents,9
Lithocarpus_loratifolius,NA,NA,NA,NA,NA
Lithocarpus_lucidus,20,7,13,Points-PointsKO-Adjacents,167
Lithocarpus_luteus,7,1,6,Points-PointsKO-Adjacents,39
Lithocarpus_luzoniensis,3,3,0,Points-PointsKO-Adjacents,21
Lithocarpus_lycoperdon,3,3,0,Points-PointsKO-Adjacents,18
Lithocarpus_macilentus,3,3,0,Points-PointsKO-Adjacents,27
Lithocarpus_macphailii,0,0,0,NA,0
Lithocarpus_magneinii,19,4,15,Points-PointsKO-Adjacents,125
Lithocarpus_magnificus,0,0,0,NA,0
Lithocarpus_maingayi,3,3,0,Points-PointsKO-Adjacents,27
Lithocarpus_mairei,9,4,5,Points-PointsKO-Adjacents,79
Lithocarpus_mariae,0,0,0,NA,0
Lithocarpus_megacarpus,27,10,17,Points-PointsKO-Adjacents,138
Lithocarpus_megalophyllus,22,3,19,Points-PointsKO-Adjacents,187
Lithocarpus_megastachyus,0,0,0,NA,0
Lithocarpus_meijeri,3,3,0,Points-PointsKO-Adjacents,24
Lithocarpus_mekongensis,0,0,0,NA,0
Lithocarpus_melanochromus,2,2,0,Points-PointsKO-Adjacents,18
Lithocarpus_melataiensis,NA,NA,NA,NA,NA
Lithocarpus_menadoensis,7,2,5,Points-PointsKO-Adjacents,48
Lithocarpus_mianningensis,2,2,0,Points-PointsKO-Adjacents,18
Lithocarpus_microbalanus,NA,NA,NA,NA,NA
Lithocarpus_microlepis,NA,NA,NA,NA,NA
Lithocarpus_milroyi,0,0,0,NA,0
Lithocarpus_mindanaensis,3,3,0,Points-PointsKO-Adjacents,24
Lithocarpus_moluccus,1,1,0,Points-PointsKO-Adjacents,9
Lithocarpus_monticolus,1,1,0,Points-PointsKO-Adjacents,9
Lithocarpus_muluensis,NA,NA,NA,NA,NA
Lithocarpus_naiadarum,11,6,5,Points-PointsKO-Adjacents,81
Lithocarpus_nantoensis,16,6,10,Points-PointsKO-Adjacents,53
Lithocarpus_nebularum,5,5,0,Points-PointsKO-Adjacents,33
Lithocarpus_neorobinsonii,0,0,0,NA,0
Lithocarpus_nhatrangensis,2,2,0,Points-PointsKO-Adjacents,18
Lithocarpus_nieuwenhuisii,12,4,8,Points-PointsKO-Adjacents,93
Lithocarpus_nodosus,0,0,0,NA,0
Lithocarpus_oblanceolatus,2,2,0,Points-PointsKO-Adjacents,18
Lithocarpus_oblancifolius,NA,NA,NA,NA,NA
Lithocarpus_obovalifolius,0,0,0,NA,0
Lithocarpus_obovatilimbus,3,3,0,Points-PointsKO-Adjacents,27
Lithocarpus_obscurus,2,2,0,Points-PointsKO-Adjacents,18
Lithocarpus_ochrocarpus,2,2,0,Points-PointsKO-Adjacents,12
Lithocarpus_oleifolius,1,1,0,Points-PointsKO-Adjacents,9
Lithocarpus_ollus,0,0,0,NA,0
Lithocarpus_ombrophilus,NA,NA,NA,NA,NA
Lithocarpus_oogyne,NA,NA,NA,NA,NA
Lithocarpus_ovalis,3,3,0,Points-PointsKO-Adjacents,24
Lithocarpus_pachycarpus,6,2,4,Points-PointsKO-Adjacents,54
Lithocarpus_pachylepis,9,6,3,Points-PointsKO-Adjacents,48
Lithocarpus_pachyphyllus,26,9,17,Points-PointsKO-Adjacents,157
Lithocarpus_paihengii,6,3,3,Points-PointsKO-Adjacents,54
Lithocarpus_pakhaensis,2,2,0,Points-PointsKO-Adjacents,18
Lithocarpus_pallidus,2,2,0,Points-PointsKO-Adjacents,18
Lithocarpus_palungensis,0,0,0,NA,0
Lithocarpus_paniculatus,27,12,15,Points-PointsKO-Adjacents,242
Lithocarpus_papillifer,6,1,5,Points-PointsKO-Adjacents,45
Lithocarpus_parvulus,0,0,0,NA,0
Lithocarpus_pattaniensis,4,4,0,Points-PointsKO-Adjacents,30
Lithocarpus_paviei,2,2,0,Points-PointsKO-Adjacents,18
Lithocarpus_perakensis,2,2,0,Points-PointsKO-Adjacents,9
Lithocarpus_petelotii,7,0,7,Points-PointsKO-Adjacents,63
Lithocarpus_phansipanensis,3,3,0,Points-PointsKO-Adjacents,21
Lithocarpus_philippinensis,9,1,8,Points-PointsKO-Adjacents,81
Lithocarpus_pierrei,0,0,0,NA,0
Lithocarpus_platycarpus,1,1,0,Points-PointsKO-Adjacents,8
Lithocarpus_platyphyllus,2,2,0,Points-PointsKO-Adjacents,18
Lithocarpus_polystachyus,33,10,23,Points-PointsKO-Adjacents,217
Lithocarpus_porcatus,1,1,0,Points-PointsKO-Adjacents,9
Lithocarpus_proboscideus,7,0,7,Points-PointsKO-Adjacents,57
Lithocarpus_propinquus,2,2,0,Points-PointsKO-Adjacents,18
Lithocarpus_psammophilus,NA,NA,NA,NA,NA
Lithocarpus_pseudokunstleri,6,0,6,Points-PointsKO-Adjacents,54
Lithocarpus_pseudomagneinii,NA,NA,NA,NA,NA
Lithocarpus_pseudomoluccus,3,2,1,Points-PointsKO-Adjacents,23
Lithocarpus_pseudoreinwardtii,3,3,0,Points-PointsKO-Adjacents,27
Lithocarpus_pseudosundaicus,6,0,6,Points-PointsKO-Adjacents,54
Lithocarpus_pseudovestitus,5,4,1,Points-PointsKO-Adjacents,45
Lithocarpus_pseudoxizangensis,NA,NA,NA,NA,NA
Lithocarpus_pulcher,10,2,8,Points-PointsKO-Adjacents,60
Lithocarpus_pusillus,8,0,8,Points-PointsKO-Adjacents,72
Lithocarpus_pycnostachys,4,4,0,Points-PointsKO-Adjacents,36
Lithocarpus_qinzhouicus,1,1,0,Points-PointsKO-Adjacents,9
Lithocarpus_quangnamensis,3,3,0,Points-PointsKO-Adjacents,18
Lithocarpus_quercifolius,1,1,0,Points-PointsKO-Adjacents,9
Lithocarpus_rassa,12,4,8,Points-PointsKO-Adjacents,100
Lithocarpus_recurvatus,3,2,1,Points-PointsKO-Adjacents,27
Lithocarpus_reinwardtii,3,3,0,Points-PointsKO-Adjacents,27
Lithocarpus_revolutus,0,0,0,NA,0
Lithocarpus_rhabdostachyus,16,8,8,Points-PointsKO-Adjacents,114
Lithocarpus_rigidus,1,1,0,Points-PointsKO-Adjacents,9
Lithocarpus_robinsonii,3,3,0,Points-PointsKO-Adjacents,18
Lithocarpus_rosthornii,9,0,9,Points-PointsKO-Adjacents,80
Lithocarpus_rotundatus,0,0,0,NA,0
Lithocarpus_rouletii,0,0,0,NA,0
Lithocarpus_rufescens,1,1,0,Points-PointsKO-Adjacents,9
Lithocarpus_rufovillosus,173,142,31,Alphahull-PointsKO-Adjacents,2835
Lithocarpus_rufus,0,0,0,NA,0
Lithocarpus_ruminatus,1,1,0,Points-PointsKO-Adjacents,9
Lithocarpus_sandakanensis,NA,NA,NA,NA,NA
Lithocarpus_scortechinii,1,1,0,Points-PointsKO-Adjacents,9
Lithocarpus_scyphiger,1,1,0,Points-PointsKO-Adjacents,9
Lithocarpus_sericobalanos,6,0,6,Points-PointsKO-Adjacents,54
Lithocarpus_shinsuiensis,5,5,0,Points-PointsKO-Adjacents,23
Lithocarpus_shunningensis,1,1,0,Points-PointsKO-Adjacents,9
Lithocarpus_siamensis,0,0,0,NA,0
Lithocarpus_silvicolarum,54,0,54,Points-PointsKO-Adjacents,379
Lithocarpus_skanianus,22,8,14,Points-PointsKO-Adjacents,189
Lithocarpus_sogerensis,13,3,10,Points-PointsKO-Adjacents,67
Lithocarpus_solerianus,16,5,11,Points-PointsKO-Adjacents,122
Lithocarpus_songkoensis,1,1,0,Points-PointsKO-Adjacents,9
Lithocarpus_sootepensis,7,2,5,Points-PointsKO-Adjacents,51
Lithocarpus_sphaerocarpus,9,1,8,Points-PointsKO-Adjacents,81
Lithocarpus_stenopus,1,1,0,Points-PointsKO-Adjacents,9
Lithocarpus_stonei,NA,NA,NA,NA,NA
Lithocarpus_submonticolus,0,0,0,NA,0
Lithocarpus_suffruticosus,4,4,0,Points-PointsKO-Adjacents,27
Lithocarpus_sulitii,0,0,0,NA,0
Lithocarpus_sundaicus,52,22,30,Alphahull-PointsKO-Adjacents,370
Lithocarpus_syncarpus,NA,NA,NA,NA,NA
Lithocarpus_tabularis,4,4,0,Points-PointsKO-Adjacents,36
Lithocarpus_taitoensis,35,23,12,Alphahull-PointsKO-Adjacents,235
Lithocarpus_talangensis,3,3,0,Points-PointsKO-Adjacents,27
Lithocarpus_tawaiensis,0,0,0,NA,0
Lithocarpus_tenuilimbus,3,3,0,Points-PointsKO-Adjacents,27
Lithocarpus_tenuinervis,NA,NA,NA,NA,NA
Lithocarpus_tephrocarpus,1,1,0,Points-PointsKO-Adjacents,9
Lithocarpus_thomsonii,29,9,20,Points-PointsKO-Adjacents,204
Lithocarpus_toumorangensis,1,1,0,Points-PointsKO-Adjacents,9
Lithocarpus_touranensis,9,1,8,Points-PointsKO-Adjacents,43
Lithocarpus_trachycarpus,39,17,22,Points-PointsKO-Adjacents,232
Lithocarpus_triqueter,NA,NA,NA,NA,NA
Lithocarpus_truncatus,56,27,29,Alphahull-PointsKO-Adjacents,779
Lithocarpus_tubulosus,11,4,7,Points-PointsKO-Adjacents,73
Lithocarpus_turbinatus,3,3,0,Points-PointsKO-Adjacents,12
Lithocarpus_uraianus,89,68,21,Alphahull-PointsKO-Adjacents,231
Lithocarpus_urceolaris,10,2,8,Points-PointsKO-Adjacents,71
Lithocarpus_uvariifolius,34,24,10,Alphahull-PointsKO-Adjacents,1096
Lithocarpus_variolosus,37,29,8,Alphahull-PointsKO-Adjacents,1226
Lithocarpus_vestitus,59,27,32,Alphahull-PointsKO-Adjacents,1988
Lithocarpus_vidalianus,0,0,0,NA,0
Lithocarpus_vidalii,4,4,0,Points-PointsKO-Adjacents,27
Lithocarpus_vinhensis,1,1,0,Points-PointsKO-Adjacents,9
Lithocarpus_vinkii,42,21,21,Alphahull-PointsKO-Adjacents,419
Lithocarpus_wallichianus,8,0,8,Points-PointsKO-Adjacents,58
Lithocarpus_woodii,4,3,1,Points-PointsKO-Adjacents,32
Lithocarpus_wrayi,9,1,8,Points-PointsKO-Adjacents,66
Lithocarpus_xizangensis,NA,NA,NA,NA,NA
Lithocarpus_xylocarpus,13,3,10,Points-PointsKO-Adjacents,113
Lithocarpus_yangchunensis,NA,NA,NA,NA,NA
Lithocarpus_yersinii,1,1,0,Points-PointsKO-Adjacents,9
Lithocarpus_yongfuensis,NA,NA,NA,NA,NA
Lithomyrtus_cordata,96,90,6,Alphahull-PointsKO-Adjacents,179
Lithomyrtus_retusa,301,252,49,Alphahull-PointsKO-Adjacents,4712
Lithraea_molleoides,486,400,86,Alphahull-PointsKO-Adjacents,19584
Lithrea_caustica,23,10,13,Points-PointsKO-Adjacents,187
Litsea_accedens,13,4,9,Points-PointsKO-Adjacents,116
Litsea_acuminata,15,4,11,Points-PointsKO-Adjacents,103
Litsea_albescens,0,0,0,NA,0
Litsea_albicans,0,0,0,NA,0
Litsea_albida,3,3,0,Points-PointsKO-Adjacents,27
Litsea_aneityensis,8,2,6,Points-PointsKO-Adjacents,52
Litsea_auriculata,6,0,6,Points-PointsKO-Adjacents,54
Litsea_balansae,12,3,9,Points-PointsKO-Adjacents,95
Litsea_baviensis,34,0,34,Points-PointsKO-Adjacents,258
Litsea_beilschmiediifolia,4,4,0,Points-PointsKO-Adjacents,36
Litsea_beusekomii,3,3,0,Points-PointsKO-Adjacents,21
Litsea_biflora,NA,NA,NA,NA,NA
Litsea_bindoniana,119,100,19,Alphahull-PointsKO-Adjacents,360
Litsea_calicaris,1001,961,40,Alphahull-PointsKO-Adjacents,1078
Litsea_cangyuanensis,NA,NA,NA,NA,NA
Litsea_castanea,8,0,8,Points-PointsKO-Adjacents,63
Litsea_chengshuzhii,NA,NA,NA,NA,NA
Litsea_chinpingensis,9,0,9,Points-PointsKO-Adjacents,60
Litsea_coelestis,1,1,0,Points-PointsKO-Adjacents,9
Litsea_cordata,28,8,20,Points-PointsKO-Adjacents,228
Litsea_costalis,7,0,7,Points-PointsKO-Adjacents,57
Litsea_crassifolia,2,2,0,Points-PointsKO-Adjacents,18
Litsea_cubeba,675,563,112,Alphahull-PointsKO-Adjacents,27953
Litsea_deccanensis,3,3,0,Points-PointsKO-Adjacents,27
Litsea_depressa,NA,NA,NA,NA,NA
Litsea_dilleniifolia,3,3,0,Points-PointsKO-Adjacents,27
Litsea_elliptica,16,1,15,Points-PointsKO-Adjacents,144
Litsea_elongata,184,134,50,Alphahull-PointsKO-Adjacents,16135
Litsea_fawcettiana,201,159,42,Alphahull-PointsKO-Adjacents,887
Litsea_umbellata,51,19,32,Points-PointsKO-Adjacents,422
Litsea_firma,46,9,37,Points-PointsKO-Adjacents,335
Litsea_foveola,NA,NA,NA,NA,NA
Litsea_fulva,15,2,13,Points-PointsKO-Adjacents,128
Litsea_garciae,11,5,6,Points-PointsKO-Adjacents,42
Litsea_glaberrima,1,0,1,Points-PointsKO-Adjacents,9
Litsea_glaucescens,371,324,47,Alphahull-PointsKO-Adjacents,7734
Litsea_globosa,7,0,7,Points-PointsKO-Adjacents,57
Litsea_glutinosa,1147,961,186,Alphahull-PointsKO-Adjacents,18538
Litsea_gongshanensis,14,8,6,Points-PointsKO-Adjacents,22
Litsea_grandis,10,0,10,Points-PointsKO-Adjacents,88
Litsea_greenmaniana,31,13,18,Points-PointsKO-Adjacents,279
Litsea_guppyi,40,22,18,Alphahull-PointsKO-Adjacents,378
Litsea_hayatae,35,22,13,Alphahull-PointsKO-Adjacents,133
Litsea_hirsutissima,0,0,0,NA,0
Litsea_honghoensis,4,4,0,Points-PointsKO-Adjacents,36
Litsea_hookeri,5,4,1,Points-PointsKO-Adjacents,45
Litsea_hunanensis,0,0,0,NA,0
Litsea_hupehana,6,0,6,Points-PointsKO-Adjacents,53
Litsea_hypophaea,457,393,64,Alphahull-PointsKO-Adjacents,457
Litsea_ichangensis,17,6,11,Points-PointsKO-Adjacents,153
Litsea_insignis,4,4,0,Points-PointsKO-Adjacents,36
Litsea_iteodaphne,2,2,0,Points-PointsKO-Adjacents,18
Litsea_johorensis,3,3,0,Points-PointsKO-Adjacents,27
Litsea_kerrii,1,1,0,Points-PointsKO-Adjacents,9
Litsea_khasyana,3,2,1,Points-PointsKO-Adjacents,27
Litsea_kingii,35,22,13,Alphahull-PointsKO-Adjacents,148
Litsea_kobuskiana,3,3,0,Points-PointsKO-Adjacents,27
Litsea_kurzii,1,1,0,Points-PointsKO-Adjacents,9
Litsea_kwangsiensis,1,1,0,Points-PointsKO-Adjacents,9
Litsea_laeta,6,0,6,Points-PointsKO-Adjacents,54
Litsea_lancifolia,24,0,24,Points-PointsKO-Adjacents,215
Litsea_lancilimba,14,2,12,Points-PointsKO-Adjacents,126
Litsea_leefeana,319,0,319,Points-PointsKO-Adjacents,738
Litsea_leiantha,0,0,0,NA,0
Litsea_liboshengii,NA,NA,NA,NA,NA
Litsea_ligustrina,4,3,1,Points-PointsKO-Adjacents,36
Litsea_liyuyingii,0,0,0,NA,0
Litsea_longifolia,4,3,1,Points-PointsKO-Adjacents,33
Litsea_longipes,0,0,0,NA,0
Litsea_longistaminata,8,3,5,Points-PointsKO-Adjacents,72
Litsea_luzonica,2,2,0,Points-PointsKO-Adjacents,18
Litsea_machilifolia,4,0,4,Points-PointsKO-Adjacents,36
Litsea_machiloides,1,1,0,Points-PointsKO-Adjacents,9
Litsea_martabanica,28,13,15,Points-PointsKO-Adjacents,240
Litsea_membranifolia,0,0,0,NA,0
Litsea_mishmiensis,0,0,0,NA,0
Litsea_mollis,130,0,130,Points-PointsKO-Adjacents,1035
Litsea_monopetala,103,56,47,Alphahull-PointsKO-Adjacents,8278
Litsea_morrisonensis,124,111,13,Alphahull-PointsKO-Adjacents,248
Litsea_myristicifolia,2,2,0,Points-PointsKO-Adjacents,13
Litsea_nemoralis,0,0,0,NA,0
Litsea_nitida,4,3,1,Points-PointsKO-Adjacents,36
Litsea_nuculanea,1,1,0,Points-PointsKO-Adjacents,9
Litsea_ochracea,8,1,7,Points-PointsKO-Adjacents,66
Litsea_oligophlebia,2,2,0,Points-PointsKO-Adjacents,18
Litsea_palmatinervia,1,1,0,Points-PointsKO-Adjacents,9
Litsea_panamanja,4,1,3,Points-PointsKO-Adjacents,36
Litsea_pedunculata,27,11,16,Points-PointsKO-Adjacents,243
Litsea_perrottetii,9,4,5,Points-PointsKO-Adjacents,72
Litsea_pierrei,2,2,0,Points-PointsKO-Adjacents,18
Litsea_populifolia,27,14,13,Points-PointsKO-Adjacents,240
Litsea_pseudolongifolia,NA,NA,NA,NA,NA
Litsea_pseudoumbellata,0,0,0,NA,0
Litsea_punctulata,0,0,0,NA,0
Litsea_pungens,83,50,33,Alphahull-PointsKO-Adjacents,11673
Actinodaphne_quinqueflora,3,3,0,Points-PointsKO-Adjacents,27
Litsea_rangoonensis,NA,NA,NA,NA,NA
Litsea_resinosa,7,0,7,Points-PointsKO-Adjacents,63
Litsea_reticulata,782,705,77,Alphahull-PointsKO-Adjacents,2174
Litsea_rotundifolia,98,70,28,Alphahull-PointsKO-Adjacents,3383
Litsea_rubescens,134,0,134,Points-PointsKO-Adjacents,838
Litsea_salicifolia,31,0,31,Points-PointsKO-Adjacents,275
Litsea_seemannii,1,1,0,Points-PointsKO-Adjacents,9
Litsea_semecarpifolia,6,0,6,Points-PointsKO-Adjacents,54
Litsea_sericea,50,25,25,Alphahull-PointsKO-Adjacents,1078
Litsea_sinoglobosa,5,5,0,Points-PointsKO-Adjacents,41
Litsea_josephi,61,0,61,Points-PointsKO-Adjacents,297
Litsea_subcoriacea,18,3,15,Points-PointsKO-Adjacents,162
Litsea_suberosa,5,5,0,Points-PointsKO-Adjacents,39
Litsea_subumbelliflora,3,0,3,Points-PointsKO-Adjacents,27
Litsea_szemaois,0,0,0,NA,0
Litsea_taronensis,3,3,0,Points-PointsKO-Adjacents,9
Litsea_tomentosa,5,1,4,Points-PointsKO-Adjacents,44
Litsea_travancorica,0,0,0,NA,0
Litsea_tsinlingensis,11,3,8,Points-PointsKO-Adjacents,99
Litsea_vang,1,1,0,Points-PointsKO-Adjacents,9
Litsea_variabilis,27,10,17,Points-PointsKO-Adjacents,234
Litsea_veitchiana,36,14,22,Points-PointsKO-Adjacents,323
Litsea_verticillata,62,38,24,Alphahull-PointsKO-Adjacents,2736
Litsea_viridis,2,2,0,Points-PointsKO-Adjacents,18
Litsea_vitiana,4,4,0,Points-PointsKO-Adjacents,29
Litsea_wightiana,4,0,4,Points-PointsKO-Adjacents,30
Litsea_wilsonii,35,0,35,Points-PointsKO-Adjacents,311
Litsea_yunnanensis,7,0,7,Points-PointsKO-Adjacents,63
Livistona_alfredii,17,10,7,Points-PointsKO-Adjacents,93
Livistona_australis,1786,0,1786,Points-PointsKO-Adjacents,1066
Livistona_benthamii,215,183,32,Alphahull-PointsKO-Adjacents,1328
Livistona_boninensis,0,0,0,NA,0
Livistona_carinensis,28,17,11,Points-PointsKO-Adjacents,87
Livistona_chinensis,17,0,17,Points-PointsKO-Adjacents,129
Livistona_concinna,8,1,7,Points-PointsKO-Adjacents,32
Livistona_decora,80,57,23,Alphahull-PointsKO-Adjacents,866
Livistona_drudei,9,0,9,Points-PointsKO-Adjacents,68
Livistona_eastonii,46,41,5,Alphahull-PointsKO-Adjacents,219
Livistona_endauensis,2,2,0,Points-PointsKO-Adjacents,15
Livistona_exigua,1,1,0,Points-PointsKO-Adjacents,9
Livistona_fulva,7,3,4,Points-PointsKO-Adjacents,34
Livistona_halongensis,1,1,0,Points-PointsKO-Adjacents,7
Livistona_humilis,2429,0,2429,Points-PointsKO-Adjacents,1736
Livistona_inermis,373,350,23,Alphahull-PointsKO-Adjacents,2350
Livistona_jenkinsiana,4,4,0,Points-PointsKO-Adjacents,36
Livistona_lorophylla,99,0,99,Points-PointsKO-Adjacents,403
Livistona_mariae,54,28,26,Alphahull-PointsKO-Adjacents,336
Livistona_muelleri,123,92,31,Alphahull-PointsKO-Adjacents,1366
Livistona_nasmophila,9,6,3,Points-PointsKO-Adjacents,66
Livistona_nitida,18,7,11,Points-PointsKO-Adjacents,91
Livistona_rigida,61,41,20,Alphahull-PointsKO-Adjacents,1472
Livistona_saribus,13,0,13,Points-PointsKO-Adjacents,117
Livistona_speciosa,11,1,10,Points-PointsKO-Adjacents,93
Livistona_tahanensis,0,0,0,NA,0
Livistona_victoriae,179,1,178,Points-PointsKO-Adjacents,674
Llagunoa_nitida,63,25,38,Alphahull-PointsKO-Adjacents,613
Llerasia_assuensis,9,3,6,Points-PointsKO-Adjacents,66
Llerasia_caucana,8,1,7,Points-PointsKO-Adjacents,70
Lobanilia_bakeriana,46,30,16,Alphahull-PointsKO-Adjacents,388
Lobanilia_crotonoides,1,1,0,Points-PointsKO-Adjacents,9
Lobanilia_hirtella,4,4,0,Points-PointsKO-Adjacents,36
Lobelia_aberdarica,4,4,0,Points-PointsKO-Adjacents,36
Lobelia_acrochila,1,1,0,Points-PointsKO-Adjacents,9
Lobelia_assurgens,26,11,15,Points-PointsKO-Adjacents,163
Lobelia_burttii,4,4,0,Points-PointsKO-Adjacents,30
Lobelia_deckenii,20,16,4,Points-PointsKO-Adjacents,38
Lobelia_excelsa,18,7,11,Points-PointsKO-Adjacents,106
Lobelia_gregoriana,18,11,7,Points-PointsKO-Adjacents,68
Lobelia_longisepala,29,23,6,Alphahull-PointsKO-Adjacents,85
Lobelia_lukwangulensis,9,0,9,Points-PointsKO-Adjacents,26
Lobelia_nicotianifolia,45,1,44,Points-PointsKO-Adjacents,370
Lobelia_robusta,31,1,30,Points-PointsKO-Adjacents,172
Lobelia_salicina,18,9,9,Points-PointsKO-Adjacents,105
Lobelia_wahiawa,5,5,0,Points-PointsKO-Adjacents,27
Lodoicea_maldivica,4,4,0,Points-PointsKO-Adjacents,10
Loesenera_gabonensis,6,3,3,Points-PointsKO-Adjacents,48
Loesenera_kalantha,17,8,9,Points-PointsKO-Adjacents,109
Loesenera_talbotii,27,22,5,Alphahull-PointsKO-Adjacents,139
Loesenera_walkeri,4,4,0,Points-PointsKO-Adjacents,32
Lomatia_dentata,49,29,20,Alphahull-PointsKO-Adjacents,891
Lomatia_hirsuta,150,117,33,Alphahull-PointsKO-Adjacents,2403
Lonchocarpus_acuminatus,167,125,42,Alphahull-PointsKO-Adjacents,1661
Lonchocarpus_aequatorialis,5,5,0,Points-PointsKO-Adjacents,45
Lonchocarpus_agyrotrichus,1,1,0,Points-PointsKO-Adjacents,9
Lonchocarpus_alternifoliolatus,8,0,8,Points-PointsKO-Adjacents,70
Lonchocarpus_angusticarpus,2,2,0,Points-PointsKO-Adjacents,18
Lonchocarpus_atropurpureus,109,59,50,Alphahull-PointsKO-Adjacents,2056
Lonchocarpus_barbatus,1,1,0,Points-PointsKO-Adjacents,9
Lonchocarpus_berriozabalensis,NA,NA,NA,NA,NA
Lonchocarpus_bicolor,3,3,0,Points-PointsKO-Adjacents,27
Lonchocarpus_blainii,2,2,0,Points-PointsKO-Adjacents,18
Lonchocarpus_brachybotrys,0,0,0,NA,0
Lonchocarpus_bracteolatus,1,1,0,Points-PointsKO-Adjacents,9
Lonchocarpus_brenesii,6,0,6,Points-PointsKO-Adjacents,54
Lonchocarpus_calcaratus,15,8,7,Points-PointsKO-Adjacents,55
Lonchocarpus_castilloi,178,0,178,Points-PointsKO-Adjacents,719
Lonchocarpus_caudatus,100,83,17,Alphahull-PointsKO-Adjacents,947
Lonchocarpus_chiangii,37,27,10,Alphahull-PointsKO-Adjacents,214
Lonchocarpus_chiricanus,8,4,4,Points-PointsKO-Adjacents,44
Lonchocarpus_cochleatus,13,2,11,Points-PointsKO-Adjacents,58
Lonchocarpus_comitensis,3,2,1,Points-PointsKO-Adjacents,27
Lonchocarpus_congestiflorus,3,3,0,Points-PointsKO-Adjacents,27
Lonchocarpus_constrictus,73,42,31,Alphahull-PointsKO-Adjacents,589
Lonchocarpus_costaricensis,38,30,8,Alphahull-PointsKO-Adjacents,120
Lonchocarpus_crassispermus,4,4,0,Points-PointsKO-Adjacents,36
Lonchocarpus_cruentus,113,84,29,Alphahull-PointsKO-Adjacents,1403
Lonchocarpus_cultratus,747,643,104,Alphahull-PointsKO-Adjacents,22876
Lonchocarpus_ellipticus,0,0,0,NA,0
Lonchocarpus_emarginatus,81,60,21,Alphahull-PointsKO-Adjacents,294
Lonchocarpus_epigaeus,9,4,5,Points-PointsKO-Adjacents,73
Lonchocarpus_eriocarinalis,128,108,20,Alphahull-PointsKO-Adjacents,769
Lonchocarpus_eriophyllus,58,49,9,Alphahull-PointsKO-Adjacents,242
Lonchocarpus_felipei,64,51,13,Alphahull-PointsKO-Adjacents,400
Lonchocarpus_ferrugineus,39,26,13,Alphahull-PointsKO-Adjacents,190
Lonchocarpus_floribundus,18,5,13,Points-PointsKO-Adjacents,150
Lonchocarpus_foveolatus,1,1,0,Points-PointsKO-Adjacents,9
Lonchocarpus_fuscopurpureus,24,0,24,Points-PointsKO-Adjacents,96
Lonchocarpus_galeottianus,1,1,0,Points-PointsKO-Adjacents,9
Lonchocarpus_glaucifolius,13,5,8,Points-PointsKO-Adjacents,33
Lonchocarpus_guatemalensis,802,710,92,Alphahull-PointsKO-Adjacents,8838
Lonchocarpus_guillemineanus,11,0,11,Points-PointsKO-Adjacents,91
Lonchocarpus_haberi,18,15,3,Points-PointsKO-Adjacents,24
Lonchocarpus_hedyosmus,123,56,67,Alphahull-PointsKO-Adjacents,4012
Lonchocarpus_heptaphyllus,430,305,125,Alphahull-PointsKO-Adjacents,6713
Lonchocarpus_hermannii,81,52,29,Alphahull-PointsKO-Adjacents,736
Lonchocarpus_hidalgensis,15,7,8,Points-PointsKO-Adjacents,94
Lonchocarpus_hintonii,66,46,20,Alphahull-PointsKO-Adjacents,733
Lonchocarpus_hondurensis,235,206,29,Alphahull-PointsKO-Adjacents,2660
Lonchocarpus_huetamoensis,17,9,8,Points-PointsKO-Adjacents,130
Lonchocarpus_hughesii,24,16,8,Points-PointsKO-Adjacents,117
Lonchocarpus_hydrophilus,1,1,0,Points-PointsKO-Adjacents,9
Lonchocarpus_imatacensis,22,9,13,Points-PointsKO-Adjacents,164
Lonchocarpus_isthmensis,3,3,0,Points-PointsKO-Adjacents,18
Lonchocarpus_kerberi,74,62,12,Alphahull-PointsKO-Adjacents,588
Lonchocarpus_lanceolatus,188,136,52,Alphahull-PointsKO-Adjacents,1587
Lonchocarpus_larensis,4,4,0,Points-PointsKO-Adjacents,36
Lonchocarpus_lasiotropis,14,0,14,Points-PointsKO-Adjacents,103
Lonchocarpus_latimarginatus,1,1,0,Points-PointsKO-Adjacents,9
Lonchocarpus_lilloi,31,14,17,Points-PointsKO-Adjacents,240
Lonchocarpus_lineatus,58,38,20,Alphahull-PointsKO-Adjacents,631
Lonchocarpus_longifolius,2,2,0,Points-PointsKO-Adjacents,18
Lonchocarpus_longipes,9,0,9,Points-PointsKO-Adjacents,78
Lonchocarpus_longistylus,36,22,14,Alphahull-PointsKO-Adjacents,775
Lonchocarpus_luteomaculatus,194,149,45,Alphahull-PointsKO-Adjacents,3319
Lonchocarpus_lutescens,0,0,0,NA,0
Lonchocarpus_macrocarpus,13,0,13,Points-PointsKO-Adjacents,116
Lonchocarpus_macrophyllus,101,68,33,Alphahull-PointsKO-Adjacents,3079
Lonchocarpus_madagascariensis,25,16,9,Points-PointsKO-Adjacents,161
Lonchocarpus_magallanesii,9,1,8,Points-PointsKO-Adjacents,28
Lonchocarpus_martinezii,5,4,1,Points-PointsKO-Adjacents,37
Lonchocarpus_mexicanus,4,3,1,Points-PointsKO-Adjacents,36
Lonchocarpus_michelianus,18,8,10,Points-PointsKO-Adjacents,143
Lonchocarpus_michoacanicus,1,1,0,Points-PointsKO-Adjacents,9
Lonchocarpus_minimiflorus,301,245,56,Alphahull-PointsKO-Adjacents,3102
Lonchocarpus_minor,20,1,19,Points-PointsKO-Adjacents,54
Lonchocarpus_molinae,2,2,0,Points-PointsKO-Adjacents,18
Lonchocarpus_monophyllus,1,1,0,Points-PointsKO-Adjacents,9
Lonchocarpus_monteviridis,17,10,7,Points-PointsKO-Adjacents,59
Lonchocarpus_monticola,13,9,4,Points-PointsKO-Adjacents,42
Lonchocarpus_morenoi,13,5,8,Points-PointsKO-Adjacents,84
Lonchocarpus_multifoliolatus,1,1,0,Points-PointsKO-Adjacents,9
Lonchocarpus_mutans,20,1,19,Points-PointsKO-Adjacents,98
Lonchocarpus_nebularis,1,1,0,Points-PointsKO-Adjacents,9
Lonchocarpus_neei,8,4,4,Points-PointsKO-Adjacents,42
Lonchocarpus_neurophyllus,6,1,5,Points-PointsKO-Adjacents,48
Lonchocarpus_nicou,37,17,20,Points-PointsKO-Adjacents,268
Lonchocarpus_nitidus,212,180,32,Alphahull-PointsKO-Adjacents,8616
Lonchocarpus_oaxacensis,25,0,25,Points-PointsKO-Adjacents,115
Lonchocarpus_obovatus,62,51,11,Alphahull-PointsKO-Adjacents,405
Lonchocarpus_oliganthus,120,103,17,Alphahull-PointsKO-Adjacents,764
Lonchocarpus_orizabensis,9,3,6,Points-PointsKO-Adjacents,71
Lonchocarpus_orotinus,3,2,1,Points-PointsKO-Adjacents,27
Lonchocarpus_parviflorus,56,39,17,Alphahull-PointsKO-Adjacents,853
Lonchocarpus_peninsularis,12,8,4,Points-PointsKO-Adjacents,47
Lonchocarpus_phaseolifolius,104,84,20,Alphahull-PointsKO-Adjacents,651
Lonchocarpus_phlebophyllus,86,73,13,Alphahull-PointsKO-Adjacents,417
Lonchocarpus_pictus,88,67,21,Alphahull-PointsKO-Adjacents,4399
Lonchocarpus_pilosus,9,3,6,Points-PointsKO-Adjacents,50
Lonchocarpus_pittieri,11,5,6,Points-PointsKO-Adjacents,72
Lonchocarpus_plicatus,1,1,0,Points-PointsKO-Adjacents,9
Lonchocarpus_pluvialis,41,21,20,Alphahull-PointsKO-Adjacents,496
Lonchocarpus_praecox,39,26,13,Alphahull-PointsKO-Adjacents,957
Lonchocarpus_pubescens,NA,NA,NA,NA,NA
Lonchocarpus_punctatus,190,126,64,Alphahull-PointsKO-Adjacents,4720
Lonchocarpus_purpureus,20,5,15,Points-PointsKO-Adjacents,109
Lonchocarpus_retifer,52,41,11,Alphahull-PointsKO-Adjacents,610
Lonchocarpus_riparius,6,0,6,Points-PointsKO-Adjacents,54
Lonchocarpus_robustus,31,21,10,Alphahull-PointsKO-Adjacents,524
Lonchocarpus_rugosus,849,770,79,Alphahull-PointsKO-Adjacents,9564
Lonchocarpus_salvadorensis,107,69,38,Alphahull-PointsKO-Adjacents,609
Lonchocarpus_sanctuarii,2,2,0,Points-PointsKO-Adjacents,18
Lonchocarpus_santarosanus,24,14,10,Points-PointsKO-Adjacents,124
Lonchocarpus_schiedeanus,83,42,41,Alphahull-PointsKO-Adjacents,2719
Lonchocarpus_schubertiae,24,14,10,Points-PointsKO-Adjacents,156
Lonchocarpus_seorsus,50,36,14,Alphahull-PointsKO-Adjacents,434
Lonchocarpus_septentrionalis,1,1,0,Points-PointsKO-Adjacents,9
Lonchocarpus_sericeus,1165,912,253,Alphahull-PointsKO-Adjacents,41396
Lonchocarpus_sericocarpus,1,1,0,Points-PointsKO-Adjacents,9
Lonchocarpus_sericophyllus,5,5,0,Points-PointsKO-Adjacents,41
Lonchocarpus_sinaloensis,7,0,7,Points-PointsKO-Adjacents,42
Lonchocarpus_spectabilis,6,1,5,Points-PointsKO-Adjacents,35
Lonchocarpus_spiciflorus,110,73,37,Alphahull-PointsKO-Adjacents,11173
Lonchocarpus_sumiderensis,1,1,0,Points-PointsKO-Adjacents,9
Lonchocarpus_sutherlandii,0,0,0,NA,0
Lonchocarpus_sylvicola,1,1,0,Points-PointsKO-Adjacents,9
Lonchocarpus_trifolius,5,5,0,Points-PointsKO-Adjacents,30
Lonchocarpus_tuxtepecensis,NA,NA,NA,NA,NA
Lonchocarpus_velutinus,41,15,26,Points-PointsKO-Adjacents,253
Lonchocarpus_verrucosus,20,10,10,Points-PointsKO-Adjacents,116
Lonchocarpus_violaceus,13,0,13,Points-PointsKO-Adjacents,93
Lonchocarpus_vittatus,NA,NA,NA,NA,NA
Lonchocarpus_wendtii,2,2,0,Points-PointsKO-Adjacents,18
Lonchocarpus_yoroensis,8,3,5,Points-PointsKO-Adjacents,50
Lonchocarpus_yucatanensis,152,0,152,Points-PointsKO-Adjacents,579
Lonicera_arborea,217,199,18,Alphahull-PointsKO-Adjacents,840
Lonicera_nummulariifolia,29,6,23,Points-PointsKO-Adjacents,234
Lophanthera_hammelii,37,27,10,Alphahull-PointsKO-Adjacents,203
Lophanthera_lactescens,39,11,28,Points-PointsKO-Adjacents,302
Lophanthera_longifolia,7,2,5,Points-PointsKO-Adjacents,63
Lophanthera_pendula,8,0,8,Points-PointsKO-Adjacents,60
Lophira_alata,316,269,47,Alphahull-PointsKO-Adjacents,7435
Lophira_lanceolata,528,475,53,Alphahull-PointsKO-Adjacents,7615
Lophocereus_gatesii,6,1,5,Points-PointsKO-Adjacents,41
Lophocereus_schottii,215,196,19,Alphahull-PointsKO-Adjacents,2485
Lophomyrtus_bullata,650,607,43,Alphahull-PointsKO-Adjacents,1807
Lophomyrtus_obcordata,823,802,21,Alphahull-PointsKO-Adjacents,815
Lophopterys_splendens,4,4,0,Points-PointsKO-Adjacents,32
Lophostemon_confertus,3704,3458,246,Alphahull-PointsKO-Adjacents,4262
Lophostemon_grandiflorus,1208,1141,67,Alphahull-PointsKO-Adjacents,15483
Lophostemon_lactifluus,1154,1116,38,Alphahull-PointsKO-Adjacents,2861
Lophostemon_suaveolens,1545,1437,108,Alphahull-PointsKO-Adjacents,9332
Lophostoma_calophylloides,19,4,15,Points-PointsKO-Adjacents,141
Lorencea_guatemalensis,33,17,16,Points-PointsKO-Adjacents,157
Lorenzanea_irazuensis,3,3,0,Points-PointsKO-Adjacents,27
Loreya_arborescens,35,10,25,Points-PointsKO-Adjacents,284
Loreya_subrotundifolia,4,4,0,Points-PointsKO-Adjacents,27
Loropetalum_chinense,192,139,53,Alphahull-PointsKO-Adjacents,12006
Loropetalum_lanceum,2,2,0,Points-PointsKO-Adjacents,18
Loropetalum_subcordatum,2,2,0,Points-PointsKO-Adjacents,18
Lorostemon_bombaciflorum,28,10,18,Points-PointsKO-Adjacents,168
Lorostemon_coelhoi,17,10,7,Points-PointsKO-Adjacents,75
Lorostemon_colombianus,23,10,13,Points-PointsKO-Adjacents,159
Lovoa_swynnertonii,28,12,16,Points-PointsKO-Adjacents,183
Lovoa_trichilioides,122,76,46,Alphahull-PointsKO-Adjacents,4195
Loxococcus_rupicola,0,0,0,NA,0
Loxopterygium_grisebachii,82,62,20,Alphahull-PointsKO-Adjacents,1296
Loxopterygium_huasango,79,69,10,Alphahull-PointsKO-Adjacents,667
Loxopterygium_sagotii,61,43,18,Alphahull-PointsKO-Adjacents,2424
Loxostylis_alata,45,0,45,Points-PointsKO-Adjacents,317
Lozanella_enantiophylla,305,221,84,Alphahull-PointsKO-Adjacents,2745
Lozanella_permollis,67,24,43,Alphahull-PointsKO-Adjacents,475
Lozania_klugii,34,0,34,Points-PointsKO-Adjacents,274
Lozania_mutisiana,442,379,63,Alphahull-PointsKO-Adjacents,8620
Lozania_pittieri,181,155,26,Alphahull-PointsKO-Adjacents,933
Lubaria_aroensis,19,7,12,Points-PointsKO-Adjacents,124
Luculia_gratissima,6,1,5,Points-PointsKO-Adjacents,44
Luculia_pinceana,37,23,14,Alphahull-PointsKO-Adjacents,340
Luculia_yunnanensis,45,29,16,Alphahull-PointsKO-Adjacents,153
Ludia_ankaranensis,4,4,0,Points-PointsKO-Adjacents,26
Ludia_antanosarum,16,2,14,Points-PointsKO-Adjacents,112
Ludia_boinensis,39,21,18,Alphahull-PointsKO-Adjacents,591
Ludia_brevipes,2,2,0,Points-PointsKO-Adjacents,14
Ludia_chapelieri,5,5,0,Points-PointsKO-Adjacents,22
Ludia_dracaenoides,17,9,8,Points-PointsKO-Adjacents,73
Ludia_erosifolia,5,5,0,Points-PointsKO-Adjacents,24
Ludia_faradifani,1,1,0,Points-PointsKO-Adjacents,9
Ludia_glaucocarpa,7,2,5,Points-PointsKO-Adjacents,33
Ludia_ikongoensis,3,3,0,Points-PointsKO-Adjacents,23
Ludia_imontiensis,1,1,0,Points-PointsKO-Adjacents,9
Ludia_leandriana,7,0,7,Points-PointsKO-Adjacents,47
Ludia_ludiifolia,5,5,0,Points-PointsKO-Adjacents,45
Ludia_madagascariensis,54,34,20,Alphahull-PointsKO-Adjacents,466
Ludia_mauritiana,50,17,33,Points-PointsKO-Adjacents,350
Ludia_myrtoides,2,2,0,Points-PointsKO-Adjacents,18
Ludia_pachyadenia,1,1,0,Points-PointsKO-Adjacents,9
Ludia_pinnatinervia,26,13,13,Points-PointsKO-Adjacents,173
Ludia_scolopioides,59,37,22,Alphahull-PointsKO-Adjacents,728
Ludia_sessilis,3,3,0,Points-PointsKO-Adjacents,23
Ludia_suarezensis,2,2,0,Points-PointsKO-Adjacents,17
Ludia_wikstroemiifolia,4,4,0,Points-PointsKO-Adjacents,32
Ludwigia_anastomosans,4,3,1,Points-PointsKO-Adjacents,36
Ludwigia_nervosa,728,562,166,Alphahull-PointsKO-Adjacents,51246
Luehea_candicans,928,846,82,Alphahull-PointsKO-Adjacents,50714
Luehea_candida,909,772,137,Alphahull-PointsKO-Adjacents,14284
Luehea_cymulosa,395,319,76,Alphahull-PointsKO-Adjacents,50308
Luehea_divaricata,1624,1491,133,Alphahull-PointsKO-Adjacents,38695
Luehea_fiebrigii,42,22,20,Alphahull-PointsKO-Adjacents,381
Luehea_grandiflora,1307,1199,108,Alphahull-PointsKO-Adjacents,46937
Luehea_herzogiana,14,7,7,Points-PointsKO-Adjacents,68
Luehea_ochrophylla,212,155,57,Alphahull-PointsKO-Adjacents,5258
Luehea_paniculata,764,651,113,Alphahull-PointsKO-Adjacents,42378
Luehea_rufescens,0,0,0,NA,0
Luehea_seemannii,641,0,641,Points-PointsKO-Adjacents,3003
Luehea_speciosa,989,826,163,Alphahull-PointsKO-Adjacents,12303
Luehea_splendens,27,19,8,Points-PointsKO-Adjacents,171
Luehea_steinbachii,17,14,3,Points-PointsKO-Adjacents,86
Luehea_tomentella,21,8,13,Points-PointsKO-Adjacents,173
Lueheopsis_althaeiflora,78,0,78,Points-PointsKO-Adjacents,569
Lueheopsis_burretiana,17,1,16,Points-PointsKO-Adjacents,101
Lueheopsis_duckeana,91,42,49,Alphahull-PointsKO-Adjacents,4169
Lueheopsis_hoehnei,52,9,43,Points-PointsKO-Adjacents,444
Lueheopsis_rosea,158,95,63,Alphahull-PointsKO-Adjacents,22112
Lueheopsis_rugosa,23,0,23,Points-PointsKO-Adjacents,197
Luetzelburgia_andina,16,0,16,Points-PointsKO-Adjacents,44
Luetzelburgia_andrade-limae,67,47,20,Alphahull-PointsKO-Adjacents,1982
Luetzelburgia_auriculata,406,361,45,Alphahull-PointsKO-Adjacents,14699
Luetzelburgia_bahiensis,187,171,16,Alphahull-PointsKO-Adjacents,2786
Luetzelburgia_guaissara,82,62,20,Alphahull-PointsKO-Adjacents,2121
Luetzelburgia_praecox,86,63,23,Alphahull-PointsKO-Adjacents,3495
Luetzelburgia_sotoi,16,8,8,Points-PointsKO-Adjacents,118
Luetzelburgia_trialata,10,3,7,Points-PointsKO-Adjacents,66
Luma_apiculata,88,61,27,Alphahull-PointsKO-Adjacents,2587
Luma_chequen,49,29,20,Alphahull-PointsKO-Adjacents,816
Lumnitzera_littorea,202,116,86,Alphahull-PointsKO-Adjacents,2049
Lumnitzera_racemosa,497,323,174,Alphahull-PointsKO-Adjacents,6547
Lunania_ekmanii,12,4,8,Points-PointsKO-Adjacents,69
Lunania_mexicana,275,238,37,Alphahull-PointsKO-Adjacents,4547
Lunania_parviflora,488,421,67,Alphahull-PointsKO-Adjacents,16147
Lunasia_amara,61,0,61,Points-PointsKO-Adjacents,426
Lundinia_plumbea,31,14,17,Points-PointsKO-Adjacents,156
Lupinus_colombiensis,14,5,9,Points-PointsKO-Adjacents,69
Lupinus_jaimehintoniana,9,5,4,Points-PointsKO-Adjacents,42
Lupinus_macbrideianus,1,1,0,Points-PointsKO-Adjacents,9
Lupinus_reflexus,8,2,6,Points-PointsKO-Adjacents,65
Luzonia_purpurea,2,2,0,Points-PointsKO-Adjacents,18
Lychnodiscus_brevibracteatus,8,0,8,Points-PointsKO-Adjacents,54
Lychnodiscus_cerospermus,39,16,23,Points-PointsKO-Adjacents,236
Lychnodiscus_dananensis,24,4,20,Points-PointsKO-Adjacents,140
Lychnodiscus_grandifolius,31,16,15,Points-PointsKO-Adjacents,188
Lychnodiscus_multinervis,6,0,6,Points-PointsKO-Adjacents,42
Lychnodiscus_reticulatus,9,4,5,Points-PointsKO-Adjacents,71
Lychnophora_crispa,22,9,13,Points-PointsKO-Adjacents,126
Lychnophora_diamantinana,32,24,8,Alphahull-PointsKO-Adjacents,73
Lychnophora_ericoides,212,182,30,Alphahull-PointsKO-Adjacents,5109
Lychnophora_granmogolensis,82,68,14,Alphahull-PointsKO-Adjacents,964
Lychnophora_humillima,4,0,4,Points-PointsKO-Adjacents,32
Lychnophora_markgravii,23,15,8,Points-PointsKO-Adjacents,99
Lychnophora_mello-barretoi,6,2,4,Points-PointsKO-Adjacents,44
Lychnophora_pinaster,132,117,15,Alphahull-PointsKO-Adjacents,902
Lychnophora_pohlii,64,57,7,Alphahull-PointsKO-Adjacents,144
Lychnophora_reticulata,21,1,20,Points-PointsKO-Adjacents,165
Lychnophora_rosmarinifolia,55,40,15,Alphahull-PointsKO-Adjacents,1117
Lychnophora_salicifolia,215,193,22,Alphahull-PointsKO-Adjacents,4074
Lychnophora_santosii,17,9,8,Points-PointsKO-Adjacents,61
Lychnophora_sellowii,32,26,6,Alphahull-PointsKO-Adjacents,98
Lychnophora_souzae,6,2,4,Points-PointsKO-Adjacents,24
Lychnophora_staavioides,34,0,34,Points-PointsKO-Adjacents,106
Lychnophora_tomentosa,62,0,62,Points-PointsKO-Adjacents,156
Lychnophora_villosissima,29,22,7,Alphahull-PointsKO-Adjacents,94
Lychnophoriopsis_candelabrum,26,21,5,Alphahull-PointsKO-Adjacents,116
Lychnophoriopsis_damazioi,19,0,19,Points-PointsKO-Adjacents,52
Lychnophoriopsis_hatschbachii,4,4,0,Points-PointsKO-Adjacents,28
Lycianthes_acidochondra,30,21,9,Alphahull-PointsKO-Adjacents,213
Lycianthes_anomala,69,38,31,Alphahull-PointsKO-Adjacents,574
Lycianthes_beckneriana,5,5,0,Points-PointsKO-Adjacents,42
Lycianthes_gorgonea,26,1,25,Points-PointsKO-Adjacents,144
Lycianthes_heteroclita,216,178,38,Alphahull-PointsKO-Adjacents,3094
Lycianthes_howardiana,6,1,5,Points-PointsKO-Adjacents,42
Lycianthes_pauciflora,260,183,77,Alphahull-PointsKO-Adjacents,8223
Lycianthes_radiata,360,295,65,Alphahull-PointsKO-Adjacents,3791
Lycianthes_sanctae-marthae,7,0,7,Points-PointsKO-Adjacents,60
Lycianthes_stenoloba,52,22,30,Alphahull-PointsKO-Adjacents,2698
Lycianthes_synanthera,256,203,53,Alphahull-PointsKO-Adjacents,2588
Lycianthes_virgata,25,14,11,Points-PointsKO-Adjacents,153
Lycium_acutifolium,51,24,27,Alphahull-PointsKO-Adjacents,579
Lycium_bosciifolium,98,75,23,Alphahull-PointsKO-Adjacents,6159
Lycium_europaeum,676,474,202,Alphahull-PointsKO-Adjacents,11759
Lycium_mascarenense,6,2,4,Points-PointsKO-Adjacents,37
Lycium_morongii,40,0,40,Points-PointsKO-Adjacents,287
Lycium_oxycarpum,96,76,20,Alphahull-PointsKO-Adjacents,4949
Lycium_shawii,385,312,73,Alphahull-PointsKO-Adjacents,834
Catha_abbottii,8,4,4,Points-PointsKO-Adjacents,36
Lydenburgia_cassinoides,16,16,0,Points-PointsKO-Adjacents,118
Lyonia_alainii,1,1,0,Points-PointsKO-Adjacents,9
Lyonia_buchii,5,5,0,Points-PointsKO-Adjacents,42
Lyonia_doyonensis,48,32,16,Alphahull-PointsKO-Adjacents,375
Lyonia_elliptica,0,0,0,NA,0
Lyonia_ferruginea,183,147,36,Alphahull-PointsKO-Adjacents,1850
Lyonia_jamaicensis,6,1,5,Points-PointsKO-Adjacents,29
Lyonia_latifolia,8,2,6,Points-PointsKO-Adjacents,58
Lyonia_macrocalyx,17,12,5,Points-PointsKO-Adjacents,107
Lyonia_maestrensis,NA,NA,NA,NA,NA
Lyonia_microcarpa,8,3,5,Points-PointsKO-Adjacents,41
Lyonia_obtusa,1,1,0,Points-PointsKO-Adjacents,9
Lyonia_octandra,3,3,0,Points-PointsKO-Adjacents,21
Lyonia_ovalifolia,1107,886,221,Alphahull-PointsKO-Adjacents,25037
Lyonia_rubiginosa,2,2,0,Points-PointsKO-Adjacents,14
Lyonia_squamulosa,228,200,28,Alphahull-PointsKO-Adjacents,3554
Lyonia_stahlii,8,6,2,Points-PointsKO-Adjacents,45
Lyonia_tinensis,4,3,1,Points-PointsKO-Adjacents,36
Lyonia_truncata,21,12,9,Points-PointsKO-Adjacents,98
Lyonia_urbaniana,3,2,1,Points-PointsKO-Adjacents,27
Lyonia_villosa,116,92,24,Alphahull-PointsKO-Adjacents,3246
Lyonothamnus_floribundus,143,126,17,Alphahull-PointsKO-Adjacents,147
Lysidice_brevicalyx,9,1,8,Points-PointsKO-Adjacents,81
Lysidice_rhodostegia,24,14,10,Points-PointsKO-Adjacents,207
Lysiloma_acapulcense,886,791,95,Alphahull-PointsKO-Adjacents,11377
Lysiloma_ambigua,1,1,0,Points-PointsKO-Adjacents,9
Lysiloma_auritum,175,132,43,Alphahull-PointsKO-Adjacents,3922
Lysiloma_candida,179,0,179,Points-PointsKO-Adjacents,526
Lysiloma_divaricatum,1034,931,103,Alphahull-PointsKO-Adjacents,13418
Lysiloma_latisiliquum,611,537,74,Alphahull-PointsKO-Adjacents,3622
Lysiloma_microphylla,517,450,67,Alphahull-PointsKO-Adjacents,8712
Lysiloma_sabicu,42,22,20,Alphahull-PointsKO-Adjacents,1372
Lysiloma_tergemina,294,260,34,Alphahull-PointsKO-Adjacents,1270
Lysiloma_watsonii,92,74,18,Alphahull-PointsKO-Adjacents,1723
Lysiphyllum_carronii,150,0,150,Points-PointsKO-Adjacents,1032
Lysiphyllum_gilvum,232,0,232,Points-PointsKO-Adjacents,1153
Maackia_amurensis,220,150,70,Alphahull-PointsKO-Adjacents,2221
Maackia_australis,NA,NA,NA,NA,NA
Maackia_floribunda,3,3,0,Points-PointsKO-Adjacents,18
Maackia_hupehensis,10,3,7,Points-PointsKO-Adjacents,90
Maackia_hwashanensis,NA,NA,NA,NA,NA
Maackia_taiwanensis,4,1,3,Points-PointsKO-Adjacents,18
Maackia_tashiroi,2,2,0,Points-PointsKO-Adjacents,13
Maackia_tenuifolia,2,2,0,Points-PointsKO-Adjacents,18
Maasia_glauca,32,3,29,Points-PointsKO-Adjacents,235
Maasia_hypoleuca,7,0,7,Points-PointsKO-Adjacents,62
Maasia_ovalifolia,0,0,0,NA,0
Maasia_sumatrana,76,47,29,Alphahull-PointsKO-Adjacents,4083
Mabea_anadena,128,101,27,Alphahull-PointsKO-Adjacents,7356
Mabea_angularis,83,40,43,Alphahull-PointsKO-Adjacents,2308
Mabea_angustifolia,393,312,81,Alphahull-PointsKO-Adjacents,46005
Mabea_anomala,103,54,49,Alphahull-PointsKO-Adjacents,4090
Mabea_arenicola,31,18,13,Points-PointsKO-Adjacents,205
Mabea_caudata,2,1,1,Points-PointsKO-Adjacents,18
Mabea_elata,30,15,15,Points-PointsKO-Adjacents,231
Mabea_elegans,38,19,19,Points-PointsKO-Adjacents,271
Mabea_excelsa,61,44,17,Alphahull-PointsKO-Adjacents,785
Mabea_fistulifera,960,855,105,Alphahull-PointsKO-Adjacents,51880
Mabea_frutescens,27,19,8,Points-PointsKO-Adjacents,145
Mabea_glaziovii,41,22,19,Alphahull-PointsKO-Adjacents,1038
Mabea_jefensis,30,25,5,Alphahull-PointsKO-Adjacents,45
Mabea_klugii,149,100,49,Alphahull-PointsKO-Adjacents,3418
Mabea_longibracteata,9,5,4,Points-PointsKO-Adjacents,60
Mabea_macbridei,84,56,28,Alphahull-PointsKO-Adjacents,2538
Mabea_macrocalyx,12,8,4,Points-PointsKO-Adjacents,73
Mabea_montana,235,179,56,Alphahull-PointsKO-Adjacents,17548
Mabea_nitida,794,734,60,Alphahull-PointsKO-Adjacents,48637
Mabea_occidentalis,160,97,63,Alphahull-PointsKO-Adjacents,9935
Mabea_ovata,4,4,0,Points-PointsKO-Adjacents,36
Mabea_paniculata,271,191,80,Alphahull-PointsKO-Adjacents,41114
Mabea_piriri,931,788,143,Alphahull-PointsKO-Adjacents,69684
Mabea_pohliana,251,198,53,Alphahull-PointsKO-Adjacents,19827
Mabea_pulcherrima,66,25,41,Alphahull-PointsKO-Adjacents,870
Mabea_rubicunda,8,3,5,Points-PointsKO-Adjacents,55
Mabea_salicoides,8,0,8,Points-PointsKO-Adjacents,59
Mabea_speciosa,502,435,67,Alphahull-PointsKO-Adjacents,41316
Mabea_standleyi,77,60,17,Alphahull-PointsKO-Adjacents,3218
Mabea_subserrulata,11,1,10,Points-PointsKO-Adjacents,93
Mabea_subsessilis,235,174,61,Alphahull-PointsKO-Adjacents,25177
Mabea_taquari,242,183,59,Alphahull-PointsKO-Adjacents,15377
Mabea_tenorioi,6,2,4,Points-PointsKO-Adjacents,30
Mabea_trianae,109,87,22,Alphahull-PointsKO-Adjacents,5341
Maburea_trinervis,15,8,7,Points-PointsKO-Adjacents,76
Macadamia_integrifolia,131,103,28,Alphahull-PointsKO-Adjacents,357
Macadamia_neurophylla,6,2,4,Points-PointsKO-Adjacents,29
Macadamia_ternifolia,100,0,100,Points-PointsKO-Adjacents,194
Macadamia_tetraphylla,330,0,330,Points-PointsKO-Adjacents,276
Macairea_chimantensis,28,16,12,Points-PointsKO-Adjacents,88
Macairea_cuieirasii,8,1,7,Points-PointsKO-Adjacents,72
Macairea_pachyphylla,212,150,62,Alphahull-PointsKO-Adjacents,7939
Macairea_radula,497,430,67,Alphahull-PointsKO-Adjacents,24383
Macairea_stylosa,76,59,17,Alphahull-PointsKO-Adjacents,1339
Macairea_sulcata,8,3,5,Points-PointsKO-Adjacents,63
Macairea_theresiae,53,28,25,Alphahull-PointsKO-Adjacents,1408
Macairea_thyrsiflora,432,348,84,Alphahull-PointsKO-Adjacents,28054
Macaranga_advena,NA,NA,NA,NA,NA
Macaranga_aenigmatica,2,2,0,Points-PointsKO-Adjacents,18
Macaranga_aetheadenia,9,2,7,Points-PointsKO-Adjacents,67
Macaranga_albescens,14,3,11,Points-PointsKO-Adjacents,105
Macaranga_alchorneoides,53,43,10,Alphahull-PointsKO-Adjacents,143
Macaranga_aleuritoides,63,25,38,Alphahull-PointsKO-Adjacents,1449
Macaranga_allorobinsonii,8,3,5,Points-PointsKO-Adjacents,47
Macaranga_alnifolia,159,137,22,Alphahull-PointsKO-Adjacents,1885
Macaranga_amentifera,1,1,0,Points-PointsKO-Adjacents,9
Macaranga_amissa,0,0,0,NA,0
Macaranga_anceps,1,0,1,Points-PointsKO-Adjacents,6
Macaranga_andamanica,24,9,15,Points-PointsKO-Adjacents,186
Macaranga_angolensis,23,6,17,Points-PointsKO-Adjacents,130
Macaranga_angulata,7,3,4,Points-PointsKO-Adjacents,42
Macaranga_angustifolia,11,5,6,Points-PointsKO-Adjacents,76
Macaranga_assas,8,2,6,Points-PointsKO-Adjacents,44
Macaranga_astrolabica,NA,NA,NA,NA,NA
Macaranga_attenuata,7,2,5,Points-PointsKO-Adjacents,22
Macaranga_auctoris,NA,NA,NA,NA,NA
Macaranga_baccaureifolia,0,0,0,NA,0
Macaranga_bancana,13,0,13,Points-PointsKO-Adjacents,89
Macaranga_barkeriana,2,2,0,Points-PointsKO-Adjacents,12
Macaranga_barteri,217,150,67,Alphahull-PointsKO-Adjacents,4697
Macaranga_beccariana,22,11,11,Points-PointsKO-Adjacents,164
Macaranga_beillei,23,13,10,Points-PointsKO-Adjacents,83
Macaranga_belensis,2,2,0,Points-PointsKO-Adjacents,18
Macaranga_bicolor,4,4,0,Points-PointsKO-Adjacents,31
Macaranga_bifoveata,11,3,8,Points-PointsKO-Adjacents,61
Macaranga_boutonioides,102,79,23,Alphahull-PointsKO-Adjacents,2432
Macaranga_brachythyrsa,NA,NA,NA,NA,NA
Macaranga_brachytricha,5,5,0,Points-PointsKO-Adjacents,27
Macaranga_brevipetiolata,0,0,0,NA,0
Macaranga_brunneofloccosa,2,2,0,Points-PointsKO-Adjacents,9
Macaranga_caesariata,0,0,0,NA,0
Macaranga_caladiifolia,2,2,0,Points-PointsKO-Adjacents,18
Macaranga_calcicola,1,1,0,Points-PointsKO-Adjacents,9
Macaranga_capensis,67,28,39,Alphahull-PointsKO-Adjacents,614
Macaranga_carolinensis,21,8,13,Points-PointsKO-Adjacents,30
Macaranga_carrii,35,17,18,Points-PointsKO-Adjacents,228
Macaranga_cassandrae,NA,NA,NA,NA,NA
Macaranga_caudata,5,5,0,Points-PointsKO-Adjacents,45
Macaranga_caudatifolia,2,2,0,Points-PointsKO-Adjacents,17
Macaranga_chlorolepis,5,5,0,Points-PointsKO-Adjacents,24
Macaranga_chrysotricha,17,7,10,Points-PointsKO-Adjacents,120
Macaranga_clavata,13,1,12,Points-PointsKO-Adjacents,87
Macaranga_clemensiae,6,1,5,Points-PointsKO-Adjacents,54
Macaranga_coggygria,2,2,0,Points-PointsKO-Adjacents,13
Macaranga_congestiflora,2,2,0,Points-PointsKO-Adjacents,15
Macaranga_conglomerata,18,9,9,Points-PointsKO-Adjacents,65
Macaranga_conifera,17,1,16,Points-PointsKO-Adjacents,122
Macaranga_constricta,0,0,0,NA,0
Macaranga_coriacea,78,63,15,Alphahull-PointsKO-Adjacents,236
Macaranga_corymbosa,57,43,14,Alphahull-PointsKO-Adjacents,147
Macaranga_costulata,18,5,13,Points-PointsKO-Adjacents,141
Macaranga_cucullata,1,1,0,Points-PointsKO-Adjacents,9
Macaranga_cumingii,5,5,0,Points-PointsKO-Adjacents,35
Macaranga_cupularis,0,0,0,NA,0
Macaranga_cuspidata,127,105,22,Alphahull-PointsKO-Adjacents,1467
Macaranga_dallachyana,21,16,5,Points-PointsKO-Adjacents,73
Macaranga_darbyshirei,5,5,0,Points-PointsKO-Adjacents,45
Macaranga_daviesii,1,1,0,Points-PointsKO-Adjacents,9
Macaranga_decipiens,9,2,7,Points-PointsKO-Adjacents,36
Macaranga_densiflora,30,10,20,Points-PointsKO-Adjacents,203
Macaranga_denticulata,78,0,78,Points-PointsKO-Adjacents,658
Macaranga_depressa,15,4,11,Points-PointsKO-Adjacents,93
Macaranga_dibeleensis,4,4,0,Points-PointsKO-Adjacents,36
Macaranga_diepenhorstii,4,0,4,Points-PointsKO-Adjacents,36
Macaranga_dioica,54,21,33,Alphahull-PointsKO-Adjacents,306
Macaranga_domatiosa,12,4,8,Points-PointsKO-Adjacents,96
Macaranga_ducis,9,0,9,Points-PointsKO-Adjacents,68
Macaranga_ebolowana,NA,NA,NA,NA,NA
Macaranga_echinocarpa,94,71,23,Alphahull-PointsKO-Adjacents,716
Macaranga_eloba,NA,NA,NA,NA,NA
Macaranga_endertii,0,0,0,NA,0
Macaranga_eymae,1,1,0,Points-PointsKO-Adjacents,9
Macaranga_faiketo,0,0,0,NA,0
Macaranga_fallacina,10,1,9,Points-PointsKO-Adjacents,64
Macaranga_ferruginea,20,7,13,Points-PointsKO-Adjacents,165
Macaranga_fragrans,7,1,6,Points-PointsKO-Adjacents,57
Macaranga_fulva,0,0,0,NA,0
Macaranga_galorei,0,0,0,NA,0
Macaranga_gigantea,26,5,21,Points-PointsKO-Adjacents,228
Macaranga_gigantifolia,0,0,0,NA,0
Macaranga_glaberrima,7,1,6,Points-PointsKO-Adjacents,56
Macaranga_glandibracteolata,4,4,0,Points-PointsKO-Adjacents,36
Macaranga_glandulifera,0,0,0,NA,0
Macaranga_gracilis,7,0,7,Points-PointsKO-Adjacents,63
Macaranga_graeffeana,0,0,0,NA,0
Macaranga_grallata,39,21,18,Alphahull-PointsKO-Adjacents,243
Macaranga_grandifolia,1,1,0,Points-PointsKO-Adjacents,9
Macaranga_grayana,0,0,0,NA,0
Macaranga_griffithiana,1,1,0,Points-PointsKO-Adjacents,9
Macaranga_hartleyana,3,3,0,Points-PointsKO-Adjacents,25
Macaranga_havilandii,2,2,0,Points-PointsKO-Adjacents,18
Macaranga_hemsleyana,7,1,6,Points-PointsKO-Adjacents,54
Macaranga_hengkyana,NA,NA,NA,NA,NA
Macaranga_henryi,33,17,16,Points-PointsKO-Adjacents,297
Macaranga_heterophylla,92,65,27,Alphahull-PointsKO-Adjacents,2772
Macaranga_heudelotii,67,0,67,Points-PointsKO-Adjacents,429
Macaranga_heynei,8,1,7,Points-PointsKO-Adjacents,63
Macaranga_hispida,40,12,28,Points-PointsKO-Adjacents,309
Macaranga_hosei,15,4,11,Points-PointsKO-Adjacents,123
Macaranga_huahineensis,2,2,0,Points-PointsKO-Adjacents,4
Macaranga_hullettii,24,8,16,Points-PointsKO-Adjacents,163
Macaranga_hurifolia,69,45,24,Alphahull-PointsKO-Adjacents,1964
Macaranga_hypoleuca,21,8,13,Points-PointsKO-Adjacents,171
Macaranga_hystrichogyne,0,0,0,NA,0
Macaranga_inamoena,79,66,13,Alphahull-PointsKO-Adjacents,145
Macaranga_indica,45,15,30,Points-PointsKO-Adjacents,351
Macaranga_indistincta,9,0,9,Points-PointsKO-Adjacents,79
Macaranga_induta,8,4,4,Points-PointsKO-Adjacents,60
Macaranga_inermis,43,19,24,Points-PointsKO-Adjacents,300
Macaranga_intonsa,5,5,0,Points-PointsKO-Adjacents,39
Macaranga_involucrata,447,361,86,Alphahull-PointsKO-Adjacents,1956
Macaranga_javanica,1,1,0,Points-PointsKO-Adjacents,9
Macaranga_johannium,1,1,0,Points-PointsKO-Adjacents,9
Macaranga_kilimandscharica,88,55,33,Alphahull-PointsKO-Adjacents,1051
Macaranga_kinabaluensis,4,4,0,Points-PointsKO-Adjacents,35
Macaranga_kingii,3,0,3,Points-PointsKO-Adjacents,27
Macaranga_kostermansii,0,0,0,NA,0
Macaranga_kurzii,28,3,25,Points-PointsKO-Adjacents,228
Macaranga_laciniata,2,2,0,Points-PointsKO-Adjacents,12
Macaranga_lamellata,5,5,0,Points-PointsKO-Adjacents,45
Macaranga_lanceolata,2,2,0,Points-PointsKO-Adjacents,18
Macaranga_lineata,2,2,0,Points-PointsKO-Adjacents,12
Macaranga_longicaudata,2,2,0,Points-PointsKO-Adjacents,18
Macaranga_louisiadum,0,0,0,NA,0
Macaranga_lowii,61,30,31,Alphahull-PointsKO-Adjacents,3542
Macaranga_lumiensis,NA,NA,NA,NA,NA
Macaranga_macropoda,133,108,25,Alphahull-PointsKO-Adjacents,752
Macaranga_magna,0,0,0,NA,0
Macaranga_magnifolia,0,0,0,NA,0
Macaranga_mappa,9,2,7,Points-PointsKO-Adjacents,79
Macaranga_marikoensis,0,0,0,NA,0
Macaranga_mauritiana,0,0,0,NA,0
Macaranga_megacarpa,13,6,7,Points-PointsKO-Adjacents,62
Macaranga_melanosticta,6,0,6,Points-PointsKO-Adjacents,27
Macaranga_mellifera,7,1,6,Points-PointsKO-Adjacents,57
Macaranga_membranacea,0,0,0,NA,0
Macaranga_minahassae,0,0,0,NA,0
Macaranga_misimae,3,3,0,Points-PointsKO-Adjacents,6
Macaranga_monandra,82,42,40,Alphahull-PointsKO-Adjacents,922
Macaranga_monostyla,1,1,0,Points-PointsKO-Adjacents,9
Macaranga_motleyana,22,11,11,Points-PointsKO-Adjacents,162
Macaranga_myriolepida,7,3,4,Points-PointsKO-Adjacents,63
Macaranga_neobritannica,25,12,13,Points-PointsKO-Adjacents,158
Macaranga_nicobarica,0,0,0,NA,0
Macaranga_novoguineensis,11,0,11,Points-PointsKO-Adjacents,85
Macaranga_nusatenggarensis,1,1,0,Points-PointsKO-Adjacents,9
Macaranga_oblongifolia,58,33,25,Alphahull-PointsKO-Adjacents,454
Macaranga_obovata,102,71,31,Alphahull-PointsKO-Adjacents,702
Macaranga_occidentalis,38,29,9,Alphahull-PointsKO-Adjacents,140
Macaranga_ovatifolia,0,0,0,NA,0
Macaranga_pachyphylla,6,0,6,Points-PointsKO-Adjacents,54
Macaranga_palustris,2,2,0,Points-PointsKO-Adjacents,12
Macaranga_papuana,9,0,9,Points-PointsKO-Adjacents,61
Macaranga_parabicolor,0,0,0,NA,0
Macaranga_paxii,2,2,0,Points-PointsKO-Adjacents,18
Macaranga_pearsonii,14,5,9,Points-PointsKO-Adjacents,104
Macaranga_peltata,5,0,5,Points-PointsKO-Adjacents,45
Macaranga_pentaloba,NA,NA,NA,NA,NA
Macaranga_pepysiana,1,1,0,Points-PointsKO-Adjacents,9
Macaranga_perrieri,5,5,0,Points-PointsKO-Adjacents,35
Macaranga_petanostyla,3,3,0,Points-PointsKO-Adjacents,27
Macaranga_pierreana,1,0,1,Points-PointsKO-Adjacents,9
Macaranga_pilosula,3,3,0,Points-PointsKO-Adjacents,9
Macaranga_platyclada,2,2,0,Points-PointsKO-Adjacents,9
Macaranga_pleioneura,23,14,9,Points-PointsKO-Adjacents,154
Macaranga_pleiostemon,20,6,14,Points-PointsKO-Adjacents,155
Macaranga_pleytei,0,0,0,NA,0
Macaranga_polyadenia,125,79,46,Alphahull-PointsKO-Adjacents,3052
Macaranga_praestans,2,2,0,Points-PointsKO-Adjacents,16
Macaranga_pruinosa,8,0,8,Points-PointsKO-Adjacents,64
Macaranga_puberula,2,2,0,Points-PointsKO-Adjacents,18
Macaranga_punctata,20,0,20,Points-PointsKO-Adjacents,153
Macaranga_puncticulata,10,1,9,Points-PointsKO-Adjacents,87
Macaranga_quadriglandulosa,54,29,25,Alphahull-PointsKO-Adjacents,1193
Macaranga_racemohispida,NA,NA,NA,NA,NA
Macaranga_racemosa,NA,NA,NA,NA,NA
Macaranga_raivavaeensis,2,2,0,Points-PointsKO-Adjacents,3
Macaranga_rarispina,1,1,0,Points-PointsKO-Adjacents,9
Macaranga_recurvata,12,4,8,Points-PointsKO-Adjacents,64
Macaranga_reiteriana,15,6,9,Points-PointsKO-Adjacents,85
Macaranga_repandodentata,5,2,3,Points-PointsKO-Adjacents,45
Macaranga_rhizinoides,1,1,0,Points-PointsKO-Adjacents,9
Macaranga_ribesioides,0,0,0,NA,0
Macaranga_rorokae,1,1,0,Points-PointsKO-Adjacents,9
Macaranga_rostrata,3,3,0,Points-PointsKO-Adjacents,21
Macaranga_rufescens,NA,NA,NA,NA,NA
Macaranga_rufibarbis,5,5,0,Points-PointsKO-Adjacents,43
Macaranga_saccifera,26,0,26,Points-PointsKO-Adjacents,199
Macaranga_salicifolia,2,2,0,Points-PointsKO-Adjacents,16
Macaranga_salomonensis,1,1,0,Points-PointsKO-Adjacents,9
Macaranga_sampsonii,24,7,17,Points-PointsKO-Adjacents,210
Macaranga_sandsii,0,0,0,NA,0
Macaranga_schweinfurthii,77,40,37,Alphahull-PointsKO-Adjacents,1420
Macaranga_secunda,0,0,0,NA,0
Macaranga_seemannii,8,2,6,Points-PointsKO-Adjacents,39
Macaranga_serratifolia,0,0,0,NA,0
Macaranga_setosa,1,1,0,Points-PointsKO-Adjacents,9
Macaranga_siamensis,3,3,0,Points-PointsKO-Adjacents,27
Macaranga_similis,8,1,7,Points-PointsKO-Adjacents,65
Macaranga_sinensis,7,0,7,Points-PointsKO-Adjacents,19
Macaranga_spathicalyx,2,2,0,Points-PointsKO-Adjacents,18
Macaranga_sphaerophylla,35,17,18,Points-PointsKO-Adjacents,164
Macaranga_spinosa,128,77,51,Alphahull-PointsKO-Adjacents,5747
Macaranga_staudtii,9,0,9,Points-PointsKO-Adjacents,80
Macaranga_stellimontium,2,2,0,Points-PointsKO-Adjacents,14
Macaranga_sterrophylla,5,5,0,Points-PointsKO-Adjacents,38
Macaranga_stipulosa,20,13,7,Points-PointsKO-Adjacents,36
Macaranga_stonei,1,1,0,Points-PointsKO-Adjacents,9
Macaranga_strigosa,11,2,9,Points-PointsKO-Adjacents,80
Macaranga_strigosissima,1,1,0,Points-PointsKO-Adjacents,9
Macaranga_subdentata,114,97,17,Alphahull-PointsKO-Adjacents,255
Macaranga_subpeltata,4,4,0,Points-PointsKO-Adjacents,33
Macaranga_suleensis,3,3,0,Points-PointsKO-Adjacents,23
Macaranga_suwo,2,2,0,Points-PointsKO-Adjacents,18
Macaranga_taitensis,4,4,0,Points-PointsKO-Adjacents,25
Macaranga_tanarius,946,739,207,Alphahull-PointsKO-Adjacents,6288
Macaranga_tchibangensis,2,2,0,Points-PointsKO-Adjacents,18
Macaranga_tentaculata,1,1,0,Points-PointsKO-Adjacents,9
Macaranga_tessellata,4,4,0,Points-PointsKO-Adjacents,27
Macaranga_thomasii,0,0,0,NA,0
Macaranga_thompsonii,1,1,0,Points-PointsKO-Adjacents,2
Macaranga_thorelii,0,0,0,NA,0
Macaranga_trachyphylla,2,2,0,Points-PointsKO-Adjacents,18
Macaranga_trichanthera,10,2,8,Points-PointsKO-Adjacents,80
Macaranga_trichocarpa,31,0,31,Points-PointsKO-Adjacents,222
Macaranga_triloba,15,0,15,Points-PointsKO-Adjacents,134
Macaranga_truncata,1,1,0,Points-PointsKO-Adjacents,9
Macaranga_tsonane,5,5,0,Points-PointsKO-Adjacents,45
Macaranga_umbrosa,1,1,0,Points-PointsKO-Adjacents,9
Macaranga_uxoris,NA,NA,NA,NA,NA
Macaranga_vanderystii,0,0,0,NA,0
Macaranga_vedeliana,25,12,13,Points-PointsKO-Adjacents,129
Macaranga_velutiniflora,1,1,0,Points-PointsKO-Adjacents,9
Macaranga_venosa,5,5,0,Points-PointsKO-Adjacents,19
Macaranga_vermoesenii,6,1,5,Points-PointsKO-Adjacents,52
Macaranga_versteeghii,0,0,0,NA,0
Macaranga_vieillardii,35,21,14,Alphahull-PointsKO-Adjacents,105
Macaranga_villosula,1,1,0,Points-PointsKO-Adjacents,9
Macaranga_vitiensis,2,2,0,Points-PointsKO-Adjacents,9
Macaranga_warburgiana,2,2,0,Points-PointsKO-Adjacents,12
Macaranga_waturandangii,1,1,0,Points-PointsKO-Adjacents,9
Macaranga_winkleri,29,14,15,Points-PointsKO-Adjacents,234
Macaranga_yakasii,1,1,0,Points-PointsKO-Adjacents,9
Macarisia_humbertiana,13,9,4,Points-PointsKO-Adjacents,70
Macarisia_lanceolata,45,28,17,Alphahull-PointsKO-Adjacents,762
Macarisia_pyramidata,98,75,23,Alphahull-PointsKO-Adjacents,1429
Macbrideina_peruviana,78,45,33,Alphahull-PointsKO-Adjacents,966
Machaerium_acutifolium,1526,1408,118,Alphahull-PointsKO-Adjacents,50318
Machaerium_altiscandens,62,18,44,Points-PointsKO-Adjacents,479
Machaerium_amazonense,8,0,8,Points-PointsKO-Adjacents,72
Machaerium_arboreum,339,254,85,Alphahull-PointsKO-Adjacents,11051
Machaerium_aristulatum,253,163,90,Alphahull-PointsKO-Adjacents,39099
Machaerium_berteronianum,0,0,0,NA,0
Machaerium_biovulatum,550,425,125,Alphahull-PointsKO-Adjacents,17519
Machaerium_bondaense,4,4,0,Points-PointsKO-Adjacents,36
Machaerium_brasiliense,849,748,101,Alphahull-PointsKO-Adjacents,24454
Machaerium_cantarellianum,96,0,96,Points-PointsKO-Adjacents,559
Machaerium_capote,214,192,22,Alphahull-PointsKO-Adjacents,3311
Machaerium_caratinganum,9,2,7,Points-PointsKO-Adjacents,73
Machaerium_chambersii,NA,NA,NA,NA,NA
Machaerium_chiapense,76,47,29,Alphahull-PointsKO-Adjacents,1028
Machaerium_cirrhiferum,28,11,17,Points-PointsKO-Adjacents,162
Machaerium_conzattii,0,0,0,NA,0
Machaerium_cultratum,0,0,0,NA,0
Machaerium_cuzcoense,1,1,0,Points-PointsKO-Adjacents,9
Machaerium_darienense,11,5,6,Points-PointsKO-Adjacents,59
Machaerium_darlense,NA,NA,NA,NA,NA
Machaerium_dubium,8,2,6,Points-PointsKO-Adjacents,72
Machaerium_eriocarpum,67,44,23,Alphahull-PointsKO-Adjacents,2966
Machaerium_ferox,289,219,70,Alphahull-PointsKO-Adjacents,37942
Machaerium_firmum,19,14,5,Points-PointsKO-Adjacents,115
Machaerium_floribundum,451,330,121,Alphahull-PointsKO-Adjacents,35325
Machaerium_floridum,65,48,17,Alphahull-PointsKO-Adjacents,2186
Machaerium_fulvovenosum,90,69,21,Alphahull-PointsKO-Adjacents,3772
Machaerium_glabripes,0,0,0,NA,0
Machaerium_goudotii,27,16,11,Points-PointsKO-Adjacents,185
Machaerium_grandifolium,10,5,5,Points-PointsKO-Adjacents,81
Machaerium_guanaiense,8,2,6,Points-PointsKO-Adjacents,64
Machaerium_guaremalense,2,2,0,Points-PointsKO-Adjacents,18
Machaerium_hatschbachii,41,30,11,Alphahull-PointsKO-Adjacents,268
Machaerium_hirtum,1627,0,1627,Points-PointsKO-Adjacents,10029
Machaerium_humboldtianum,18,8,10,Points-PointsKO-Adjacents,150
Machaerium_incorruptibile,90,66,24,Alphahull-PointsKO-Adjacents,1954
Machaerium_inundatum,485,389,96,Alphahull-PointsKO-Adjacents,55372
Machaerium_isadelphum,709,512,197,Alphahull-PointsKO-Adjacents,45224
Machaerium_kegelii,205,115,90,Alphahull-PointsKO-Adjacents,6198
Machaerium_latialatum,22,9,13,Points-PointsKO-Adjacents,182
Machaerium_legale,20,9,11,Points-PointsKO-Adjacents,164
Machaerium_leiophyllum,181,74,107,Alphahull-PointsKO-Adjacents,18677
Machaerium_leucopterum,88,67,21,Alphahull-PointsKO-Adjacents,3463
Machaerium_lunatum,354,207,147,Alphahull-PointsKO-Adjacents,5347
Machaerium_macrophyllum,76,26,50,Alphahull-PointsKO-Adjacents,1195
Machaerium_madeirense,95,38,57,Alphahull-PointsKO-Adjacents,5068
Machaerium_microphyllum,257,162,95,Alphahull-PointsKO-Adjacents,17940
Machaerium_milleflorum,39,18,21,Points-PointsKO-Adjacents,167
Machaerium_millei,85,66,19,Alphahull-PointsKO-Adjacents,761
Machaerium_moritzianum,41,18,23,Points-PointsKO-Adjacents,311
Machaerium_mucronulatum,8,1,7,Points-PointsKO-Adjacents,72
Machaerium_multifoliolatum,57,15,42,Points-PointsKO-Adjacents,413
Machaerium_mutisii,27,7,20,Points-PointsKO-Adjacents,222
Machaerium_myrianthum,33,9,24,Points-PointsKO-Adjacents,292
Machaerium_nicaraguense,20,14,6,Points-PointsKO-Adjacents,109
Machaerium_nyctitans,865,747,118,Alphahull-PointsKO-Adjacents,16586
Machaerium_obovatum,8,0,8,Points-PointsKO-Adjacents,44
Machaerium_opacum,514,465,49,Alphahull-PointsKO-Adjacents,13209
Machaerium_orthocarpum,NA,NA,NA,NA,NA
Machaerium_ovalifolium,76,51,25,Alphahull-PointsKO-Adjacents,2230
Machaerium_paraense,29,0,29,Points-PointsKO-Adjacents,211
Machaerium_paraguariense,473,417,56,Alphahull-PointsKO-Adjacents,18308
Machaerium_pedicellatum,84,0,84,Points-PointsKO-Adjacents,565
Machaerium_penduliflorum,2,2,0,Points-PointsKO-Adjacents,18
Machaerium_punctatum,176,142,34,Alphahull-PointsKO-Adjacents,8514
Machaerium_robiniifolium,104,59,45,Alphahull-PointsKO-Adjacents,3591
Machaerium_salvadorense,160,101,59,Alphahull-PointsKO-Adjacents,5538
Machaerium_salzmannii,107,0,107,Points-PointsKO-Adjacents,652
Machaerium_scleroxylon,327,264,63,Alphahull-PointsKO-Adjacents,12984
Machaerium_seemannii,223,181,42,Alphahull-PointsKO-Adjacents,3361
Machaerium_spicatum,0,0,0,NA,0
Machaerium_stipitatum,1044,937,107,Alphahull-PointsKO-Adjacents,21074
Machaerium_striatum,12,3,9,Points-PointsKO-Adjacents,101
Machaerium_tortipes,19,4,15,Points-PointsKO-Adjacents,165
Machaerium_truxillense,0,0,0,NA,0
Machaerium_villosum,555,487,68,Alphahull-PointsKO-Adjacents,13849
Machaonia_acuminata,363,230,133,Alphahull-PointsKO-Adjacents,15968
Machaonia_brasiliensis,482,376,106,Alphahull-PointsKO-Adjacents,28515
Machaonia_erythrocarpa,95,58,37,Alphahull-PointsKO-Adjacents,1729
Machaonia_lindeniana,312,0,312,Points-PointsKO-Adjacents,999
Machaonia_martinicensis,41,0,41,Points-PointsKO-Adjacents,237
Machaonia_microphylla,5,5,0,Points-PointsKO-Adjacents,39
Machaonia_ottonis,28,8,20,Points-PointsKO-Adjacents,196
Machaonia_pauciflora,4,4,0,Points-PointsKO-Adjacents,35
Machaonia_portoricensis,13,10,3,Points-PointsKO-Adjacents,36
Machaonia_pubescens,0,0,0,NA,0
Machaonia_rysonii,NA,NA,NA,NA,NA
Machaonia_williamsii,3,3,0,Points-PointsKO-Adjacents,27
Machaonia_woodburyana,3,3,0,Points-PointsKO-Adjacents,12
Machilus_austroguizhouensis,1,1,0,Points-PointsKO-Adjacents,9
Machilus_balansae,0,0,0,NA,0
Machilus_bonii,12,2,10,Points-PointsKO-Adjacents,108
Machilus_boninensis,2,2,0,Points-PointsKO-Adjacents,6
Machilus_breviflora,37,19,18,Points-PointsKO-Adjacents,250
Machilus_calcicola,9,1,8,Points-PointsKO-Adjacents,81
Machilus_cavaleriei,1,1,0,Points-PointsKO-Adjacents,9
Machilus_chayuensis,NA,NA,NA,NA,NA
Machilus_chekiangensis,23,11,12,Points-PointsKO-Adjacents,207
Machilus_chienkweiensis,3,3,0,Points-PointsKO-Adjacents,27
Machilus_chinensis,37,21,16,Alphahull-PointsKO-Adjacents,1865
Machilus_chrysotricha,1,1,0,Points-PointsKO-Adjacents,9
Machilus_chuanchienensis,1,1,0,Points-PointsKO-Adjacents,9
Machilus_cicatricosa,4,4,0,Points-PointsKO-Adjacents,27
Machilus_daozhenensis,3,3,0,Points-PointsKO-Adjacents,27
Machilus_decursinervis,17,7,10,Points-PointsKO-Adjacents,153
Machilus_dinganensis,2,2,0,Points-PointsKO-Adjacents,18
Machilus_dumicola,4,4,0,Points-PointsKO-Adjacents,36
Machilus_duthiei,32,0,32,Points-PointsKO-Adjacents,253
Machilus_fasciculata,8,1,7,Points-PointsKO-Adjacents,72
Machilus_foonchewii,6,0,6,Points-PointsKO-Adjacents,54
Machilus_forrestii,16,7,9,Points-PointsKO-Adjacents,124
Machilus_fukienensis,1,1,0,Points-PointsKO-Adjacents,9
Machilus_glabrophylla,3,2,1,Points-PointsKO-Adjacents,27
Machilus_glaucescens,18,1,17,Points-PointsKO-Adjacents,156
Machilus_glaucifolia,2,2,0,Points-PointsKO-Adjacents,18
Machilus_gongshanensis,17,13,4,Points-PointsKO-Adjacents,69
Machilus_gracillima,4,4,0,Points-PointsKO-Adjacents,36
Machilus_grandibracteata,4,4,0,Points-PointsKO-Adjacents,32
Machilus_grijsii,41,21,20,Alphahull-PointsKO-Adjacents,1523
Machilus_ichangensis,71,41,30,Alphahull-PointsKO-Adjacents,4862
Machilus_japonica,685,96,589,Alphahull-PointsKO-Adjacents,1814
Machilus_kurzii,9,5,4,Points-PointsKO-Adjacents,59
Machilus_kwangtungensis,18,0,18,Points-PointsKO-Adjacents,160
Machilus_lenticellata,NA,NA,NA,NA,NA
Machilus_leptophylla,83,60,23,Alphahull-PointsKO-Adjacents,4569
Machilus_lichuanensis,4,4,0,Points-PointsKO-Adjacents,36
Machilus_litseifolia,15,6,9,Points-PointsKO-Adjacents,135
Machilus_lohuiensis,3,3,0,Points-PointsKO-Adjacents,26
Machilus_mangdangshanensis,NA,NA,NA,NA,NA
Machilus_melanophylla,8,3,5,Points-PointsKO-Adjacents,72
Machilus_miaoshanensis,1,1,0,Points-PointsKO-Adjacents,9
Machilus_microcarpa,17,5,12,Points-PointsKO-Adjacents,153
Machilus_microphylla,2,2,0,Points-PointsKO-Adjacents,18
Machilus_minkweiensis,4,4,0,Points-PointsKO-Adjacents,36
Machilus_minutiflora,4,4,0,Points-PointsKO-Adjacents,36
Machilus_minutiloba,NA,NA,NA,NA,NA
Machilus_monticola,3,2,1,Points-PointsKO-Adjacents,27
Machilus_multinervia,8,2,6,Points-PointsKO-Adjacents,72
Machilus_nakao,5,0,5,Points-PointsKO-Adjacents,45
Machilus_nanchuanensis,NA,NA,NA,NA,NA
Machilus_nanmu,20,5,15,Points-PointsKO-Adjacents,180
Machilus_obovatifolia,70,62,8,Alphahull-PointsKO-Adjacents,34
Machilus_obscurinervis,NA,NA,NA,NA,NA
Machilus_oculodracontis,4,3,1,Points-PointsKO-Adjacents,36
Machilus_oreophila,33,15,18,Points-PointsKO-Adjacents,297
Machilus_ovatiloba,NA,NA,NA,NA,NA
Machilus_pauhoi,32,19,13,Points-PointsKO-Adjacents,287
Machilus_phoenicis,18,5,13,Points-PointsKO-Adjacents,160
Machilus_platycarpa,6,2,4,Points-PointsKO-Adjacents,41
Machilus_pomifera,3,3,0,Points-PointsKO-Adjacents,27
Machilus_pyramidalis,1,1,0,Points-PointsKO-Adjacents,9
Machilus_rehderi,9,3,6,Points-PointsKO-Adjacents,81
Machilus_reticulata,1,1,0,Points-PointsKO-Adjacents,9
Machilus_rufipes,6,0,6,Points-PointsKO-Adjacents,48
Machilus_salicoides,NA,NA,NA,NA,NA
Machilus_shweliensis,5,5,0,Points-PointsKO-Adjacents,45
Machilus_sichourensis,2,2,0,Points-PointsKO-Adjacents,18
Machilus_sichuanensis,2,2,0,Points-PointsKO-Adjacents,18
Machilus_submultinervia,1,1,0,Points-PointsKO-Adjacents,9
Machilus_tenuipilis,10,1,9,Points-PointsKO-Adjacents,90
Machilus_thunbergii,829,621,208,Alphahull-PointsKO-Adjacents,7370
Machilus_velutina,101,69,32,Alphahull-PointsKO-Adjacents,6253
Machilus_verruculosa,4,4,0,Points-PointsKO-Adjacents,36
Machilus_versicolora,9,2,7,Points-PointsKO-Adjacents,81
Machilus_viridis,20,9,11,Points-PointsKO-Adjacents,152
Machilus_wangchiana,4,4,0,Points-PointsKO-Adjacents,36
Machilus_wenshanensis,5,5,0,Points-PointsKO-Adjacents,45
Machilus_yunnanensis,44,0,44,Points-PointsKO-Adjacents,367
Machilus_zuihoensis,399,340,59,Alphahull-PointsKO-Adjacents,412
Mackaya_bella,24,9,15,Points-PointsKO-Adjacents,204
Mackinlaya_celebica,102,66,36,Alphahull-PointsKO-Adjacents,1665
Macleania_cordifolia,30,17,13,Points-PointsKO-Adjacents,154
Macleania_loeseneriana,34,25,9,Alphahull-PointsKO-Adjacents,120
Macleania_rupestris,676,611,65,Alphahull-PointsKO-Adjacents,3896
Maclura_africana,60,23,37,Alphahull-PointsKO-Adjacents,992
Maclura_brasiliensis,6,0,6,Points-PointsKO-Adjacents,50
Maclura_cochinchinensis,1825,0,1825,Points-PointsKO-Adjacents,4287
Maclura_pomifera,3064,2586,478,Alphahull-PointsKO-Adjacents,37859
Maclura_tinctoria,2980,2617,363,Alphahull-PointsKO-Adjacents,123212
Maclura_tricuspidata,86,36,50,Alphahull-PointsKO-Adjacents,4038
Maclurodendron_oligophlebium,11,4,7,Points-PointsKO-Adjacents,79
Maclurodendron_porteri,12,4,8,Points-PointsKO-Adjacents,102
Macoubea_guianensis,381,275,106,Alphahull-PointsKO-Adjacents,35902
Macoubea_mesoamericana,16,6,10,Points-PointsKO-Adjacents,76
Macoubea_sprucei,209,119,90,Alphahull-PointsKO-Adjacents,6295
Macphersonia_chapelieri,10,3,7,Points-PointsKO-Adjacents,59
Macphersonia_gracilis,121,93,28,Alphahull-PointsKO-Adjacents,4217
Macphersonia_madagascariensis,34,22,12,Alphahull-PointsKO-Adjacents,520
Macphersonia_radlkoferi,23,11,12,Points-PointsKO-Adjacents,125
Macrocarpaea_auriculata,9,4,5,Points-PointsKO-Adjacents,28
Macrocarpaea_bangiana,15,11,4,Points-PointsKO-Adjacents,72
Macrocarpaea_cinchonifolia,33,21,12,Alphahull-PointsKO-Adjacents,165
Macrocarpaea_cochabambensis,18,8,10,Points-PointsKO-Adjacents,105
Macrocarpaea_ewaniana,2,2,0,Points-PointsKO-Adjacents,18
Macrocarpaea_fuentesii,7,0,7,Points-PointsKO-Adjacents,39
Macrocarpaea_gattaca,7,1,6,Points-PointsKO-Adjacents,30
Macrocarpaea_glaziovii,53,33,20,Alphahull-PointsKO-Adjacents,718
Macrocarpaea_harlingii,16,9,7,Points-PointsKO-Adjacents,100
Macrocarpaea_jalca,10,6,4,Points-PointsKO-Adjacents,56
Macrocarpaea_kayakifolia,2,2,0,Points-PointsKO-Adjacents,9
Macrocarpaea_kuelap,9,3,6,Points-PointsKO-Adjacents,70
Macrocarpaea_luya,2,2,0,Points-PointsKO-Adjacents,18
Macrocarpaea_macrophylla,207,172,35,Alphahull-PointsKO-Adjacents,2056
Macrocarpaea_maguirei,6,3,3,Points-PointsKO-Adjacents,52
Macrocarpaea_pachystyla,11,2,9,Points-PointsKO-Adjacents,95
Macrocarpaea_revoluta,22,10,12,Points-PointsKO-Adjacents,164
Macrocarpaea_robin-fosteri,16,12,4,Points-PointsKO-Adjacents,39
Macrocarpaea_rugosa,4,4,0,Points-PointsKO-Adjacents,36
Macrocarpaea_tabula-fluctivagifolia,1,1,0,Points-PointsKO-Adjacents,9
Macrocarpaea_thamnoides,4,3,1,Points-PointsKO-Adjacents,27
Macrocarpaea_viscosa,19,10,9,Points-PointsKO-Adjacents,123
Macrocarpaea_wallnoeferi,13,7,6,Points-PointsKO-Adjacents,74
Macrocarpaea_weaveri,7,0,7,Points-PointsKO-Adjacents,50
Macrocarpaea_weigendiorum,2,2,0,Points-PointsKO-Adjacents,18
Macrocarpaea_zophoflora,0,0,0,NA,0
Macrocnemum_grandiflorum,16,8,8,Points-PointsKO-Adjacents,120
Macrocnemum_humboldtianum,10,5,5,Points-PointsKO-Adjacents,72
Macrocnemum_jamaicense,0,0,0,NA,0
Macrocnemum_roseum,548,479,69,Alphahull-PointsKO-Adjacents,13756
Macrocnemum_stylocarpum,1,1,0,Points-PointsKO-Adjacents,9
Macrocnemum_tortuosum,1,1,0,Points-PointsKO-Adjacents,9
Macrohasseltia_macroterantha,84,58,26,Alphahull-PointsKO-Adjacents,927
Macrolobium_acaciifolium,1160,1100,60,Alphahull-PointsKO-Adjacents,73760
Macrolobium_acrothamnos,9,5,4,Points-PointsKO-Adjacents,77
Macrolobium_amplexans,8,2,6,Points-PointsKO-Adjacents,52
Macrolobium_angustifolium,584,511,73,Alphahull-PointsKO-Adjacents,44056
Macrolobium_anomalum,2,2,0,Points-PointsKO-Adjacents,16
Macrolobium_archeri,46,31,15,Alphahull-PointsKO-Adjacents,956
Macrolobium_arenarium,86,44,42,Alphahull-PointsKO-Adjacents,4732
Macrolobium_bifolium,489,418,71,Alphahull-PointsKO-Adjacents,33561
Macrolobium_brevense,20,4,16,Points-PointsKO-Adjacents,160
Macrolobium_campestre,103,58,45,Alphahull-PointsKO-Adjacents,7257
Macrolobium_canaliculatum,53,32,21,Alphahull-PointsKO-Adjacents,3364
Macrolobium_cataractarum,4,4,0,Points-PointsKO-Adjacents,23
Macrolobium_cidii,9,3,6,Points-PointsKO-Adjacents,77
Macrolobium_colombianum,126,89,37,Alphahull-PointsKO-Adjacents,3092
Macrolobium_conjunctum,2,2,0,Points-PointsKO-Adjacents,18
Macrolobium_costaricense,79,59,20,Alphahull-PointsKO-Adjacents,575
Macrolobium_cowanii,9,2,7,Points-PointsKO-Adjacents,66
Macrolobium_defloccatum,1,1,0,Points-PointsKO-Adjacents,9
Macrolobium_discolor,53,36,17,Alphahull-PointsKO-Adjacents,1828
Macrolobium_dressleri,26,16,10,Points-PointsKO-Adjacents,68
Macrolobium_duckeanum,7,1,6,Points-PointsKO-Adjacents,55
Macrolobium_evenulosum,3,3,0,Points-PointsKO-Adjacents,27
Macrolobium_exfoliatum,7,1,6,Points-PointsKO-Adjacents,63
Macrolobium_extensum,7,2,5,Points-PointsKO-Adjacents,44
Macrolobium_flexuosum,43,19,24,Points-PointsKO-Adjacents,352
Macrolobium_floridum,0,0,0,NA,0
Macrolobium_froesii,3,3,0,Points-PointsKO-Adjacents,27
Macrolobium_furcatum,8,1,7,Points-PointsKO-Adjacents,72
Macrolobium_gracile,287,226,61,Alphahull-PointsKO-Adjacents,21885
Macrolobium_guianense,6,2,4,Points-PointsKO-Adjacents,49
Macrolobium_hartshornii,24,13,11,Points-PointsKO-Adjacents,101
Macrolobium_herrerae,11,2,9,Points-PointsKO-Adjacents,67
Macrolobium_huberianum,70,25,45,Alphahull-PointsKO-Adjacents,3945
Macrolobium_inaequale,11,3,8,Points-PointsKO-Adjacents,84
Macrolobium_ischnocalyx,58,37,21,Alphahull-PointsKO-Adjacents,1734
Macrolobium_jenmanii,4,3,1,Points-PointsKO-Adjacents,34
Macrolobium_latifolium,170,0,170,Points-PointsKO-Adjacents,709
Macrolobium_limbatum,416,363,53,Alphahull-PointsKO-Adjacents,29265
Macrolobium_longeracemosum,23,13,10,Points-PointsKO-Adjacents,152
Macrolobium_longipedicellatum,11,3,8,Points-PointsKO-Adjacents,63
Macrolobium_longipes,17,7,10,Points-PointsKO-Adjacents,80
Macrolobium_machaerioides,6,0,6,Points-PointsKO-Adjacents,52
Macrolobium_microcalyx,137,84,53,Alphahull-PointsKO-Adjacents,8120
Macrolobium_modicopetalum,14,9,5,Points-PointsKO-Adjacents,59
Macrolobium_molle,25,0,25,Points-PointsKO-Adjacents,193
Macrolobium_montanum,15,3,12,Points-PointsKO-Adjacents,127
Macrolobium_multijugum,547,485,62,Alphahull-PointsKO-Adjacents,50973
Macrolobium_obtusum,1,1,0,Points-PointsKO-Adjacents,9
Macrolobium_palustre,5,5,0,Points-PointsKO-Adjacents,45
Macrolobium_pendulum,94,54,40,Alphahull-PointsKO-Adjacents,4659
Macrolobium_pittieri,27,9,18,Points-PointsKO-Adjacents,183
Macrolobium_prancei,9,2,7,Points-PointsKO-Adjacents,54
Macrolobium_punctatum,112,81,31,Alphahull-PointsKO-Adjacents,6556
Macrolobium_rigidum,62,32,30,Alphahull-PointsKO-Adjacents,272
Macrolobium_rubrum,44,22,22,Alphahull-PointsKO-Adjacents,803
Macrolobium_schinifolium,13,0,13,Points-PointsKO-Adjacents,62
Macrolobium_spectabile,6,0,6,Points-PointsKO-Adjacents,42
Macrolobium_stenocladum,8,2,6,Points-PointsKO-Adjacents,68
Macrolobium_stenopetalum,5,5,0,Points-PointsKO-Adjacents,27
Macrolobium_stenosiphon,23,13,10,Points-PointsKO-Adjacents,113
Macrolobium_steyermarkii,6,2,4,Points-PointsKO-Adjacents,54
Macrolobium_suaveolens,234,173,61,Alphahull-PointsKO-Adjacents,22207
Macrolobium_taxifolium,4,4,0,Points-PointsKO-Adjacents,34
Macrolobium_taylorii,4,4,0,Points-PointsKO-Adjacents,36
Macrolobium_trinitense,1,1,0,Points-PointsKO-Adjacents,9
Macrolobium_unifoliolatum,6,0,6,Points-PointsKO-Adjacents,54
Macrolobium_urupaense,7,1,6,Points-PointsKO-Adjacents,63
Macrolobium_venulosum,22,11,11,Points-PointsKO-Adjacents,148
Macrolobium_wurdackii,7,0,7,Points-PointsKO-Adjacents,54
Macropanax_chienii,1,1,0,Points-PointsKO-Adjacents,9
Macropanax_concinnus,0,0,0,NA,0
Macropanax_decandrus,2,2,0,Points-PointsKO-Adjacents,18
Macropanax_dispermus,36,17,19,Points-PointsKO-Adjacents,259
Macropanax_grushvitzkii,0,0,0,NA,0
Macropanax_maingayi,3,3,0,Points-PointsKO-Adjacents,25
Macropanax_meghalayensis,NA,NA,NA,NA,NA
Macropanax_membranifolius,0,0,0,NA,0
Macropanax_paucinervis,1,1,0,Points-PointsKO-Adjacents,9
Macropanax_rosthornii,44,19,25,Points-PointsKO-Adjacents,393
Macropanax_schmidii,NA,NA,NA,NA,NA
Macropanax_simplicifolius,0,0,0,NA,0
Macropanax_undulatus,23,0,23,Points-PointsKO-Adjacents,172
Macropeplus_dentatus,51,38,13,Alphahull-PointsKO-Adjacents,557
Macropeplus_friburgensis,10,1,9,Points-PointsKO-Adjacents,69
Macropeplus_ligustrinus,119,91,28,Alphahull-PointsKO-Adjacents,4235
Macropeplus_schwackeanus,42,30,12,Alphahull-PointsKO-Adjacents,424
Piper_timothianum,8,0,8,Points-PointsKO-Adjacents,45
Piper_vitiense,1,1,0,Points-PointsKO-Adjacents,6
Lumnitzera_montana,48,44,4,Alphahull-PointsKO-Adjacents,199
Macrosamanea_amplissima,63,40,23,Alphahull-PointsKO-Adjacents,2533
Macrosamanea_consanguinea,8,1,7,Points-PointsKO-Adjacents,66
Macrosamanea_discolor,121,94,27,Alphahull-PointsKO-Adjacents,4417
Macrosamanea_duckei,83,59,24,Alphahull-PointsKO-Adjacents,3112
Macrosamanea_froesii,10,1,9,Points-PointsKO-Adjacents,90
Macrosamanea_macrocalyx,6,0,6,Points-PointsKO-Adjacents,48
Macrosamanea_prancei,10,3,7,Points-PointsKO-Adjacents,86
Macrosamanea_pubiramea,362,279,83,Alphahull-PointsKO-Adjacents,34456
Macrosamanea_simabifolia,64,46,18,Alphahull-PointsKO-Adjacents,2022
Macrosamanea_spruceana,70,37,33,Alphahull-PointsKO-Adjacents,3150
Macrosphyra_brachystylis,9,2,7,Points-PointsKO-Adjacents,81
Macrostelia_laurina,24,14,10,Points-PointsKO-Adjacents,82
Macrothumia_kuhlmannii,83,60,23,Alphahull-PointsKO-Adjacents,1686
Macrotorus_utriculatus,76,51,25,Alphahull-PointsKO-Adjacents,598
Maddenia_himalaica,20,0,20,Points-PointsKO-Adjacents,159
Maddenia_hypoleuca,22,0,22,Points-PointsKO-Adjacents,183
Maddenia_wilsonii,15,3,12,Points-PointsKO-Adjacents,126
Madhuca_alpina,4,0,4,Points-PointsKO-Adjacents,18
Madhuca_aristulata,0,0,0,NA,0
Madhuca_aspera,0,0,0,NA,0
Madhuca_barbata,2,2,0,Points-PointsKO-Adjacents,18
Madhuca_bejaudii,2,2,0,Points-PointsKO-Adjacents,18
Madhuca_betis,5,5,0,Points-PointsKO-Adjacents,41
Madhuca_boerlageana,4,4,0,Points-PointsKO-Adjacents,32
Madhuca_borneensis,8,3,5,Points-PointsKO-Adjacents,56
Madhuca_bourdillonii,0,0,0,NA,0
Madhuca_brochidodroma,0,0,0,NA,0
Madhuca_burckiana,5,0,5,Points-PointsKO-Adjacents,43
Madhuca_butyrospermoides,4,3,1,Points-PointsKO-Adjacents,36
Madhuca_calcicola,0,0,0,NA,0
Madhuca_cheongiana,0,0,0,NA,0
Madhuca_chia-ananii,1,1,0,Points-PointsKO-Adjacents,9
Madhuca_chiangmaiensis,0,0,0,NA,0
Madhuca_clavata,NA,NA,NA,NA,NA
Madhuca_cochinchinensis,7,2,5,Points-PointsKO-Adjacents,55
Madhuca_coriacea,0,0,0,NA,0
Madhuca_costulata,0,0,0,NA,0
Madhuca_crassipes,4,1,3,Points-PointsKO-Adjacents,36
Madhuca_cuneata,1,1,0,Points-PointsKO-Adjacents,9
Madhuca_cuprea,0,0,0,NA,0
Madhuca_curtisii,6,0,6,Points-PointsKO-Adjacents,48
Madhuca_daemonica,1,1,0,Points-PointsKO-Adjacents,9
Madhuca_decipiens,1,1,0,Points-PointsKO-Adjacents,7
Madhuca_diplostemon,0,0,0,NA,0
Madhuca_dongnaiensis,1,1,0,Points-PointsKO-Adjacents,9
Madhuca_dubardii,2,1,1,Points-PointsKO-Adjacents,18
Madhuca_elliptica,13,7,6,Points-PointsKO-Adjacents,108
Madhuca_elmeri,7,0,7,Points-PointsKO-Adjacents,43
Madhuca_endertii,2,2,0,Points-PointsKO-Adjacents,18
Madhuca_engkikiana,NA,NA,NA,NA,NA
Madhuca_engleri,0,0,0,NA,0
Madhuca_erythrophylla,0,0,0,NA,0
Madhuca_esculenta,0,0,0,NA,0
Madhuca_firma,2,1,1,Points-PointsKO-Adjacents,18
Madhuca_floribunda,3,2,1,Points-PointsKO-Adjacents,27
Madhuca_fulva,2,2,0,Points-PointsKO-Adjacents,14
Madhuca_fusca,1,0,1,Points-PointsKO-Adjacents,9
Madhuca_glabrescens,2,2,0,Points-PointsKO-Adjacents,18
Madhuca_hainanensis,5,5,0,Points-PointsKO-Adjacents,36
Madhuca_heynei,NA,NA,NA,NA,NA
Madhuca_hirtiflora,1,1,0,Points-PointsKO-Adjacents,9
Madhuca_insignis,2,0,2,Points-PointsKO-Adjacents,18
Madhuca_kingiana,10,5,5,Points-PointsKO-Adjacents,55
Madhuca_klackenbergii,0,0,0,NA,0
Madhuca_kompongsonensis,3,3,0,Points-PointsKO-Adjacents,23
Madhuca_korthalsii,8,1,7,Points-PointsKO-Adjacents,70
Madhuca_krabiensis,0,0,0,NA,0
Madhuca_kuchingensis,1,1,0,Points-PointsKO-Adjacents,9
Madhuca_kunstleri,5,4,1,Points-PointsKO-Adjacents,28
Madhuca_lanceolata,0,0,0,NA,0
Madhuca_lancifolia,1,1,0,Points-PointsKO-Adjacents,9
Madhuca_lanuginosa,0,0,0,NA,0
Madhuca_laurifolia,0,0,0,NA,0
Madhuca_lecomtei,0,0,0,NA,0
Madhuca_leucodermis,9,3,6,Points-PointsKO-Adjacents,60
Madhuca_ligulata,0,0,0,NA,0
Madhuca_lobbii,0,0,0,NA,0
Madhuca_longifolia,24,1,23,Points-PointsKO-Adjacents,176
Madhuca_longistyla,NA,NA,NA,NA,NA
Madhuca_macrophylla,3,0,3,Points-PointsKO-Adjacents,27
Madhuca_magnifolia,1,1,0,Points-PointsKO-Adjacents,9
Madhuca_malaccensis,10,3,7,Points-PointsKO-Adjacents,75
Madhuca_markleeana,NA,NA,NA,NA,NA
Madhuca_microphylla,1,0,1,Points-PointsKO-Adjacents,7
Madhuca_mindanaensis,9,0,9,Points-PointsKO-Adjacents,63
Madhuca_mirandae,0,0,0,NA,0
Madhuca_montana,1,1,0,Points-PointsKO-Adjacents,9
Madhuca_monticola,0,0,0,NA,0
Madhuca_moonii,1,1,0,Points-PointsKO-Adjacents,9
Madhuca_motleyana,19,4,15,Points-PointsKO-Adjacents,143
Madhuca_multiflora,1,1,0,Points-PointsKO-Adjacents,9
Madhuca_multinervia,0,0,0,NA,0
Madhuca_neriifolia,3,3,0,Points-PointsKO-Adjacents,23
Madhuca_oblongifolia,0,0,0,NA,0
Madhuca_obovatifolia,1,1,0,Points-PointsKO-Adjacents,9
Madhuca_obtusifolia,NA,NA,NA,NA,NA
Madhuca_ochracea,NA,NA,NA,NA,NA
Madhuca_orientalis,6,0,6,Points-PointsKO-Adjacents,48
Madhuca_ovata,4,4,0,Points-PointsKO-Adjacents,36
Madhuca_palembanica,3,3,0,Points-PointsKO-Adjacents,27
Madhuca_pallida,6,1,5,Points-PointsKO-Adjacents,53
Madhuca_pasquieri,28,10,18,Points-PointsKO-Adjacents,228
Madhuca_penangiana,1,1,0,Points-PointsKO-Adjacents,9
Madhuca_penicillata,0,0,0,NA,0
Madhuca_pierrei,3,1,2,Points-PointsKO-Adjacents,27
Madhuca_platyphylla,0,0,0,NA,0
Madhuca_primoplagensis,NA,NA,NA,NA,NA
Madhuca_prolixa,0,0,0,NA,0
Madhuca_pubicalyx,3,3,0,Points-PointsKO-Adjacents,25
Madhuca_punctata,0,0,0,NA,0
Madhuca_ridleyi,2,2,0,Points-PointsKO-Adjacents,16
Madhuca_rufa,NA,NA,NA,NA,NA
Madhuca_sandakanensis,1,1,0,Points-PointsKO-Adjacents,9
Madhuca_sarawakensis,2,2,0,Points-PointsKO-Adjacents,18
Madhuca_sepilokensis,3,3,0,Points-PointsKO-Adjacents,9
Madhuca_sericea,8,1,7,Points-PointsKO-Adjacents,66
Madhuca_sessiliflora,0,0,0,NA,0
Madhuca_sessilis,0,0,0,NA,0
Madhuca_silamensis,NA,NA,NA,NA,NA
Madhuca_smitinandii,0,0,0,NA,0
Madhuca_spectabilis,2,2,0,Points-PointsKO-Adjacents,18
Madhuca_stipulacea,0,0,0,NA,0
Madhuca_stylosa,0,0,0,NA,0
Madhuca_takensis,0,0,0,NA,0
Madhuca_thorelii,5,5,0,Points-PointsKO-Adjacents,43
Madhuca_tomentosa,2,2,0,Points-PointsKO-Adjacents,12
Madhuca_tubulosa,1,1,0,Points-PointsKO-Adjacents,9
Madhuca_utilis,0,0,0,NA,0
Madhuca_vulcanica,0,0,0,NA,0
Madhuca_vulpina,0,0,0,NA,0
Madhuca_woodii,1,1,0,Points-PointsKO-Adjacents,9
Madlabium_magenteum,18,10,8,Points-PointsKO-Adjacents,100
Maerua_acuminata,4,4,0,Points-PointsKO-Adjacents,36
Maerua_angolensis,341,210,131,Alphahull-PointsKO-Adjacents,14058
Maerua_bussei,4,4,0,Points-PointsKO-Adjacents,36
Maerua_cafra,120,79,41,Alphahull-PointsKO-Adjacents,3824
Maerua_crassifolia,75,31,44,Alphahull-PointsKO-Adjacents,829
Maerua_duchesnei,68,35,33,Alphahull-PointsKO-Adjacents,555
Maerua_filiformis,35,26,9,Alphahull-PointsKO-Adjacents,525
Maerua_gilgii,18,10,8,Points-PointsKO-Adjacents,160
Maerua_juncea,121,77,44,Alphahull-PointsKO-Adjacents,7415
Maerua_kirkii,21,5,16,Points-PointsKO-Adjacents,168
Maerua_nervosa,55,17,38,Points-PointsKO-Adjacents,407
Maerua_parvifolia,94,61,33,Alphahull-PointsKO-Adjacents,1805
Maerua_prittwitzii,9,0,9,Points-PointsKO-Adjacents,64
Maerua_pubescens,0,0,0,NA,0
Maerua_racemulosa,56,27,29,Alphahull-PointsKO-Adjacents,1001
Maerua_rosmarinoides,67,50,17,Alphahull-PointsKO-Adjacents,1023
Maerua_schinzii,69,47,22,Alphahull-PointsKO-Adjacents,2612
Maerua_sessiliflora,2,2,0,Points-PointsKO-Adjacents,18
Maerua_triphylla,116,75,41,Alphahull-PointsKO-Adjacents,3055
Maesa_argentea,18,0,18,Points-PointsKO-Adjacents,161
Maesa_carolinensis,17,9,8,Points-PointsKO-Adjacents,16
Maesa_indica,41,22,19,Alphahull-PointsKO-Adjacents,2056
Maesa_lanceolata,575,424,151,Alphahull-PointsKO-Adjacents,16758
Maesa_montana,206,151,55,Alphahull-PointsKO-Adjacents,6145
Maesa_nemoralis,10,5,5,Points-PointsKO-Adjacents,56
Maesa_permollis,12,2,10,Points-PointsKO-Adjacents,107
Maesa_ramentacea,126,53,73,Alphahull-PointsKO-Adjacents,4426
Maesa_reticulata,1,1,0,Points-PointsKO-Adjacents,9
Maesa_tetrandra,22,4,18,Points-PointsKO-Adjacents,154
Maesa_welwitschii,14,0,14,Points-PointsKO-Adjacents,113
Maesobotrya_barteri,291,242,49,Alphahull-PointsKO-Adjacents,6371
Maesobotrya_bertramiana,59,37,22,Alphahull-PointsKO-Adjacents,2436
Maesobotrya_cordulata,30,19,11,Points-PointsKO-Adjacents,170
Maesobotrya_fallax,2,2,0,Points-PointsKO-Adjacents,18
Maesobotrya_floribunda,62,30,32,Alphahull-PointsKO-Adjacents,5361
Maesobotrya_griffoniana,75,60,15,Alphahull-PointsKO-Adjacents,1718
Maesobotrya_klaineana,154,129,25,Alphahull-PointsKO-Adjacents,3493
Maesobotrya_longipes,40,12,28,Points-PointsKO-Adjacents,273
Maesobotrya_pierlotii,1,1,0,Points-PointsKO-Adjacents,9
Maesobotrya_purseglovei,26,17,9,Points-PointsKO-Adjacents,172
Maesobotrya_pynaertii,16,4,12,Points-PointsKO-Adjacents,104
Maesobotrya_staudtii,56,42,14,Alphahull-PointsKO-Adjacents,1947
Maesobotrya_vermeulenii,9,0,9,Points-PointsKO-Adjacents,57
Maesobotrya_villosa,14,1,13,Points-PointsKO-Adjacents,98
Maesopsis_eminii,209,146,63,Alphahull-PointsKO-Adjacents,6808
Magnistipula_bimarsupiata,30,22,8,Alphahull-PointsKO-Adjacents,244
Magnistipula_butayei,119,59,60,Alphahull-PointsKO-Adjacents,8115
Magnistipula_cerebriformis,7,1,6,Points-PointsKO-Adjacents,53
Magnistipula_conrauana,12,10,2,Points-PointsKO-Adjacents,70
Magnistipula_cuneatifolia,3,3,0,Points-PointsKO-Adjacents,27
Magnistipula_cupheiflora,14,1,13,Points-PointsKO-Adjacents,95
Magnistipula_devriesii,2,2,0,Points-PointsKO-Adjacents,12
Magnistipula_glaberrima,18,9,9,Points-PointsKO-Adjacents,95
Magnistipula_multinervia,1,1,0,Points-PointsKO-Adjacents,9
Magnistipula_tamenaka,59,38,21,Alphahull-PointsKO-Adjacents,374
Magnistipula_tessmannii,41,25,16,Alphahull-PointsKO-Adjacents,904
Magnistipula_zenkeri,28,9,19,Points-PointsKO-Adjacents,211
Magnolia_acuminata,179,137,42,Alphahull-PointsKO-Adjacents,9768
Magnolia_albosericea,16,2,14,Points-PointsKO-Adjacents,144
Magnolia_allenii,3,3,0,Points-PointsKO-Adjacents,23
Magnolia_amazonica,21,3,18,Points-PointsKO-Adjacents,158
Magnolia_amoena,2,2,0,Points-PointsKO-Adjacents,18
Magnolia_angatensis,12,2,10,Points-PointsKO-Adjacents,82
Magnolia_angustioblonga,2,2,0,Points-PointsKO-Adjacents,18
Magnolia_annamensis,0,0,0,NA,0
Magnolia_arcabucoana,2,2,0,Points-PointsKO-Adjacents,18
Magnolia_argyrothricha,9,5,4,Points-PointsKO-Adjacents,27
Magnolia_aromatica,7,1,6,Points-PointsKO-Adjacents,63
Magnolia_ashtonii,1,1,0,Points-PointsKO-Adjacents,9
Magnolia_atlantida,0,0,0,NA,0
Magnolia_baillonii,17,4,13,Points-PointsKO-Adjacents,153
Magnolia_balansae,17,5,12,Points-PointsKO-Adjacents,142
Magnolia_banghamii,0,0,0,NA,0
Magnolia_bankardiorum,9,3,6,Points-PointsKO-Adjacents,58
Magnolia_betongensis,17,2,15,Points-PointsKO-Adjacents,141
Magnolia_bintuluensis,3,3,0,Points-PointsKO-Adjacents,27
Magnolia_biondii,5,4,1,Points-PointsKO-Adjacents,45
Magnolia_blaoensis,0,0,0,NA,0
Magnolia_boliviana,12,5,7,Points-PointsKO-Adjacents,77
Magnolia_borneensis,4,4,0,Points-PointsKO-Adjacents,36
Magnolia_braianensis,0,0,0,NA,0
Magnolia_calimaensis,1,1,0,Points-PointsKO-Adjacents,9
Magnolia_calophylla,3,3,0,Points-PointsKO-Adjacents,21
Magnolia_calophylloides,2,2,0,Points-PointsKO-Adjacents,18
Magnolia_campbellii,22,12,10,Points-PointsKO-Adjacents,157
Magnolia_cararensis,1,1,0,Points-PointsKO-Adjacents,9
Magnolia_caricifragrans,16,13,3,Points-PointsKO-Adjacents,83
Magnolia_carsonii,12,0,12,Points-PointsKO-Adjacents,63
Magnolia_cathcartii,18,4,14,Points-PointsKO-Adjacents,154
Magnolia_cavaleriei,18,8,10,Points-PointsKO-Adjacents,162
Magnolia_caveana,1,1,0,Points-PointsKO-Adjacents,9
Magnolia_cespedesii,1,1,0,Points-PointsKO-Adjacents,9
Magnolia_champaca,35,1,34,Points-PointsKO-Adjacents,297
Magnolia_championii,12,0,12,Points-PointsKO-Adjacents,93
Magnolia_changhungtana,1,1,0,Points-PointsKO-Adjacents,9
Magnolia_chapensis,18,3,15,Points-PointsKO-Adjacents,144
Magnolia_chevalieri,2,2,0,Points-PointsKO-Adjacents,18
Magnolia_chimantensis,6,0,6,Points-PointsKO-Adjacents,30
Magnolia_chiriquiensis,1,1,0,Points-PointsKO-Adjacents,9
Magnolia_chocoensis,3,3,0,Points-PointsKO-Adjacents,23
Magnolia_citrata,NA,NA,NA,NA,NA
Magnolia_clemensiorum,1,1,0,Points-PointsKO-Adjacents,9
Magnolia_cochranii,3,3,0,Points-PointsKO-Adjacents,27
Magnolia_coco,12,1,11,Points-PointsKO-Adjacents,108
Magnolia_colombiana,6,3,3,Points-PointsKO-Adjacents,20
Magnolia_compressa,489,421,68,Alphahull-PointsKO-Adjacents,818
Magnolia_conifera,49,30,19,Alphahull-PointsKO-Adjacents,2421
Magnolia_coriacea,4,4,0,Points-PointsKO-Adjacents,36
Magnolia_coronata,2,2,0,Points-PointsKO-Adjacents,18
Magnolia_costaricensis,7,2,5,Points-PointsKO-Adjacents,56
Magnolia_crassipes,1,1,0,Points-PointsKO-Adjacents,9
Magnolia_cristalensis,0,0,0,NA,0
Magnolia_cubensis,6,2,4,Points-PointsKO-Adjacents,36
Magnolia_cylindrica,7,0,7,Points-PointsKO-Adjacents,63
Magnolia_dandyi,4,1,3,Points-PointsKO-Adjacents,36
Magnolia_dawsoniana,3,3,0,Points-PointsKO-Adjacents,27
Magnolia_dealbata,40,24,16,Alphahull-PointsKO-Adjacents,224
Magnolia_decastroi,0,0,0,NA,0
Magnolia_decidua,NA,NA,NA,NA,NA
Magnolia_denudata,52,25,27,Alphahull-PointsKO-Adjacents,2436
Magnolia_dixonii,0,0,0,NA,0
Magnolia_dodecapetala,2,1,1,Points-PointsKO-Adjacents,18
Magnolia_doltsopa,40,28,12,Alphahull-PointsKO-Adjacents,326
Magnolia_domingensis,1,1,0,Points-PointsKO-Adjacents,9
Magnolia_duclouxii,6,0,6,Points-PointsKO-Adjacents,54
Magnolia_duperreana,2,2,0,Points-PointsKO-Adjacents,18
Magnolia_ekmanii,1,1,0,Points-PointsKO-Adjacents,8
Magnolia_elegans,1,0,1,Points-PointsKO-Adjacents,9
Magnolia_elfina,1,1,0,Points-PointsKO-Adjacents,9
Magnolia_elliptigemmata,NA,NA,NA,NA,NA
Magnolia_emarginata,1,1,0,Points-PointsKO-Adjacents,7
Magnolia_equatorialis,9,5,4,Points-PointsKO-Adjacents,53
Magnolia_ernestii,6,0,6,Points-PointsKO-Adjacents,53
Magnolia_espinalii,9,3,6,Points-PointsKO-Adjacents,42
Magnolia_faustinomirandae,1,1,0,Points-PointsKO-Adjacents,9
Magnolia_figlarii,3,3,0,Points-PointsKO-Adjacents,27
Magnolia_figo,82,62,20,Alphahull-PointsKO-Adjacents,4349
Magnolia_fistulosa,19,6,13,Points-PointsKO-Adjacents,167
Magnolia_flaviflora,3,3,0,Points-PointsKO-Adjacents,27
Magnolia_floribunda,41,22,19,Alphahull-PointsKO-Adjacents,2183
Magnolia_fordiana,59,31,28,Alphahull-PointsKO-Adjacents,4232
Magnolia_foveolata,45,21,24,Alphahull-PointsKO-Adjacents,2103
Magnolia_fraseri,99,86,13,Alphahull-PointsKO-Adjacents,3282
Magnolia_fujianensis,2,2,0,Points-PointsKO-Adjacents,18
Magnolia_fulva,3,3,0,Points-PointsKO-Adjacents,27
Magnolia_garrettii,3,3,0,Points-PointsKO-Adjacents,17
Magnolia_gentryi,3,3,0,Points-PointsKO-Adjacents,24
Magnolia_georgii,6,3,3,Points-PointsKO-Adjacents,15
Magnolia_gigantifolia,2,0,2,Points-PointsKO-Adjacents,18
Magnolia_gilbertoi,7,4,3,Points-PointsKO-Adjacents,36
Magnolia_globosa,14,6,8,Points-PointsKO-Adjacents,91
Magnolia_gloriensis,95,67,28,Alphahull-PointsKO-Adjacents,521
Magnolia_grandiflora,258,149,109,Alphahull-PointsKO-Adjacents,14512
Magnolia_grandis,2,2,0,Points-PointsKO-Adjacents,18
Magnolia_griffithii,1,1,0,Points-PointsKO-Adjacents,9
Magnolia_guanacastensis,2,2,0,Points-PointsKO-Adjacents,17
Magnolia_guangdongensis,NA,NA,NA,NA,NA
Magnolia_guangxiensis,NA,NA,NA,NA,NA
Magnolia_guatapensis,4,1,3,Points-PointsKO-Adjacents,24
Magnolia_guatemalensis,12,7,5,Points-PointsKO-Adjacents,66
Magnolia_guerrerensis,4,4,0,Points-PointsKO-Adjacents,25
Magnolia_gustavii,2,1,1,Points-PointsKO-Adjacents,18
Magnolia_hamorii,8,3,5,Points-PointsKO-Adjacents,21
Magnolia_henaoi,5,1,4,Points-PointsKO-Adjacents,30
Magnolia_henryi,15,5,10,Points-PointsKO-Adjacents,135
Magnolia_hernandezii,20,10,10,Points-PointsKO-Adjacents,127
Magnolia_hodgsonii,6,0,6,Points-PointsKO-Adjacents,54
Magnolia_hongheensis,NA,NA,NA,NA,NA
Magnolia_hookeri,13,4,9,Points-PointsKO-Adjacents,103
Magnolia_hypolampra,4,0,4,Points-PointsKO-Adjacents,36
Magnolia_iltisiana,38,27,11,Alphahull-PointsKO-Adjacents,82
Magnolia_inbioana,4,4,0,Points-PointsKO-Adjacents,32
Magnolia_insignis,85,58,27,Alphahull-PointsKO-Adjacents,1970
Magnolia_irwiniana,1,1,0,Points-PointsKO-Adjacents,9
Magnolia_iteophylla,NA,NA,NA,NA,NA
Magnolia_jaliscana,0,0,0,NA,0
Magnolia_jardinensis,4,4,0,Points-PointsKO-Adjacents,21
Magnolia_kachirachirai,51,42,9,Alphahull-PointsKO-Adjacents,60
Magnolia_katiorum,8,5,3,Points-PointsKO-Adjacents,24
Magnolia_kingii,0,0,0,NA,0
Magnolia_kisopa,5,5,0,Points-PointsKO-Adjacents,36
Magnolia_kobus,175,92,83,Alphahull-PointsKO-Adjacents,1774
Magnolia_koordersiana,4,1,3,Points-PointsKO-Adjacents,27
Magnolia_krusei,2,2,0,Points-PointsKO-Adjacents,18
Magnolia_kwangsiensis,2,2,0,Points-PointsKO-Adjacents,18
Magnolia_kwangtungensis,9,4,5,Points-PointsKO-Adjacents,81
Magnolia_lacandonica,5,5,0,Points-PointsKO-Adjacents,45
Magnolia_lacei,1,1,0,Points-PointsKO-Adjacents,9
Magnolia_laevifolia,29,19,10,Points-PointsKO-Adjacents,254
Magnolia_lanuginosa,2,2,0,Points-PointsKO-Adjacents,18
Magnolia_lanuginosoides,NA,NA,NA,NA,NA
Magnolia_lasia,12,3,9,Points-PointsKO-Adjacents,82
Magnolia_lenticellata,5,4,1,Points-PointsKO-Adjacents,12
Magnolia_leveilleana,3,3,0,Points-PointsKO-Adjacents,27
Magnolia_liliifera,116,47,69,Alphahull-PointsKO-Adjacents,2560
Magnolia_liliiflora,34,3,31,Points-PointsKO-Adjacents,305
Magnolia_longipedunculata,NA,NA,NA,NA,NA
Magnolia_lopezobradorii,2,2,0,Points-PointsKO-Adjacents,13
Magnolia_lotungensis,6,1,5,Points-PointsKO-Adjacents,54
Magnolia_lozanoi,2,2,0,Points-PointsKO-Adjacents,18
Magnolia_lucida,NA,NA,NA,NA,NA
Magnolia_macclurei,22,11,11,Points-PointsKO-Adjacents,198
Magnolia_macklottii,16,2,14,Points-PointsKO-Adjacents,95
Magnolia_macrocarpa,69,49,20,Alphahull-PointsKO-Adjacents,1407
Magnolia_macrophylla,86,53,33,Alphahull-PointsKO-Adjacents,3661
Magnolia_madidiensis,9,6,3,Points-PointsKO-Adjacents,39
Magnolia_mahechae,3,3,0,Points-PointsKO-Adjacents,23
Magnolia_mannii,0,0,0,NA,0
Magnolia_mariusjacobsia,3,3,0,Points-PointsKO-Adjacents,27
Magnolia_martini,7,0,7,Points-PointsKO-Adjacents,63
Magnolia_masticata,1,1,0,Points-PointsKO-Adjacents,9
Magnolia_maudiae,56,41,15,Alphahull-PointsKO-Adjacents,3020
Magnolia_mayae,2,2,0,Points-PointsKO-Adjacents,12
Magnolia_mediocris,9,2,7,Points-PointsKO-Adjacents,81
Magnolia_mexicana,154,125,29,Alphahull-PointsKO-Adjacents,1762
Magnolia_minor,9,0,9,Points-PointsKO-Adjacents,69
Magnolia_montana,7,0,7,Points-PointsKO-Adjacents,48
Magnolia_morii,6,1,5,Points-PointsKO-Adjacents,41
Magnolia_multinervia,1,1,0,Points-PointsKO-Adjacents,9
Magnolia_nana,0,0,0,NA,0
Magnolia_narinensis,2,2,0,Points-PointsKO-Adjacents,9
Magnolia_neillii,3,0,3,Points-PointsKO-Adjacents,25
Magnolia_nilagirica,6,0,6,Points-PointsKO-Adjacents,43
Magnolia_nitida,20,6,14,Points-PointsKO-Adjacents,144
Magnolia_oaxacensis,1,1,0,Points-PointsKO-Adjacents,9
Magnolia_oblonga,1,1,0,Points-PointsKO-Adjacents,9
Magnolia_obovalifolia,2,2,0,Points-PointsKO-Adjacents,18
Magnolia_obovata,182,117,65,Alphahull-PointsKO-Adjacents,1227
Magnolia_odora,22,8,14,Points-PointsKO-Adjacents,198
Magnolia_odoratissima,0,0,0,NA,0
Magnolia_ofeliae,0,0,0,NA,0
Magnolia_officinalis,26,8,18,Points-PointsKO-Adjacents,233
Magnolia_omeiensis,4,4,0,Points-PointsKO-Adjacents,30
Magnolia_opipara,1,1,0,Points-PointsKO-Adjacents,9
Magnolia_ovata,240,198,42,Alphahull-PointsKO-Adjacents,10792
Magnolia_ovoidea,0,0,0,NA,0
Magnolia_pacifica,45,26,19,Alphahull-PointsKO-Adjacents,377
Magnolia_pahangensis,2,2,0,Points-PointsKO-Adjacents,12
Magnolia_pallescens,17,12,5,Points-PointsKO-Adjacents,58
Magnolia_panamensis,3,3,0,Points-PointsKO-Adjacents,18
Magnolia_paranaensis,69,30,39,Alphahull-PointsKO-Adjacents,2250
Magnolia_patungensis,4,4,0,Points-PointsKO-Adjacents,30
Magnolia_pealiana,1,0,1,Points-PointsKO-Adjacents,9
Magnolia_pedrazae,0,0,0,NA,0
Magnolia_persuaveolens,5,5,0,Points-PointsKO-Adjacents,15
Magnolia_peruviana,1,1,0,Points-PointsKO-Adjacents,9
Magnolia_philippinensis,2,2,0,Points-PointsKO-Adjacents,18
Magnolia_platyphylla,0,0,0,NA,0
Magnolia_pleiocarpa,1,1,0,Points-PointsKO-Adjacents,9
Magnolia_poasana,59,49,10,Alphahull-PointsKO-Adjacents,158
Magnolia_polyhypsophylla,6,1,5,Points-PointsKO-Adjacents,18
Magnolia_portoricensis,27,21,6,Alphahull-PointsKO-Adjacents,48
Magnolia_praecalva,1,1,0,Points-PointsKO-Adjacents,9
Magnolia_ptaritepuiana,3,3,0,Points-PointsKO-Adjacents,27
Magnolia_pterocarpa,1,1,0,Points-PointsKO-Adjacents,9
Magnolia_pubescens,2,2,0,Points-PointsKO-Adjacents,18
Magnolia_pugana,7,3,4,Points-PointsKO-Adjacents,24
Magnolia_punduana,3,3,0,Points-PointsKO-Adjacents,27
Magnolia_quetzal,2,2,0,Points-PointsKO-Adjacents,9
Magnolia_rabaniana,2,1,1,Points-PointsKO-Adjacents,18
Magnolia_rajaniana,0,0,0,NA,0
Magnolia_rimachii,10,3,7,Points-PointsKO-Adjacents,88
Magnolia_rostrata,14,8,6,Points-PointsKO-Adjacents,81
Magnolia_rufibarbata,5,5,0,Points-PointsKO-Adjacents,45
Magnolia_sabahensis,1,1,0,Points-PointsKO-Adjacents,9
Magnolia_salicifolia,316,253,63,Alphahull-PointsKO-Adjacents,2246
Magnolia_sambuensis,19,10,9,Points-PointsKO-Adjacents,135
Magnolia_santanderiana,3,3,0,Points-PointsKO-Adjacents,9
Magnolia_sapaensis,2,2,0,Points-PointsKO-Adjacents,9
Magnolia_sarawakensis,1,1,0,Points-PointsKO-Adjacents,9
Magnolia_sargentiana,6,0,6,Points-PointsKO-Adjacents,54
Magnolia_savegrensis,1,1,0,Points-PointsKO-Adjacents,9
Magnolia_schiedeana,200,156,44,Alphahull-PointsKO-Adjacents,4657
Magnolia_scortechinii,1,1,0,Points-PointsKO-Adjacents,9
Magnolia_sellowiana,1,1,0,Points-PointsKO-Adjacents,9
Magnolia_sharpii,45,40,5,Alphahull-PointsKO-Adjacents,63
Magnolia_shiluensis,0,0,0,NA,0
Magnolia_siamensis,5,5,0,Points-PointsKO-Adjacents,45
Magnolia_sieboldii,44,16,28,Points-PointsKO-Adjacents,348
Magnolia_silvioi,7,5,2,Points-PointsKO-Adjacents,42
Magnolia_sinacacolinii,1,1,0,Points-PointsKO-Adjacents,9
Magnolia_singapurensis,7,0,7,Points-PointsKO-Adjacents,57
Magnolia_sinica,1,1,0,Points-PointsKO-Adjacents,9
Magnolia_sirindhorniae,1,1,0,Points-PointsKO-Adjacents,9
Magnolia_sororum,48,38,10,Alphahull-PointsKO-Adjacents,80
Magnolia_sphaerantha,0,0,0,NA,0
Magnolia_splendens,7,4,3,Points-PointsKO-Adjacents,24
Magnolia_sprengeri,17,5,12,Points-PointsKO-Adjacents,153
Magnolia_stellata,5,2,3,Points-PointsKO-Adjacents,40
Magnolia_steyermarkii,1,1,0,Points-PointsKO-Adjacents,9
Magnolia_striatifolia,9,3,6,Points-PointsKO-Adjacents,47
Magnolia_sumatrae,1,1,0,Points-PointsKO-Adjacents,9
Magnolia_sumatrana,4,4,0,Points-PointsKO-Adjacents,36
Magnolia_talamancana,1,1,0,Points-PointsKO-Adjacents,9
Magnolia_tamaulipana,19,15,4,Points-PointsKO-Adjacents,40
Magnolia_tarahumara,45,26,19,Alphahull-PointsKO-Adjacents,377
Magnolia_thailandica,0,0,0,NA,0
Magnolia_tripetala,116,69,47,Alphahull-PointsKO-Adjacents,6163
Magnolia_tsiampacca,72,39,33,Alphahull-PointsKO-Adjacents,1364
Magnolia_urraoensis,3,3,0,Points-PointsKO-Adjacents,18
Magnolia_utilis,8,0,8,Points-PointsKO-Adjacents,45
Magnolia_vallartensis,45,26,19,Alphahull-PointsKO-Adjacents,377
Magnolia_vazquezii,1,1,0,Points-PointsKO-Adjacents,9
Magnolia_venezuelensis,0,0,0,NA,0
Magnolia_ventii,2,2,0,Points-PointsKO-Adjacents,18
Magnolia_villosa,6,0,6,Points-PointsKO-Adjacents,51
Magnolia_virginiana,264,182,82,Alphahull-PointsKO-Adjacents,10969
Magnolia_virolinensis,6,1,5,Points-PointsKO-Adjacents,35
Magnolia_vovidesii,1,1,0,Points-PointsKO-Adjacents,9
Magnolia_vrieseana,17,5,12,Points-PointsKO-Adjacents,133
Magnolia_wendtii,1,1,0,Points-PointsKO-Adjacents,9
Magnolia_wetteri,2,2,0,Points-PointsKO-Adjacents,14
Magnolia_wilsonii,12,4,8,Points-PointsKO-Adjacents,107
Magnolia_wolfii,2,2,0,Points-PointsKO-Adjacents,18
Magnolia_xanthantha,1,1,0,Points-PointsKO-Adjacents,9
Magnolia_xiana,NA,NA,NA,NA,NA
Magnolia_xinganensis,NA,NA,NA,NA,NA
Magnolia_yarumalensis,7,2,5,Points-PointsKO-Adjacents,41
Magnolia_yoroconte,17,6,11,Points-PointsKO-Adjacents,106
Magnolia_yunnanensis,6,1,5,Points-PointsKO-Adjacents,54
Magnolia_yuyuanensis,6,2,4,Points-PointsKO-Adjacents,54
Magnolia_zamudioi,0,0,0,NA,0
Magnolia_zenii,4,4,0,Points-PointsKO-Adjacents,36
Magnolia_zhengyiana,0,0,0,NA,0
Magnolia_zoquepopolucae,1,1,0,Points-PointsKO-Adjacents,9
Magodendron_mennyae,9,2,7,Points-PointsKO-Adjacents,59
Magodendron_venefici,12,2,10,Points-PointsKO-Adjacents,72
Magonia_pubescens,830,770,60,Alphahull-PointsKO-Adjacents,36537
Maguireocharis_neblinae,4,4,0,Points-PointsKO-Adjacents,36
Mahonia_bealei,46,14,32,Points-PointsKO-Adjacents,414
Mahonia_bodinieri,19,6,13,Points-PointsKO-Adjacents,171
Mahonia_conferta,4,4,0,Points-PointsKO-Adjacents,36
Mahonia_duclouxiana,22,0,22,Points-PointsKO-Adjacents,198
Mahonia_napaulensis,15,0,15,Points-PointsKO-Adjacents,129
Mahonia_oiwakensis,63,50,13,Alphahull-PointsKO-Adjacents,141
Mahurea_exstipulata,215,0,215,Points-PointsKO-Adjacents,1514
Mahurea_palustris,15,0,15,Points-PointsKO-Adjacents,127
Maieta_guianensis,696,617,79,Alphahull-PointsKO-Adjacents,48826
Maieta_scabrosa,14,0,14,Points-PointsKO-Adjacents,102
Majidea_forsteri,7,3,4,Points-PointsKO-Adjacents,47
Majidea_zanguebarica,1,1,0,Points-PointsKO-Adjacents,9
Malacocarpus_crithmifolius,1,1,0,Points-PointsKO-Adjacents,9
Malagasia_alticola,10,6,4,Points-PointsKO-Adjacents,65
Malanea_erecta,51,31,20,Alphahull-PointsKO-Adjacents,373
Malanea_guaiquinimensis,1,1,0,Points-PointsKO-Adjacents,9
Malania_oleifera,9,3,6,Points-PointsKO-Adjacents,81
Malleastrum_antsingyense,18,10,8,Points-PointsKO-Adjacents,120
Malleastrum_depauperatum,2,2,0,Points-PointsKO-Adjacents,16
Malleastrum_letouzeyanum,4,4,0,Points-PointsKO-Adjacents,36
Malleastrum_mandenense,31,16,15,Points-PointsKO-Adjacents,110
Malleastrum_mocquerysi,3,3,0,Points-PointsKO-Adjacents,26
Malleastrum_obtusifolium,16,7,9,Points-PointsKO-Adjacents,102
Malleastrum_pseudodepauperatum,6,0,6,Points-PointsKO-Adjacents,32
Malleastrum_sambiranense,4,4,0,Points-PointsKO-Adjacents,36
Malleastrum_sepaliferum,14,7,7,Points-PointsKO-Adjacents,61
Malleastrum_tampolense,4,4,0,Points-PointsKO-Adjacents,26
Mallotus_actinoneurus,0,0,0,NA,0
Mallotus_apelta,221,173,48,Alphahull-PointsKO-Adjacents,17413
Mallotus_atrovirens,2,1,1,Points-PointsKO-Adjacents,18
Mallotus_aureopunctatus,2,2,0,Points-PointsKO-Adjacents,15
Mallotus_barbatus,107,71,36,Alphahull-PointsKO-Adjacents,9272
Mallotus_beddomei,0,0,0,NA,0
Mallotus_blumeanus,16,2,14,Points-PointsKO-Adjacents,139
Mallotus_brachythyrsus,3,3,0,Points-PointsKO-Adjacents,27
Mallotus_brevipetiolatus,3,3,0,Points-PointsKO-Adjacents,27
Mallotus_calocarpus,2,2,0,Points-PointsKO-Adjacents,18
Mallotus_canii,NA,NA,NA,NA,NA
Mallotus_caudatus,46,27,19,Alphahull-PointsKO-Adjacents,2414
Mallotus_cauliflorus,0,0,0,NA,0
Mallotus_chromocarpus,6,1,5,Points-PointsKO-Adjacents,43
Mallotus_claoxyloides,290,238,52,Alphahull-PointsKO-Adjacents,1545
Mallotus_connatus,7,0,7,Points-PointsKO-Adjacents,62
Mallotus_cumingii,32,0,32,Points-PointsKO-Adjacents,237
Mallotus_darbyshirei,1,1,0,Points-PointsKO-Adjacents,9
Mallotus_decipiens,23,12,11,Points-PointsKO-Adjacents,159
Mallotus_didymochryseus,17,0,17,Points-PointsKO-Adjacents,78
Mallotus_discolor,217,0,217,Points-PointsKO-Adjacents,554
Mallotus_dispar,53,12,41,Points-PointsKO-Adjacents,413
Mallotus_dispersus,62,41,21,Alphahull-PointsKO-Adjacents,208
Mallotus_distans,0,0,0,NA,0
Mallotus_eriocarpus,3,3,0,Points-PointsKO-Adjacents,27
Mallotus_eximius,2,2,0,Points-PointsKO-Adjacents,18
Mallotus_ficifolius,96,55,41,Alphahull-PointsKO-Adjacents,362
Mallotus_floribundus,111,27,84,Alphahull-PointsKO-Adjacents,1343
Mallotus_fuscescens,8,3,5,Points-PointsKO-Adjacents,57
Mallotus_garrettii,1,1,0,Points-PointsKO-Adjacents,9
Mallotus_glabriusculus,3,3,0,Points-PointsKO-Adjacents,27
Mallotus_havilandii,1,1,0,Points-PointsKO-Adjacents,9
Mallotus_hymenophyllus,2,2,0,Points-PointsKO-Adjacents,18
Mallotus_illudens,10,1,9,Points-PointsKO-Adjacents,90
Mallotus_insularum,1,1,0,Points-PointsKO-Adjacents,9
Mallotus_intercedens,0,0,0,NA,0
Mallotus_khasianus,12,4,8,Points-PointsKO-Adjacents,96
Mallotus_kongkandae,2,2,0,Points-PointsKO-Adjacents,18
Mallotus_korthalsii,34,13,21,Points-PointsKO-Adjacents,268
Mallotus_lackeyi,48,29,19,Alphahull-PointsKO-Adjacents,655
Mallotus_lanceolatus,15,2,13,Points-PointsKO-Adjacents,116
Mallotus_lancifolius,31,5,26,Points-PointsKO-Adjacents,267
Mallotus_lauterbachianus,4,4,0,Points-PointsKO-Adjacents,25
Mallotus_leptostachyus,1,1,0,Points-PointsKO-Adjacents,9
Mallotus_leucocalyx,26,10,16,Points-PointsKO-Adjacents,207
Mallotus_leucocarpus,0,0,0,NA,0
Mallotus_leucodermis,46,18,28,Points-PointsKO-Adjacents,363
Mallotus_lianus,26,11,15,Points-PointsKO-Adjacents,234
Mallotus_longinervis,1,1,0,Points-PointsKO-Adjacents,9
Mallotus_longipes,1,1,0,Points-PointsKO-Adjacents,9
Mallotus_macrostachyus,79,38,41,Alphahull-PointsKO-Adjacents,3007
Mallotus_macularis,2,2,0,Points-PointsKO-Adjacents,18
Mallotus_megadontus,26,14,12,Points-PointsKO-Adjacents,42
Mallotus_metcalfianus,6,1,5,Points-PointsKO-Adjacents,42
Mallotus_minimifructus,30,11,19,Points-PointsKO-Adjacents,211
Mallotus_miquelianus,56,31,25,Alphahull-PointsKO-Adjacents,727
Mallotus_mollissimus,416,246,170,Alphahull-PointsKO-Adjacents,7696
Mallotus_monanthos,0,0,0,NA,0
Mallotus_montanus,4,4,0,Points-PointsKO-Adjacents,36
Mallotus_muticus,52,23,29,Alphahull-PointsKO-Adjacents,2665
Mallotus_nepalensis,69,26,43,Alphahull-PointsKO-Adjacents,3208
Mallotus_nesophilus,587,515,72,Alphahull-PointsKO-Adjacents,9624
Mallotus_nudiflorus,47,9,38,Points-PointsKO-Adjacents,395
Mallotus_oppositifolius,12,3,9,Points-PointsKO-Adjacents,99
Mallotus_oreophilus,18,6,12,Points-PointsKO-Adjacents,160
Mallotus_pallidus,3,3,0,Points-PointsKO-Adjacents,14
Mallotus_paniculatus,744,535,209,Alphahull-PointsKO-Adjacents,25504
Mallotus_peltatus,229,104,125,Alphahull-PointsKO-Adjacents,6889
Mallotus_philippensis,2141,1840,301,Alphahull-PointsKO-Adjacents,26496
Mallotus_pleiogynus,12,1,11,Points-PointsKO-Adjacents,101
Mallotus_plicatus,4,4,0,Points-PointsKO-Adjacents,36
Mallotus_polyadenos,316,0,316,Points-PointsKO-Adjacents,815
Mallotus_polycarpus,0,0,0,NA,0
Mallotus_puber,7,1,6,Points-PointsKO-Adjacents,52
Mallotus_resinosus,129,57,72,Alphahull-PointsKO-Adjacents,983
Mallotus_rhamnifolius,7,3,4,Points-PointsKO-Adjacents,63
Mallotus_roxburghianus,5,0,5,Points-PointsKO-Adjacents,45
Mallotus_rufidulus,15,1,14,Points-PointsKO-Adjacents,116
Mallotus_sphaerocarpus,2,0,2,Points-PointsKO-Adjacents,18
Mallotus_spinifructus,2,2,0,Points-PointsKO-Adjacents,16
Mallotus_subcuneatus,4,0,4,Points-PointsKO-Adjacents,35
Mallotus_subulatus,44,15,29,Points-PointsKO-Adjacents,295
Mallotus_sumatranus,8,0,8,Points-PointsKO-Adjacents,58
Mallotus_surculosus,43,29,14,Alphahull-PointsKO-Adjacents,200
Mallotus_taoyuanensis,NA,NA,NA,NA,NA
Mallotus_tetracoccus,11,1,10,Points-PointsKO-Adjacents,99
Mallotus_thorelii,1,1,0,Points-PointsKO-Adjacents,9
Mallotus_tiliifolius,71,12,59,Points-PointsKO-Adjacents,542
Mallotus_trinervius,16,2,14,Points-PointsKO-Adjacents,104
Mallotus_wrayi,86,64,22,Alphahull-PointsKO-Adjacents,3727
Malmea_cuspidata,14,6,8,Points-PointsKO-Adjacents,108
Malmea_dielsiana,44,32,12,Alphahull-PointsKO-Adjacents,2341
Malmea_dimera,29,23,6,Alphahull-PointsKO-Adjacents,442
Malmea_manausensis,11,2,9,Points-PointsKO-Adjacents,63
Malmea_obovata,3,3,0,Points-PointsKO-Adjacents,19
Malmea_peruviana,1,1,0,Points-PointsKO-Adjacents,9
Malmeanthus_subintegerrimus,51,40,11,Alphahull-PointsKO-Adjacents,2838
Malosma_laurina,894,620,274,Alphahull-PointsKO-Adjacents,1183
Malouetia_amazonica,11,5,6,Points-PointsKO-Adjacents,81
Malouetia_amplexicaulis,7,2,5,Points-PointsKO-Adjacents,63
Malouetia_aquatica,2,2,0,Points-PointsKO-Adjacents,9
Malouetia_arborea,92,54,38,Alphahull-PointsKO-Adjacents,1836
Malouetia_bubalina,3,3,0,Points-PointsKO-Adjacents,23
Malouetia_calva,17,6,11,Points-PointsKO-Adjacents,143
Malouetia_cuatrecasatis,4,4,0,Points-PointsKO-Adjacents,27
Malouetia_duckei,38,12,26,Points-PointsKO-Adjacents,314
Malouetia_flavescens,13,0,13,Points-PointsKO-Adjacents,116
Malouetia_gentryi,1,1,0,Points-PointsKO-Adjacents,9
Malouetia_glandulifera,60,0,60,Points-PointsKO-Adjacents,377
Malouetia_gracilis,13,8,5,Points-PointsKO-Adjacents,62
Malouetia_gracillima,13,4,9,Points-PointsKO-Adjacents,95
Malouetia_grandiflora,5,5,0,Points-PointsKO-Adjacents,21
Malouetia_guatemalensis,173,134,39,Alphahull-PointsKO-Adjacents,3127
Malouetia_heudelotii,7,1,6,Points-PointsKO-Adjacents,54
Malouetia_isthmica,54,36,18,Alphahull-PointsKO-Adjacents,980
Malouetia_killipii,8,5,3,Points-PointsKO-Adjacents,42
Malouetia_lata,39,19,20,Points-PointsKO-Adjacents,336
Malouetia_mildbraedii,26,8,18,Points-PointsKO-Adjacents,191
Malouetia_naias,28,9,19,Points-PointsKO-Adjacents,155
Malouetia_nitida,7,0,7,Points-PointsKO-Adjacents,54
Malouetia_parvifolia,2,2,0,Points-PointsKO-Adjacents,18
Malouetia_pubescens,30,14,16,Points-PointsKO-Adjacents,227
Malouetia_quadricasarum,69,50,19,Alphahull-PointsKO-Adjacents,1145
Malouetia_sessilis,3,3,0,Points-PointsKO-Adjacents,27
Malouetia_tamaquarina,673,591,82,Alphahull-PointsKO-Adjacents,60468
Malouetia_virescens,53,37,16,Alphahull-PointsKO-Adjacents,3559
Malpighia_albiflora,265,231,34,Alphahull-PointsKO-Adjacents,1743
Malpighia_cauliflora,0,0,0,NA,0
Malpighia_cnide,26,8,18,Points-PointsKO-Adjacents,210
Malpighia_coccigera,23,8,15,Points-PointsKO-Adjacents,163
Malpighia_cubensis,12,5,7,Points-PointsKO-Adjacents,81
Malpighia_emarginata,333,0,333,Points-PointsKO-Adjacents,2053
Malpighia_fucata,6,1,5,Points-PointsKO-Adjacents,31
Malpighia_glabra,702,0,702,Points-PointsKO-Adjacents,3608
Malpighia_harrisii,4,4,0,Points-PointsKO-Adjacents,22
Malpighia_hintonii,6,1,5,Points-PointsKO-Adjacents,36
Malpighia_infestissima,8,2,6,Points-PointsKO-Adjacents,48
Malpighia_linearis,4,0,4,Points-PointsKO-Adjacents,23
Malpighia_macracantha,5,5,0,Points-PointsKO-Adjacents,32
Malpighia_macrocarpa,29,0,29,Points-PointsKO-Adjacents,165
Malpighia_megacantha,4,4,0,Points-PointsKO-Adjacents,36
Malpighia_mexicana,246,0,246,Points-PointsKO-Adjacents,939
Malpighia_obtusifolia,1,1,0,Points-PointsKO-Adjacents,9
Malpighia_ovata,75,40,35,Alphahull-PointsKO-Adjacents,2367
Malpighia_oxycocca,4,4,0,Points-PointsKO-Adjacents,33
Malpighia_proctorii,0,0,0,NA,0
Malpighia_romeroana,78,54,24,Alphahull-PointsKO-Adjacents,382
Malpighia_setosa,9,1,8,Points-PointsKO-Adjacents,64
Malpighia_stevensii,46,34,12,Alphahull-PointsKO-Adjacents,241
Malpighia_urens,3,2,1,Points-PointsKO-Adjacents,21
Malpighia_velutina,1,1,0,Points-PointsKO-Adjacents,7
Malpighia_verruculosa,25,10,15,Points-PointsKO-Adjacents,144
Malpighia_woodburyana,2,1,1,Points-PointsKO-Adjacents,11
Malus_angustifolia,436,343,93,Alphahull-PointsKO-Adjacents,13471
Malus_asiatica,39,14,25,Points-PointsKO-Adjacents,343
Pyrus_brevipes,0,0,0,NA,0
Malus_coronaria,588,409,179,Alphahull-PointsKO-Adjacents,15612
Malus_daochengensis,9,3,6,Points-PointsKO-Adjacents,72
Malus_dasyphylla,2,2,0,Points-PointsKO-Adjacents,18
Malus_doumeri,132,94,38,Alphahull-PointsKO-Adjacents,4775
Malus_florentina,29,13,16,Points-PointsKO-Adjacents,162
Malus_floribunda,80,13,67,Points-PointsKO-Adjacents,630
Malus_fusca,533,374,159,Alphahull-PointsKO-Adjacents,8811
Malus_halliana,29,3,26,Points-PointsKO-Adjacents,231
Malus_honanensis,18,4,14,Points-PointsKO-Adjacents,153
Malus_hupehensis,6,2,4,Points-PointsKO-Adjacents,21
Malus_ioensis,498,339,159,Alphahull-PointsKO-Adjacents,14365
Malus_jinxianensis,NA,NA,NA,NA,NA
Malus_komarovii,0,0,0,NA,0
Malus_leiocalyca,6,1,5,Points-PointsKO-Adjacents,54
Malus_mandshurica,6,1,5,Points-PointsKO-Adjacents,52
Malus_micromalus,9,0,9,Points-PointsKO-Adjacents,76
Malus_niedzwetzkyana,0,0,0,NA,0
Malus_ombrophila,28,18,10,Points-PointsKO-Adjacents,198
Malus_orientalis,103,0,103,Points-PointsKO-Adjacents,612
Malus_prattii,26,17,9,Points-PointsKO-Adjacents,167
Malus_prunifolia,10,1,9,Points-PointsKO-Adjacents,81
Malus_pumila,30421,0,30421,Points-PointsKO-Adjacents,40034
Malus_rockii,39,22,17,Alphahull-PointsKO-Adjacents,1352
Malus_sieboldii,294,194,100,Alphahull-PointsKO-Adjacents,2804
Malus_sieversii,81,0,81,Points-PointsKO-Adjacents,303
Malus_sikkimensis,13,2,11,Points-PointsKO-Adjacents,77
Malus_spectabilis,12,0,12,Points-PointsKO-Adjacents,99
Malus_spontanea,2,1,1,Points-PointsKO-Adjacents,18
Malus_sylvestris,28074,24191,3883,Alphahull-PointsKO-Adjacents,58412
Malus_toringo,151,103,48,Alphahull-PointsKO-Adjacents,961
Malus_toringoides,22,13,9,Points-PointsKO-Adjacents,140
Malus_transitoria,18,5,13,Points-PointsKO-Adjacents,138
Malus_trilobata,30,21,9,Alphahull-PointsKO-Adjacents,75
Malus_tschonoskii,122,94,28,Alphahull-PointsKO-Adjacents,993
Malus_yunnanensis,62,43,19,Alphahull-PointsKO-Adjacents,2521
Malva_assurgentiflora,130,75,55,Alphahull-PointsKO-Adjacents,414
Malva_parviflora,7658,0,7658,Points-PointsKO-Adjacents,23078
Malvaviscus_arboreus,3249,2869,380,Alphahull-PointsKO-Adjacents,23027
Malvaviscus_lanceolatus,74,56,18,Alphahull-PointsKO-Adjacents,1265
Malvaviscus_palmanus,67,55,12,Alphahull-PointsKO-Adjacents,217
Malvaviscus_palmatus,5,5,0,Points-PointsKO-Adjacents,45
Ochrocarpos_acuminatus,12,5,7,Points-PointsKO-Adjacents,80
Mammea_africana,201,143,58,Alphahull-PointsKO-Adjacents,8655
Mammea_americana,198,94,104,Alphahull-PointsKO-Adjacents,5349
Mammea_angustifolia,6,0,6,Points-PointsKO-Adjacents,36
Mammea_bongo,33,13,20,Points-PointsKO-Adjacents,207
Mammea_eugenioides,15,4,11,Points-PointsKO-Adjacents,84
Ochrocarpos_glaucus,4,4,0,Points-PointsKO-Adjacents,23
Mammea_glaucifolia,2,2,0,Points-PointsKO-Adjacents,18
Mammea_immansueta,4,1,3,Points-PointsKO-Adjacents,9
Mammea_novoguineensis,5,5,0,Points-PointsKO-Adjacents,42
Mammea_odorata,8,1,7,Points-PointsKO-Adjacents,45
Ochrocarpos_papuanus,1,1,0,Points-PointsKO-Adjacents,9
Mammea_pseudoprotorhus,2,2,0,Points-PointsKO-Adjacents,9
Mammea_sanguinea,0,0,0,NA,0
Mammea_sessiliflora,26,10,16,Points-PointsKO-Adjacents,136
Calophyllum_suriga,0,0,0,NA,0
Mammea_usambarensis,8,5,3,Points-PointsKO-Adjacents,18
Mammea_yunnanensis,0,0,0,NA,0
Mandevilla_angustata,1,1,0,Points-PointsKO-Adjacents,9
Mandevilla_subcarnosa,43,24,19,Alphahull-PointsKO-Adjacents,1220
Mangifera_altissima,18,0,18,Points-PointsKO-Adjacents,114
Mangifera_caesia,29,1,28,Points-PointsKO-Adjacents,221
Mangifera_casturi,1,1,0,Points-PointsKO-Adjacents,9
Mangifera_foetida,54,14,40,Points-PointsKO-Adjacents,393
Mangifera_indica,17,1,16,Points-PointsKO-Adjacents,128
Mangifera_laurina,47,6,41,Points-PointsKO-Adjacents,361
Mangifera_odorata,0,0,0,NA,0
Mangifera_persiciforma,9,3,6,Points-PointsKO-Adjacents,80
Mangifera_rubropetala,1,0,1,Points-PointsKO-Adjacents,8
Mangifera_siamensis,2,2,0,Points-PointsKO-Adjacents,18
Mangifera_sylvatica,8,1,7,Points-PointsKO-Adjacents,72
Manicaria_martiana,7,2,5,Points-PointsKO-Adjacents,50
Manicaria_saccifera,228,143,85,Alphahull-PointsKO-Adjacents,6141
Manihot_aesculifolia,427,316,111,Alphahull-PointsKO-Adjacents,9275
Manihot_auriculata,3,3,0,Points-PointsKO-Adjacents,27
Manihot_baccata,67,36,31,Alphahull-PointsKO-Adjacents,4086
Manihot_brachyloba,529,396,133,Alphahull-PointsKO-Adjacents,45479
Manihot_caerulescens,920,850,70,Alphahull-PointsKO-Adjacents,44845
Manihot_carthaginensis,396,243,153,Alphahull-PointsKO-Adjacents,14018
Manihot_catingae,14,2,12,Points-PointsKO-Adjacents,93
Manihot_caudata,66,31,35,Alphahull-PointsKO-Adjacents,999
Manihot_chlorosticta,167,107,60,Alphahull-PointsKO-Adjacents,3227
Manihot_crassisepala,19,5,14,Points-PointsKO-Adjacents,135
Manihot_dichotoma,270,239,31,Alphahull-PointsKO-Adjacents,6530
Manihot_epruinosa,125,93,32,Alphahull-PointsKO-Adjacents,5913
Manihot_esculenta,164,75,89,Alphahull-PointsKO-Adjacents,3623
Manihot_foetida,16,2,14,Points-PointsKO-Adjacents,126
Manihot_grahamii,465,392,73,Alphahull-PointsKO-Adjacents,13580
Manihot_guaranitica,97,64,33,Alphahull-PointsKO-Adjacents,8505
Manihot_heptaphylla,10,0,10,Points-PointsKO-Adjacents,69
Manihot_maracasensis,38,0,38,Points-PointsKO-Adjacents,187
Manihot_michaelis,25,13,12,Points-PointsKO-Adjacents,118
Manihot_oaxacana,77,0,77,Points-PointsKO-Adjacents,235
Manihot_palmata,18,1,17,Points-PointsKO-Adjacents,152
Manihot_pauciflora,85,0,85,Points-PointsKO-Adjacents,125
Manihot_pilosa,192,146,46,Alphahull-PointsKO-Adjacents,3559
Manihot_pseudoglaziovii,96,70,26,Alphahull-PointsKO-Adjacents,4225
Manihot_rubricaulis,94,75,19,Alphahull-PointsKO-Adjacents,2110
Manihot_tomatophylla,20,9,11,Points-PointsKO-Adjacents,137
Manihot_triloba,5,4,1,Points-PointsKO-Adjacents,45
Manihot_tristis,135,77,58,Alphahull-PointsKO-Adjacents,2544
Manihot_websteri,9,5,4,Points-PointsKO-Adjacents,35
Manihot_zehntneri,2,2,0,Points-PointsKO-Adjacents,18
Manilkara_adolfi-friederici,4,3,1,Points-PointsKO-Adjacents,33
Manilkara_bequaertii,11,4,7,Points-PointsKO-Adjacents,75
Manilkara_bidentata,838,0,838,Points-PointsKO-Adjacents,5510
Manilkara_boivinii,32,17,15,Points-PointsKO-Adjacents,173
Manilkara_bolivarensis,2,2,0,Points-PointsKO-Adjacents,18
Manilkara_butugi,12,4,8,Points-PointsKO-Adjacents,97
Manilkara_capuronii,4,4,0,Points-PointsKO-Adjacents,36
Manilkara_casteelsii,1,1,0,Points-PointsKO-Adjacents,9
Manilkara_cavalcantei,48,26,22,Alphahull-PointsKO-Adjacents,853
Manilkara_celebica,2,2,0,Points-PointsKO-Adjacents,17
Manilkara_chicle,235,189,46,Alphahull-PointsKO-Adjacents,5281
Manilkara_concolor,24,13,11,Points-PointsKO-Adjacents,205
Manilkara_dardanoi,9,0,9,Points-PointsKO-Adjacents,37
Manilkara_dawei,20,0,20,Points-PointsKO-Adjacents,83
Manilkara_decrescens,17,0,17,Points-PointsKO-Adjacents,104
Manilkara_discolor,69,27,42,Alphahull-PointsKO-Adjacents,854
Manilkara_dissecta,13,8,5,Points-PointsKO-Adjacents,68
Manilkara_doeringii,NA,NA,NA,NA,NA
Manilkara_dukensis,NA,NA,NA,NA,NA
Manilkara_elata,26,0,26,Points-PointsKO-Adjacents,220
Manilkara_excelsa,21,0,21,Points-PointsKO-Adjacents,189
Manilkara_excisa,2,2,0,Points-PointsKO-Adjacents,18
Manilkara_fasciculata,11,4,7,Points-PointsKO-Adjacents,51
Manilkara_fischeri,NA,NA,NA,NA,NA
Manilkara_fouilloyana,22,12,10,Points-PointsKO-Adjacents,173
Manilkara_frondosa,3,2,1,Points-PointsKO-Adjacents,27
Manilkara_gonavensis,2,2,0,Points-PointsKO-Adjacents,16
Manilkara_hexandra,21,2,19,Points-PointsKO-Adjacents,158
Manilkara_hoshinoi,0,0,0,NA,0
Manilkara_huberi,159,100,59,Alphahull-PointsKO-Adjacents,10118
Manilkara_ilendensis,NA,NA,NA,NA,NA
Manilkara_inundata,153,97,56,Alphahull-PointsKO-Adjacents,13884
Manilkara_jaimiqui,56,0,56,Points-PointsKO-Adjacents,384
Manilkara_kanosiensis,2,2,0,Points-PointsKO-Adjacents,9
Manilkara_kauki,97,0,97,Points-PointsKO-Adjacents,276
Manilkara_koechlinii,1,1,0,Points-PointsKO-Adjacents,9
Manilkara_kribensis,3,3,0,Points-PointsKO-Adjacents,15
Manilkara_kurziana,NA,NA,NA,NA,NA
Manilkara_le-testui,1,1,0,Points-PointsKO-Adjacents,9
Manilkara_letouzei,0,0,0,NA,0
Manilkara_littoralis,1,1,0,Points-PointsKO-Adjacents,9
Manilkara_longistyla,NA,NA,NA,NA,NA
Manilkara_lososiana,4,2,2,Points-PointsKO-Adjacents,23
Manilkara_mabokeensis,12,5,7,Points-PointsKO-Adjacents,37
Manilkara_maxima,36,22,14,Alphahull-PointsKO-Adjacents,186
Manilkara_mayarensis,7,3,4,Points-PointsKO-Adjacents,37
Manilkara_microphylla,5,5,0,Points-PointsKO-Adjacents,34
Manilkara_mochisia,82,35,47,Alphahull-PointsKO-Adjacents,1234
Manilkara_multifida,19,0,19,Points-PointsKO-Adjacents,110
Manilkara_nicholsonii,5,5,0,Points-PointsKO-Adjacents,31
Manilkara_obovata,483,386,97,Alphahull-PointsKO-Adjacents,18821
Manilkara_paraensis,48,22,26,Alphahull-PointsKO-Adjacents,2115
Manilkara_pellegriniana,8,5,3,Points-PointsKO-Adjacents,57
Manilkara_perrieri,6,1,5,Points-PointsKO-Adjacents,54
Manilkara_pleeana,15,7,8,Points-PointsKO-Adjacents,75
Manilkara_pobeguinii,NA,NA,NA,NA,NA
Manilkara_pubicarpa,1,1,0,Points-PointsKO-Adjacents,9
Manilkara_roxburghiana,1,0,1,Points-PointsKO-Adjacents,9
Manilkara_rufula,153,118,35,Alphahull-PointsKO-Adjacents,7508
Manilkara_sahafarensis,2,2,0,Points-PointsKO-Adjacents,12
Manilkara_salzmannii,426,312,114,Alphahull-PointsKO-Adjacents,9451
Manilkara_samoensis,0,0,0,NA,0
Manilkara_sansibarensis,49,34,15,Alphahull-PointsKO-Adjacents,285
Manilkara_sapota,57,0,57,Points-PointsKO-Adjacents,317
Manilkara_seretii,0,0,0,NA,0
Manilkara_sideroxylon,4,4,0,Points-PointsKO-Adjacents,36
Manilkara_smithiana,0,0,0,NA,0
Manilkara_spectabilis,1,1,0,Points-PointsKO-Adjacents,6
Manilkara_staminodella,55,36,19,Alphahull-PointsKO-Adjacents,609
Manilkara_suarezensis,4,4,0,Points-PointsKO-Adjacents,25
Manilkara_subsericea,215,157,58,Alphahull-PointsKO-Adjacents,1033
Manilkara_sulcata,52,35,17,Alphahull-PointsKO-Adjacents,545
Manilkara_sylvestris,0,0,0,NA,0
Manilkara_triflora,174,115,59,Alphahull-PointsKO-Adjacents,17007
Manilkara_udoido,3,3,0,Points-PointsKO-Adjacents,9
Manilkara_valenzuelana,10,0,10,Points-PointsKO-Adjacents,81
Manilkara_vitiensis,0,0,0,NA,0
Manilkara_zapota,987,848,139,Alphahull-PointsKO-Adjacents,13072
Manilkara_zenkeri,8,3,5,Points-PointsKO-Adjacents,69
Maniltoa_amicorum,0,0,0,NA,0
Maniltoa_basifoliola,1,1,0,Points-PointsKO-Adjacents,9
Maniltoa_brassii,4,4,0,Points-PointsKO-Adjacents,36
Maniltoa_brevipes,0,0,0,NA,0
Maniltoa_browneoides,9,1,8,Points-PointsKO-Adjacents,63
Maniltoa_cynometroides,9,0,9,Points-PointsKO-Adjacents,61
Maniltoa_floribunda,0,0,0,NA,0
Maniltoa_fortuna-tironis,3,3,0,Points-PointsKO-Adjacents,12
Maniltoa_lenticellata,71,36,35,Alphahull-PointsKO-Adjacents,920
Maniltoa_mariettae,4,3,1,Points-PointsKO-Adjacents,15
Maniltoa_megalocephala,3,3,0,Points-PointsKO-Adjacents,26
Maniltoa_minor,0,0,0,NA,0
Maniltoa_plurijuga,7,0,7,Points-PointsKO-Adjacents,38
Maniltoa_polyandra,1,1,0,Points-PointsKO-Adjacents,9
Maniltoa_psilogyne,27,11,16,Points-PointsKO-Adjacents,138
Maniltoa_rosea,3,3,0,Points-PointsKO-Adjacents,21
Maniltoa_schefferi,48,22,26,Alphahull-PointsKO-Adjacents,308
Maniltoa_vestita,0,0,0,NA,0
Manoao_colensoi,1340,1301,39,Alphahull-PointsKO-Adjacents,1848
Mansoa_montecillensis,NA,NA,NA,NA,NA
Mansonia_altissima,101,70,31,Alphahull-PointsKO-Adjacents,2271
Mansonia_diatomanthera,4,4,0,Points-PointsKO-Adjacents,28
Mantalania_capuronii,8,1,7,Points-PointsKO-Adjacents,55
Mantalania_longipedunculata,2,2,0,Points-PointsKO-Adjacents,15
Manuleopsis_dinteri,18,8,10,Points-PointsKO-Adjacents,146
Maoutia_australis,5,0,5,Points-PointsKO-Adjacents,33
Mappia_mexicana,3,3,0,Points-PointsKO-Adjacents,18
Mappia_multiflora,29,10,19,Points-PointsKO-Adjacents,230
Mappia_racemosa,7,0,7,Points-PointsKO-Adjacents,63
Maprounea_africana,119,54,65,Alphahull-PointsKO-Adjacents,5612
Maprounea_amazonica,379,299,80,Alphahull-PointsKO-Adjacents,24961
Maprounea_guianensis,1923,1772,151,Alphahull-PointsKO-Adjacents,122214
Maprounea_membranacea,101,68,33,Alphahull-PointsKO-Adjacents,5947
Maquira_calophylla,332,268,64,Alphahull-PointsKO-Adjacents,34036
Maquira_coriacea,325,235,90,Alphahull-PointsKO-Adjacents,53180
Maquira_guianensis,698,573,125,Alphahull-PointsKO-Adjacents,56986
Maquira_sclerophylla,124,80,44,Alphahull-PointsKO-Adjacents,14423
Maranthes_aubrevillei,42,24,18,Alphahull-PointsKO-Adjacents,556
Maranthes_chrysophylla,81,57,24,Alphahull-PointsKO-Adjacents,2171
Maranthes_corymbosa,748,644,104,Alphahull-PointsKO-Adjacents,4166
Maranthes_floribunda,26,12,14,Points-PointsKO-Adjacents,198
Maranthes_gabunensis,66,45,21,Alphahull-PointsKO-Adjacents,1811
Maranthes_glabra,193,120,73,Alphahull-PointsKO-Adjacents,10051
Maranthes_goetzeniana,13,3,10,Points-PointsKO-Adjacents,83
Maranthes_kerstingii,26,11,15,Points-PointsKO-Adjacents,190
Maranthes_panamensis,87,70,17,Alphahull-PointsKO-Adjacents,793
Maranthes_polyandra,627,589,38,Alphahull-PointsKO-Adjacents,4950
Maranthes_robusta,95,65,30,Alphahull-PointsKO-Adjacents,932
Maranthes_sanagensis,9,3,6,Points-PointsKO-Adjacents,62
Sanguisorba_moquiniana,23,0,23,Points-PointsKO-Adjacents,86
Marcgravia_stonei,14,5,9,Points-PointsKO-Adjacents,78
Marcgraviastrum_cuneifolium,16,0,16,Points-PointsKO-Adjacents,122
Mareya_acuminata,1,0,1,Points-PointsKO-Adjacents,9
Mareya_brevipes,75,54,21,Alphahull-PointsKO-Adjacents,2749
Mareya_congolensis,16,4,12,Points-PointsKO-Adjacents,128
Mareya_micrantha,202,168,34,Alphahull-PointsKO-Adjacents,5279
Mareyopsis_longifolia,99,0,99,Points-PointsKO-Adjacents,519
Mareyopsis_oligogyna,15,8,7,Points-PointsKO-Adjacents,104
Margaritaria_anomala,42,16,26,Points-PointsKO-Adjacents,216
Margaritaria_cyanosperma,1,1,0,Points-PointsKO-Adjacents,9
Margaritaria_decaryana,18,5,13,Points-PointsKO-Adjacents,119
Margaritaria_discoidea,690,539,151,Alphahull-PointsKO-Adjacents,34688
Margaritaria_dubium-traceyi,268,225,43,Alphahull-PointsKO-Adjacents,4215
Margaritaria_hispidula,2,2,0,Points-PointsKO-Adjacents,18
Margaritaria_indica,84,34,50,Alphahull-PointsKO-Adjacents,672
Margaritaria_luzoniensis,0,0,0,NA,0
Margaritaria_nobilis,2764,2418,346,Alphahull-PointsKO-Adjacents,158113
Margaritaria_rhomboidalis,32,12,20,Points-PointsKO-Adjacents,222
Margaritaria_scandens,9,1,8,Points-PointsKO-Adjacents,52
Margaritolobium_luteum,2,2,0,Points-PointsKO-Adjacents,18
Margaritopsis_albert-smithii,47,21,26,Alphahull-PointsKO-Adjacents,2040
Margaritopsis_astrellantha,419,288,131,Alphahull-PointsKO-Adjacents,20363
Margaritopsis_boliviana,221,129,92,Alphahull-PointsKO-Adjacents,11245
Margaritopsis_cephalantha,263,179,84,Alphahull-PointsKO-Adjacents,12656
Margaritopsis_chaenotricha,255,169,86,Alphahull-PointsKO-Adjacents,4821
Margaritopsis_cymuligera,36,8,28,Points-PointsKO-Adjacents,249
Margaritopsis_deinocalyx,99,53,46,Alphahull-PointsKO-Adjacents,11572
Margaritopsis_guianensis,78,52,26,Alphahull-PointsKO-Adjacents,1298
Margaritopsis_haematocarpa,97,65,32,Alphahull-PointsKO-Adjacents,1250
Margaritopsis_kappleri,108,61,47,Alphahull-PointsKO-Adjacents,2961
Margaritopsis_microdon,470,342,128,Alphahull-PointsKO-Adjacents,11029
Margaritopsis_paupertina,15,7,8,Points-PointsKO-Adjacents,128
Margaritopsis_podocephala,226,163,63,Alphahull-PointsKO-Adjacents,25720
Marila_alternifolia,20,9,11,Points-PointsKO-Adjacents,178
Marila_cespedesiana,9,5,4,Points-PointsKO-Adjacents,75
Marila_domingensis,2,2,0,Points-PointsKO-Adjacents,17
Marila_grandiflora,9,4,5,Points-PointsKO-Adjacents,54
Marila_lactogena,20,10,10,Points-PointsKO-Adjacents,138
Marila_laxiflora,386,309,77,Alphahull-PointsKO-Adjacents,18276
Marila_macrophylla,27,18,9,Points-PointsKO-Adjacents,193
Marila_magnifica,0,0,0,NA,0
Marila_nitida,6,0,6,Points-PointsKO-Adjacents,48
Marila_podantha,89,55,34,Alphahull-PointsKO-Adjacents,1784
Marila_saramaccana,1,1,0,Points-PointsKO-Adjacents,9
Marila_spiciformis,2,2,0,Points-PointsKO-Adjacents,18
Marila_tomentosa,151,115,36,Alphahull-PointsKO-Adjacents,12393
Mariosousa_acatlensis,17,8,9,Points-PointsKO-Adjacents,143
Mariosousa_centralis,129,91,38,Alphahull-PointsKO-Adjacents,3321
Mariosousa_compacta,38,32,6,Alphahull-PointsKO-Adjacents,79
Mariosousa_coulteri,29,15,14,Points-PointsKO-Adjacents,245
Mariosousa_dolichostachya,288,256,32,Alphahull-PointsKO-Adjacents,2150
Mariosousa_durangensis,59,45,14,Alphahull-PointsKO-Adjacents,599
Mariosousa_mammifera,49,35,14,Alphahull-PointsKO-Adjacents,713
Mariosousa_millefolia,36,22,14,Alphahull-PointsKO-Adjacents,415
Mariosousa_russelliana,26,0,26,Points-PointsKO-Adjacents,152
Mariosousa_salazarii,20,9,11,Points-PointsKO-Adjacents,133
Mariosousa_sericea,40,28,12,Alphahull-PointsKO-Adjacents,152
Mariosousa_usumacintensis,29,23,6,Alphahull-PointsKO-Adjacents,314
Mariosousa_willardiana,69,0,69,Points-PointsKO-Adjacents,188
Markea_harlingiana,8,4,4,Points-PointsKO-Adjacents,63
Markhamia_lutea,141,91,50,Alphahull-PointsKO-Adjacents,2372
Markhamia_obtusifolia,128,84,44,Alphahull-PointsKO-Adjacents,7425
Markhamia_stipulata,46,12,34,Points-PointsKO-Adjacents,405
Markhamia_tomentosa,203,134,69,Alphahull-PointsKO-Adjacents,9577
Markhamia_zanzibarica,58,22,36,Alphahull-PointsKO-Adjacents,980
Marlierea_acuminatissima,8,0,8,Points-PointsKO-Adjacents,69
Marlierea_areolata,16,7,9,Points-PointsKO-Adjacents,123
Marlierea_biptera,2,2,0,Points-PointsKO-Adjacents,18
Marlierea_buxifolia,13,6,7,Points-PointsKO-Adjacents,65
Marlierea_caesariata,2,2,0,Points-PointsKO-Adjacents,9
Marlierea_cana,7,0,7,Points-PointsKO-Adjacents,57
Marlierea_capitata,2,2,0,Points-PointsKO-Adjacents,18
Marlierea_caudata,102,62,40,Alphahull-PointsKO-Adjacents,6307
Marlierea_choriophylla,7,0,7,Points-PointsKO-Adjacents,40
Marlierea_clausseniana,161,123,38,Alphahull-PointsKO-Adjacents,2497
Marlierea_convexivenia,9,3,6,Points-PointsKO-Adjacents,79
Marlierea_cordata,1,1,0,Points-PointsKO-Adjacents,9
Marlierea_cuprea,19,10,9,Points-PointsKO-Adjacents,133
Marlierea_dimorpha,18,0,18,Points-PointsKO-Adjacents,151
Marlierea_ensiformis,3,3,0,Points-PointsKO-Adjacents,25
Marlierea_estrellensis,3,3,0,Points-PointsKO-Adjacents,27
Marlierea_excoriata,571,486,85,Alphahull-PointsKO-Adjacents,7477
Marlierea_foveolata,2,2,0,Points-PointsKO-Adjacents,18
Marlierea_gardneriana,14,6,8,Points-PointsKO-Adjacents,119
Marlierea_gaudichaudiana,19,0,19,Points-PointsKO-Adjacents,150
Marlierea_guanabarina,5,4,1,Points-PointsKO-Adjacents,37
Marlierea_guildingiana,3,3,0,Points-PointsKO-Adjacents,9
Marlierea_imperfecta,8,3,5,Points-PointsKO-Adjacents,54
Marlierea_insignis,5,5,0,Points-PointsKO-Adjacents,45
Marlierea_involucrata,4,4,0,Points-PointsKO-Adjacents,32
Marlierea_karuaiensis,41,21,20,Alphahull-PointsKO-Adjacents,1584
Marlierea_krapovickae,17,11,6,Points-PointsKO-Adjacents,103
Marlierea_langsdorffii,5,5,0,Points-PointsKO-Adjacents,43
Marlierea_leal-costae,3,1,2,Points-PointsKO-Adjacents,17
Marlierea_ligustrina,6,1,5,Points-PointsKO-Adjacents,47
Marlierea_lituatinervia,27,13,14,Points-PointsKO-Adjacents,129
Marlierea_luschnathiana,10,2,8,Points-PointsKO-Adjacents,42
Marlierea_macrophylla,5,5,0,Points-PointsKO-Adjacents,45
Marlierea_maguirei,2,2,0,Points-PointsKO-Adjacents,18
Marlierea_martinellii,6,3,3,Points-PointsKO-Adjacents,37
Marlierea_mcvaughii,21,13,8,Points-PointsKO-Adjacents,173
Marlierea_mesoamericana,18,10,8,Points-PointsKO-Adjacents,95
Marlierea_montana,9,0,9,Points-PointsKO-Adjacents,72
Marlierea_multiglomerata,1,1,0,Points-PointsKO-Adjacents,9
Marlierea_neuwiedeana,113,59,54,Alphahull-PointsKO-Adjacents,558
Marlierea_obscura,135,0,135,Points-PointsKO-Adjacents,814
Marlierea_obversa,80,58,22,Alphahull-PointsKO-Adjacents,806
Marlierea_occhionii,2,2,0,Points-PointsKO-Adjacents,18
Marlierea_parvifolia,12,1,11,Points-PointsKO-Adjacents,100
Marlierea_polygama,34,17,17,Points-PointsKO-Adjacents,218
Marlierea_pudica,3,3,0,Points-PointsKO-Adjacents,21
Marlierea_regeliana,115,71,44,Alphahull-PointsKO-Adjacents,2565
Marlierea_resupinata,1,1,0,Points-PointsKO-Adjacents,9
Marlierea_rubiginosa,34,19,15,Points-PointsKO-Adjacents,199
Marlierea_rufa,13,4,9,Points-PointsKO-Adjacents,82
Marlierea_rugosior,2,2,0,Points-PointsKO-Adjacents,12
Marlierea_salticola,5,5,0,Points-PointsKO-Adjacents,36
Marlierea_schomburgkiana,5,1,4,Points-PointsKO-Adjacents,45
Marlierea_schottii,9,0,9,Points-PointsKO-Adjacents,73
Marlierea_scytophylla,17,1,16,Points-PointsKO-Adjacents,151
Marlierea_sessiliflora,2,2,0,Points-PointsKO-Adjacents,18
Marlierea_silvestris,1,1,0,Points-PointsKO-Adjacents,9
Marlierea_sintenisii,6,4,2,Points-PointsKO-Adjacents,15
Marlierea_skortzoviana,5,5,0,Points-PointsKO-Adjacents,30
Marlierea_spruceana,142,95,47,Alphahull-PointsKO-Adjacents,8920
Marlierea_suaveolens,111,0,111,Points-PointsKO-Adjacents,645
Marlierea_subacuminata,15,0,15,Points-PointsKO-Adjacents,114
Marlierea_subcordata,3,3,0,Points-PointsKO-Adjacents,21
Marlierea_suborbicularis,17,12,5,Points-PointsKO-Adjacents,112
Marlierea_subulata,34,15,19,Points-PointsKO-Adjacents,296
Marlierea_sucrei,46,25,21,Alphahull-PointsKO-Adjacents,292
Marlierea_summa,69,44,25,Alphahull-PointsKO-Adjacents,3370
Marlierea_teuscheriana,26,13,13,Points-PointsKO-Adjacents,186
Marlierea_tovarensis,4,4,0,Points-PointsKO-Adjacents,27
Marlierea_umbraticola,251,183,68,Alphahull-PointsKO-Adjacents,24607
Marlierea_velutina,23,8,15,Points-PointsKO-Adjacents,182
Marlierea_ventuarensis,2,2,0,Points-PointsKO-Adjacents,18
Marlierea_verticillaris,21,10,11,Points-PointsKO-Adjacents,127
Marlierea_vicina,4,4,0,Points-PointsKO-Adjacents,27
Marmaroxylon_dinizii,36,9,27,Points-PointsKO-Adjacents,285
Marmaroxylon_ramiflorum,11,2,9,Points-PointsKO-Adjacents,84
Marojejya_darianii,19,12,7,Points-PointsKO-Adjacents,68
Marojejya_insignis,33,15,18,Points-PointsKO-Adjacents,180
Marquesia_acuminata,7,1,6,Points-PointsKO-Adjacents,60
Marquesia_excelsa,15,10,5,Points-PointsKO-Adjacents,109
Marquesia_macroura,11,2,9,Points-PointsKO-Adjacents,83
Polyalthia_littoralis,1,1,0,Points-PointsKO-Adjacents,4
Marsypopetalum_pallidum,7,0,7,Points-PointsKO-Adjacents,63
Martellidendron_androcephalanthos,17,10,7,Points-PointsKO-Adjacents,77
Martellidendron_cruciatum,18,7,11,Points-PointsKO-Adjacents,122
Martellidendron_gallinarum,3,3,0,Points-PointsKO-Adjacents,27
Martellidendron_hornei,3,3,0,Points-PointsKO-Adjacents,17
Martellidendron_karaka,21,8,13,Points-PointsKO-Adjacents,118
Martellidendron_kariangense,3,3,0,Points-PointsKO-Adjacents,27
Martensianthus_macdougallii,0,0,0,NA,0
Martiodendron_elatum,109,65,44,Alphahull-PointsKO-Adjacents,11041
Martiodendron_excelsum,42,0,42,Points-PointsKO-Adjacents,274
Martiodendron_fluminense,19,10,9,Points-PointsKO-Adjacents,129
Martiodendron_mediterraneum,179,141,38,Alphahull-PointsKO-Adjacents,6901
Martiodendron_parviflorum,54,28,26,Alphahull-PointsKO-Adjacents,1411
Martretia_quadricornis,64,22,42,Alphahull-PointsKO-Adjacents,1610
Mascarenhasia_arborescens,16,3,13,Points-PointsKO-Adjacents,129
Mascarenhasia_havetii,21,8,13,Points-PointsKO-Adjacents,156
Mascarenhasia_lanceolata,60,46,14,Alphahull-PointsKO-Adjacents,274
Mascarenhasia_lisianthiflora,156,133,23,Alphahull-PointsKO-Adjacents,3329
Mascarenhasia_macrosiphon,10,4,6,Points-PointsKO-Adjacents,65
Mascarenhasia_rubra,5,5,0,Points-PointsKO-Adjacents,35
Mascarenhasia_speciosa,38,26,12,Alphahull-PointsKO-Adjacents,111
Mascarenhasia_tampinensis,5,5,0,Points-PointsKO-Adjacents,18
Maschalodesme_arborea,2,2,0,Points-PointsKO-Adjacents,18
Masoala_kona,9,2,7,Points-PointsKO-Adjacents,31
Masoala_madagascariensis,12,6,6,Points-PointsKO-Adjacents,72
Massularia_acuminata,506,430,76,Alphahull-PointsKO-Adjacents,17778
Mastixia_arborea,0,0,0,NA,0
Mastixia_caudatilimba,3,3,0,Points-PointsKO-Adjacents,27
Mastixia_congylos,0,0,0,NA,0
Mastixia_cuspidata,3,1,2,Points-PointsKO-Adjacents,27
Mastixia_eugenioides,1,1,0,Points-PointsKO-Adjacents,9
Mastixia_euonymoides,2,2,0,Points-PointsKO-Adjacents,12
Mastixia_glauca,0,0,0,NA,0
Mastixia_macrocarpa,0,0,0,NA,0
Mastixia_microcarpa,NA,NA,NA,NA,NA
Mastixia_montana,0,0,0,NA,0
Mastixia_nimalii,0,0,0,NA,0
Mastixia_octandra,1,1,0,Points-PointsKO-Adjacents,9
Mastixia_parviflora,NA,NA,NA,NA,NA
Mastixia_pentandra,22,0,22,Points-PointsKO-Adjacents,192
Mastixia_rostrata,19,12,7,Points-PointsKO-Adjacents,147
Mastixia_tetrandra,0,0,0,NA,0
Mastixia_tetrapetala,1,1,0,Points-PointsKO-Adjacents,9
Mastixia_trichophylla,0,0,0,NA,0
Mastixia_trichotoma,18,4,14,Points-PointsKO-Adjacents,154
Mastixiodendron_flavidum,0,0,0,NA,0
Mastixiodendron_pachyclados,40,12,28,Points-PointsKO-Adjacents,247
Mastixiodendron_pilosum,0,0,0,NA,0
Mastixiodendron_plectocarpum,8,3,5,Points-PointsKO-Adjacents,33
Mastixiodendron_robustum,0,0,0,NA,0
Mastixiodendron_smithii,10,4,6,Points-PointsKO-Adjacents,58
Mastixiodendron_stoddardii,6,0,6,Points-PointsKO-Adjacents,27
Matayba_adenanthera,97,40,57,Alphahull-PointsKO-Adjacents,6947
Matayba_arborescens,793,698,95,Alphahull-PointsKO-Adjacents,73868
Matayba_atropurpurea,24,0,24,Points-PointsKO-Adjacents,164
Matayba_boliviana,17,9,8,Points-PointsKO-Adjacents,115
Matayba_camptoneura,98,0,98,Points-PointsKO-Adjacents,651
Matayba_clavelligera,62,41,21,Alphahull-PointsKO-Adjacents,1129
Matayba_cristae,87,67,20,Alphahull-PointsKO-Adjacents,2943
Matayba_discolor,146,75,71,Alphahull-PointsKO-Adjacents,1455
Matayba_domingensis,64,42,22,Alphahull-PointsKO-Adjacents,603
Matayba_elaeagnoides,1139,1050,89,Alphahull-PointsKO-Adjacents,19318
Matayba_elegans,162,112,50,Alphahull-PointsKO-Adjacents,14922
Matayba_glaberrima,97,54,43,Alphahull-PointsKO-Adjacents,638
Matayba_grandis,22,7,15,Points-PointsKO-Adjacents,157
Matayba_guianensis,2077,1894,183,Alphahull-PointsKO-Adjacents,120115
Matayba_heterophylla,167,139,28,Alphahull-PointsKO-Adjacents,5804
Matayba_inelegans,353,283,70,Alphahull-PointsKO-Adjacents,51102
Matayba_ingifolia,34,24,10,Alphahull-PointsKO-Adjacents,353
Matayba_intermedia,293,0,293,Points-PointsKO-Adjacents,1428
Matayba_juglandifolia,244,204,40,Alphahull-PointsKO-Adjacents,4742
Matayba_kavanayena,8,2,6,Points-PointsKO-Adjacents,68
Matayba_kennedyae,1,1,0,Points-PointsKO-Adjacents,9
Matayba_laevigata,37,13,24,Points-PointsKO-Adjacents,300
Matayba_longipes,33,11,22,Points-PointsKO-Adjacents,224
Matayba_macrocarpa,25,15,10,Points-PointsKO-Adjacents,164
Matayba_marginata,135,102,33,Alphahull-PointsKO-Adjacents,6215
Matayba_mollis,121,101,20,Alphahull-PointsKO-Adjacents,1341
Matayba_opaca,284,238,46,Alphahull-PointsKO-Adjacents,19956
Matayba_oppositifolia,216,178,38,Alphahull-PointsKO-Adjacents,4871
Matayba_paucijuga,1,1,0,Points-PointsKO-Adjacents,9
Matayba_peruviana,72,37,35,Alphahull-PointsKO-Adjacents,2093
Matayba_ptariana,73,61,12,Alphahull-PointsKO-Adjacents,1860
Matayba_purgans,222,148,74,Alphahull-PointsKO-Adjacents,30036
Matayba_robusta,4,4,0,Points-PointsKO-Adjacents,36
Matayba_scrobiculata,182,109,73,Alphahull-PointsKO-Adjacents,9765
Matayba_spruceana,67,17,50,Points-PointsKO-Adjacents,528
Matayba_stenodictya,12,0,12,Points-PointsKO-Adjacents,75
Matayba_sylvatica,31,15,16,Points-PointsKO-Adjacents,181
Matayba_yutajensis,9,3,6,Points-PointsKO-Adjacents,38
Matelea_tristis,13,5,8,Points-PointsKO-Adjacents,84
Mathurina_penduliflora,0,0,0,NA,0
Matisia_alata,6,1,5,Points-PointsKO-Adjacents,51
Matisia_alchornifolia,39,21,18,Alphahull-PointsKO-Adjacents,406
Matisia_amplifolia,17,6,11,Points-PointsKO-Adjacents,138
Matisia_arteagensis,55,33,22,Alphahull-PointsKO-Adjacents,1776
Matisia_bicolor,78,54,24,Alphahull-PointsKO-Adjacents,4297
Matisia_bolivarii,59,46,13,Alphahull-PointsKO-Adjacents,1284
Matisia_bracteolosa,16,0,16,Points-PointsKO-Adjacents,132
Matisia_calimana,17,5,12,Points-PointsKO-Adjacents,130
Matisia_castano,87,68,19,Alphahull-PointsKO-Adjacents,1363
Matisia_coloradorum,20,13,7,Points-PointsKO-Adjacents,118
Matisia_cordata,376,308,68,Alphahull-PointsKO-Adjacents,18760
Matisia_dolichopoda,46,0,46,Points-PointsKO-Adjacents,291
Matisia_dolichosiphon,3,3,0,Points-PointsKO-Adjacents,21
Matisia_exalata,22,16,6,Points-PointsKO-Adjacents,58
Matisia_floccosa,46,0,46,Points-PointsKO-Adjacents,345
Matisia_giacomettoi,13,4,9,Points-PointsKO-Adjacents,86
Matisia_grandifolia,22,17,5,Points-PointsKO-Adjacents,157
Matisia_idroboi,67,45,22,Alphahull-PointsKO-Adjacents,4417
Quararibea_inaequilatera,24,10,14,Points-PointsKO-Adjacents,201
Matisia_intricata,5,5,0,Points-PointsKO-Adjacents,45
Matisia_jefensis,11,7,4,Points-PointsKO-Adjacents,30
Matisia_lasiocalyx,72,37,35,Alphahull-PointsKO-Adjacents,2809
Matisia_lecythicarpa,7,0,7,Points-PointsKO-Adjacents,45
Matisia_leptandra,29,19,10,Points-PointsKO-Adjacents,157
Matisia_longiflora,26,17,9,Points-PointsKO-Adjacents,169
Matisia_longipes,26,13,13,Points-PointsKO-Adjacents,166
Matisia_longitubulosa,2,2,0,Points-PointsKO-Adjacents,18
Matisia_malacocalyx,219,194,25,Alphahull-PointsKO-Adjacents,5374
Matisia_obliquifolia,228,188,40,Alphahull-PointsKO-Adjacents,3333
Matisia_oblongifolia,59,43,16,Alphahull-PointsKO-Adjacents,2323
Matisia_ochrocalyx,401,315,86,Alphahull-PointsKO-Adjacents,37976
Matisia_palenquiana,8,3,5,Points-PointsKO-Adjacents,62
Matisia_samariensis,5,5,0,Points-PointsKO-Adjacents,39
Matisia_sanblasensis,35,23,12,Alphahull-PointsKO-Adjacents,285
Matisia_serpicostata,1,1,0,Points-PointsKO-Adjacents,9
Matisia_soegengii,66,52,14,Alphahull-PointsKO-Adjacents,1050
Matisia_spathacea,9,1,8,Points-PointsKO-Adjacents,62
Matisia_stenopetala,24,14,10,Points-PointsKO-Adjacents,99
Quararibea_sulcata,3,3,0,Points-PointsKO-Adjacents,27
Matisia_tinamastiana,9,5,4,Points-PointsKO-Adjacents,60
Quararibea_uribei,14,10,4,Points-PointsKO-Adjacents,103
Mattfeldanthus_andrade-limae,23,6,17,Points-PointsKO-Adjacents,178
Matudaea_colombiana,13,3,10,Points-PointsKO-Adjacents,104
Matudaea_trinervia,103,0,103,Points-PointsKO-Adjacents,297
Mauloutchia_chapelieri,44,30,14,Alphahull-PointsKO-Adjacents,470
Mauloutchia_coriacea,8,0,8,Points-PointsKO-Adjacents,46
Mauloutchia_heckelii,2,2,0,Points-PointsKO-Adjacents,18
Mauloutchia_parvifolia,12,1,11,Points-PointsKO-Adjacents,88
Mauloutchia_sambiranensis,5,5,0,Points-PointsKO-Adjacents,21
Mauria_ferruginea,102,80,22,Alphahull-PointsKO-Adjacents,687
Mauria_heterophylla,669,565,104,Alphahull-PointsKO-Adjacents,9816
Mauria_killipii,4,4,0,Points-PointsKO-Adjacents,36
Mauria_membranifolia,4,4,0,Points-PointsKO-Adjacents,33
Mauria_obtusifolia,7,3,4,Points-PointsKO-Adjacents,63
Mauria_peruviana,8,0,8,Points-PointsKO-Adjacents,72
Mauria_sericea,4,4,0,Points-PointsKO-Adjacents,33
Mauria_simplicifolia,87,59,28,Alphahull-PointsKO-Adjacents,1243
Mauria_subserrata,45,28,17,Alphahull-PointsKO-Adjacents,309
Mauria_thaumatophylla,59,43,16,Alphahull-PointsKO-Adjacents,516
Mauria_trichothyrsa,1,1,0,Points-PointsKO-Adjacents,9
Mauritia_carana,85,59,26,Alphahull-PointsKO-Adjacents,4405
Mauritia_flexuosa,926,832,94,Alphahull-PointsKO-Adjacents,96160
Mauritiella_aculeata,163,112,51,Alphahull-PointsKO-Adjacents,11589
Mauritiella_armata,372,269,103,Alphahull-PointsKO-Adjacents,40142
Mauritiella_macroclada,18,10,8,Points-PointsKO-Adjacents,114
Cassine_maurocenia,7,0,7,Points-PointsKO-Adjacents,57
Maxburretia_furtadoana,0,0,0,NA,0
Maxburretia_gracilis,2,2,0,Points-PointsKO-Adjacents,7
Mayna_grandifolia,153,114,39,Alphahull-PointsKO-Adjacents,7801
Mayna_odorata,948,856,92,Alphahull-PointsKO-Adjacents,30054
Mayna_pubescens,2,2,0,Points-PointsKO-Adjacents,18
Mayna_suaveolens,4,4,0,Points-PointsKO-Adjacents,36
Mayodendron_igneum,29,7,22,Points-PointsKO-Adjacents,240
Maytenus_abbottii,8,5,3,Points-PointsKO-Adjacents,36
Maytenus_acuminata,319,221,98,Alphahull-PointsKO-Adjacents,10911
Maytenus_agostinii,0,0,0,NA,0
Maytenus_alaternoides,9,0,9,Points-PointsKO-Adjacents,45
Maytenus_amazonica,19,10,9,Points-PointsKO-Adjacents,139
Maytenus_angolensis,0,0,0,NA,0
Maytenus_apiculata,5,5,0,Points-PointsKO-Adjacents,43
Maytenus_apurimacensis,4,4,0,Points-PointsKO-Adjacents,36
Maytenus_basidentata,2,2,0,Points-PointsKO-Adjacents,18
Maytenus_belizensis,26,13,13,Points-PointsKO-Adjacents,185
Maytenus_boaria,215,147,68,Alphahull-PointsKO-Adjacents,6696
Maytenus_boarioides,7,2,5,Points-PointsKO-Adjacents,53
Maytenus_brasiliensis,153,117,36,Alphahull-PointsKO-Adjacents,2239
Maytenus_buxifolia,50,28,22,Alphahull-PointsKO-Adjacents,679
Maytenus_cajalbanica,4,4,0,Points-PointsKO-Adjacents,23
Maytenus_canariensis,101,0,101,Points-PointsKO-Adjacents,159
Maytenus_cardenasii,85,66,19,Alphahull-PointsKO-Adjacents,1425
Maytenus_cassineformis,59,0,59,Points-PointsKO-Adjacents,364
Maytenus_catingarum,107,96,11,Alphahull-PointsKO-Adjacents,1150
Maytenus_cestrifolia,66,39,27,Alphahull-PointsKO-Adjacents,624
Maytenus_chasei,3,3,0,Points-PointsKO-Adjacents,24
Maytenus_chiapensis,19,0,19,Points-PointsKO-Adjacents,78
Maytenus_communis,159,132,27,Alphahull-PointsKO-Adjacents,3339
Maytenus_cordata,20,6,14,Points-PointsKO-Adjacents,162
Maytenus_coriacea,1,1,0,Points-PointsKO-Adjacents,9
Maytenus_curranii,1,1,0,Points-PointsKO-Adjacents,9
Maytenus_dasyclados,172,135,37,Alphahull-PointsKO-Adjacents,7229
Maytenus_distichophylla,279,1,278,Points-PointsKO-Adjacents,1267
Maytenus_dryandri,5,3,2,Points-PointsKO-Adjacents,20
Maytenus_durifolia,7,0,7,Points-PointsKO-Adjacents,51
Maytenus_ebenifolia,31,7,24,Points-PointsKO-Adjacents,257
Maytenus_eggersii,9,2,7,Points-PointsKO-Adjacents,62
Maytenus_elongata,16,13,3,Points-PointsKO-Adjacents,62
Maytenus_erythrocarpa,17,5,12,Points-PointsKO-Adjacents,130
Maytenus_evonymoides,552,0,552,Points-PointsKO-Adjacents,3108
Maytenus_ficiformis,50,32,18,Alphahull-PointsKO-Adjacents,1848
Maytenus_glaucescens,126,99,27,Alphahull-PointsKO-Adjacents,1558
Maytenus_gonoclada,986,904,82,Alphahull-PointsKO-Adjacents,17515
Maytenus_grisea,5,4,1,Points-PointsKO-Adjacents,27
Maytenus_guyanensis,465,394,71,Alphahull-PointsKO-Adjacents,40252
Maytenus_horrida,29,15,14,Points-PointsKO-Adjacents,232
Maytenus_huberi,7,0,7,Points-PointsKO-Adjacents,50
Maytenus_ilicina,2,2,0,Points-PointsKO-Adjacents,17
Maytenus_jefeana,7,3,4,Points-PointsKO-Adjacents,46
Maytenus_jelskii,36,11,25,Points-PointsKO-Adjacents,256
Maytenus_kanukuensis,15,6,9,Points-PointsKO-Adjacents,99
Maytenus_karstenii,34,18,16,Points-PointsKO-Adjacents,235
Maytenus_krukovii,10,0,10,Points-PointsKO-Adjacents,90
Maytenus_laevigata,59,29,30,Alphahull-PointsKO-Adjacents,343
Maytenus_laevis,85,62,23,Alphahull-PointsKO-Adjacents,2093
Maytenus_laurina,10,0,10,Points-PointsKO-Adjacents,75
Maytenus_lineata,0,0,0,NA,0
Maytenus_longifolia,53,39,14,Alphahull-PointsKO-Adjacents,301
Maytenus_longipes,35,22,13,Alphahull-PointsKO-Adjacents,1373
Maytenus_longistipitata,3,3,0,Points-PointsKO-Adjacents,27
Maytenus_macrocarpa,204,169,35,Alphahull-PointsKO-Adjacents,8946
Maytenus_macrophylla,32,17,15,Points-PointsKO-Adjacents,217
Maytenus_manabiensis,3,3,0,Points-PointsKO-Adjacents,25
Maytenus_matudae,17,0,17,Points-PointsKO-Adjacents,90
Maytenus_meguillensis,24,10,14,Points-PointsKO-Adjacents,183
Maytenus_meridensis,5,0,5,Points-PointsKO-Adjacents,34
Maytenus_myrsinoides,143,99,44,Alphahull-PointsKO-Adjacents,10983
Maytenus_neblinae,2,2,0,Points-PointsKO-Adjacents,18
Maytenus_novograntensis,25,14,11,Points-PointsKO-Adjacents,115
Maytenus_oblongata,65,41,24,Alphahull-PointsKO-Adjacents,3060
Maytenus_obtusifolia,348,245,103,Alphahull-PointsKO-Adjacents,6841
Maytenus_officinalis,99,61,38,Alphahull-PointsKO-Adjacents,6072
Maytenus_oleoides,128,99,29,Alphahull-PointsKO-Adjacents,1322
Gymnosporia_parviflora,4,4,0,Points-PointsKO-Adjacents,36
Maytenus_patens,89,49,40,Alphahull-PointsKO-Adjacents,1958
Maytenus_peduncularis,121,84,37,Alphahull-PointsKO-Adjacents,2270
Maytenus_peruana,13,2,11,Points-PointsKO-Adjacents,100
Maytenus_pittieriana,8,2,6,Points-PointsKO-Adjacents,57
Maytenus_planifolia,13,8,5,Points-PointsKO-Adjacents,56
Maytenus_ponceana,13,7,6,Points-PointsKO-Adjacents,59
Maytenus_pruinosa,48,29,19,Alphahull-PointsKO-Adjacents,1580
Maytenus_prunifolia,36,15,21,Points-PointsKO-Adjacents,238
Maytenus_pseudoboaria,9,0,9,Points-PointsKO-Adjacents,81
Maytenus_purpusii,13,2,11,Points-PointsKO-Adjacents,89
Maytenus_pustulata,2,2,0,Points-PointsKO-Adjacents,15
Maytenus_quadrangulata,52,32,20,Alphahull-PointsKO-Adjacents,573
Maytenus_radlkoferiana,2,2,0,Points-PointsKO-Adjacents,18
Maytenus_recondita,47,36,11,Alphahull-PointsKO-Adjacents,227
Maytenus_retusa,9,1,8,Points-PointsKO-Adjacents,71
Maytenus_rigida,569,0,569,Points-PointsKO-Adjacents,3224
Maytenus_salicifolia,58,30,28,Alphahull-PointsKO-Adjacents,963
Maytenus_schippii,128,87,41,Alphahull-PointsKO-Adjacents,2553
Maytenus_schumanniana,180,144,36,Alphahull-PointsKO-Adjacents,2471
Maytenus_scutioides,26,18,8,Points-PointsKO-Adjacents,208
Maytenus_segoviarum,116,105,11,Alphahull-PointsKO-Adjacents,1207
Maytenus_sieberiana,23,3,20,Points-PointsKO-Adjacents,188
Maytenus_spinosa,129,95,34,Alphahull-PointsKO-Adjacents,6110
Maytenus_sprucei,29,11,18,Points-PointsKO-Adjacents,227
Maytenus_stipitata,17,10,7,Points-PointsKO-Adjacents,82
Maytenus_tikalensis,3,3,0,Points-PointsKO-Adjacents,26
Maytenus_undata,354,265,89,Alphahull-PointsKO-Adjacents,11000
Maytenus_verticillata,124,73,51,Alphahull-PointsKO-Adjacents,1638
Maytenus_viscifolia,53,33,20,Alphahull-PointsKO-Adjacents,2361
Maytenus_vitis-idaea,134,102,32,Alphahull-PointsKO-Adjacents,11122
Maytenus_williamsii,2,2,0,Points-PointsKO-Adjacents,18
Maytenus_woodsonii,48,39,9,Alphahull-PointsKO-Adjacents,79
Mecranium_alpestre,2,2,0,Points-PointsKO-Adjacents,16
Mecranium_amygdalinum,24,9,15,Points-PointsKO-Adjacents,150
Mecranium_birimosum,6,2,4,Points-PointsKO-Adjacents,51
Mecranium_crassinerve,2,2,0,Points-PointsKO-Adjacents,12
Mecranium_haemanthum,9,1,8,Points-PointsKO-Adjacents,61
Mecranium_haitiense,5,5,0,Points-PointsKO-Adjacents,23
Mecranium_integrifolium,33,15,18,Points-PointsKO-Adjacents,187
Mecranium_latifolium,60,49,11,Alphahull-PointsKO-Adjacents,82
Mecranium_multiflorum,7,1,6,Points-PointsKO-Adjacents,47
Mecranium_ovatum,13,9,4,Points-PointsKO-Adjacents,31
Mecranium_plicatum,1,1,0,Points-PointsKO-Adjacents,9
Mecranium_puberulum,19,14,5,Points-PointsKO-Adjacents,78
Mecranium_purpurascens,7,3,4,Points-PointsKO-Adjacents,36
Mecranium_revolutum,2,2,0,Points-PointsKO-Adjacents,18
Mecranium_septentrionale,7,3,4,Points-PointsKO-Adjacents,36
Mecranium_tricostatum,4,4,0,Points-PointsKO-Adjacents,19
Medemia_argun,15,5,10,Points-PointsKO-Adjacents,113
Medicago_arborea,355,209,146,Alphahull-PointsKO-Adjacents,5586
Medicago_citrina,43,16,27,Points-PointsKO-Adjacents,189
Medinilla_arboricola,6,1,5,Points-PointsKO-Adjacents,54
Medinilla_assamica,31,14,17,Points-PointsKO-Adjacents,237
Medinilla_lanceata,0,0,0,NA,0
Mediusella_bernieri,31,26,5,Alphahull-PointsKO-Adjacents,65
Medusandra_mpomiana,24,18,6,Points-PointsKO-Adjacents,156
Medusandra_richardsiana,15,11,4,Points-PointsKO-Adjacents,64
Medusanthera_gracilis,8,1,7,Points-PointsKO-Adjacents,61
Medusanthera_laxiflora,91,48,43,Alphahull-PointsKO-Adjacents,764
Medusanthera_samoensis,2,2,0,Points-PointsKO-Adjacents,13
Medusanthera_vitiensis,1,1,0,Points-PointsKO-Adjacents,9
Megistostegium_nodulosum,46,33,13,Alphahull-PointsKO-Adjacents,681
Meineckia_acuminata,8,6,2,Points-PointsKO-Adjacents,35
Meineckia_capillipes,4,4,0,Points-PointsKO-Adjacents,27
Meineckia_grandiflora,6,1,5,Points-PointsKO-Adjacents,30
Meineckia_nguruensis,2,2,0,Points-PointsKO-Adjacents,14
Meineckia_ovata,7,3,4,Points-PointsKO-Adjacents,27
Meineckia_paxii,12,6,6,Points-PointsKO-Adjacents,38
Meineckia_pubiflora,3,3,0,Points-PointsKO-Adjacents,18
Meineckia_stipularis,8,2,6,Points-PointsKO-Adjacents,52
Meiocarpidium_lepidotum,69,49,20,Alphahull-PointsKO-Adjacents,703
Meiogyne_baillonii,7,1,6,Points-PointsKO-Adjacents,48
Meiogyne_beccarii,NA,NA,NA,NA,NA
Meiogyne_cylindrocarpa,185,133,52,Alphahull-PointsKO-Adjacents,1303
Meiogyne_lecardii,2,2,0,Points-PointsKO-Adjacents,17
Meiogyne_monosperma,6,2,4,Points-PointsKO-Adjacents,21
Meiogyne_pannosa,1,0,1,Points-PointsKO-Adjacents,9
Meiogyne_ramarowii,1,1,0,Points-PointsKO-Adjacents,9
Meiogyne_tiebaghiensis,3,3,0,Points-PointsKO-Adjacents,24
Meiogyne_virgata,29,0,29,Points-PointsKO-Adjacents,232
Meiostemon_tetrandrus,6,0,6,Points-PointsKO-Adjacents,48
Melaleuca_acacioides,540,0,540,Points-PointsKO-Adjacents,2192
Melaleuca_acutifolia,161,134,27,Alphahull-PointsKO-Adjacents,1565
Melaleuca_alsophila,156,132,24,Alphahull-PointsKO-Adjacents,1543
Melaleuca_alternifolia,361,340,21,Alphahull-PointsKO-Adjacents,848
Melaleuca_amydra,36,29,7,Alphahull-PointsKO-Adjacents,136
Melaleuca_arcana,105,0,105,Points-PointsKO-Adjacents,217
Melaleuca_argentea,779,712,67,Alphahull-PointsKO-Adjacents,21540
Melaleuca_armillaris,1106,866,240,Alphahull-PointsKO-Adjacents,5708
Melaleuca_atroviridis,251,240,11,Alphahull-PointsKO-Adjacents,2259
Melaleuca_biconvexa,314,226,88,Alphahull-PointsKO-Adjacents,249
Melaleuca_bracteata,1099,984,115,Alphahull-PointsKO-Adjacents,22555
Melaleuca_brevifolia,1401,1329,72,Alphahull-PointsKO-Adjacents,3768
Melaleuca_brevisepala,2,2,0,Points-PointsKO-Adjacents,17
Melaleuca_buseana,9,6,3,Points-PointsKO-Adjacents,48
Melaleuca_cajuputi,1285,1185,100,Alphahull-PointsKO-Adjacents,6561
Melaleuca_cheelii,70,54,16,Alphahull-PointsKO-Adjacents,124
Melaleuca_citrina,63,34,29,Alphahull-PointsKO-Adjacents,557
Melaleuca_citrolens,380,345,35,Alphahull-PointsKO-Adjacents,5141
Melaleuca_clarksonii,67,42,25,Alphahull-PointsKO-Adjacents,1009
Melaleuca_croxfordiae,33,0,33,Points-PointsKO-Adjacents,99
Melaleuca_cuticularis,285,252,33,Alphahull-PointsKO-Adjacents,1845
Melaleuca_dawsonii,13,7,6,Points-PointsKO-Adjacents,39
Melaleuca_dealbata,499,420,79,Alphahull-PointsKO-Adjacents,6843
Melaleuca_decora,892,671,221,Alphahull-PointsKO-Adjacents,2886
Melaleuca_decussata,1279,0,1279,Points-PointsKO-Adjacents,1336
Melaleuca_eleuterostachya,617,0,617,Points-PointsKO-Adjacents,2425
Melaleuca_ericifolia,995,0,995,Points-PointsKO-Adjacents,1483
Melaleuca_fluviatilis,350,314,36,Alphahull-PointsKO-Adjacents,7725
Melaleuca_foliolosa,212,36,176,Alphahull-PointsKO-Adjacents,1393
Melaleuca_gibbosa,1320,1264,56,Alphahull-PointsKO-Adjacents,2431
Melaleuca_globifera,35,27,8,Alphahull-PointsKO-Adjacents,69
Melaleuca_glomerata,1099,1054,45,Alphahull-PointsKO-Adjacents,22962
Melaleuca_groveana,150,126,24,Alphahull-PointsKO-Adjacents,1685
Melaleuca_halmaturorum,1093,1030,63,Alphahull-PointsKO-Adjacents,6529
Melaleuca_hamata,744,726,18,Alphahull-PointsKO-Adjacents,6771
Melaleuca_hamulosa,175,154,21,Alphahull-PointsKO-Adjacents,2852
Melaleuca_huegelii,113,72,41,Alphahull-PointsKO-Adjacents,584
Melaleuca_hypericifolia,353,260,93,Alphahull-PointsKO-Adjacents,836
Melaleuca_incana,274,223,51,Alphahull-PointsKO-Adjacents,1555
Melaleuca_lanceolata,7811,7602,209,Alphahull-PointsKO-Adjacents,15702
Melaleuca_lasiandra,428,392,36,Alphahull-PointsKO-Adjacents,14616
Melaleuca_lateriflora,424,401,23,Alphahull-PointsKO-Adjacents,4095
Melaleuca_leucadendra,1877,1740,137,Alphahull-PointsKO-Adjacents,16574
Melaleuca_linariifolia,1905,1583,322,Alphahull-PointsKO-Adjacents,5109
Melaleuca_longistaminea,85,71,14,Alphahull-PointsKO-Adjacents,418
Melaleuca_minutifolia,418,390,28,Alphahull-PointsKO-Adjacents,3024
Melaleuca_nanophylla,32,24,8,Alphahull-PointsKO-Adjacents,111
Melaleuca_nervosa,2160,2073,87,Alphahull-PointsKO-Adjacents,22794
Melaleuca_nodosa,1679,1430,249,Alphahull-PointsKO-Adjacents,5046
Melaleuca_pancheri,13,10,3,Points-PointsKO-Adjacents,32
Melaleuca_parvistaminea,470,421,49,Alphahull-PointsKO-Adjacents,2271
Melaleuca_pauperiflora,1275,1230,45,Alphahull-PointsKO-Adjacents,6502
Melaleuca_phoidophylla,69,60,9,Alphahull-PointsKO-Adjacents,1127
Melaleuca_preissiana,197,0,197,Points-PointsKO-Adjacents,712
Melaleuca_pustulata,202,197,5,Alphahull-PointsKO-Adjacents,96
Melaleuca_quinquenervia,2631,2185,446,Alphahull-PointsKO-Adjacents,9160
Melaleuca_rhaphiophylla,384,308,76,Alphahull-PointsKO-Adjacents,2040
Melaleuca_saligna,191,0,191,Points-PointsKO-Adjacents,703
Melaleuca_sericea,140,0,140,Points-PointsKO-Adjacents,516
Melaleuca_sheathiana,105,91,14,Alphahull-PointsKO-Adjacents,2100
Melaleuca_sieberi,966,0,966,Points-PointsKO-Adjacents,965
Melaleuca_spectabilis,18,16,2,Points-PointsKO-Adjacents,20
Melaleuca_sphaerodendra,47,30,17,Alphahull-PointsKO-Adjacents,135
Melaleuca_squamophloia,66,62,4,Alphahull-PointsKO-Adjacents,322
Melaleuca_squarrosa,3934,3808,126,Alphahull-PointsKO-Adjacents,4765
Melaleuca_stenostachya,315,293,22,Alphahull-PointsKO-Adjacents,3863
Melaleuca_stereophloia,256,0,256,Points-PointsKO-Adjacents,970
Melaleuca_stipitata,7,3,4,Points-PointsKO-Adjacents,28
Melaleuca_strobophylla,111,83,28,Alphahull-PointsKO-Adjacents,1902
Melaleuca_styphelioides,1792,1454,338,Alphahull-PointsKO-Adjacents,2958
Melaleuca_subalaris,34,29,5,Alphahull-PointsKO-Adjacents,384
Melaleuca_tamariscina,121,108,13,Alphahull-PointsKO-Adjacents,1592
Melaleuca_teretifolia,100,0,100,Points-PointsKO-Adjacents,271
Melaleuca_thyoides,205,188,17,Alphahull-PointsKO-Adjacents,2622
Melaleuca_uncinata,4575,4473,102,Alphahull-PointsKO-Adjacents,28460
Melaleuca_viminea,488,0,488,Points-PointsKO-Adjacents,1665
Melaleuca_viridiflora,4223,4087,136,Alphahull-PointsKO-Adjacents,19765
Melaleuca_xerophila,168,141,27,Alphahull-PointsKO-Adjacents,2938
Nothopegia_borneensis,2,2,0,Points-PointsKO-Adjacents,18
Semecarpus_caesia,10,0,10,Points-PointsKO-Adjacents,81
Rhus_retusa,75,33,42,Alphahull-PointsKO-Adjacents,424
Melanolepis_multiglandulosa,164,1,163,Points-PointsKO-Adjacents,730
Melanolepis_vitifolia,1,1,0,Points-PointsKO-Adjacents,9
Melanophylla_alnifolia,46,28,18,Alphahull-PointsKO-Adjacents,707
Melanophylla_angustior,3,3,0,Points-PointsKO-Adjacents,9
Melanophylla_aucubifolia,74,57,17,Alphahull-PointsKO-Adjacents,372
Melanophylla_crenata,54,35,19,Alphahull-PointsKO-Adjacents,262
Melanophylla_madagascariensis,7,3,4,Points-PointsKO-Adjacents,37
Melanophylla_modestei,6,0,6,Points-PointsKO-Adjacents,18
Melanophylla_perrieri,4,4,0,Points-PointsKO-Adjacents,33
Melanopsidium_nigrum,120,0,120,Points-PointsKO-Adjacents,580
Melanoxerus_suavissimus,75,48,27,Alphahull-PointsKO-Adjacents,1251
Melanoxylon_brauna,364,311,53,Alphahull-PointsKO-Adjacents,6209
Melastoma_dodecandrum,135,107,28,Alphahull-PointsKO-Adjacents,6766
Melastoma_imbricatum,7,0,7,Points-PointsKO-Adjacents,63
Melastoma_sanguineum,55,22,33,Alphahull-PointsKO-Adjacents,1387
Melia_azedarach,4085,2938,1147,Alphahull-PointsKO-Adjacents,86262
Melia_volkensii,9,1,8,Points-PointsKO-Adjacents,66
Melianthus_comosus,125,92,33,Alphahull-PointsKO-Adjacents,5807
Melicoccus_antioquensis,2,2,0,Points-PointsKO-Adjacents,18
Melicoccus_aymardii,1,1,0,Points-PointsKO-Adjacents,9
Melicoccus_bijugatus,233,180,53,Alphahull-PointsKO-Adjacents,7086
Melicoccus_espiritosantensis,13,0,13,Points-PointsKO-Adjacents,59
Melicoccus_jimenezii,2,2,0,Points-PointsKO-Adjacents,17
Melicoccus_lepidopetalus,96,61,35,Alphahull-PointsKO-Adjacents,2292
Melicoccus_novogranatensis,15,10,5,Points-PointsKO-Adjacents,68
Melicoccus_oliviformis,43,18,25,Points-PointsKO-Adjacents,342
Melicoccus_pedicellaris,54,25,29,Alphahull-PointsKO-Adjacents,1970
Melicope_accedens,25,2,23,Points-PointsKO-Adjacents,206
Melicope_adscendens,2,2,0,Points-PointsKO-Adjacents,7
Melicope_anisata,8,6,2,Points-PointsKO-Adjacents,16
Melicope_bakeri,9,4,5,Points-PointsKO-Adjacents,47
Melicope_balankazo,3,3,0,Points-PointsKO-Adjacents,27
Melicope_balloui,3,3,0,Points-PointsKO-Adjacents,13
Melicope_barbigera,7,4,3,Points-PointsKO-Adjacents,23
Melicope_belahe,26,12,14,Points-PointsKO-Adjacents,154
Melicope_bonwickii,138,90,48,Alphahull-PointsKO-Adjacents,784
Melicope_burmahia,0,0,0,NA,0
Melicope_christophersenii,1,1,0,Points-PointsKO-Adjacents,9
Melicope_chunii,0,0,0,NA,0
Melicope_cinerea,2,2,0,Points-PointsKO-Adjacents,16
Melicope_clusiifolia,41,27,14,Alphahull-PointsKO-Adjacents,151
Melicope_confusa,16,2,14,Points-PointsKO-Adjacents,122
Melicope_cruciata,5,5,0,Points-PointsKO-Adjacents,21
Melicope_degeneri,5,2,3,Points-PointsKO-Adjacents,14
Melicope_denhamii,214,163,51,Alphahull-PointsKO-Adjacents,4770
Melicope_elleryana,1094,961,133,Alphahull-PointsKO-Adjacents,10335
Melicope_fatraina,9,1,8,Points-PointsKO-Adjacents,57
Melicope_fatuhivensis,NA,NA,NA,NA,NA
Melicope_feddei,5,5,0,Points-PointsKO-Adjacents,23
Melicope_floribunda,3,3,0,Points-PointsKO-Adjacents,27
Melicope_glabra,7,1,6,Points-PointsKO-Adjacents,52
Melicope_glomerata,5,5,0,Points-PointsKO-Adjacents,45
Melicope_grisea,1,1,0,Points-PointsKO-Adjacents,1
Melicope_haleakalae,8,4,4,Points-PointsKO-Adjacents,19
Melicope_haupuensis,6,3,3,Points-PointsKO-Adjacents,14
Melicope_hawaiensis,13,9,4,Points-PointsKO-Adjacents,58
Melicope_hiiakae,2,2,0,Points-PointsKO-Adjacents,11
Melicope_hosakae,2,2,0,Points-PointsKO-Adjacents,12
Melicope_kaalaensis,0,0,0,NA,0
Evodiella_velutina,6,3,3,Points-PointsKO-Adjacents,25
Melicope_kavaiensis,4,4,0,Points-PointsKO-Adjacents,17
Melicope_knudsenii,5,0,5,Points-PointsKO-Adjacents,23
Melicope_latifolia,68,14,54,Points-PointsKO-Adjacents,423
Melicope_littoralis,2,1,1,Points-PointsKO-Adjacents,3
Melicope_lucida,7,4,3,Points-PointsKO-Adjacents,24
Melicope_lunu-ankenda,15,2,13,Points-PointsKO-Adjacents,125
Melicope_lydgatei,0,0,0,NA,0
Melicope_macrocarpa,1,1,0,Points-PointsKO-Adjacents,9
Melicope_macropus,1,1,0,Points-PointsKO-Adjacents,9
Melicope_madagascariensis,65,53,12,Alphahull-PointsKO-Adjacents,769
Melicope_makahae,1,1,0,Points-PointsKO-Adjacents,9
Melicope_margaretae,4,4,0,Points-PointsKO-Adjacents,4
Melicope_micrococca,1231,1112,119,Alphahull-PointsKO-Adjacents,2397
Melicope_molokaiensis,13,7,6,Points-PointsKO-Adjacents,48
Melicope_mucronulata,2,2,0,Points-PointsKO-Adjacents,9
Melicope_munroi,3,3,0,Points-PointsKO-Adjacents,16
Melicope_nealae,0,0,0,NA,0
Melicope_nukuhivensis,3,3,0,Points-PointsKO-Adjacents,11
Melicope_oahuensis,2,2,0,Points-PointsKO-Adjacents,15
Melicope_obovata,1,1,0,Points-PointsKO-Adjacents,8
Melicope_obtusifolia,0,0,0,NA,0
Melicope_orbicularis,7,4,3,Points-PointsKO-Adjacents,26
Melicope_ovalis,0,0,0,NA,0
Melicope_ovata,5,5,0,Points-PointsKO-Adjacents,15
Melicope_pallida,1,1,0,Points-PointsKO-Adjacents,9
Melicope_paniculata,3,3,0,Points-PointsKO-Adjacents,21
Melicope_peduncularis,11,3,8,Points-PointsKO-Adjacents,68
Melicope_pseudoanisata,11,7,4,Points-PointsKO-Adjacents,34
Melicope_pteleifolia,113,60,53,Alphahull-PointsKO-Adjacents,2306
Melicope_puberula,3,3,0,Points-PointsKO-Adjacents,16
Melicope_quadrangularis,1,1,0,Points-PointsKO-Adjacents,9
Melicope_quadrilocularis,0,0,0,NA,0
Melicope_radiata,3,3,0,Points-PointsKO-Adjacents,24
Melicope_reflexa,0,0,0,NA,0
Melicope_richii,4,4,0,Points-PointsKO-Adjacents,16
Melicope_rotundifolia,2,2,0,Points-PointsKO-Adjacents,12
Melicope_saintjohnii,0,0,0,NA,0
Melicope_sambiranensis,4,4,0,Points-PointsKO-Adjacents,36
Melicope_sandwicensis,2,1,1,Points-PointsKO-Adjacents,14
Melicope_seemannii,0,0,0,NA,0
Melicope_semecarpifolia,98,73,25,Alphahull-PointsKO-Adjacents,328
Melicope_sessilis,8,4,4,Points-PointsKO-Adjacents,33
Melicope_subunifoliolata,6,1,5,Points-PointsKO-Adjacents,30
Melicope_trichantha,0,0,0,NA,0
Melicope_triphylla,114,52,62,Alphahull-PointsKO-Adjacents,1522
Melicope_tsaratananensis,6,0,6,Points-PointsKO-Adjacents,19
Melicope_vatiana,0,0,0,NA,0
Melicope_viticina,6,0,6,Points-PointsKO-Adjacents,36
Melicope_volcanica,14,7,7,Points-PointsKO-Adjacents,92
Melicope_waialealae,5,1,4,Points-PointsKO-Adjacents,19
Melicope_wailauensis,0,0,0,NA,0
Melicope_wawraeana,6,1,5,Points-PointsKO-Adjacents,32
Melicope_xanthoxyloides,130,107,23,Alphahull-PointsKO-Adjacents,304
Melicope_zahlbruckneri,0,0,0,NA,0
Hymenanthera_latifolia,6,1,5,Points-PointsKO-Adjacents,16
Melicytus_novae-zelandiae,74,0,74,Points-PointsKO-Adjacents,227
Melientha_suavis,10,1,9,Points-PointsKO-Adjacents,82
Meliosma_alba,6,1,5,Points-PointsKO-Adjacents,54
Meliosma_allenii,89,74,15,Alphahull-PointsKO-Adjacents,382
Meliosma_andina,9,3,6,Points-PointsKO-Adjacents,52
Meliosma_angustifolia,14,0,14,Points-PointsKO-Adjacents,117
Meliosma_antioquiensis,4,4,0,Points-PointsKO-Adjacents,36
Meliosma_arenosa,104,64,40,Alphahull-PointsKO-Adjacents,1211
Meliosma_aristeguietae,4,4,0,Points-PointsKO-Adjacents,30
Meliosma_arnottiana,20,5,15,Points-PointsKO-Adjacents,180
Meliosma_bifida,NA,NA,NA,NA,NA
Meliosma_bogotana,41,22,19,Alphahull-PointsKO-Adjacents,605
Meliosma_brenesii,68,48,20,Alphahull-PointsKO-Adjacents,381
Meliosma_callicarpifolia,36,32,4,Alphahull-PointsKO-Adjacents,25
Meliosma_chartacea,24,9,15,Points-PointsKO-Adjacents,164
Meliosma_chiriquensis,7,2,5,Points-PointsKO-Adjacents,39
Meliosma_clandestina,15,6,9,Points-PointsKO-Adjacents,71
Meliosma_cordata,2,2,0,Points-PointsKO-Adjacents,18
Meliosma_corymbosa,14,8,6,Points-PointsKO-Adjacents,77
Meliosma_cresstolina,6,2,4,Points-PointsKO-Adjacents,30
Meliosma_cuneifolia,96,68,28,Alphahull-PointsKO-Adjacents,6666
Meliosma_dentata,259,215,44,Alphahull-PointsKO-Adjacents,4068
Meliosma_depressiva,31,23,8,Alphahull-PointsKO-Adjacents,75
Meliosma_dilleniifolia,11,0,11,Points-PointsKO-Adjacents,87
Meliosma_donnellsmithii,70,56,14,Alphahull-PointsKO-Adjacents,401
Meliosma_dumicola,7,0,7,Points-PointsKO-Adjacents,63
Meliosma_echeverriae,8,3,5,Points-PointsKO-Adjacents,57
Meliosma_echeverryana,11,0,11,Points-PointsKO-Adjacents,81
Meliosma_flexuosa,42,22,20,Alphahull-PointsKO-Adjacents,2209
Meliosma_fordii,64,38,26,Alphahull-PointsKO-Adjacents,3086
Meliosma_frondosa,141,90,51,Alphahull-PointsKO-Adjacents,2290
Meliosma_gentryi,1,1,0,Points-PointsKO-Adjacents,9
Meliosma_glabrata,247,200,47,Alphahull-PointsKO-Adjacents,1666
Meliosma_glandulosa,14,3,11,Points-PointsKO-Adjacents,126
Meliosma_glossophylla,10,5,5,Points-PointsKO-Adjacents,53
Meliosma_grandiflora,74,61,13,Alphahull-PointsKO-Adjacents,192
Meliosma_grandifolia,32,12,20,Points-PointsKO-Adjacents,202
Meliosma_henryi,5,5,0,Points-PointsKO-Adjacents,45
Meliosma_herbertii,361,277,84,Alphahull-PointsKO-Adjacents,25689
Meliosma_idiopoda,164,138,26,Alphahull-PointsKO-Adjacents,311
Meliosma_irazuensis,37,37,0,Alphahull,2290
Meliosma_isthmensis,23,14,9,Points-PointsKO-Adjacents,159
Meliosma_itatiaiae,48,33,15,Alphahull-PointsKO-Adjacents,603
Meliosma_kirkii,22,4,18,Points-PointsKO-Adjacents,197
Meliosma_laui,6,0,6,Points-PointsKO-Adjacents,54
Meliosma_laxiflora,4,4,0,Points-PointsKO-Adjacents,14
Meliosma_lindae,2,1,1,Points-PointsKO-Adjacents,12
Meliosma_linearifolia,5,0,5,Points-PointsKO-Adjacents,26
Meliosma_littlei,0,0,0,NA,0
Meliosma_longipes,2,2,0,Points-PointsKO-Adjacents,18
Meliosma_loretoyacuensis,24,9,15,Points-PointsKO-Adjacents,198
Meliosma_martana,6,1,5,Points-PointsKO-Adjacents,30
Meliosma_meridensis,67,0,67,Points-PointsKO-Adjacents,448
Sapindus_microcarpus,0,0,0,NA,0
Meliosma_minutipetala,2,2,0,Points-PointsKO-Adjacents,14
Meliosma_myriantha,431,320,111,Alphahull-PointsKO-Adjacents,4282
Meliosma_nanarum,7,3,4,Points-PointsKO-Adjacents,21
Meliosma_nesites,18,9,9,Points-PointsKO-Adjacents,52
Meliosma_novogranatensis,26,13,13,Points-PointsKO-Adjacents,187
Meliosma_obtusifolia,7,3,4,Points-PointsKO-Adjacents,37
Meliosma_occidentalis,103,76,27,Alphahull-PointsKO-Adjacents,2699
Meliosma_oldhamii,54,24,30,Alphahull-PointsKO-Adjacents,2415
Meliosma_oligantha,5,5,0,Points-PointsKO-Adjacents,35
Meliosma_parviflora,10,1,9,Points-PointsKO-Adjacents,90
Meliosma_paupera,18,0,18,Points-PointsKO-Adjacents,153
Meliosma_petalodentata,27,14,13,Points-PointsKO-Adjacents,110
Meliosma_peytonii,43,24,19,Alphahull-PointsKO-Adjacents,216
Meliosma_pinnata,43,0,43,Points-PointsKO-Adjacents,385
Meliosma_pittieriana,45,10,35,Points-PointsKO-Adjacents,315
Meliosma_pumila,17,0,17,Points-PointsKO-Adjacents,109
Meliosma_rhoifolia,72,0,72,Points-PointsKO-Adjacents,247
Meliosma_rigida,161,90,71,Alphahull-PointsKO-Adjacents,4164
Meliosma_schlimii,17,4,13,Points-PointsKO-Adjacents,132
Meliosma_sellowii,466,407,59,Alphahull-PointsKO-Adjacents,6351
Meliosma_simiarum,10,0,10,Points-PointsKO-Adjacents,81
Meliosma_simplicifolia,26,8,18,Points-PointsKO-Adjacents,211
Meliosma_sirensis,3,3,0,Points-PointsKO-Adjacents,27
Meliosma_solomonii,21,11,10,Points-PointsKO-Adjacents,133
Meliosma_squamulata,144,110,34,Alphahull-PointsKO-Adjacents,2280
Meliosma_stellata,1,1,0,Points-PointsKO-Adjacents,9
Meliosma_subcordata,14,9,5,Points-PointsKO-Adjacents,53
Meliosma_tachirensis,11,2,9,Points-PointsKO-Adjacents,66
Meliosma_thomsonii,11,0,11,Points-PointsKO-Adjacents,99
Meliosma_thorelii,21,3,18,Points-PointsKO-Adjacents,180
Meliosma_trujilloi,NA,NA,NA,NA,NA
Meliosma_vasquezii,71,40,31,Alphahull-PointsKO-Adjacents,2701
Meliosma_veitchiorum,14,4,10,Points-PointsKO-Adjacents,126
Meliosma_velutina,22,6,16,Points-PointsKO-Adjacents,196
Meliosma_venezuelensis,7,1,6,Points-PointsKO-Adjacents,55
Meliosma_vernicosa,41,29,12,Alphahull-PointsKO-Adjacents,129
Meliosma_violacea,52,38,14,Alphahull-PointsKO-Adjacents,619
Meliosma_wurdackii,33,8,25,Points-PointsKO-Adjacents,279
Meliosma_youngii,2,2,0,Points-PointsKO-Adjacents,18
Meliosma_yunnanensis,36,23,13,Alphahull-PointsKO-Adjacents,1549
Melochia_aristata,1,1,0,Points-PointsKO-Adjacents,3
Melochia_caracasana,15,1,14,Points-PointsKO-Adjacents,123
Melochia_degeneriana,2,2,0,Points-PointsKO-Adjacents,12
Melochia_longepetiolata,0,0,0,NA,0
Melochia_oaxacana,14,0,14,Points-PointsKO-Adjacents,53
Melochia_odorata,90,0,90,Points-PointsKO-Adjacents,486
Melochia_pyramidata,1426,1074,352,Alphahull-PointsKO-Adjacents,46887
Melochia_roseiflora,0,0,0,NA,0
Melochia_ulmifolia,47,24,23,Alphahull-PointsKO-Adjacents,1325
Melochia_umbellata,150,70,80,Alphahull-PointsKO-Adjacents,1275
Melochia_villosissima,9,0,9,Points-PointsKO-Adjacents,35
Melodorum_fruticosum,18,0,18,Points-PointsKO-Adjacents,137
Memecylon_aberrans,1,1,0,Points-PointsKO-Adjacents,9
Memecylon_afzelii,108,76,32,Alphahull-PointsKO-Adjacents,895
Memecylon_auratifolium,5,5,0,Points-PointsKO-Adjacents,26
Memecylon_bachmannii,8,2,6,Points-PointsKO-Adjacents,70
Memecylon_boinense,11,3,8,Points-PointsKO-Adjacents,80
Memecylon_breteleranum,1,1,0,Points-PointsKO-Adjacents,9
Memecylon_buxoides,4,4,0,Points-PointsKO-Adjacents,18
Memecylon_caeruleum,6,0,6,Points-PointsKO-Adjacents,52
Memecylon_calophyllum,20,0,20,Points-PointsKO-Adjacents,153
Memecylon_candidum,26,15,11,Points-PointsKO-Adjacents,131
Memecylon_celastrinum,1,0,1,Points-PointsKO-Adjacents,9
Memecylon_cogniauxii,38,28,10,Alphahull-PointsKO-Adjacents,206
Memecylon_collinum,22,16,6,Points-PointsKO-Adjacents,150
Memecylon_cordatum,0,0,0,NA,0
Memecylon_corymbiforme,2,2,0,Points-PointsKO-Adjacents,18
Memecylon_cotinifolioides,12,0,12,Points-PointsKO-Adjacents,73
Memecylon_dalleizettei,1,1,0,Points-PointsKO-Adjacents,9
Memecylon_dasyanthum,22,18,4,Points-PointsKO-Adjacents,134
Memecylon_deminutum,12,9,3,Points-PointsKO-Adjacents,44
Memecylon_diluviorum,13,9,4,Points-PointsKO-Adjacents,99
Memecylon_englerianum,29,13,16,Points-PointsKO-Adjacents,181
Memecylon_erythranthum,3,3,0,Points-PointsKO-Adjacents,18
Memecylon_flavovirens,19,6,13,Points-PointsKO-Adjacents,154
Memecylon_galeatum,1,1,0,Points-PointsKO-Adjacents,9
Memecylon_germainii,7,0,7,Points-PointsKO-Adjacents,45
Memecylon_hainanense,2,2,0,Points-PointsKO-Adjacents,18
Memecylon_klaineanum,23,15,8,Points-PointsKO-Adjacents,134
Memecylon_lanceolatum,7,0,7,Points-PointsKO-Adjacents,33
Memecylon_lateriflorum,68,40,28,Alphahull-PointsKO-Adjacents,1571
Memecylon_ligustrifolium,2,2,0,Points-PointsKO-Adjacents,18
Memecylon_longipetalum,33,15,18,Points-PointsKO-Adjacents,193
Memecylon_louvelianum,34,15,19,Points-PointsKO-Adjacents,206
Memecylon_macrodendron,23,14,9,Points-PointsKO-Adjacents,195
Memecylon_magnifoliatum,6,1,5,Points-PointsKO-Adjacents,36
Memecylon_matitanense,26,13,13,Points-PointsKO-Adjacents,151
Memecylon_memoratum,7,2,5,Points-PointsKO-Adjacents,48
Memecylon_myrianthum,19,0,19,Points-PointsKO-Adjacents,120
Memecylon_myrtiforme,0,0,0,NA,0
Memecylon_myrtilloides,15,10,5,Points-PointsKO-Adjacents,101
Memecylon_natalense,1,1,0,Points-PointsKO-Adjacents,9
Memecylon_nigrescens,0,0,0,NA,0
Memecylon_normandii,28,14,14,Points-PointsKO-Adjacents,200
Memecylon_occultum,4,4,0,Points-PointsKO-Adjacents,27
Memecylon_oubanguianum,8,0,8,Points-PointsKO-Adjacents,63
Memecylon_pauciflorum,812,741,71,Alphahull-PointsKO-Adjacents,6043
Memecylon_pedunculatum,7,1,6,Points-PointsKO-Adjacents,48
Memecylon_peracuminatum,2,2,0,Points-PointsKO-Adjacents,18
Memecylon_polyanthemos,18,0,18,Points-PointsKO-Adjacents,118
Memecylon_polyanthum,2,2,0,Points-PointsKO-Adjacents,18
Memecylon_ramosum,6,2,4,Points-PointsKO-Adjacents,52
Memecylon_roseum,3,3,0,Points-PointsKO-Adjacents,18
Memecylon_salicifolium,5,1,4,Points-PointsKO-Adjacents,30
Memecylon_scutellatum,20,2,18,Points-PointsKO-Adjacents,161
Memecylon_teitense,8,5,3,Points-PointsKO-Adjacents,26
Memecylon_thouarsianum,8,1,7,Points-PointsKO-Adjacents,65
Memecylon_thouvenotii,2,2,0,Points-PointsKO-Adjacents,18
Memecylon_tsaratananense,1,1,0,Points-PointsKO-Adjacents,9
Memecylon_urschii,5,5,0,Points-PointsKO-Adjacents,37
Memecylon_verruculosum,22,13,9,Points-PointsKO-Adjacents,86
Memecylon_viride,34,22,12,Alphahull-PointsKO-Adjacents,176
Mendoravia_dumaziana,3,3,0,Points-PointsKO-Adjacents,15
Mentzelia_arborescens,16,9,7,Points-PointsKO-Adjacents,81
Meriania_acida,5,2,3,Points-PointsKO-Adjacents,39
Meriania_acostae,8,3,5,Points-PointsKO-Adjacents,42
Meriania_albertiae,15,10,5,Points-PointsKO-Adjacents,60
Meriania_ampla,3,3,0,Points-PointsKO-Adjacents,21
Meriania_antioquiensis,22,15,7,Points-PointsKO-Adjacents,107
Meriania_aracaensis,8,0,8,Points-PointsKO-Adjacents,27
Meriania_arborea,9,2,7,Points-PointsKO-Adjacents,63
Meriania_boliviensis,15,6,9,Points-PointsKO-Adjacents,118
Meriania_brachycera,77,61,16,Alphahull-PointsKO-Adjacents,1567
Meriania_brittoniana,35,21,14,Alphahull-PointsKO-Adjacents,608
Meriania_calophylla,18,0,18,Points-PointsKO-Adjacents,102
Meriania_calyptrata,26,17,9,Points-PointsKO-Adjacents,95
Meriania_campii,4,4,0,Points-PointsKO-Adjacents,33
Meriania_claussenii,68,44,24,Alphahull-PointsKO-Adjacents,788
Meriania_crassiramis,22,15,7,Points-PointsKO-Adjacents,110
Meriania_cuneifolia,12,4,8,Points-PointsKO-Adjacents,77
Meriania_denticulata,20,11,9,Points-PointsKO-Adjacents,124
Meriania_drakei,31,19,12,Points-PointsKO-Adjacents,182
Meriania_excelsa,6,2,4,Points-PointsKO-Adjacents,40
Meriania_finicola,7,0,7,Points-PointsKO-Adjacents,53
Meriania_franciscana,5,5,0,Points-PointsKO-Adjacents,18
Meriania_furvanthera,14,9,5,Points-PointsKO-Adjacents,40
Meriania_glabra,52,33,19,Alphahull-PointsKO-Adjacents,227
Meriania_glazioviana,4,3,1,Points-PointsKO-Adjacents,31
Meriania_grandidens,104,87,17,Alphahull-PointsKO-Adjacents,2159
Meriania_grandiflora,47,36,11,Alphahull-PointsKO-Adjacents,128
Meriania_haemantha,80,68,12,Alphahull-PointsKO-Adjacents,1013
Meriania_heptamera,21,13,8,Points-PointsKO-Adjacents,140
Meriania_hernandoi,26,16,10,Points-PointsKO-Adjacents,91
Meriania_hexamera,66,35,31,Alphahull-PointsKO-Adjacents,675
Meriania_involucrata,33,26,7,Alphahull-PointsKO-Adjacents,206
Meriania_kirkbridei,5,5,0,Points-PointsKO-Adjacents,33
Meriania_leucantha,4,2,2,Points-PointsKO-Adjacents,35
Meriania_longifolia,205,166,39,Alphahull-PointsKO-Adjacents,3881
Meriania_longipes,3,3,0,Points-PointsKO-Adjacents,25
Meriania_macrophylla,82,49,33,Alphahull-PointsKO-Adjacents,1658
Meriania_maxima,65,57,8,Alphahull-PointsKO-Adjacents,262
Meriania_mutabilis,8,0,8,Points-PointsKO-Adjacents,63
Meriania_mutisii,17,10,7,Points-PointsKO-Adjacents,83
Meriania_neblinensis,1,1,0,Points-PointsKO-Adjacents,9
Meriania_nobilis,108,84,24,Alphahull-PointsKO-Adjacents,1121
Meriania_odorata,18,4,14,Points-PointsKO-Adjacents,104
Meriania_ornata,2,2,0,Points-PointsKO-Adjacents,16
Meriania_panamensis,12,0,12,Points-PointsKO-Adjacents,18
Meriania_paniculata,48,31,17,Alphahull-PointsKO-Adjacents,206
Meriania_pastazana,20,11,9,Points-PointsKO-Adjacents,102
Meriania_peltata,15,7,8,Points-PointsKO-Adjacents,119
Meriania_phlomoides,134,111,23,Alphahull-PointsKO-Adjacents,841
Meriania_pichinchensis,9,3,6,Points-PointsKO-Adjacents,40
Meriania_pulcherrima,8,2,6,Points-PointsKO-Adjacents,44
Meriania_purpurea,8,2,6,Points-PointsKO-Adjacents,46
Meriania_radula,32,22,10,Alphahull-PointsKO-Adjacents,328
Meriania_robusta,24,2,22,Points-PointsKO-Adjacents,86
Meriania_speciosa,127,96,31,Alphahull-PointsKO-Adjacents,2606
Meriania_stellata,2,2,0,Points-PointsKO-Adjacents,18
Meriania_steyermarkii,32,15,17,Points-PointsKO-Adjacents,241
Meriania_tetramera,36,26,10,Alphahull-PointsKO-Adjacents,124
Meriania_tomentosa,257,207,50,Alphahull-PointsKO-Adjacents,2691
Meriania_trianae,3,3,0,Points-PointsKO-Adjacents,27
Meriania_tuberculata,38,26,12,Alphahull-PointsKO-Adjacents,137
Meriania_urceolata,344,273,71,Alphahull-PointsKO-Adjacents,15711
Meriania_vilcabambensis,1,1,0,Points-PointsKO-Adjacents,9
Merianthera_pulchra,36,29,7,Alphahull-PointsKO-Adjacents,395
Merianthera_sipolisii,48,37,11,Alphahull-PointsKO-Adjacents,235
Merrillia_caloxylon,2,2,0,Points-PointsKO-Adjacents,18
Merrilliodendron_megacarpum,6,2,4,Points-PointsKO-Adjacents,39
Merrilliopanax_alpinus,1,1,0,Points-PointsKO-Adjacents,9
Merrilliopanax_listeri,38,30,8,Alphahull-PointsKO-Adjacents,146
Merrilliopanax_membranifolius,28,16,12,Points-PointsKO-Adjacents,124
Meryta_angustifolia,7,1,6,Points-PointsKO-Adjacents,3
Meryta_balansae,25,15,10,Points-PointsKO-Adjacents,106
Meryta_brachypoda,1,1,0,Points-PointsKO-Adjacents,3
Meryta_choristantha,3,3,0,Points-PointsKO-Adjacents,4
Meryta_coriacea,25,15,10,Points-PointsKO-Adjacents,121
Meryta_denhamii,24,14,10,Points-PointsKO-Adjacents,90
Meryta_drakeana,1,1,0,Points-PointsKO-Adjacents,9
Meryta_lanceolata,4,4,0,Points-PointsKO-Adjacents,13
Meryta_latifolia,5,4,1,Points-PointsKO-Adjacents,3
Meryta_lucida,4,4,0,Points-PointsKO-Adjacents,12
Meryta_macrophylla,16,10,6,Points-PointsKO-Adjacents,45
Meryta_malietoa,2,2,0,Points-PointsKO-Adjacents,17
Meryta_mauluulu,1,1,0,Points-PointsKO-Adjacents,8
Meryta_mauruensis,2,2,0,Points-PointsKO-Adjacents,9
Meryta_neoebudica,14,4,10,Points-PointsKO-Adjacents,87
Meryta_oxylaena,9,2,7,Points-PointsKO-Adjacents,49
Meryta_pachycarpa,5,5,0,Points-PointsKO-Adjacents,23
Meryta_pandanicarpa,0,0,0,NA,0
Meryta_pastoralis,2,2,0,Points-PointsKO-Adjacents,9
Meryta_pauciflora,3,3,0,Points-PointsKO-Adjacents,5
Meryta_raiateensis,1,1,0,Points-PointsKO-Adjacents,5
Meryta_salicifolia,3,3,0,Points-PointsKO-Adjacents,9
Meryta_schizolaena,9,0,9,Points-PointsKO-Adjacents,43
Meryta_senfftiana,2,1,1,Points-PointsKO-Adjacents,11
Meryta_sinclairii,46,15,31,Points-PointsKO-Adjacents,175
Meryta_sonchifolia,5,1,4,Points-PointsKO-Adjacents,24
Meryta_tenuifolia,1,1,0,Points-PointsKO-Adjacents,9
Mesogyne_insignis,40,32,8,Alphahull-PointsKO-Adjacents,142
Mesosphaerum_oblongifolium,162,109,53,Alphahull-PointsKO-Adjacents,1577
Mespilus_canescens,3,3,0,Points-PointsKO-Adjacents,21
Mespilus_germanica,76,42,34,Alphahull-PointsKO-Adjacents,2336
Mesua_assamica,1,1,0,Points-PointsKO-Adjacents,9
Mesua_beccariana,2,0,2,Points-PointsKO-Adjacents,18
Kayea_daphnifolia,0,0,0,NA,0
Kayea_elegans,2,2,0,Points-PointsKO-Adjacents,15
Mesua_ferrea,25,2,23,Points-PointsKO-Adjacents,219
Kayea_ferruginea,1,1,0,Points-PointsKO-Adjacents,9
Kayea_grandis,2,2,0,Points-PointsKO-Adjacents,18
Kayea_kunstleri,7,0,7,Points-PointsKO-Adjacents,63
Mesua_macrophylla,2,2,0,Points-PointsKO-Adjacents,14
Kayea_manii,1,1,0,Points-PointsKO-Adjacents,9
Kayea_nervosa,0,0,0,NA,0
Kayea_racemosa,2,2,0,Points-PointsKO-Adjacents,18
Kayea_rosea,NA,NA,NA,NA,NA
Kayea_stylosa,1,1,0,Points-PointsKO-Adjacents,9
Kayea_wrayi,1,1,0,Points-PointsKO-Adjacents,9
Metapanax_davidii,84,61,23,Alphahull-PointsKO-Adjacents,7233
Metapanax_delavayi,37,24,13,Alphahull-PointsKO-Adjacents,846
Metaporana_densiflora,14,4,10,Points-PointsKO-Adjacents,103
Metarungia_pubinervia,25,0,25,Points-PointsKO-Adjacents,193
Metasequoia_glyptostroboides,22,0,22,Points-PointsKO-Adjacents,171
Meteoromyrtus_wynaadensis,1,1,0,Points-PointsKO-Adjacents,9
Metopium_brownei,610,555,55,Alphahull-PointsKO-Adjacents,3167
Metopium_toxiferum,93,53,40,Alphahull-PointsKO-Adjacents,1214
Metrodorea_flavida,446,401,45,Alphahull-PointsKO-Adjacents,26980
Metrodorea_maracasana,50,36,14,Alphahull-PointsKO-Adjacents,727
Metrodorea_nigra,380,294,86,Alphahull-PointsKO-Adjacents,9474
Metrodorea_stipularis,160,129,31,Alphahull-PointsKO-Adjacents,4295
Metrosideros_angustifolia,42,28,14,Alphahull-PointsKO-Adjacents,3005
Metrosideros_arfakensis,1,1,0,Points-PointsKO-Adjacents,9
Metrosideros_bartlettii,14,9,5,Points-PointsKO-Adjacents,18
Metrosideros_boninensis,0,0,0,NA,0
Metrosideros_brevistylis,36,25,11,Alphahull-PointsKO-Adjacents,104
Metrosideros_cacuminum,7,3,4,Points-PointsKO-Adjacents,42
Metrosideros_collina,111,57,54,Alphahull-PointsKO-Adjacents,296
Metrosideros_dolichandra,9,5,4,Points-PointsKO-Adjacents,32
Metrosideros_elegans,14,4,10,Points-PointsKO-Adjacents,68
Metrosideros_engleriana,16,7,9,Points-PointsKO-Adjacents,80
Metrosideros_excelsa,483,2,481,Points-PointsKO-Adjacents,836
Metrosideros_gregoryi,0,0,0,NA,0
Metrosideros_halconensis,3,3,0,Points-PointsKO-Adjacents,17
Metrosideros_humboldtiana,4,4,0,Points-PointsKO-Adjacents,20
Metrosideros_kermadecensis,34,6,28,Points-PointsKO-Adjacents,128
Metrosideros_laurifolia,63,49,14,Alphahull-PointsKO-Adjacents,142
Metrosideros_macropus,5,5,0,Points-PointsKO-Adjacents,21
Metrosideros_microphylla,15,10,5,Points-PointsKO-Adjacents,48
Metrosideros_nervulosa,13,9,4,Points-PointsKO-Adjacents,5
Metrosideros_nitida,36,24,12,Alphahull-PointsKO-Adjacents,122
Metrosideros_ochrantha,1,1,0,Points-PointsKO-Adjacents,9
Metrosideros_oreomyrtus,7,2,5,Points-PointsKO-Adjacents,43
Metrosideros_ovata,2,2,0,Points-PointsKO-Adjacents,9
Metrosideros_paniensis,3,3,0,Points-PointsKO-Adjacents,15
Metrosideros_parallelinervis,0,0,0,NA,0
Metrosideros_parkinsonii,115,94,21,Alphahull-PointsKO-Adjacents,751
Metrosideros_polymorpha,272,251,21,Alphahull-PointsKO-Adjacents,281
Metrosideros_porphyrea,14,9,5,Points-PointsKO-Adjacents,69
Metrosideros_punctata,29,17,12,Points-PointsKO-Adjacents,103
Metrosideros_ramiflora,9,2,7,Points-PointsKO-Adjacents,62
Metrosideros_regelii,2,2,0,Points-PointsKO-Adjacents,18
Metrosideros_robusta,3438,3364,74,Alphahull-PointsKO-Adjacents,3754
Metrosideros_rugosa,4,4,0,Points-PointsKO-Adjacents,26
Metrosideros_salomonensis,0,0,0,NA,0
Metrosideros_sclerocarpa,8,5,3,Points-PointsKO-Adjacents,5
Metrosideros_tetragyna,0,0,0,NA,0
Metrosideros_tremuloides,1,1,0,Points-PointsKO-Adjacents,9
Metrosideros_umbellata,5169,5101,68,Alphahull-PointsKO-Adjacents,3685
Metrosideros_waialealae,9,2,7,Points-PointsKO-Adjacents,41
Metroxylon_amicarum,1,1,0,Points-PointsKO-Adjacents,9
Metroxylon_paulcoxii,NA,NA,NA,NA,NA
Metroxylon_sagu,23,0,23,Points-PointsKO-Adjacents,131
Metroxylon_salomonense,2,2,0,Points-PointsKO-Adjacents,17
Metroxylon_upoluense,0,0,0,NA,0
Metroxylon_vitiense,1,1,0,Points-PointsKO-Adjacents,5
Metroxylon_warburgii,8,1,7,Points-PointsKO-Adjacents,50
Metteniusa_cogolloi,5,5,0,Points-PointsKO-Adjacents,21
Metteniusa_edulis,5,0,5,Points-PointsKO-Adjacents,33
Metteniusa_nucifera,8,1,7,Points-PointsKO-Adjacents,63
Metteniusa_tessmanniana,147,113,34,Alphahull-PointsKO-Adjacents,2439
Metternichia_princeps,172,136,36,Alphahull-PointsKO-Adjacents,3253
Meyna_grisea,0,0,0,NA,0
Meyna_pierrei,0,0,0,NA,0
Meyna_pubescens,0,0,0,NA,0
Meyna_spinosa,1,1,0,Points-PointsKO-Adjacents,9
Meyna_tetraphylla,12,1,11,Points-PointsKO-Adjacents,89
Mezilaurus_caatingae,9,2,7,Points-PointsKO-Adjacents,81
Mezilaurus_campaucola,4,4,0,Points-PointsKO-Adjacents,32
Mezilaurus_crassiramea,132,82,50,Alphahull-PointsKO-Adjacents,6513
Mezilaurus_decurrens,5,5,0,Points-PointsKO-Adjacents,45
Mezilaurus_duckei,32,17,15,Points-PointsKO-Adjacents,229
Mezilaurus_ita-uba,76,0,76,Points-PointsKO-Adjacents,526
Mezilaurus_lindaviana,61,25,36,Alphahull-PointsKO-Adjacents,733
Mezilaurus_manausensis,8,2,6,Points-PointsKO-Adjacents,47
Mezilaurus_micrantha,10,7,3,Points-PointsKO-Adjacents,64
Mezilaurus_navalium,16,0,16,Points-PointsKO-Adjacents,113
Mezilaurus_opaca,17,8,9,Points-PointsKO-Adjacents,117
Mezilaurus_palcazuensis,11,5,6,Points-PointsKO-Adjacents,68
Mezilaurus_sprucei,30,14,16,Points-PointsKO-Adjacents,183
Mezilaurus_subcordata,58,22,36,Alphahull-PointsKO-Adjacents,2224
Mezilaurus_synandra,55,23,32,Alphahull-PointsKO-Adjacents,1037
Mezilaurus_thoroflora,1,1,0,Points-PointsKO-Adjacents,9
Mezilaurus_triunca,25,15,10,Points-PointsKO-Adjacents,144
Mezilaurus_vanderwerffii,25,12,13,Points-PointsKO-Adjacents,167
Mezzettia_havilandii,1,0,1,Points-PointsKO-Adjacents,9
Mezzettia_macrocarpa,2,2,0,Points-PointsKO-Adjacents,18
Mezzettia_parviflora,21,0,21,Points-PointsKO-Adjacents,179
Mezzettia_umbellata,12,3,9,Points-PointsKO-Adjacents,81
Michelsonia_microphylla,12,2,10,Points-PointsKO-Adjacents,84
Miconia_abbreviata,61,32,29,Alphahull-PointsKO-Adjacents,3523
Miconia_acanthocoryne,11,8,3,Points-PointsKO-Adjacents,69
Miconia_acuminata,53,29,24,Alphahull-PointsKO-Adjacents,576
Miconia_acuminifera,70,59,11,Alphahull-PointsKO-Adjacents,1179
Miconia_acutifolia,72,53,19,Alphahull-PointsKO-Adjacents,2713
Miconia_acutipetala,5,5,0,Points-PointsKO-Adjacents,39
Miconia_adenocalyx,3,3,0,Points-PointsKO-Adjacents,27
Miconia_adinantha,10,5,5,Points-PointsKO-Adjacents,50
Miconia_aenigmatica,2,2,0,Points-PointsKO-Adjacents,18
Miconia_aequatorialis,5,5,0,Points-PointsKO-Adjacents,39
Miconia_aeruginosa,415,332,83,Alphahull-PointsKO-Adjacents,5584
Miconia_affinis,1207,995,212,Alphahull-PointsKO-Adjacents,102099
Miconia_aggregata,117,84,33,Alphahull-PointsKO-Adjacents,2016
Miconia_aguirrei,13,8,5,Points-PointsKO-Adjacents,90
Miconia_albertobrenesii,158,123,35,Alphahull-PointsKO-Adjacents,1043
Miconia_albicans,2971,2620,351,Alphahull-PointsKO-Adjacents,108358
Miconia_alborufescens,186,123,63,Alphahull-PointsKO-Adjacents,4934
Miconia_aligera,2,2,0,Points-PointsKO-Adjacents,18
Miconia_aliquantula,63,34,29,Alphahull-PointsKO-Adjacents,583
Miconia_alloeotricha,2,2,0,Points-PointsKO-Adjacents,18
Miconia_alpina,10,5,5,Points-PointsKO-Adjacents,68
Miconia_alternans,97,31,66,Alphahull-PointsKO-Adjacents,1376
Miconia_altissima,19,10,9,Points-PointsKO-Adjacents,109
Miconia_amabilis,13,5,8,Points-PointsKO-Adjacents,86
Miconia_amacurensis,85,46,39,Alphahull-PointsKO-Adjacents,721
Miconia_amazonica,113,89,24,Alphahull-PointsKO-Adjacents,6585
Miconia_amblyandra,8,0,8,Points-PointsKO-Adjacents,48
Miconia_amissa,3,3,0,Points-PointsKO-Adjacents,21
Miconia_amnicola,48,32,16,Alphahull-PointsKO-Adjacents,2542
Miconia_amoena,218,162,56,Alphahull-PointsKO-Adjacents,1106
Miconia_ampla,361,240,121,Alphahull-PointsKO-Adjacents,24174
Miconia_amplinodis,35,26,9,Alphahull-PointsKO-Adjacents,79
Miconia_anchicayensis,1,1,0,Points-PointsKO-Adjacents,9
Miconia_angelana,6,1,5,Points-PointsKO-Adjacents,45
Miconia_annulata,12,6,6,Points-PointsKO-Adjacents,90
Miconia_apiculata,3,3,0,Points-PointsKO-Adjacents,16
Miconia_aplostachya,382,317,65,Alphahull-PointsKO-Adjacents,22501
Miconia_aponeura,96,69,27,Alphahull-PointsKO-Adjacents,2559
Miconia_appendiculata,111,67,44,Alphahull-PointsKO-Adjacents,1214
Miconia_araguensis,23,7,16,Points-PointsKO-Adjacents,148
Miconia_archeri,8,1,7,Points-PointsKO-Adjacents,66
Miconia_argentea,511,447,64,Alphahull-PointsKO-Adjacents,7331
Miconia_argyraea,14,4,10,Points-PointsKO-Adjacents,89
Miconia_argyrophylla,393,297,96,Alphahull-PointsKO-Adjacents,35997
Miconia_asperrima,180,153,27,Alphahull-PointsKO-Adjacents,2641
Miconia_aspratilis,1,1,0,Points-PointsKO-Adjacents,9
Miconia_astroplocama,125,83,42,Alphahull-PointsKO-Adjacents,6504
Miconia_atrofusca,9,3,6,Points-PointsKO-Adjacents,49
Miconia_augusti,3,3,0,Points-PointsKO-Adjacents,27
Miconia_aulocalyx,67,34,33,Alphahull-PointsKO-Adjacents,4401
Miconia_aurantiaca,14,3,11,Points-PointsKO-Adjacents,66
Miconia_aurea,178,135,43,Alphahull-PointsKO-Adjacents,9647
Miconia_aureoides,134,0,134,Points-PointsKO-Adjacents,964
Miconia_axinaeoides,16,8,8,Points-PointsKO-Adjacents,115
Miconia_ayacuchensis,0,0,0,NA,0
Miconia_bailloniana,21,11,10,Points-PointsKO-Adjacents,144
Miconia_bangii,31,14,17,Points-PointsKO-Adjacents,160
Miconia_barbeyana,128,94,34,Alphahull-PointsKO-Adjacents,1375
Miconia_barbinervis,383,0,383,Points-PointsKO-Adjacents,2458
Miconia_barbipilis,3,3,0,Points-PointsKO-Adjacents,27
Miconia_barkeri,3,3,0,Points-PointsKO-Adjacents,16
Miconia_baumgratziana,34,17,17,Points-PointsKO-Adjacents,188
Miconia_bella,7,1,6,Points-PointsKO-Adjacents,30
Miconia_beneolens,3,3,0,Points-PointsKO-Adjacents,27
Miconia_biacuta,9,3,6,Points-PointsKO-Adjacents,60
Miconia_biappendiculata,73,57,16,Alphahull-PointsKO-Adjacents,580
Miconia_biglandulosa,99,40,59,Alphahull-PointsKO-Adjacents,6620
Miconia_biolleyana,36,25,11,Alphahull-PointsKO-Adjacents,119
Miconia_bipatrialis,7,3,4,Points-PointsKO-Adjacents,57
Miconia_biperulifera,44,29,15,Alphahull-PointsKO-Adjacents,106
Miconia_bisulcata,1,1,0,Points-PointsKO-Adjacents,8
Miconia_boliviensis,52,36,16,Alphahull-PointsKO-Adjacents,276
Miconia_boomii,5,5,0,Points-PointsKO-Adjacents,45
Miconia_brachyanthera,18,7,11,Points-PointsKO-Adjacents,107
Miconia_brachybotrya,42,11,31,Points-PointsKO-Adjacents,323
Miconia_brachycalyx,58,40,18,Alphahull-PointsKO-Adjacents,707
Miconia_brachygyna,66,50,16,Alphahull-PointsKO-Adjacents,1561
Miconia_bracteolata,144,115,29,Alphahull-PointsKO-Adjacents,1063
Miconia_bractiflora,184,150,34,Alphahull-PointsKO-Adjacents,2359
Miconia_brasiliensis,82,50,32,Alphahull-PointsKO-Adjacents,858
Miconia_brenesii,91,80,11,Alphahull-PointsKO-Adjacents,229
Miconia_brevipes,115,73,42,Alphahull-PointsKO-Adjacents,6055
Miconia_brevis,6,0,6,Points-PointsKO-Adjacents,42
Miconia_brevistylis,6,1,5,Points-PointsKO-Adjacents,54
Miconia_brevitheca,60,48,12,Alphahull-PointsKO-Adjacents,752
Miconia_brittonii,47,38,9,Alphahull-PointsKO-Adjacents,302
Miconia_brunnea,118,94,24,Alphahull-PointsKO-Adjacents,3243
Miconia_bubalina,501,400,101,Alphahull-PointsKO-Adjacents,34249
Miconia_budlejoides,317,259,58,Alphahull-PointsKO-Adjacents,4038
Miconia_buntingii,4,4,0,Points-PointsKO-Adjacents,21
Miconia_burchellii,240,209,31,Alphahull-PointsKO-Adjacents,7959
Miconia_cabucu,220,0,220,Points-PointsKO-Adjacents,1029
Miconia_cacatin,14,9,5,Points-PointsKO-Adjacents,94
Miconia_caelata,26,15,11,Points-PointsKO-Adjacents,119
Miconia_caesariata,26,14,12,Points-PointsKO-Adjacents,179
Miconia_cajanumana,16,10,6,Points-PointsKO-Adjacents,80
Miconia_calocoma,11,7,4,Points-PointsKO-Adjacents,55
Miconia_calophylla,7,2,5,Points-PointsKO-Adjacents,54
Miconia_calvescens,1290,1080,210,Alphahull-PointsKO-Adjacents,50661
Miconia_campii,9,4,5,Points-PointsKO-Adjacents,72
Miconia_cannabina,51,25,26,Alphahull-PointsKO-Adjacents,1981
Miconia_capixaba,9,5,4,Points-PointsKO-Adjacents,29
Miconia_carnea,42,37,5,Alphahull-PointsKO-Adjacents,101
Miconia_carpishana,9,5,4,Points-PointsKO-Adjacents,58
Miconia_castaneiflora,43,24,19,Alphahull-PointsKO-Adjacents,577
Miconia_castillensis,12,7,5,Points-PointsKO-Adjacents,86
Miconia_castrensis,3,3,0,Points-PointsKO-Adjacents,27
Miconia_cataractae,75,60,15,Alphahull-PointsKO-Adjacents,422
Miconia_caucana,3,3,0,Points-PointsKO-Adjacents,21
Miconia_caudata,301,253,48,Alphahull-PointsKO-Adjacents,4636
Miconia_caudigera,128,100,28,Alphahull-PointsKO-Adjacents,2789
Miconia_cautis,35,0,35,Points-PointsKO-Adjacents,231
Miconia_cazaletii,52,37,15,Alphahull-PointsKO-Adjacents,920
Miconia_centrodesma,490,372,118,Alphahull-PointsKO-Adjacents,19879
Miconia_centronioides,68,42,26,Alphahull-PointsKO-Adjacents,1030
Miconia_centrosperma,15,11,4,Points-PointsKO-Adjacents,44
Miconia_ceramicarpa,187,143,44,Alphahull-PointsKO-Adjacents,7955
Miconia_cercophora,33,25,8,Alphahull-PointsKO-Adjacents,294
Miconia_chamissois,959,821,138,Alphahull-PointsKO-Adjacents,38164
Miconia_chapensis,3,2,1,Points-PointsKO-Adjacents,27
Miconia_chartacea,445,385,60,Alphahull-PointsKO-Adjacents,11636
Miconia_chinantlana,35,23,12,Alphahull-PointsKO-Adjacents,605
Miconia_chiriquiensis,48,38,10,Alphahull-PointsKO-Adjacents,144
Miconia_chlorocarpa,80,64,16,Alphahull-PointsKO-Adjacents,621
Miconia_chrysophylla,586,442,144,Alphahull-PointsKO-Adjacents,73148
Miconia_ciliaris,2,2,0,Points-PointsKO-Adjacents,18
Miconia_ciliata,943,733,210,Alphahull-PointsKO-Adjacents,41439
Miconia_cinchonaefolia,6,0,6,Points-PointsKO-Adjacents,54
Miconia_cinerascens,857,782,75,Alphahull-PointsKO-Adjacents,10340
Miconia_cinnamomifolia,689,600,89,Alphahull-PointsKO-Adjacents,8231
Miconia_cionotricha,37,21,16,Alphahull-PointsKO-Adjacents,439
Miconia_cladonia,137,109,28,Alphahull-PointsKO-Adjacents,2239
Miconia_clathrantha,68,43,25,Alphahull-PointsKO-Adjacents,628
Miconia_codonostigma,22,14,8,Points-PointsKO-Adjacents,116
Miconia_coelestis,28,11,17,Points-PointsKO-Adjacents,173
Miconia_collatata,138,90,48,Alphahull-PointsKO-Adjacents,6680
Miconia_colliculosa,9,1,8,Points-PointsKO-Adjacents,73
Miconia_commutata,14,8,6,Points-PointsKO-Adjacents,68
Miconia_comptifolia,18,11,7,Points-PointsKO-Adjacents,90
Miconia_coniophora,2,2,0,Points-PointsKO-Adjacents,18
Miconia_contrerasii,6,4,2,Points-PointsKO-Adjacents,32
Miconia_cookii,3,3,0,Points-PointsKO-Adjacents,27
Miconia_corallina,113,96,17,Alphahull-PointsKO-Adjacents,1791
Miconia_coriacea,19,6,13,Points-PointsKO-Adjacents,84
Miconia_coronata,58,40,18,Alphahull-PointsKO-Adjacents,1676
Miconia_coronifera,4,4,0,Points-PointsKO-Adjacents,21
Miconia_costaricensis,150,116,34,Alphahull-PointsKO-Adjacents,730
Miconia_cowanii,10,0,10,Points-PointsKO-Adjacents,87
Miconia_crassinervia,53,17,36,Points-PointsKO-Adjacents,438
Miconia_crebribullata,8,6,2,Points-PointsKO-Adjacents,56
Miconia_cretacea,19,7,12,Points-PointsKO-Adjacents,137
Miconia_crocata,15,10,5,Points-PointsKO-Adjacents,16
Miconia_cubatanensis,480,420,60,Alphahull-PointsKO-Adjacents,9127
Miconia_cundinamarcensis,64,46,18,Alphahull-PointsKO-Adjacents,967
Miconia_cuprea,6,0,6,Points-PointsKO-Adjacents,45
Miconia_cuspidata,334,227,107,Alphahull-PointsKO-Adjacents,33216
Miconia_cuspidatissima,13,5,8,Points-PointsKO-Adjacents,54
Miconia_cyanocarpa,188,151,37,Alphahull-PointsKO-Adjacents,1522
Miconia_dasyclada,2,2,0,Points-PointsKO-Adjacents,18
Miconia_decipiens,7,0,7,Points-PointsKO-Adjacents,61
Miconia_decurrens,136,83,53,Alphahull-PointsKO-Adjacents,7938
Miconia_demissifolia,14,6,8,Points-PointsKO-Adjacents,105
Miconia_desmantha,188,140,48,Alphahull-PointsKO-Adjacents,2323
Miconia_desportesii,7,3,4,Points-PointsKO-Adjacents,49
Miconia_dichrophylla,105,51,54,Alphahull-PointsKO-Adjacents,6873
Miconia_diegogomezii,3,3,0,Points-PointsKO-Adjacents,2
Miconia_dielsiana,10,7,3,Points-PointsKO-Adjacents,42
Miconia_dielsii,24,16,8,Points-PointsKO-Adjacents,117
Miconia_discolor,235,194,41,Alphahull-PointsKO-Adjacents,6493
Miconia_dispar,369,287,82,Alphahull-PointsKO-Adjacents,30166
Miconia_dissimulans,6,2,4,Points-PointsKO-Adjacents,42
Miconia_dissita,20,12,8,Points-PointsKO-Adjacents,76
Miconia_dissitinervia,19,15,4,Points-PointsKO-Adjacents,42
Miconia_divaricata,12,0,12,Points-PointsKO-Adjacents,73
Miconia_divergens,11,3,8,Points-PointsKO-Adjacents,81
Miconia_dodecandra,1402,1148,254,Alphahull-PointsKO-Adjacents,42423
Miconia_dodsonii,14,10,4,Points-PointsKO-Adjacents,59
Miconia_dolichopoda,137,89,48,Alphahull-PointsKO-Adjacents,2456
Miconia_dolichorrhyncha,671,582,89,Alphahull-PointsKO-Adjacents,40562
Miconia_domingensis,3,3,0,Points-PointsKO-Adjacents,27
Miconia_donaeana,187,139,48,Alphahull-PointsKO-Adjacents,1344
Miconia_dorsaliporosa,11,6,5,Points-PointsKO-Adjacents,40
Miconia_dorsiloba,123,81,42,Alphahull-PointsKO-Adjacents,1213
Miconia_duckei,60,1,59,Points-PointsKO-Adjacents,431
Miconia_dudleyi,25,15,10,Points-PointsKO-Adjacents,172
Miconia_dunstervillei,7,0,7,Points-PointsKO-Adjacents,33
Miconia_egensis,140,66,74,Alphahull-PointsKO-Adjacents,5185
Miconia_elaeodendron,13,6,7,Points-PointsKO-Adjacents,79
Miconia_elaeoides,128,109,19,Alphahull-PointsKO-Adjacents,1561
Miconia_elata,485,378,107,Alphahull-PointsKO-Adjacents,24143
Miconia_elegans,421,365,56,Alphahull-PointsKO-Adjacents,22858
Miconia_elongata,74,52,22,Alphahull-PointsKO-Adjacents,727
Miconia_elvirae,11,6,5,Points-PointsKO-Adjacents,30
Miconia_emendata,64,26,38,Alphahull-PointsKO-Adjacents,6216
Miconia_eriocalyx,84,51,33,Alphahull-PointsKO-Adjacents,5184
Miconia_erioclada,127,82,45,Alphahull-PointsKO-Adjacents,8674
Miconia_eriodonta,86,50,36,Alphahull-PointsKO-Adjacents,2976
Miconia_eugenioides,121,86,35,Alphahull-PointsKO-Adjacents,6659
Miconia_expansa,15,2,13,Points-PointsKO-Adjacents,135
Miconia_fasciculata,292,251,41,Alphahull-PointsKO-Adjacents,3791
Miconia_favosa,1,1,0,Points-PointsKO-Adjacents,9
Miconia_ferruginata,664,587,77,Alphahull-PointsKO-Adjacents,21759
Miconia_ferruginea,17,14,3,Points-PointsKO-Adjacents,112
Miconia_filamentosa,53,31,22,Alphahull-PointsKO-Adjacents,3031
Miconia_firma,9,4,5,Points-PointsKO-Adjacents,70
Miconia_fissa,8,2,6,Points-PointsKO-Adjacents,72
Miconia_flammea,115,85,30,Alphahull-PointsKO-Adjacents,3864
Miconia_floccosa,18,10,8,Points-PointsKO-Adjacents,107
Miconia_floribunda,158,109,49,Alphahull-PointsKO-Adjacents,3316
Miconia_fluminensis,1,1,0,Points-PointsKO-Adjacents,9
Miconia_formosa,41,0,41,Points-PointsKO-Adjacents,227
Miconia_fosteri,63,41,22,Alphahull-PointsKO-Adjacents,900
Miconia_foveolata,11,8,3,Points-PointsKO-Adjacents,14
Miconia_fragilis,26,9,17,Points-PointsKO-Adjacents,182
Miconia_fragrans,41,22,19,Alphahull-PointsKO-Adjacents,1947
Miconia_francavillana,37,5,32,Points-PointsKO-Adjacents,259
Miconia_friedmaniorum,25,14,11,Points-PointsKO-Adjacents,117
Miconia_fuertesii,3,3,0,Points-PointsKO-Adjacents,18
Miconia_fulvostellata,75,55,20,Alphahull-PointsKO-Adjacents,1010
Miconia_galactantha,27,9,18,Points-PointsKO-Adjacents,191
Miconia_galdamesiae,8,4,4,Points-PointsKO-Adjacents,42
Miconia_galeiformis,3,3,0,Points-PointsKO-Adjacents,27
Miconia_gentryi,5,5,0,Points-PointsKO-Adjacents,30
Miconia_gibba,20,15,5,Points-PointsKO-Adjacents,110
Miconia_gigantea,4,4,0,Points-PointsKO-Adjacents,36
Miconia_gilva,2,2,0,Points-PointsKO-Adjacents,18
Miconia_glaberrima,576,519,57,Alphahull-PointsKO-Adjacents,5165
Miconia_glandulistyla,28,17,11,Points-PointsKO-Adjacents,137
Miconia_glaucescens,51,30,21,Alphahull-PointsKO-Adjacents,348
Miconia_gleasoniana,109,91,18,Alphahull-PointsKO-Adjacents,1359
Miconia_globuliflora,28,1,27,Points-PointsKO-Adjacents,126
Miconia_glomerulifera,9,4,5,Points-PointsKO-Adjacents,57
Miconia_glyptophylla,2,2,0,Points-PointsKO-Adjacents,15
Miconia_goudotii,2,2,0,Points-PointsKO-Adjacents,18
Miconia_gracilis,467,405,62,Alphahull-PointsKO-Adjacents,5892
Miconia_grandiflora,24,16,8,Points-PointsKO-Adjacents,182
Miconia_grandifoliata,63,0,63,Points-PointsKO-Adjacents,474
Miconia_gratissima,223,144,79,Alphahull-PointsKO-Adjacents,23938
Miconia_griffisii,9,5,4,Points-PointsKO-Adjacents,41
Miconia_guaiquinimae,5,5,0,Points-PointsKO-Adjacents,39
Miconia_hadrophylla,13,0,13,Points-PointsKO-Adjacents,79
Miconia_harlingii,73,52,21,Alphahull-PointsKO-Adjacents,553
Miconia_heliotropoides,70,44,26,Alphahull-PointsKO-Adjacents,5457
Miconia_hemenostigma,82,63,19,Alphahull-PointsKO-Adjacents,789
Miconia_heterochaeta,9,5,4,Points-PointsKO-Adjacents,67
Miconia_heteromera,16,6,10,Points-PointsKO-Adjacents,128
Miconia_heterothrix,2,1,1,Points-PointsKO-Adjacents,18
Miconia_hildeana,5,5,0,Points-PointsKO-Adjacents,30
Miconia_hirtella,102,81,21,Alphahull-PointsKO-Adjacents,4640
Miconia_holosericea,1116,931,185,Alphahull-PointsKO-Adjacents,88513
Miconia_hondurensis,188,151,37,Alphahull-PointsKO-Adjacents,2372
Miconia_hospitalis,0,0,0,NA,0
Miconia_huigrensis,30,19,11,Points-PointsKO-Adjacents,222
Miconia_hyemalis,377,332,45,Alphahull-PointsKO-Adjacents,5404
Miconia_hylophila,7,2,5,Points-PointsKO-Adjacents,42
Miconia_hyperprasina,112,78,34,Alphahull-PointsKO-Adjacents,1974
Miconia_hypiodes,2,2,0,Points-PointsKO-Adjacents,9
Miconia_hypoleuca,301,207,94,Alphahull-PointsKO-Adjacents,6889
Miconia_ibaguensis,235,170,65,Alphahull-PointsKO-Adjacents,17780
Miconia_icosandra,2,2,0,Points-PointsKO-Adjacents,18
Miconia_idroboi,20,5,15,Points-PointsKO-Adjacents,160
Miconia_iluensis,8,1,7,Points-PointsKO-Adjacents,36
Miconia_imitans,10,3,7,Points-PointsKO-Adjacents,69
Miconia_impetiolaris,727,576,151,Alphahull-PointsKO-Adjacents,20790
Miconia_incachacana,9,3,6,Points-PointsKO-Adjacents,66
Miconia_inconspicua,179,149,30,Alphahull-PointsKO-Adjacents,3624
Miconia_incurva,26,22,4,Alphahull-PointsKO-Adjacents,59
Miconia_ingens,1,1,0,Points-PointsKO-Adjacents,9
Miconia_insularis,42,17,25,Points-PointsKO-Adjacents,285
Miconia_integrifolia,3,3,0,Points-PointsKO-Adjacents,27
Miconia_intricata,54,29,25,Alphahull-PointsKO-Adjacents,419
Miconia_jahnii,198,164,34,Alphahull-PointsKO-Adjacents,2314
Miconia_jimenezii,6,1,5,Points-PointsKO-Adjacents,32
Miconia_jucunda,99,57,42,Alphahull-PointsKO-Adjacents,2640
Miconia_juruensis,13,3,10,Points-PointsKO-Adjacents,99
Miconia_kappellei,4,4,0,Points-PointsKO-Adjacents,18
Miconia_kappleri,0,0,0,NA,0
Miconia_kavanayensis,24,5,19,Points-PointsKO-Adjacents,187
Miconia_klotzschii,1,1,0,Points-PointsKO-Adjacents,9
Miconia_klugii,19,6,13,Points-PointsKO-Adjacents,146
Miconia_kollmannii,7,3,4,Points-PointsKO-Adjacents,35
Miconia_kuntzei,2,2,0,Points-PointsKO-Adjacents,18
Miconia_lachnoclada,2,2,0,Points-PointsKO-Adjacents,18
Miconia_laetivirens,33,22,11,Alphahull-PointsKO-Adjacents,954
Miconia_laevigata,5,5,0,Points-PointsKO-Adjacents,45
Miconia_lagunensis,6,0,6,Points-PointsKO-Adjacents,39
Miconia_lamprophylla,213,146,67,Alphahull-PointsKO-Adjacents,9715
Miconia_lanata,50,19,31,Points-PointsKO-Adjacents,378
Miconia_lanceolata,8,6,2,Points-PointsKO-Adjacents,34
Miconia_lasiocalyx,84,46,38,Alphahull-PointsKO-Adjacents,1388
Miconia_lasiostyla,9,0,9,Points-PointsKO-Adjacents,54
Miconia_latecrenata,788,718,70,Alphahull-PointsKO-Adjacents,15199
Miconia_lateriflora,429,319,110,Alphahull-PointsKO-Adjacents,12992
Miconia_latidecurrens,26,19,7,Points-PointsKO-Adjacents,53
Miconia_latifolia,209,164,45,Alphahull-PointsKO-Adjacents,2429
Miconia_laxivenula,168,133,35,Alphahull-PointsKO-Adjacents,1657
Miconia_lehmannii,320,286,34,Alphahull-PointsKO-Adjacents,3563
Miconia_lepidota,588,457,131,Alphahull-PointsKO-Adjacents,54435
Miconia_leucocarpa,146,113,33,Alphahull-PointsKO-Adjacents,6455
Miconia_ligulata,170,145,25,Alphahull-PointsKO-Adjacents,1083
Miconia_ligustrina,225,193,32,Alphahull-PointsKO-Adjacents,1863
Miconia_ligustroides,1101,988,113,Alphahull-PointsKO-Adjacents,28237
Miconia_limitaris,6,2,4,Points-PointsKO-Adjacents,48
Miconia_littlei,9,3,6,Points-PointsKO-Adjacents,72
Miconia_livida,88,41,47,Alphahull-PointsKO-Adjacents,715
Miconia_lonchophylla,227,164,63,Alphahull-PointsKO-Adjacents,3643
Miconia_longicuspidata,0,0,0,NA,0
Miconia_longifolia,622,503,119,Alphahull-PointsKO-Adjacents,49733
Miconia_longiracemosa,2,2,0,Points-PointsKO-Adjacents,18
Miconia_longisepala,17,5,12,Points-PointsKO-Adjacents,147
Miconia_longispicata,209,139,70,Alphahull-PointsKO-Adjacents,21594
Miconia_lourteigiana,29,10,19,Points-PointsKO-Adjacents,222
Miconia_luciana,9,4,5,Points-PointsKO-Adjacents,15
Miconia_lugonis,25,16,9,Points-PointsKO-Adjacents,188
Miconia_luteola,6,2,4,Points-PointsKO-Adjacents,23
Miconia_lymanii,132,112,20,Alphahull-PointsKO-Adjacents,1242
Miconia_macrantha,1,1,0,Points-PointsKO-Adjacents,9
Miconia_macrotis,78,47,31,Alphahull-PointsKO-Adjacents,475
Miconia_magdalenae,69,54,15,Alphahull-PointsKO-Adjacents,2309
Miconia_majalis,13,7,6,Points-PointsKO-Adjacents,112
Miconia_manauara,24,0,24,Points-PointsKO-Adjacents,146
Miconia_mandonii,35,25,10,Alphahull-PointsKO-Adjacents,231
Miconia_mansfeldiana,1,1,0,Points-PointsKO-Adjacents,9
Miconia_maroana,42,28,14,Alphahull-PointsKO-Adjacents,1206
Miconia_martiniana,2,2,0,Points-PointsKO-Adjacents,18
Miconia_matthaei,395,257,138,Alphahull-PointsKO-Adjacents,17865
Miconia_mattogrossensis,45,0,45,Points-PointsKO-Adjacents,382
Miconia_maximowicziana,2,2,0,Points-PointsKO-Adjacents,18
Miconia_mazanana,41,21,20,Alphahull-PointsKO-Adjacents,1359
Miconia_mcphersonii,4,4,0,Points-PointsKO-Adjacents,24
Miconia_media,64,46,18,Alphahull-PointsKO-Adjacents,707
Miconia_mediocris,5,5,0,Points-PointsKO-Adjacents,41
Miconia_mellina,14,0,14,Points-PointsKO-Adjacents,105
Miconia_mexicana,381,329,52,Alphahull-PointsKO-Adjacents,2987
Miconia_michelangeliana,8,0,8,Points-PointsKO-Adjacents,53
Miconia_micrantha,13,6,7,Points-PointsKO-Adjacents,102
Miconia_micropetala,70,46,24,Alphahull-PointsKO-Adjacents,251
Miconia_militis,48,36,12,Alphahull-PointsKO-Adjacents,156
Miconia_minutiflora,1975,1704,271,Alphahull-PointsKO-Adjacents,126561
Miconia_miocarpa,3,3,0,Points-PointsKO-Adjacents,27
Miconia_mirabilis,847,637,210,Alphahull-PointsKO-Adjacents,22146
Miconia_mituana,7,0,7,Points-PointsKO-Adjacents,58
Miconia_molesta,4,4,0,Points-PointsKO-Adjacents,36
Miconia_molybdea,134,106,28,Alphahull-PointsKO-Adjacents,1203
Miconia_monzoniensis,27,15,12,Points-PointsKO-Adjacents,154
Miconia_mouraei,2,2,0,Points-PointsKO-Adjacents,18
Miconia_multiflora,35,19,16,Points-PointsKO-Adjacents,253
Miconia_multiglandulosa,0,0,0,NA,0
Miconia_multiplinervia,175,144,31,Alphahull-PointsKO-Adjacents,2786
Miconia_multispicata,301,198,103,Alphahull-PointsKO-Adjacents,16053
Miconia_myriantha,357,272,85,Alphahull-PointsKO-Adjacents,30875
Miconia_namandensis,22,15,7,Points-PointsKO-Adjacents,77
Miconia_napoana,69,47,22,Alphahull-PointsKO-Adjacents,3854
Miconia_nasella,1,1,0,Points-PointsKO-Adjacents,9
Miconia_navioensis,39,0,39,Points-PointsKO-Adjacents,304
Miconia_neei,19,9,10,Points-PointsKO-Adjacents,87
Miconia_nematophora,0,0,0,NA,0
Miconia_neomicrantha,522,439,83,Alphahull-PointsKO-Adjacents,10823
Miconia_neriifolia,36,24,12,Alphahull-PointsKO-Adjacents,684
Miconia_nervosa,684,556,128,Alphahull-PointsKO-Adjacents,56240
Miconia_nigricans,26,17,9,Points-PointsKO-Adjacents,125
Miconia_nobilis,0,0,0,NA,0
Miconia_notabilis,111,88,23,Alphahull-PointsKO-Adjacents,796
Miconia_nubicola,1,1,0,Points-PointsKO-Adjacents,9
Miconia_nutans,278,206,72,Alphahull-PointsKO-Adjacents,3414
Miconia_oblongifolia,4,4,0,Points-PointsKO-Adjacents,36
Miconia_obscura,66,50,16,Alphahull-PointsKO-Adjacents,348
Miconia_ochracea,53,37,16,Alphahull-PointsKO-Adjacents,381
Miconia_octopetala,52,31,21,Alphahull-PointsKO-Adjacents,270
Miconia_oligocephala,24,14,10,Points-PointsKO-Adjacents,137
Miconia_oligotricha,153,118,35,Alphahull-PointsKO-Adjacents,1559
Miconia_ombrophila,3,3,0,Points-PointsKO-Adjacents,25
Miconia_oraria,117,81,36,Alphahull-PointsKO-Adjacents,2386
Miconia_orcheotoma,25,15,10,Points-PointsKO-Adjacents,140
Miconia_orescia,21,10,11,Points-PointsKO-Adjacents,145
Miconia_organensis,12,1,11,Points-PointsKO-Adjacents,85
Miconia_osaensis,13,9,4,Points-PointsKO-Adjacents,27
Miconia_ovalifolia,5,5,0,Points-PointsKO-Adjacents,43
Miconia_ovata,1,1,0,Points-PointsKO-Adjacents,9
Miconia_pachydonta,13,2,11,Points-PointsKO-Adjacents,117
Miconia_pachyphylla,13,10,3,Points-PointsKO-Adjacents,25
Miconia_paleacea,182,142,40,Alphahull-PointsKO-Adjacents,3269
Miconia_paniculata,124,78,46,Alphahull-PointsKO-Adjacents,2220
Miconia_pastazana,10,7,3,Points-PointsKO-Adjacents,68
Miconia_pastoensis,5,5,0,Points-PointsKO-Adjacents,32
Miconia_paucidens,101,83,18,Alphahull-PointsKO-Adjacents,1712
Miconia_pausana,3,3,0,Points-PointsKO-Adjacents,18
Miconia_pavoniana,10,4,6,Points-PointsKO-Adjacents,88
Miconia_peltata,4,4,0,Points-PointsKO-Adjacents,15
Miconia_penningtonii,12,2,10,Points-PointsKO-Adjacents,88
Miconia_pepericarpa,346,297,49,Alphahull-PointsKO-Adjacents,6308
Miconia_perelegans,1,1,0,Points-PointsKO-Adjacents,9
Miconia_pergamentacea,20,7,13,Points-PointsKO-Adjacents,139
Miconia_perturbata,8,1,7,Points-PointsKO-Adjacents,68
Miconia_petroniana,14,4,10,Points-PointsKO-Adjacents,99
Miconia_petropolitana,337,298,39,Alphahull-PointsKO-Adjacents,5940
Miconia_phaeochaeta,14,8,6,Points-PointsKO-Adjacents,113
Miconia_phaeophylla,227,159,68,Alphahull-PointsKO-Adjacents,25234
Miconia_phanerostila,103,66,37,Alphahull-PointsKO-Adjacents,3353
Miconia_phlebodes,6,0,6,Points-PointsKO-Adjacents,50
Miconia_picinguabensis,6,2,4,Points-PointsKO-Adjacents,27
Miconia_pileata,141,65,76,Alphahull-PointsKO-Adjacents,2423
Miconia_piperifolia,8,2,6,Points-PointsKO-Adjacents,71
Miconia_pisinniflora,2,2,0,Points-PointsKO-Adjacents,9
Miconia_pittieri,55,43,12,Alphahull-PointsKO-Adjacents,124
Miconia_plena,26,17,9,Points-PointsKO-Adjacents,153
Miconia_plethorica,23,18,5,Points-PointsKO-Adjacents,128
Miconia_plukenetii,93,71,22,Alphahull-PointsKO-Adjacents,3711
Miconia_poecilantha,11,3,8,Points-PointsKO-Adjacents,97
Miconia_poeppigii,461,350,111,Alphahull-PointsKO-Adjacents,67875
Miconia_polyandra,70,50,20,Alphahull-PointsKO-Adjacents,803
Miconia_polychaeta,9,3,6,Points-PointsKO-Adjacents,56
Miconia_polyneura,27,16,11,Points-PointsKO-Adjacents,157
Miconia_poortmannii,17,12,5,Points-PointsKO-Adjacents,113
Miconia_prancei,26,8,18,Points-PointsKO-Adjacents,195
Miconia_prasina,3086,2786,300,Alphahull-PointsKO-Adjacents,125275
Miconia_prasinifolia,7,2,5,Points-PointsKO-Adjacents,45
Miconia_prominens,1,1,0,Points-PointsKO-Adjacents,9
Miconia_protuberans,1,1,0,Points-PointsKO-Adjacents,9
Miconia_pseudoradula,7,0,7,Points-PointsKO-Adjacents,60
Miconia_pseudorigida,1,1,0,Points-PointsKO-Adjacents,9
Miconia_pterocaulon,134,97,37,Alphahull-PointsKO-Adjacents,8085
Miconia_puberula,48,0,48,Points-PointsKO-Adjacents,336
Miconia_pubicalyx,3,3,0,Points-PointsKO-Adjacents,18
Miconia_pubipetala,195,132,63,Alphahull-PointsKO-Adjacents,15970
Miconia_pulchra,3,3,0,Points-PointsKO-Adjacents,25
Miconia_pulverulenta,6,0,6,Points-PointsKO-Adjacents,54
Miconia_punctata,1028,875,153,Alphahull-PointsKO-Adjacents,91601
Miconia_puracencis,7,1,6,Points-PointsKO-Adjacents,57
Miconia_pusilliflora,945,854,91,Alphahull-PointsKO-Adjacents,15093
Miconia_pustulata,90,72,18,Alphahull-PointsKO-Adjacents,705
Miconia_pycnoneura,8,5,3,Points-PointsKO-Adjacents,24
Miconia_pyrifolia,311,195,116,Alphahull-PointsKO-Adjacents,19624
Miconia_quadrangularis,9,4,5,Points-PointsKO-Adjacents,28
Miconia_quadrialata,12,5,7,Points-PointsKO-Adjacents,55
Miconia_quadridomius,20,13,7,Points-PointsKO-Adjacents,82
Miconia_quadrifolia,2,2,0,Points-PointsKO-Adjacents,18
Miconia_quadripora,30,22,8,Alphahull-PointsKO-Adjacents,768
Miconia_quintuplinervia,31,22,9,Alphahull-PointsKO-Adjacents,159
Miconia_rabenii,2,2,0,Points-PointsKO-Adjacents,18
Miconia_racemifera,81,58,23,Alphahull-PointsKO-Adjacents,1002
Miconia_racemosa,289,199,90,Alphahull-PointsKO-Adjacents,5307
Miconia_ramboi,97,84,13,Alphahull-PointsKO-Adjacents,1541
Miconia_rava,1,1,0,Points-PointsKO-Adjacents,9
Miconia_recondita,18,11,7,Points-PointsKO-Adjacents,77
Miconia_reducens,301,244,57,Alphahull-PointsKO-Adjacents,6172
Miconia_regelii,92,49,43,Alphahull-PointsKO-Adjacents,4016
Miconia_rigida,3,3,0,Points-PointsKO-Adjacents,17
Miconia_rimalis,193,165,28,Alphahull-PointsKO-Adjacents,3711
Miconia_rimbachii,4,4,0,Points-PointsKO-Adjacents,36
Miconia_rivalis,34,18,16,Points-PointsKO-Adjacents,238
Miconia_rivetii,38,29,9,Alphahull-PointsKO-Adjacents,321
Miconia_robustissima,28,17,11,Points-PointsKO-Adjacents,156
Miconia_roraimensis,26,14,12,Points-PointsKO-Adjacents,117
Miconia_rubiginosa,670,511,159,Alphahull-PointsKO-Adjacents,40076
Miconia_rufescens,241,156,85,Alphahull-PointsKO-Adjacents,15090
Miconia_ruficalyx,173,88,85,Alphahull-PointsKO-Adjacents,10622
Miconia_rufipila,5,5,0,Points-PointsKO-Adjacents,27
Miconia_rugosa,129,87,42,Alphahull-PointsKO-Adjacents,8666
Miconia_ruizii,52,28,24,Alphahull-PointsKO-Adjacents,437
Miconia_rupticalyx,29,10,19,Points-PointsKO-Adjacents,161
Miconia_sagotiana,7,0,7,Points-PointsKO-Adjacents,63
Miconia_saldanhaei,41,18,23,Points-PointsKO-Adjacents,255
Miconia_salicifolia,213,176,37,Alphahull-PointsKO-Adjacents,2603
Miconia_samanensis,17,13,4,Points-PointsKO-Adjacents,67
Miconia_sandemanii,23,16,7,Points-PointsKO-Adjacents,86
Miconia_sanguinea,33,17,16,Points-PointsKO-Adjacents,251
Miconia_santanana,3,3,0,Points-PointsKO-Adjacents,27
Miconia_santaritensis,13,10,3,Points-PointsKO-Adjacents,72
Miconia_sastrei,9,3,6,Points-PointsKO-Adjacents,39
Miconia_schlechtendalii,102,72,30,Alphahull-PointsKO-Adjacents,1005
Miconia_schlimii,227,189,38,Alphahull-PointsKO-Adjacents,2953
Miconia_schnellii,57,49,8,Alphahull-PointsKO-Adjacents,107
Miconia_schwackei,10,6,4,Points-PointsKO-Adjacents,50
Miconia_sciurea,25,17,8,Points-PointsKO-Adjacents,187
Miconia_sclerophylla,133,0,133,Points-PointsKO-Adjacents,561
Miconia_scutata,16,7,9,Points-PointsKO-Adjacents,107
Miconia_secunda,1,1,0,Points-PointsKO-Adjacents,9
Miconia_secundiflora,11,6,5,Points-PointsKO-Adjacents,63
Miconia_selleana,0,0,0,NA,0
Miconia_sellowiana,757,683,74,Alphahull-PointsKO-Adjacents,11260
Miconia_semisterilis,12,5,7,Points-PointsKO-Adjacents,97
Miconia_septentrionalis,2,2,0,Points-PointsKO-Adjacents,9
Miconia_serialis,128,52,76,Alphahull-PointsKO-Adjacents,7005
Miconia_serrulata,1086,901,185,Alphahull-PointsKO-Adjacents,55674
Miconia_setosociliata,27,11,16,Points-PointsKO-Adjacents,172
Miconia_setulosa,35,19,16,Points-PointsKO-Adjacents,164
Miconia_shattuckii,67,42,25,Alphahull-PointsKO-Adjacents,810
Miconia_shepherdii,40,29,11,Alphahull-PointsKO-Adjacents,146
Miconia_silicicola,58,43,15,Alphahull-PointsKO-Adjacents,1591
Miconia_simplex,186,159,27,Alphahull-PointsKO-Adjacents,2310
Miconia_sintenisii,37,15,22,Points-PointsKO-Adjacents,70
Miconia_smaragdina,257,210,47,Alphahull-PointsKO-Adjacents,5031
Miconia_smithii,8,0,8,Points-PointsKO-Adjacents,43
Miconia_sodiroi,3,3,0,Points-PointsKO-Adjacents,26
Miconia_sparrei,5,5,0,Points-PointsKO-Adjacents,45
Miconia_spatellophora,13,0,13,Points-PointsKO-Adjacents,70
Miconia_speciosa,16,0,16,Points-PointsKO-Adjacents,96
Miconia_spennerostachya,109,75,34,Alphahull-PointsKO-Adjacents,1640
Miconia_spicellata,87,70,17,Alphahull-PointsKO-Adjacents,2019
Miconia_spichigeri,7,2,5,Points-PointsKO-Adjacents,61
Miconia_spiciformis,77,50,27,Alphahull-PointsKO-Adjacents,779
Miconia_splendens,1073,936,137,Alphahull-PointsKO-Adjacents,87756
Miconia_sprucei,26,10,16,Points-PointsKO-Adjacents,188
Miconia_squamulosa,134,112,22,Alphahull-PointsKO-Adjacents,387
Miconia_staminea,99,46,53,Alphahull-PointsKO-Adjacents,1056
Miconia_stelligera,67,0,67,Points-PointsKO-Adjacents,512
Miconia_stellulata,18,0,18,Points-PointsKO-Adjacents,158
Miconia_stenobotrys,1,1,0,Points-PointsKO-Adjacents,9
Miconia_stenostachya,1291,1091,200,Alphahull-PointsKO-Adjacents,91583
Miconia_stephananthera,113,63,50,Alphahull-PointsKO-Adjacents,6983
Miconia_stevensiana,55,1,54,Points-PointsKO-Adjacents,271
Miconia_stipitata,16,4,12,Points-PointsKO-Adjacents,99
Miconia_stipularis,83,68,15,Alphahull-PointsKO-Adjacents,1434
Miconia_subandicola,72,40,32,Alphahull-PointsKO-Adjacents,2063
Miconia_subcompressa,17,7,10,Points-PointsKO-Adjacents,67
Miconia_subcordata,1,1,0,Points-PointsKO-Adjacents,9
Miconia_submacrophylla,17,4,13,Points-PointsKO-Adjacents,136
Miconia_subsessilifolia,30,26,4,Alphahull-PointsKO-Adjacents,114
Miconia_subspicata,50,35,15,Alphahull-PointsKO-Adjacents,789
Miconia_subulipetala,1,1,0,Points-PointsKO-Adjacents,9
Miconia_subvernicosa,12,0,12,Points-PointsKO-Adjacents,73
Miconia_sulcata,1,1,0,Points-PointsKO-Adjacents,9
Miconia_summa,69,63,6,Alphahull-PointsKO-Adjacents,320
Miconia_superba,31,22,9,Alphahull-PointsKO-Adjacents,310
Miconia_tacanensis,6,3,3,Points-PointsKO-Adjacents,30
Miconia_talamancensis,22,14,8,Points-PointsKO-Adjacents,73
Miconia_tentaculifera,36,0,36,Points-PointsKO-Adjacents,244
Miconia_tenuis,1,1,0,Points-PointsKO-Adjacents,9
Miconia_teotepecensis,2,2,0,Points-PointsKO-Adjacents,18
Miconia_terera,20,11,9,Points-PointsKO-Adjacents,127
Miconia_ternatifolia,138,91,47,Alphahull-PointsKO-Adjacents,9035
Miconia_tetragona,51,18,33,Points-PointsKO-Adjacents,426
Miconia_tetrandra,65,39,26,Alphahull-PointsKO-Adjacents,826
Miconia_tetrasperma,110,50,60,Alphahull-PointsKO-Adjacents,10642
Miconia_tetraspermoides,78,0,78,Points-PointsKO-Adjacents,614
Miconia_tetrastoma,21,8,13,Points-PointsKO-Adjacents,111
Miconia_tetrazygioides,0,0,0,NA,0
Miconia_thaminantha,16,5,11,Points-PointsKO-Adjacents,111
Miconia_theaezans,1285,1091,194,Alphahull-PointsKO-Adjacents,21038
Miconia_thomasiana,17,12,5,Points-PointsKO-Adjacents,60
Miconia_thysanophylla,6,2,4,Points-PointsKO-Adjacents,18
Miconia_tillettii,99,0,99,Points-PointsKO-Adjacents,546
Miconia_tinifolia,246,195,51,Alphahull-PointsKO-Adjacents,6546
Miconia_tomentosa,229,188,41,Alphahull-PointsKO-Adjacents,10696
Miconia_tonduzii,282,259,23,Alphahull-PointsKO-Adjacents,594
Miconia_tovarensis,37,17,20,Points-PointsKO-Adjacents,235
Miconia_traillii,99,48,51,Alphahull-PointsKO-Adjacents,6730
Miconia_transversa,18,5,13,Points-PointsKO-Adjacents,123
Miconia_trianae,124,97,27,Alphahull-PointsKO-Adjacents,3080
Miconia_triangularis,33,19,14,Points-PointsKO-Adjacents,224
Miconia_trinervia,981,871,110,Alphahull-PointsKO-Adjacents,35224
Miconia_triplinervis,478,392,86,Alphahull-PointsKO-Adjacents,15622
Miconia_tristis,376,321,55,Alphahull-PointsKO-Adjacents,6227
Miconia_truncata,69,45,24,Alphahull-PointsKO-Adjacents,2915
Miconia_tschudyoides,25,19,6,Points-PointsKO-Adjacents,131
Miconia_turgida,18,11,7,Points-PointsKO-Adjacents,115
Miconia_turquinensis,3,3,0,Points-PointsKO-Adjacents,13
Miconia_umbriensis,18,5,13,Points-PointsKO-Adjacents,137
Miconia_umbrosa,10,3,7,Points-PointsKO-Adjacents,56
Miconia_undata,58,36,22,Alphahull-PointsKO-Adjacents,224
Miconia_valida,17,11,6,Points-PointsKO-Adjacents,57
Miconia_valtheri,209,168,41,Alphahull-PointsKO-Adjacents,3360
Miconia_variabilis,354,300,54,Alphahull-PointsKO-Adjacents,4444
Miconia_velutina,81,63,18,Alphahull-PointsKO-Adjacents,2421
Miconia_venulosa,43,21,22,Alphahull-PointsKO-Adjacents,1055
Miconia_versicolor,67,41,26,Alphahull-PointsKO-Adjacents,1018
Miconia_vestita,3,3,0,Points-PointsKO-Adjacents,18
Miconia_villonacensis,9,5,4,Points-PointsKO-Adjacents,45
Miconia_voronovii,1,1,0,Points-PointsKO-Adjacents,9
Miconia_wagneri,11,0,11,Points-PointsKO-Adjacents,93
Miconia_warmingiana,4,4,0,Points-PointsKO-Adjacents,36
Miconia_weddellii,3,3,0,Points-PointsKO-Adjacents,27
Miconia_willdenowii,77,55,22,Alphahull-PointsKO-Adjacents,1752
Miconia_wittii,48,28,20,Alphahull-PointsKO-Adjacents,1177
Miconia_woytkowskii,34,13,21,Points-PointsKO-Adjacents,267
Miconia_wurdackii,58,44,14,Alphahull-PointsKO-Adjacents,696
Miconia_xenotricha,2,2,0,Points-PointsKO-Adjacents,12
Miconia_zanonii,6,1,5,Points-PointsKO-Adjacents,41
Miconia_zemurrayana,31,22,9,Alphahull-PointsKO-Adjacents,230
Miconia_zubenetana,14,6,8,Points-PointsKO-Adjacents,109
Micrandra_elata,194,94,100,Alphahull-PointsKO-Adjacents,6798
Micrandra_gleasoniana,9,6,3,Points-PointsKO-Adjacents,48
Micrandra_inundata,10,0,10,Points-PointsKO-Adjacents,37
Micrandra_lopezii,6,0,6,Points-PointsKO-Adjacents,54
Micrandra_minor,43,23,20,Alphahull-PointsKO-Adjacents,1314
Micrandra_rossiana,29,6,23,Points-PointsKO-Adjacents,254
Micrandra_siphonioides,240,192,48,Alphahull-PointsKO-Adjacents,13222
Micrandra_spruceana,236,190,46,Alphahull-PointsKO-Adjacents,12152
Micrandra_sprucei,27,15,12,Points-PointsKO-Adjacents,219
Micrandropsis_scleroxylon,66,0,66,Points-PointsKO-Adjacents,371
Micrechites_malipoensis,4,4,0,Points-PointsKO-Adjacents,36
Microberlinia_bisulcata,23,19,4,Points-PointsKO-Adjacents,124
Microberlinia_brazzavillensis,16,8,8,Points-PointsKO-Adjacents,85
Micrococca_capensis,29,8,21,Points-PointsKO-Adjacents,222
Micrococca_scariosa,8,2,6,Points-PointsKO-Adjacents,57
Micrococca_wightii,0,0,0,NA,0
Microcos_antidesmifolia,10,1,9,Points-PointsKO-Adjacents,81
Grewia_calophylla,1,1,0,Points-PointsKO-Adjacents,9
Grewia_conocarpa,26,19,7,Points-PointsKO-Adjacents,157
Grewia_conocarpoides,1,1,0,Points-PointsKO-Adjacents,9
Microcos_coriacea,144,123,21,Alphahull-PointsKO-Adjacents,2889
Microcos_erythrocarpa,0,0,0,NA,0
Microcos_fibrocarpa,17,1,16,Points-PointsKO-Adjacents,126
Microcos_globulifera,1,1,0,Points-PointsKO-Adjacents,9
Microcos_hirsuta,16,5,11,Points-PointsKO-Adjacents,117
Microcos_latifolia,2,2,0,Points-PointsKO-Adjacents,18
Microcos_latistipulata,0,0,0,NA,0
Microcos_laurifolia,1,1,0,Points-PointsKO-Adjacents,9
Microcos_malayana,NA,NA,NA,NA,NA
Microcos_oligoneura,51,27,24,Alphahull-PointsKO-Adjacents,2506
Microcos_paniculata,72,0,72,Points-PointsKO-Adjacents,595
Grewia_philippinensis,0,0,0,NA,0
Grewia_pinnatifida,37,7,30,Points-PointsKO-Adjacents,279
Microcos_riparia,NA,NA,NA,NA,NA
Grewia_sinuata,0,0,0,NA,0
Microcos_stauntoniana,1,1,0,Points-PointsKO-Adjacents,9
Microcos_triflora,6,1,5,Points-PointsKO-Adjacents,47
Microcos_tomentosa,33,5,28,Points-PointsKO-Adjacents,272
Grewia_ugandensis,21,11,10,Points-PointsKO-Adjacents,137
Microdesmis_afrodecandra,31,23,8,Alphahull-PointsKO-Adjacents,387
Microdesmis_camerunensis,23,9,14,Points-PointsKO-Adjacents,181
Microdesmis_haumaniana,15,4,11,Points-PointsKO-Adjacents,131
Microdesmis_kasaiensis,13,4,9,Points-PointsKO-Adjacents,105
Microdesmis_klainei,19,9,10,Points-PointsKO-Adjacents,124
Microdesmis_magallanensis,1,1,0,Points-PointsKO-Adjacents,8
Microdesmis_pierlotiana,24,9,15,Points-PointsKO-Adjacents,169
Microdesmis_puberula,358,303,55,Alphahull-PointsKO-Adjacents,9199
Microdesmis_yafungana,32,19,13,Points-PointsKO-Adjacents,151
Microlobius_foetidus,104,68,36,Alphahull-PointsKO-Adjacents,737
Micromelum_integerrimum,59,29,30,Alphahull-PointsKO-Adjacents,2637
Micromeria_unguentaria,0,0,0,NA,0
Micronychia_acuminata,6,0,6,Points-PointsKO-Adjacents,32
Micronychia_danguyana,2,2,0,Points-PointsKO-Adjacents,18
Micronychia_macrophylla,26,16,10,Points-PointsKO-Adjacents,146
Micronychia_madagascariensis,12,7,5,Points-PointsKO-Adjacents,78
Micronychia_minutiflora,50,36,14,Alphahull-PointsKO-Adjacents,871
Micronychia_tsiramiramy,65,54,11,Alphahull-PointsKO-Adjacents,539
Micropholis_acutangula,67,33,34,Alphahull-PointsKO-Adjacents,3890
Micropholis_brochidodroma,18,7,11,Points-PointsKO-Adjacents,116
Micropholis_casiquiarensis,52,25,27,Alphahull-PointsKO-Adjacents,306
Micropholis_caudata,5,5,0,Points-PointsKO-Adjacents,45
Micropholis_cayennensis,14,0,14,Points-PointsKO-Adjacents,101
Micropholis_compta,45,18,27,Points-PointsKO-Adjacents,289
Micropholis_crassipedicellata,185,142,43,Alphahull-PointsKO-Adjacents,1824
Micropholis_crotonoides,107,65,42,Alphahull-PointsKO-Adjacents,4520
Micropholis_cylindrocarpa,53,22,31,Alphahull-PointsKO-Adjacents,1968
Micropholis_egensis,645,577,68,Alphahull-PointsKO-Adjacents,60528
Micropholis_emarginata,45,33,12,Alphahull-PointsKO-Adjacents,770
Micropholis_garciniifolia,19,13,6,Points-PointsKO-Adjacents,42
Micropholis_gardneriana,433,0,433,Points-PointsKO-Adjacents,2976
Micropholis_gnaphaloclados,116,79,37,Alphahull-PointsKO-Adjacents,4824
Micropholis_grandiflora,3,2,1,Points-PointsKO-Adjacents,25
Micropholis_guyanensis,1329,1186,143,Alphahull-PointsKO-Adjacents,89670
Micropholis_humboldtiana,43,26,17,Alphahull-PointsKO-Adjacents,2275
Micropholis_longipedicellata,14,5,9,Points-PointsKO-Adjacents,104
Micropholis_macrophylla,2,2,0,Points-PointsKO-Adjacents,18
Micropholis_madeirensis,43,16,27,Points-PointsKO-Adjacents,356
Micropholis_maguirei,11,5,6,Points-PointsKO-Adjacents,68
Micropholis_melinoniana,203,116,87,Alphahull-PointsKO-Adjacents,5592
Micropholis_mensalis,84,41,43,Alphahull-PointsKO-Adjacents,4641
Micropholis_obscura,42,12,30,Points-PointsKO-Adjacents,320
Micropholis_polita,6,2,4,Points-PointsKO-Adjacents,46
Micropholis_porphyrocarpa,82,34,48,Alphahull-PointsKO-Adjacents,3280
Micropholis_resinifera,5,5,0,Points-PointsKO-Adjacents,39
Micropholis_retusa,3,3,0,Points-PointsKO-Adjacents,27
Micropholis_rugosa,6,1,5,Points-PointsKO-Adjacents,42
Micropholis_sanctae-rosae,24,5,19,Points-PointsKO-Adjacents,188
Micropholis_spectabilis,3,3,0,Points-PointsKO-Adjacents,21
Micropholis_splendens,52,35,17,Alphahull-PointsKO-Adjacents,1444
Micropholis_submarginalis,6,2,4,Points-PointsKO-Adjacents,38
Micropholis_suborbicularis,19,7,12,Points-PointsKO-Adjacents,120
Micropholis_trunciflora,64,35,29,Alphahull-PointsKO-Adjacents,814
Micropholis_venamoensis,6,1,5,Points-PointsKO-Adjacents,52
Micropholis_venulosa,1405,1296,109,Alphahull-PointsKO-Adjacents,100602
Micropholis_williamii,62,45,17,Alphahull-PointsKO-Adjacents,2063
Microtropis_discolor,16,1,15,Points-PointsKO-Adjacents,140
Microtropis_fallax,0,0,0,NA,0
Microtropis_fokienensis,186,155,31,Alphahull-PointsKO-Adjacents,454
Microtropis_japonica,74,37,37,Alphahull-PointsKO-Adjacents,225
Microtropis_longifolia,0,0,0,NA,0
Microtropis_malipoensis,NA,NA,NA,NA,NA
Microtropis_obliquinervia,2,2,0,Points-PointsKO-Adjacents,18
Microtropis_paucinervia,0,0,0,NA,0
Microtropis_petelotii,7,1,6,Points-PointsKO-Adjacents,60
Microtropis_pyramidalis,NA,NA,NA,NA,NA
Microtropis_semipaniculata,NA,NA,NA,NA,NA
Microtropis_sphaerocarpa,1,1,0,Points-PointsKO-Adjacents,9
Microtropis_tetragona,5,5,0,Points-PointsKO-Adjacents,36
Microtropis_thyrsiflora,1,1,0,Points-PointsKO-Adjacents,9
Microtropis_yunnanensis,0,0,0,NA,0
Mildbraedia_carpinifolia,99,72,27,Alphahull-PointsKO-Adjacents,888
Mildbraediodendron_excelsum,18,4,14,Points-PointsKO-Adjacents,116
Milicia_excelsa,882,763,119,Alphahull-PointsKO-Adjacents,16501
Milicia_regia,104,74,30,Alphahull-PointsKO-Adjacents,2933
Miliusa_brahei,252,190,62,Alphahull-PointsKO-Adjacents,1566
Miliusa_cuneata,9,3,6,Points-PointsKO-Adjacents,81
Miliusa_horsfieldii,108,64,44,Alphahull-PointsKO-Adjacents,453
Miliusa_indica,4,3,1,Points-PointsKO-Adjacents,36
Saccopetalum_longiflorum,0,0,0,NA,0
Miliusa_macropoda,6,0,6,Points-PointsKO-Adjacents,45
Uvaria_dioeca,9,3,6,Points-PointsKO-Adjacents,80
Miliusa_sclerocarpa,5,4,1,Points-PointsKO-Adjacents,45
Miliusa_sinensis,13,4,9,Points-PointsKO-Adjacents,117
Miliusa_tenuistipitata,3,3,0,Points-PointsKO-Adjacents,27
Uvaria_tomentosa,0,0,0,NA,0
Miliusa_velutina,15,2,13,Points-PointsKO-Adjacents,132
Millettia_aboensis,1,1,0,Points-PointsKO-Adjacents,9
Millettia_acutiflora,9,1,8,Points-PointsKO-Adjacents,65
Millettia_ahernii,2,2,0,Points-PointsKO-Adjacents,18
Millettia_aromatica,1,1,0,Points-PointsKO-Adjacents,9
Millettia_aurea,24,15,9,Points-PointsKO-Adjacents,152
Millettia_austroyunnanensis,NA,NA,NA,NA,NA
Millettia_bequaertii,7,2,5,Points-PointsKO-Adjacents,61
Millettia_boniana,0,0,0,NA,0
Millettia_borneensis,29,10,19,Points-PointsKO-Adjacents,232
Millettia_brachycarpa,6,0,6,Points-PointsKO-Adjacents,50
Millettia_brandisiana,7,1,6,Points-PointsKO-Adjacents,57
Millettia_bussei,25,12,13,Points-PointsKO-Adjacents,208
Millettia_buteoides,1,1,0,Points-PointsKO-Adjacents,9
Millettia_capuronii,9,0,9,Points-PointsKO-Adjacents,58
Millettia_chrysophylla,67,38,29,Alphahull-PointsKO-Adjacents,1809
Millettia_conraui,6,3,3,Points-PointsKO-Adjacents,45
Millettia_coruscans,1,1,0,Points-PointsKO-Adjacents,9
Millettia_cubittii,1,1,0,Points-PointsKO-Adjacents,9
Millettia_decipiens,0,0,0,NA,0
Millettia_dinklagei,21,10,11,Points-PointsKO-Adjacents,163
Millettia_diptera,1,1,0,Points-PointsKO-Adjacents,9
Millettia_drastica,44,12,32,Points-PointsKO-Adjacents,344
Millettia_dubia,31,14,17,Points-PointsKO-Adjacents,201
Millettia_dura,34,21,13,Alphahull-PointsKO-Adjacents,528
Millettia_eberhardtii,2,2,0,Points-PointsKO-Adjacents,9
Millettia_eetveldeana,103,54,49,Alphahull-PointsKO-Adjacents,8544
Millettia_elongatistyla,20,11,9,Points-PointsKO-Adjacents,113
Millettia_eriocarpa,3,3,0,Points-PointsKO-Adjacents,27
Millettia_erythrocalyx,0,0,0,NA,0
Millettia_fallax,NA,NA,NA,NA,NA
Millettia_ferruginea,22,11,11,Points-PointsKO-Adjacents,148
Millettia_foliolosa,NA,NA,NA,NA,NA
Millettia_galliflagrans,NA,NA,NA,NA,NA
Millettia_glabra,3,3,0,Points-PointsKO-Adjacents,17
Millettia_glaucescens,9,1,8,Points-PointsKO-Adjacents,49
Millettia_gracilis,2,2,0,Points-PointsKO-Adjacents,18
Millettia_grandis,48,19,29,Points-PointsKO-Adjacents,345
Millettia_griffoniana,172,127,45,Alphahull-PointsKO-Adjacents,5351
Millettia_harmandii,0,0,0,NA,0
Millettia_hedraeantha,NA,NA,NA,NA,NA
Millettia_hitsika,6,2,4,Points-PointsKO-Adjacents,16
Millettia_hockii,4,4,0,Points-PointsKO-Adjacents,36
Millettia_hylobia,9,0,9,Points-PointsKO-Adjacents,30
Millettia_ichthyochtona,1,1,0,Points-PointsKO-Adjacents,9
Millettia_irvinei,3,3,0,Points-PointsKO-Adjacents,25
Millettia_kangensis,0,0,0,NA,0
Millettia_lacus-alberti,1,1,0,Points-PointsKO-Adjacents,9
Millettia_lane-poolei,38,22,16,Alphahull-PointsKO-Adjacents,916
Millettia_lantsangensis,2,2,0,Points-PointsKO-Adjacents,9
Millettia_laotica,NA,NA,NA,NA,NA
Millettia_latifolia,1,1,0,Points-PointsKO-Adjacents,9
Millettia_laurentii,46,32,14,Alphahull-PointsKO-Adjacents,2340
Millettia_lecomtei,4,4,0,Points-PointsKO-Adjacents,36
Millettia_lenneoides,51,28,23,Alphahull-PointsKO-Adjacents,1036
Millettia_leucantha,4,4,0,Points-PointsKO-Adjacents,36
Millettia_liberica,12,4,8,Points-PointsKO-Adjacents,83
Millettia_limbutuensis,13,11,2,Points-PointsKO-Adjacents,51
Millettia_longipes,1,1,0,Points-PointsKO-Adjacents,9
Millettia_macrophylla,35,25,10,Alphahull-PointsKO-Adjacents,306
Millettia_macrostachya,1,1,0,Points-PointsKO-Adjacents,9
Millettia_macroura,53,33,20,Alphahull-PointsKO-Adjacents,4290
Millettia_mannii,86,68,18,Alphahull-PointsKO-Adjacents,2555
Millettia_micans,9,5,4,Points-PointsKO-Adjacents,53
Millettia_mossambicensis,9,1,8,Points-PointsKO-Adjacents,81
Millettia_nathaliae,17,10,7,Points-PointsKO-Adjacents,80
Millettia_nigrescens,0,0,0,NA,0
Millettia_nudiflora,1,1,0,Points-PointsKO-Adjacents,9
Millettia_nutans,9,4,5,Points-PointsKO-Adjacents,74
Millettia_oblata,70,56,14,Alphahull-PointsKO-Adjacents,1935
Millettia_oraria,2,2,0,Points-PointsKO-Adjacents,18
Millettia_orientalis,9,2,7,Points-PointsKO-Adjacents,41
Millettia_pachycarpa,149,103,46,Alphahull-PointsKO-Adjacents,9512
Millettia_pallens,65,49,16,Alphahull-PointsKO-Adjacents,1279
Millettia_peguensis,5,5,0,Points-PointsKO-Adjacents,45
Millettia_piscidia,1,1,0,Points-PointsKO-Adjacents,9
Millettia_platyphylla,0,0,0,NA,0
Millettia_podocarpa,0,0,0,NA,0
Millettia_pseudoracemosa,NA,NA,NA,NA,NA
Millettia_psilopetala,47,0,47,Points-PointsKO-Adjacents,336
Millettia_pterocarpa,NA,NA,NA,NA,NA
Millettia_pubinervis,0,0,0,NA,0
Millettia_pulchra,50,27,23,Alphahull-PointsKO-Adjacents,3255
Millettia_rhodantha,49,26,23,Alphahull-PointsKO-Adjacents,1414
Millettia_richardiana,141,111,30,Alphahull-PointsKO-Adjacents,1823
Millettia_sacleuxii,8,3,5,Points-PointsKO-Adjacents,29
Millettia_sanagana,57,39,18,Alphahull-PointsKO-Adjacents,2960
Millettia_schliebenii,5,4,1,Points-PointsKO-Adjacents,41
Millettia_semseii,9,4,5,Points-PointsKO-Adjacents,61
Millettia_sericantha,2,2,0,Points-PointsKO-Adjacents,18
Millettia_sericea,6,0,6,Points-PointsKO-Adjacents,45
Millettia_setigera,2,2,0,Points-PointsKO-Adjacents,9
Millettia_stenopetala,1,1,0,Points-PointsKO-Adjacents,9
Millettia_stipulata,0,0,0,NA,0
Millettia_stuhlmannii,48,24,24,Alphahull-PointsKO-Adjacents,678
Millettia_taolanaroensis,29,24,5,Alphahull-PointsKO-Adjacents,70
Millettia_tetraptera,1,1,0,Points-PointsKO-Adjacents,9
Millettia_thonningii,313,284,29,Alphahull-PointsKO-Adjacents,1515
Millettia_trifoliata,0,0,0,NA,0
Millettia_usaramensis,53,25,28,Alphahull-PointsKO-Adjacents,1571
Millettia_utilis,0,0,0,NA,0
Millettia_velutina,16,4,12,Points-PointsKO-Adjacents,144
Millettia_velvetina,7,1,6,Points-PointsKO-Adjacents,46
Millettia_venusta,0,0,0,NA,0
Millettia_versicolor,43,26,17,Alphahull-PointsKO-Adjacents,2026
Millettia_warneckei,29,10,19,Points-PointsKO-Adjacents,199
Millettia_wrightiana,NA,NA,NA,NA,NA
Millettia_xylocarpa,15,0,15,Points-PointsKO-Adjacents,125
Millettia_zechiana,128,89,39,Alphahull-PointsKO-Adjacents,2277
Millingtonia_hortensis,14,2,12,Points-PointsKO-Adjacents,126
Mimetes_arboreus,3,2,1,Points-PointsKO-Adjacents,18
Mimetes_fimbriifolius,29,0,29,Points-PointsKO-Adjacents,59
Mimosa_acantholoba,284,203,81,Alphahull-PointsKO-Adjacents,2266
Mimosa_acerba,84,0,84,Points-PointsKO-Adjacents,585
Mimosa_aculeaticarpa,1219,1113,106,Alphahull-PointsKO-Adjacents,23652
Mimosa_acutistipula,482,433,49,Alphahull-PointsKO-Adjacents,12859
Mimosa_albida,1596,1354,242,Alphahull-PointsKO-Adjacents,16257
Mimosa_antioquensis,50,36,14,Alphahull-PointsKO-Adjacents,300
Mimosa_apodocarpa,29,15,14,Points-PointsKO-Adjacents,213
Mimosa_arenosa,46,23,23,Alphahull-PointsKO-Adjacents,1962
Mimosa_artemisiana,64,42,22,Alphahull-PointsKO-Adjacents,1833
Mimosa_bahamensis,2,2,0,Points-PointsKO-Adjacents,16
Mimosa_balansae,44,24,20,Alphahull-PointsKO-Adjacents,1042
Mimosa_benthamii,269,251,18,Alphahull-PointsKO-Adjacents,2797
Mimosa_bifurca,26,0,26,Points-PointsKO-Adjacents,191
Mimosa_bimucronata,614,465,149,Alphahull-PointsKO-Adjacents,23399
Mimosa_brandegei,22,9,13,Points-PointsKO-Adjacents,121
Mimosa_brevipetiolata,15,6,9,Points-PointsKO-Adjacents,121
Mimosa_brevispicata,24,19,5,Points-PointsKO-Adjacents,105
Mimosa_caduca,20,13,7,Points-PointsKO-Adjacents,86
Mimosa_caesalpiniifolia,361,0,361,Points-PointsKO-Adjacents,2166
Mimosa_canahuensis,1,1,0,Points-PointsKO-Adjacents,9
Mimosa_ceratonia,25,13,12,Points-PointsKO-Adjacents,100
Mimosa_costenya,17,0,17,Points-PointsKO-Adjacents,80
Mimosa_cruenta,22,0,22,Points-PointsKO-Adjacents,172
Mimosa_cubatanensis,18,3,15,Points-PointsKO-Adjacents,108
Mimosa_dalyi,10,5,5,Points-PointsKO-Adjacents,72
Mimosa_detinens,100,82,18,Alphahull-PointsKO-Adjacents,5881
Mimosa_distachya,7,0,7,Points-PointsKO-Adjacents,51
Mimosa_dolens,229,170,59,Alphahull-PointsKO-Adjacents,9684
Mimosa_eurycarpa,142,92,50,Alphahull-PointsKO-Adjacents,751
Mimosa_extranea,0,0,0,NA,0
Mimosa_farinosa,49,30,19,Alphahull-PointsKO-Adjacents,977
Mimosa_flocculosa,55,36,19,Alphahull-PointsKO-Adjacents,1582
Mimosa_galeottii,167,137,30,Alphahull-PointsKO-Adjacents,2051
Mimosa_gemmulata,458,411,47,Alphahull-PointsKO-Adjacents,11164
Mimosa_glutinosa,44,0,44,Points-PointsKO-Adjacents,267
Mimosa_goldmanii,68,48,20,Alphahull-PointsKO-Adjacents,307
Mimosa_haavoa,3,3,0,Points-PointsKO-Adjacents,27
Mimosa_hexandra,241,185,56,Alphahull-PointsKO-Adjacents,7663
Mimosa_hirsutissima,230,150,80,Alphahull-PointsKO-Adjacents,7212
Mimosa_huanchacae,9,0,9,Points-PointsKO-Adjacents,48
Mimosa_insignis,8,3,5,Points-PointsKO-Adjacents,72
Mimosa_interrupta,56,38,18,Alphahull-PointsKO-Adjacents,1614
Mimosa_lacerata,153,125,28,Alphahull-PointsKO-Adjacents,1281
Mimosa_lactiflua,175,151,24,Alphahull-PointsKO-Adjacents,1147
Mimosa_laticifera,138,101,37,Alphahull-PointsKO-Adjacents,9335
Mimosa_lepidota,32,25,7,Alphahull-PointsKO-Adjacents,128
Mimosa_leucaenoides,158,147,11,Alphahull-PointsKO-Adjacents,872
Mimosa_lingvatouana,5,1,4,Points-PointsKO-Adjacents,24
Mimosa_mensicola,17,10,7,Points-PointsKO-Adjacents,45
Mimosa_mollis,91,0,91,Points-PointsKO-Adjacents,252
Mimosa_myuros,15,7,8,Points-PointsKO-Adjacents,125
Mimosa_nothacacia,6,2,4,Points-PointsKO-Adjacents,51
Mimosa_ophthalmocentra,499,459,40,Alphahull-PointsKO-Adjacents,8511
Mimosa_ostenii,9,3,6,Points-PointsKO-Adjacents,81
Mimosa_palmeri,87,67,20,Alphahull-PointsKO-Adjacents,988
Mimosa_panamensis,20,7,13,Points-PointsKO-Adjacents,140
Mimosa_parvifoliolata,NA,NA,NA,NA,NA
Mimosa_pellita,189,78,111,Alphahull-PointsKO-Adjacents,3160
Mimosa_pigra,2283,1720,563,Alphahull-PointsKO-Adjacents,122689
Mimosa_pilulifera,193,155,38,Alphahull-PointsKO-Adjacents,6107
Mimosa_platycarpa,63,45,18,Alphahull-PointsKO-Adjacents,834
Mimosa_polyantha,324,278,46,Alphahull-PointsKO-Adjacents,1991
Mimosa_prainiana,NA,NA,NA,NA,NA
Mimosa_purpurascens,58,0,58,Points-PointsKO-Adjacents,232
Mimosa_quadrivalvis,1037,802,235,Alphahull-PointsKO-Adjacents,43560
Mimosa_quitensis,79,56,23,Alphahull-PointsKO-Adjacents,280
Mimosa_regina,9,6,3,Points-PointsKO-Adjacents,27
Mimosa_regnellii,106,88,18,Alphahull-PointsKO-Adjacents,2364
Mimosa_revoluta,47,29,18,Alphahull-PointsKO-Adjacents,469
Mimosa_rheiptera,13,9,4,Points-PointsKO-Adjacents,58
Mimosa_rhodocarpa,77,58,19,Alphahull-PointsKO-Adjacents,2039
Mimosa_rhododactyla,36,23,13,Alphahull-PointsKO-Adjacents,860
Mimosa_rigidicaulis,2,2,0,Points-PointsKO-Adjacents,18
Mimosa_rosei,100,1,99,Points-PointsKO-Adjacents,345
Mimosa_rufescens,146,75,71,Alphahull-PointsKO-Adjacents,19110
Mimosa_scabrella,463,409,54,Alphahull-PointsKO-Adjacents,5310
Mimosa_schomburgkii,76,34,42,Alphahull-PointsKO-Adjacents,2587
Mimosa_setosissima,24,21,3,Alphahull-PointsKO-Adjacents,23
Mimosa_tarda,65,0,65,Points-PointsKO-Adjacents,417
Mimosa_tenuiflora,984,869,115,Alphahull-PointsKO-Adjacents,12434
Mimosa_townsendii,7,3,4,Points-PointsKO-Adjacents,40
Mimosa_trianae,8,4,4,Points-PointsKO-Adjacents,51
Mimosa_verrucosa,278,252,26,Alphahull-PointsKO-Adjacents,6324
Mimosa_woodii,3,3,0,Points-PointsKO-Adjacents,24
Mimozyganthus_carinatus,101,79,22,Alphahull-PointsKO-Adjacents,6164
Mimulopsis_arborescens,51,32,19,Alphahull-PointsKO-Adjacents,492
Mimusops_acutifolia,1,1,0,Points-PointsKO-Adjacents,9
Mimusops_aedificatoria,6,0,6,Points-PointsKO-Adjacents,45
Mimusops_affinis,1,1,0,Points-PointsKO-Adjacents,9
Mimusops_andamanensis,0,0,0,NA,0
Mimusops_andongensis,110,77,33,Alphahull-PointsKO-Adjacents,660
Mimusops_angel,2,2,0,Points-PointsKO-Adjacents,12
Mimusops_ankaibeensis,26,15,11,Points-PointsKO-Adjacents,134
Mimusops_antongilensis,15,10,5,Points-PointsKO-Adjacents,80
Mimusops_antorakensis,9,3,6,Points-PointsKO-Adjacents,57
Mimusops_antsiranensis,9,2,7,Points-PointsKO-Adjacents,21
Mimusops_bagshawei,26,14,12,Points-PointsKO-Adjacents,131
Mimusops_balata,2,2,0,Points-PointsKO-Adjacents,15
Mimusops_caffra,61,22,39,Alphahull-PointsKO-Adjacents,615
Mimusops_capuronii,78,55,23,Alphahull-PointsKO-Adjacents,1290
Mimusops_comorensis,2,2,0,Points-PointsKO-Adjacents,8
Mimusops_coriacea,70,41,29,Alphahull-PointsKO-Adjacents,808
Mimusops_dodensis,NA,NA,NA,NA,NA
Mimusops_ebolowensis,0,0,0,NA,0
Mimusops_elengi,415,297,118,Alphahull-PointsKO-Adjacents,3925
Mimusops_erythroxylon,0,0,0,NA,0
Mimusops_giorgii,1,1,0,Points-PointsKO-Adjacents,9
Mimusops_kummel,129,79,50,Alphahull-PointsKO-Adjacents,4121
Mimusops_laurifolia,7,0,7,Points-PointsKO-Adjacents,53
Mimusops_lecomtei,29,0,29,Points-PointsKO-Adjacents,70
Mimusops_lohindri,20,10,10,Points-PointsKO-Adjacents,63
Mimusops_longipedicellata,1,1,0,Points-PointsKO-Adjacents,6
Mimusops_mayumbensis,1,1,0,Points-PointsKO-Adjacents,9
Mimusops_membranacea,14,4,10,Points-PointsKO-Adjacents,85
Mimusops_mildbraedii,NA,NA,NA,NA,NA
Mimusops_ngembe,NA,NA,NA,NA,NA
Mimusops_nossibeensis,1,1,0,Points-PointsKO-Adjacents,9
Mimusops_oblongifolia,NA,NA,NA,NA,NA
Mimusops_obovata,62,35,27,Alphahull-PointsKO-Adjacents,704
Mimusops_obtusifolia,40,19,21,Points-PointsKO-Adjacents,330
Mimusops_occidentalis,15,6,9,Points-PointsKO-Adjacents,81
Mimusops_penduliflora,1,1,0,Points-PointsKO-Adjacents,9
Mimusops_perrieri,39,24,15,Alphahull-PointsKO-Adjacents,178
Mimusops_petiolaris,2,1,1,Points-PointsKO-Adjacents,18
Mimusops_riparia,9,1,8,Points-PointsKO-Adjacents,81
Mimusops_sambiranensis,9,2,7,Points-PointsKO-Adjacents,59
Mimusops_sechellarum,1,1,0,Points-PointsKO-Adjacents,8
Mimusops_somalensis,15,4,11,Points-PointsKO-Adjacents,96
Mimusops_voalela,21,10,11,Points-PointsKO-Adjacents,120
Mimusops_zeyheri,132,94,38,Alphahull-PointsKO-Adjacents,2205
Mimusops_zeylanica,0,0,0,NA,0
Minquartia_guianensis,1222,1133,89,Alphahull-PointsKO-Adjacents,77132
Misanteca_mutisii,2,2,0,Points-PointsKO-Adjacents,18
Misanteca_tenuifolia,1,1,0,Points-PointsKO-Adjacents,9
Mischarytera_bullata,2,2,0,Points-PointsKO-Adjacents,9
Mischarytera_lautereriana,149,123,26,Alphahull-PointsKO-Adjacents,543
Mischarytera_macrobotrys,29,16,13,Points-PointsKO-Adjacents,102
Mischocarpus_hainanensis,1,1,0,Points-PointsKO-Adjacents,9
Mischocarpus_pentapetalus,65,17,48,Points-PointsKO-Adjacents,537
Mischocarpus_sundaicus,106,22,84,Alphahull-PointsKO-Adjacents,812
Mischodon_zeylanicus,1,1,0,Points-PointsKO-Adjacents,9
Mischogyne_elliotianum,33,0,33,Points-PointsKO-Adjacents,247
Mitragyna_diversifolia,9,0,9,Points-PointsKO-Adjacents,80
Mitragyna_hirsuta,7,1,6,Points-PointsKO-Adjacents,63
Mitragyna_inermis,469,414,55,Alphahull-PointsKO-Adjacents,10595
Mitragyna_parvifolia,7,1,6,Points-PointsKO-Adjacents,60
Mitragyna_rotundifolia,13,0,13,Points-PointsKO-Adjacents,117
Mitragyna_rubrostipulata,69,44,25,Alphahull-PointsKO-Adjacents,951
Mitragyna_speciosa,13,4,9,Points-PointsKO-Adjacents,95
Mitragyna_stipulosa,151,76,75,Alphahull-PointsKO-Adjacents,4443
Mitragyna_tubulosa,1,1,0,Points-PointsKO-Adjacents,9
Mitranthes_clarendonensis,2,2,0,Points-PointsKO-Adjacents,18
Mitranthes_macrophylla,0,0,0,NA,0
Mitranthes_nivea,0,0,0,NA,0
Mitrantia_bilocularis,6,4,2,Points-PointsKO-Adjacents,18
Mitreola_petiolata,730,473,257,Alphahull-PointsKO-Adjacents,24675
Mitrephora_amdjahii,0,0,0,NA,0
Mitrephora_clemensiorum,1,1,0,Points-PointsKO-Adjacents,9
Mitrephora_endertii,1,1,0,Points-PointsKO-Adjacents,9
Mitrephora_fragrans,2,2,0,Points-PointsKO-Adjacents,18
Mitrephora_glabra,15,5,10,Points-PointsKO-Adjacents,108
Mitrephora_heyneana,4,2,2,Points-PointsKO-Adjacents,30
Mitrephora_korthalsiana,3,3,0,Points-PointsKO-Adjacents,27
Mitrephora_kostermansii,0,0,0,NA,0
Mitrephora_longipetala,6,0,6,Points-PointsKO-Adjacents,52
Mitrephora_macclurei,1,1,0,Points-PointsKO-Adjacents,9
Mitrephora_teysmannii,16,0,16,Points-PointsKO-Adjacents,144
Mitrephora_thorelii,16,1,15,Points-PointsKO-Adjacents,135
Mitrephora_tomentosa,15,1,14,Points-PointsKO-Adjacents,126
Mitrephora_uniflora,1,1,0,Points-PointsKO-Adjacents,9
Mitrephora_vittata,3,3,0,Points-PointsKO-Adjacents,27
Mitrephora_wangii,5,5,0,Points-PointsKO-Adjacents,45
Mitrephora_woodii,0,0,0,NA,0
Mitriostigma_axillare,17,3,14,Points-PointsKO-Adjacents,115
Mkilua_fragrans,41,30,11,Alphahull-PointsKO-Adjacents,260
Mocinnodaphne_cinnamomoidea,4,4,0,Points-PointsKO-Adjacents,30
Moldenhawera_acuminata,9,2,7,Points-PointsKO-Adjacents,81
Moldenhawera_blanchetiana,93,1,92,Points-PointsKO-Adjacents,288
Moldenhawera_floribunda,51,32,19,Alphahull-PointsKO-Adjacents,435
Moldenhawera_lushnathiana,18,8,10,Points-PointsKO-Adjacents,75
Moldenhawera_mollis,NA,NA,NA,NA,NA
Moldenhawera_nutans,19,8,11,Points-PointsKO-Adjacents,68
Moldenhawera_papillanthera,30,21,9,Alphahull-PointsKO-Adjacents,150
Moldenhawera_polysperma,41,27,14,Alphahull-PointsKO-Adjacents,195
Molinadendron_guatemalense,47,28,19,Alphahull-PointsKO-Adjacents,275
Molinadendron_hondurense,12,5,7,Points-PointsKO-Adjacents,84
Molinaea_arborea,1,1,0,Points-PointsKO-Adjacents,9
Molinaea_retusa,40,27,13,Alphahull-PointsKO-Adjacents,426
Molinaea_tolambitou,19,8,11,Points-PointsKO-Adjacents,135
Mollia_burchellii,59,32,27,Alphahull-PointsKO-Adjacents,1595
Mollia_glabrescens,12,5,7,Points-PointsKO-Adjacents,62
Mollia_globularis,9,4,5,Points-PointsKO-Adjacents,74
Mollia_gracilis,110,71,39,Alphahull-PointsKO-Adjacents,12933
Mollia_grandiflora,9,0,9,Points-PointsKO-Adjacents,68
Mollia_lepidota,502,426,76,Alphahull-PointsKO-Adjacents,47828
Mollia_longifolia,8,0,8,Points-PointsKO-Adjacents,72
Mollia_lucens,9,0,9,Points-PointsKO-Adjacents,81
Mollia_macrophylla,3,3,0,Points-PointsKO-Adjacents,27
Mollia_nitida,7,0,7,Points-PointsKO-Adjacents,57
Mollia_speciosa,208,160,48,Alphahull-PointsKO-Adjacents,10904
Mollia_sphaerocarpa,30,2,28,Points-PointsKO-Adjacents,230
Mollia_tomentosa,41,26,15,Alphahull-PointsKO-Adjacents,384
Mollia_ulei,50,0,50,Points-PointsKO-Adjacents,367
Mollia_williamsii,9,0,9,Points-PointsKO-Adjacents,63
Mollinedia_acutissima,30,0,30,Points-PointsKO-Adjacents,192
Mollinedia_argyrogyna,274,237,37,Alphahull-PointsKO-Adjacents,6599
Mollinedia_blumenaviana,114,87,27,Alphahull-PointsKO-Adjacents,3093
Mollinedia_boliviensis,31,17,14,Points-PointsKO-Adjacents,229
Mollinedia_butleriana,6,2,4,Points-PointsKO-Adjacents,45
Mollinedia_calodonta,47,34,13,Alphahull-PointsKO-Adjacents,632
Mollinedia_clavigera,250,218,32,Alphahull-PointsKO-Adjacents,4008
Mollinedia_corcovadensis,4,4,0,Points-PointsKO-Adjacents,36
Mollinedia_costaricensis,137,118,19,Alphahull-PointsKO-Adjacents,497
Mollinedia_elegans,269,229,40,Alphahull-PointsKO-Adjacents,4086
Mollinedia_engleriana,63,0,63,Points-PointsKO-Adjacents,343
Mollinedia_eugeniifolia,11,5,6,Points-PointsKO-Adjacents,85
Mollinedia_gilgiana,44,0,44,Points-PointsKO-Adjacents,231
Mollinedia_glabra,140,102,38,Alphahull-PointsKO-Adjacents,1730
Mollinedia_glaziovii,12,1,11,Points-PointsKO-Adjacents,71
Mollinedia_heteranthera,29,0,29,Points-PointsKO-Adjacents,206
Mollinedia_howeana,11,6,5,Points-PointsKO-Adjacents,81
Mollinedia_jorgearum,3,2,1,Points-PointsKO-Adjacents,27
Mollinedia_killipii,229,181,48,Alphahull-PointsKO-Adjacents,11004
Mollinedia_lamprophylla,19,6,13,Points-PointsKO-Adjacents,150
Mollinedia_lanceolata,419,331,88,Alphahull-PointsKO-Adjacents,9515
Mollinedia_longicuspidata,4,4,0,Points-PointsKO-Adjacents,36
Mollinedia_longifolia,76,0,76,Points-PointsKO-Adjacents,359
Mollinedia_luizae,11,5,6,Points-PointsKO-Adjacents,93
Mollinedia_maxima,11,1,10,Points-PointsKO-Adjacents,48
Mollinedia_micrantha,64,0,64,Points-PointsKO-Adjacents,475
Mollinedia_minutiflora,109,90,19,Alphahull-PointsKO-Adjacents,781
Mollinedia_oligantha,155,115,40,Alphahull-PointsKO-Adjacents,1559
Mollinedia_ovata,894,721,173,Alphahull-PointsKO-Adjacents,44505
Mollinedia_pachysandra,26,0,26,Points-PointsKO-Adjacents,192
Mollinedia_pallida,45,0,45,Points-PointsKO-Adjacents,157
Mollinedia_repanda,162,0,162,Points-PointsKO-Adjacents,855
Mollinedia_salicifolia,26,0,26,Points-PointsKO-Adjacents,181
Mollinedia_schottiana,824,748,76,Alphahull-PointsKO-Adjacents,5994
Mollinedia_steinbachiana,33,17,16,Points-PointsKO-Adjacents,227
Mollinedia_stenophylla,6,3,3,Points-PointsKO-Adjacents,39
Mollinedia_tomentosa,140,123,17,Alphahull-PointsKO-Adjacents,2619
Mollinedia_uleana,290,249,41,Alphahull-PointsKO-Adjacents,2697
Mollinedia_viridiflora,656,600,56,Alphahull-PointsKO-Adjacents,5410
Mollinedia_widgrenii,365,315,50,Alphahull-PointsKO-Adjacents,7780
Molongum_laxum,104,82,22,Alphahull-PointsKO-Adjacents,4011
Molongum_lucidum,57,37,20,Alphahull-PointsKO-Adjacents,1401
Molongum_zschokkeiforme,24,13,11,Points-PointsKO-Adjacents,167
Molopanthera_paniculata,94,66,28,Alphahull-PointsKO-Adjacents,2907
Monactis_dubia,0,0,0,NA,0
Monactis_holwayae,12,8,4,Points-PointsKO-Adjacents,78
Monactis_pallatangensis,17,8,9,Points-PointsKO-Adjacents,132
Monactis_rhombifolia,3,3,0,Points-PointsKO-Adjacents,27
Monadenium_spinescens,2,2,0,Points-PointsKO-Adjacents,9
Monanthotaxis_buchananii,196,132,64,Alphahull-PointsKO-Adjacents,12370
Monanthotaxis_caffra,20,1,19,Points-PointsKO-Adjacents,144
Monanthotaxis_capea,6,3,3,Points-PointsKO-Adjacents,46
Monanthotaxis_ferruginea,63,24,39,Alphahull-PointsKO-Adjacents,929
Monanthotaxis_fornicata,90,65,25,Alphahull-PointsKO-Adjacents,474
Monanthotaxis_littoralis,13,2,11,Points-PointsKO-Adjacents,111
Monanthotaxis_orophila,33,23,10,Alphahull-PointsKO-Adjacents,232
Monanthotaxis_parvifolia,116,49,67,Alphahull-PointsKO-Adjacents,846
Monanthotaxis_vogelii,33,7,26,Points-PointsKO-Adjacents,238
Monarrhenus_salicifolius,0,0,0,NA,0
Monodora_grandidieri,108,79,29,Alphahull-PointsKO-Adjacents,3310
Monelasmum_umbricola,14,11,3,Points-PointsKO-Adjacents,94
Monilicarpa_tenuisiliqua,27,9,18,Points-PointsKO-Adjacents,161
Monimia_amplexicaulis,1,1,0,Points-PointsKO-Adjacents,9
Monimia_rotundifolia,6,2,4,Points-PointsKO-Adjacents,17
Monnina_aestuans,150,126,24,Alphahull-PointsKO-Adjacents,1680
Monnina_amplibracteata,6,0,6,Points-PointsKO-Adjacents,39
Monnina_bonplandiana,6,0,6,Points-PointsKO-Adjacents,36
Monnina_cladostachya,1,1,0,Points-PointsKO-Adjacents,9
Monnina_coriacea,0,0,0,NA,0
Monnina_crepinii,39,31,8,Alphahull-PointsKO-Adjacents,81
Monnina_decurrens,10,1,9,Points-PointsKO-Adjacents,57
Monnina_densa,8,1,7,Points-PointsKO-Adjacents,54
Monnina_marginata,38,19,19,Points-PointsKO-Adjacents,269
Monnina_membranifolia,1,1,0,Points-PointsKO-Adjacents,9
Monnina_mollis,8,4,4,Points-PointsKO-Adjacents,66
Monnina_pseudosalicifolia,11,4,7,Points-PointsKO-Adjacents,61
Monnina_pubescens,8,1,7,Points-PointsKO-Adjacents,51
Monnina_salicifolia,186,130,56,Alphahull-PointsKO-Adjacents,2400
Monnina_xalapensis,941,850,91,Alphahull-PointsKO-Adjacents,7554
Monocarpia_borneensis,5,5,0,Points-PointsKO-Adjacents,45
Monocarpia_euneura,19,2,17,Points-PointsKO-Adjacents,167
Monocyclanthus_vignei,15,6,9,Points-PointsKO-Adjacents,117
Monodora_angolensis,180,126,54,Alphahull-PointsKO-Adjacents,21779
Monodora_brevipes,62,41,21,Alphahull-PointsKO-Adjacents,538
Monodora_crispata,63,36,27,Alphahull-PointsKO-Adjacents,3283
Monodora_junodii,151,102,49,Alphahull-PointsKO-Adjacents,6396
Monodora_louisii,26,8,18,Points-PointsKO-Adjacents,183
Monodora_minor,38,28,10,Alphahull-PointsKO-Adjacents,718
Monodora_myristica,345,258,87,Alphahull-PointsKO-Adjacents,15713
Monodora_tenuifolia,386,310,76,Alphahull-PointsKO-Adjacents,11145
Monodora_undulata,65,41,24,Alphahull-PointsKO-Adjacents,648
Monodora_unwinii,0,0,0,NA,0
Monoon_lateriflorum,22,2,20,Points-PointsKO-Adjacents,167
Monoporus_bipinnatus,24,24,0,Alphahull,6396
Monoporus_clusiifolius,29,16,13,Points-PointsKO-Adjacents,82
Monoporus_floribundus,32,21,11,Alphahull-PointsKO-Adjacents,269
Monoporus_paludosus,23,13,10,Points-PointsKO-Adjacents,97
Monoporus_spathulatus,58,39,19,Alphahull-PointsKO-Adjacents,578
Monopteryx_angustifolia,17,9,8,Points-PointsKO-Adjacents,126
Monopteryx_inpae,47,0,47,Points-PointsKO-Adjacents,345
Monopteryx_uaucu,61,45,16,Alphahull-PointsKO-Adjacents,3093
Monosis_parishii,14,0,14,Points-PointsKO-Adjacents,126
Monosis_volkameriifolia,33,16,17,Points-PointsKO-Adjacents,291
Monotes_adenophyllus,14,1,13,Points-PointsKO-Adjacents,105
Monotes_africanus,29,6,23,Points-PointsKO-Adjacents,192
Monotes_angolensis,21,1,20,Points-PointsKO-Adjacents,177
Monotes_caloneurus,21,2,19,Points-PointsKO-Adjacents,177
Monotes_carrissoanus,6,0,6,Points-PointsKO-Adjacents,54
Monotes_dasyanthus,4,4,0,Points-PointsKO-Adjacents,36
Monotes_dawei,6,0,6,Points-PointsKO-Adjacents,54
Monotes_discolor,21,3,18,Points-PointsKO-Adjacents,177
Monotes_elegans,45,11,34,Points-PointsKO-Adjacents,341
Monotes_engleri,12,3,9,Points-PointsKO-Adjacents,95
Monotes_gossweileri,1,1,0,Points-PointsKO-Adjacents,9
Monotes_hutchinsonianus,1,1,0,Points-PointsKO-Adjacents,9
Monotes_hypoleucus,18,1,17,Points-PointsKO-Adjacents,141
Monotes_katangensis,12,5,7,Points-PointsKO-Adjacents,103
Monotes_kerstingii,367,332,35,Alphahull-PointsKO-Adjacents,5452
Monotes_loandensis,15,3,12,Points-PointsKO-Adjacents,129
Monotes_lutambensis,1,1,0,Points-PointsKO-Adjacents,9
Monotes_madagascariensis,8,3,5,Points-PointsKO-Adjacents,32
Monotes_magnificus,8,4,4,Points-PointsKO-Adjacents,66
Monotes_noldeae,6,0,6,Points-PointsKO-Adjacents,54
Monotes_pearsonii,1,1,0,Points-PointsKO-Adjacents,9
Monotes_redheadii,1,1,0,Points-PointsKO-Adjacents,9
Monotes_rubriglans,1,1,0,Points-PointsKO-Adjacents,9
Monotes_rufotomentosus,7,2,5,Points-PointsKO-Adjacents,44
Monotes_xasenguensis,1,1,0,Points-PointsKO-Adjacents,9
Montanoa_guatemalensis,74,49,25,Alphahull-PointsKO-Adjacents,361
Montanoa_hexagona,40,27,13,Alphahull-PointsKO-Adjacents,251
Montanoa_josei,2,2,0,Points-PointsKO-Adjacents,18
Montanoa_ovalifolia,16,7,9,Points-PointsKO-Adjacents,99
Montanoa_quadrangularis,67,46,21,Alphahull-PointsKO-Adjacents,1006
Montanoa_revealii,40,32,8,Alphahull-PointsKO-Adjacents,151
Montanoa_tomentosa,913,784,129,Alphahull-PointsKO-Adjacents,7246
Montinia_caryophyllacea,239,198,41,Alphahull-PointsKO-Adjacents,6018
Moquiniastrum_mollissimum,7,0,7,Points-PointsKO-Adjacents,46
Moquiniastrum_oligocephalum,241,192,49,Alphahull-PointsKO-Adjacents,3957
Moquiniastrum_polymorphum,1187,1073,114,Alphahull-PointsKO-Adjacents,26113
Mora_abbottii,12,8,4,Points-PointsKO-Adjacents,81
Mora_ekmanii,14,10,4,Points-PointsKO-Adjacents,75
Mora_excelsa,51,33,18,Alphahull-PointsKO-Adjacents,1754
Mora_gonggrijpii,31,16,15,Points-PointsKO-Adjacents,233
Mora_megistosperma,19,4,15,Points-PointsKO-Adjacents,137
Mora_oleifera,40,19,21,Points-PointsKO-Adjacents,218
Mora_paraensis,54,21,33,Alphahull-PointsKO-Adjacents,1164
Morelia_senegalensis,378,296,82,Alphahull-PointsKO-Adjacents,24680
Morella_cerifera,1709,1421,288,Alphahull-PointsKO-Adjacents,20482
Morella_chevalieri,69,50,19,Alphahull-PointsKO-Adjacents,444
Morella_faya,492,438,54,Alphahull-PointsKO-Adjacents,369
Morella_funckii,9,6,3,Points-PointsKO-Adjacents,79
Morella_holdridgeana,3,2,1,Points-PointsKO-Adjacents,18
Morella_integra,11,1,10,Points-PointsKO-Adjacents,93
Morella_kandtiana,18,8,10,Points-PointsKO-Adjacents,120
Morella_lindeniana,45,23,22,Alphahull-PointsKO-Adjacents,274
Morella_parvifolia,281,243,38,Alphahull-PointsKO-Adjacents,2759
Morella_pavonis,8,2,6,Points-PointsKO-Adjacents,59
Morella_pensylvanica,367,253,114,Alphahull-PointsKO-Adjacents,6376
Morella_pilulifera,63,40,23,Alphahull-PointsKO-Adjacents,2265
Morella_pringlei,27,0,27,Points-PointsKO-Adjacents,140
Morella_pubescens,902,811,91,Alphahull-PointsKO-Adjacents,6126
Morella_punctata,7,1,6,Points-PointsKO-Adjacents,62
Morella_rotundata,1,1,0,Points-PointsKO-Adjacents,9
Morella_salicifolia,92,50,42,Alphahull-PointsKO-Adjacents,933
Morella_serrata,225,145,80,Alphahull-PointsKO-Adjacents,8452
Morella_singularis,41,34,7,Alphahull-PointsKO-Adjacents,181
Morella_spathulata,51,35,16,Alphahull-PointsKO-Adjacents,246
Morierina_montana,4,4,0,Points-PointsKO-Adjacents,33
Morina_nepalensis,69,35,34,Alphahull-PointsKO-Adjacents,2119
Morinda_angustifolia,2,2,0,Points-PointsKO-Adjacents,18
Morinda_asteroscepa,21,14,7,Points-PointsKO-Adjacents,62
Morinda_chrysorhiza,62,42,20,Alphahull-PointsKO-Adjacents,2752
Morinda_citrifolia,536,363,173,Alphahull-PointsKO-Adjacents,6833
Morinda_coreia,12,0,12,Points-PointsKO-Adjacents,89
Morinda_corneri,0,0,0,NA,0
Morinda_fasciculata,1,0,1,Points-PointsKO-Adjacents,9
Morinda_hoffmannioides,3,3,0,Points-PointsKO-Adjacents,27
Morinda_intermedia,0,0,0,NA,0
Morinda_latibractea,2,2,0,Points-PointsKO-Adjacents,7
Morinda_leiantha,NA,NA,NA,NA,NA
Morinda_lucida,682,606,76,Alphahull-PointsKO-Adjacents,27490
Morinda_mayorii,NA,NA,NA,NA,NA
Morinda_multinervis,0,0,0,NA,0
Morinda_pacifica,7,1,6,Points-PointsKO-Adjacents,32
Morinda_panamensis,238,190,48,Alphahull-PointsKO-Adjacents,3239
Morinda_pedunculata,7,2,5,Points-PointsKO-Adjacents,13
Morinda_persicifolia,0,0,0,NA,0
Morinda_ramosus,NA,NA,NA,NA,NA
Morinda_royoc,568,467,101,Alphahull-PointsKO-Adjacents,4820
Morinda_titanophylla,31,14,17,Points-PointsKO-Adjacents,244
Morinda_trimera,5,0,5,Points-PointsKO-Adjacents,38
Morinda_umbellata,184,131,53,Alphahull-PointsKO-Adjacents,8905
Morinda_undulata,NA,NA,NA,NA,NA
Morindopsis_capillaris,2,2,0,Points-PointsKO-Adjacents,18
Moringa_arborea,1,1,0,Points-PointsKO-Adjacents,9
Moringa_borziana,6,1,5,Points-PointsKO-Adjacents,46
Moringa_concanensis,0,0,0,NA,0
Moringa_drouhardii,34,23,11,Alphahull-PointsKO-Adjacents,238
Moringa_hildebrandtii,19,8,11,Points-PointsKO-Adjacents,127
Moringa_longituba,6,0,6,Points-PointsKO-Adjacents,54
Moringa_oleifera,581,230,351,Alphahull-PointsKO-Adjacents,12810
Moringa_ovalifolia,40,26,14,Alphahull-PointsKO-Adjacents,699
Moringa_peregrina,80,33,47,Alphahull-PointsKO-Adjacents,387
Moringa_rivae,10,0,10,Points-PointsKO-Adjacents,86
Moringa_ruspoliana,2,2,0,Points-PointsKO-Adjacents,18
Moringa_stenopetala,3,3,0,Points-PointsKO-Adjacents,27
Morisonia_americana,453,328,125,Alphahull-PointsKO-Adjacents,11668
Morisonia_multiflora,15,6,9,Points-PointsKO-Adjacents,97
Morisonia_oblongifolia,75,54,21,Alphahull-PointsKO-Adjacents,3499
Moronobea_candida,6,0,6,Points-PointsKO-Adjacents,50
Moronobea_coccinea,111,63,48,Alphahull-PointsKO-Adjacents,7680
Moronobea_intermedia,5,5,0,Points-PointsKO-Adjacents,45
Moronobea_jenmanii,39,32,7,Alphahull-PointsKO-Adjacents,387
Moronobea_ptaritepuiana,34,21,13,Alphahull-PointsKO-Adjacents,331
Moronobea_pulchra,20,7,13,Points-PointsKO-Adjacents,150
Moronobea_riparia,58,37,21,Alphahull-PointsKO-Adjacents,1365
Mortoniella_pittieri,36,21,15,Alphahull-PointsKO-Adjacents,148
Mortoniodendron_abelianum,19,0,19,Points-PointsKO-Adjacents,46
Mortoniodendron_anisophyllum,167,139,28,Alphahull-PointsKO-Adjacents,842
Mortoniodendron_apetalum,15,8,7,Points-PointsKO-Adjacents,53
Mortoniodendron_guatemalense,174,137,37,Alphahull-PointsKO-Adjacents,1429
Mortoniodendron_hirsutum,42,26,16,Alphahull-PointsKO-Adjacents,357
Mortoniodendron_moralesii,47,35,12,Alphahull-PointsKO-Adjacents,354
Mortoniodendron_ruizii,4,4,0,Points-PointsKO-Adjacents,27
Mortoniodendron_sulcatum,5,5,0,Points-PointsKO-Adjacents,42
Morus_alba,2828,1830,998,Alphahull-PointsKO-Adjacents,96459
Morus_australis,1135,807,328,Alphahull-PointsKO-Adjacents,25246
Morus_cathayana,70,30,40,Alphahull-PointsKO-Adjacents,374
Morus_celtidifolia,11,1,10,Points-PointsKO-Adjacents,68
Morus_indica,1,1,0,Points-PointsKO-Adjacents,9
Morus_insignis,286,220,66,Alphahull-PointsKO-Adjacents,4575
Morus_japonica,1,1,0,Points-PointsKO-Adjacents,9
Morus_liboensis,NA,NA,NA,NA,NA
Morus_macroura,17,0,17,Points-PointsKO-Adjacents,138
Morus_mesozygia,91,42,49,Alphahull-PointsKO-Adjacents,1082
Morus_mongolica,52,14,38,Points-PointsKO-Adjacents,459
Morus_nigra,0,0,0,NA,0
Morus_notabilis,12,0,12,Points-PointsKO-Adjacents,92
Morus_rubra,6685,5972,713,Alphahull-PointsKO-Adjacents,44736
Morus_serrata,4,3,1,Points-PointsKO-Adjacents,36
Morus_trilobata,NA,NA,NA,NA,NA
Morus_wittiorum,15,3,12,Points-PointsKO-Adjacents,135
Mosannona_costaricensis,17,7,10,Points-PointsKO-Adjacents,102
Mosannona_depressa,329,298,31,Alphahull-PointsKO-Adjacents,3830
Mosannona_discolor,5,5,0,Points-PointsKO-Adjacents,39
Mosannona_garwoodii,5,4,1,Points-PointsKO-Adjacents,12
Mosannona_guatemalensis,2,2,0,Points-PointsKO-Adjacents,18
Mosannona_hypoglauca,20,7,13,Points-PointsKO-Adjacents,162
Mosannona_maculata,11,5,6,Points-PointsKO-Adjacents,80
Mosannona_pachiteae,6,1,5,Points-PointsKO-Adjacents,54
Mosannona_pacifica,8,4,4,Points-PointsKO-Adjacents,45
Mosannona_papillosa,22,15,7,Points-PointsKO-Adjacents,131
Mosannona_raimondii,36,22,14,Alphahull-PointsKO-Adjacents,852
Mosannona_vasquezii,4,4,0,Points-PointsKO-Adjacents,15
Mosannona_xanthochlora,13,6,7,Points-PointsKO-Adjacents,111
Mosiera_androsiana,1,1,0,Points-PointsKO-Adjacents,9
Mosiera_bullata,3,3,0,Points-PointsKO-Adjacents,27
Mosiera_cabanasensis,3,3,0,Points-PointsKO-Adjacents,24
Mosiera_calycolpoides,5,1,4,Points-PointsKO-Adjacents,44
Mosiera_contrerasii,9,3,6,Points-PointsKO-Adjacents,39
Mosiera_crenulata,1,1,0,Points-PointsKO-Adjacents,8
Mosiera_cuspidata,1,1,0,Points-PointsKO-Adjacents,9
Mosiera_ehrenbergii,19,1,18,Points-PointsKO-Adjacents,94
Mosiera_gracilipes,0,0,0,NA,0
Mosiera_havanensis,2,2,0,Points-PointsKO-Adjacents,18
Mosiera_longipes,12,3,9,Points-PointsKO-Adjacents,80
Mosiera_munizii,1,1,0,Points-PointsKO-Adjacents,8
Mosiera_tiburona,2,2,0,Points-PointsKO-Adjacents,16
Mosiera_tussacii,1,1,0,Points-PointsKO-Adjacents,6
Mosiera_xerophytica,3,2,1,Points-PointsKO-Adjacents,11
Mosquitoxylum_jamaicense,322,264,58,Alphahull-PointsKO-Adjacents,4467
Motherwellia_haplosciadea,71,60,11,Alphahull-PointsKO-Adjacents,181
Motleyia_borneensis,4,4,0,Points-PointsKO-Adjacents,35
Moultonianthus_leembruggianus,6,0,6,Points-PointsKO-Adjacents,54
Mouretia_tonkinensis,3,3,0,Points-PointsKO-Adjacents,27
Mouriri_acutiflora,496,402,94,Alphahull-PointsKO-Adjacents,68488
Mouriri_ambiconvexa,9,4,5,Points-PointsKO-Adjacents,45
Mouriri_angustifolia,4,4,0,Points-PointsKO-Adjacents,36
Mouriri_apiranga,320,270,50,Alphahull-PointsKO-Adjacents,22103
Mouriri_arborea,56,37,19,Alphahull-PointsKO-Adjacents,628
Mouriri_bahiensis,8,2,6,Points-PointsKO-Adjacents,50
Mouriri_brevipes,89,54,35,Alphahull-PointsKO-Adjacents,7600
Mouriri_cauliflora,118,76,42,Alphahull-PointsKO-Adjacents,6213
Mouriri_cearensis,52,21,31,Alphahull-PointsKO-Adjacents,933
Mouriri_chamissoana,166,0,166,Points-PointsKO-Adjacents,999
Mouriri_collocarpa,115,53,62,Alphahull-PointsKO-Adjacents,5190
Mouriri_colombiana,10,0,10,Points-PointsKO-Adjacents,46
Mouriri_completens,21,12,9,Points-PointsKO-Adjacents,124
Mouriri_crassifolia,49,25,24,Alphahull-PointsKO-Adjacents,750
Mouriri_cyphocarpa,42,29,13,Alphahull-PointsKO-Adjacents,354
Mouriri_densifoliata,23,2,21,Points-PointsKO-Adjacents,191
Mouriri_dimorphandra,17,2,15,Points-PointsKO-Adjacents,122
Mouriri_domingensis,12,1,11,Points-PointsKO-Adjacents,87
Mouriri_doriana,8,2,6,Points-PointsKO-Adjacents,70
Mouriri_duckeana,68,29,39,Alphahull-PointsKO-Adjacents,3927
Mouriri_duckeanoides,8,4,4,Points-PointsKO-Adjacents,50
Mouriri_dumetosa,21,3,18,Points-PointsKO-Adjacents,188
Mouriri_elliptica,457,420,37,Alphahull-PointsKO-Adjacents,21451
Mouriri_eugeniifolia,22,6,16,Points-PointsKO-Adjacents,184
Mouriri_exadenia,3,3,0,Points-PointsKO-Adjacents,27
Mouriri_exilis,67,46,21,Alphahull-PointsKO-Adjacents,425
Mouriri_ficoides,21,0,21,Points-PointsKO-Adjacents,144
Mouriri_floribunda,19,4,15,Points-PointsKO-Adjacents,152
Mouriri_francavillana,38,26,12,Alphahull-PointsKO-Adjacents,328
Mouriri_froesii,2,2,0,Points-PointsKO-Adjacents,18
Mouriri_gardneri,16,2,14,Points-PointsKO-Adjacents,143
Mouriri_glazioviana,201,161,40,Alphahull-PointsKO-Adjacents,12323
Mouriri_gleasoniana,59,32,27,Alphahull-PointsKO-Adjacents,683
Mouriri_grandiflora,517,434,83,Alphahull-PointsKO-Adjacents,50118
Mouriri_helleri,32,21,11,Alphahull-PointsKO-Adjacents,160
Mouriri_huberi,84,31,53,Alphahull-PointsKO-Adjacents,606
Mouriri_lancifolia,0,0,0,NA,0
Mouriri_laxiflora,11,8,3,Points-PointsKO-Adjacents,69
Mouriri_longifolia,2,2,0,Points-PointsKO-Adjacents,18
Mouriri_lunatanthera,20,0,20,Points-PointsKO-Adjacents,130
Mouriri_megasperma,2,2,0,Points-PointsKO-Adjacents,18
Mouriri_micradenia,2,2,0,Points-PointsKO-Adjacents,18
Mouriri_micranthera,14,9,5,Points-PointsKO-Adjacents,58
Mouriri_muelleri,5,4,1,Points-PointsKO-Adjacents,39
Mouriri_myrtifolia,165,82,83,Alphahull-PointsKO-Adjacents,12641
Mouriri_myrtilloides,564,420,144,Alphahull-PointsKO-Adjacents,17700
Mouriri_nervosa,116,52,64,Alphahull-PointsKO-Adjacents,2314
Mouriri_nigra,371,268,103,Alphahull-PointsKO-Adjacents,50728
Mouriri_obtusiloba,4,4,0,Points-PointsKO-Adjacents,36
Mouriri_oligantha,57,24,33,Alphahull-PointsKO-Adjacents,682
Mouriri_osaensis,13,10,3,Points-PointsKO-Adjacents,27
Mouriri_pachyphylla,7,1,6,Points-PointsKO-Adjacents,52
Mouriri_pauciflora,21,4,17,Points-PointsKO-Adjacents,185
Mouriri_peruviana,51,31,20,Alphahull-PointsKO-Adjacents,479
Mouriri_pranceana,8,0,8,Points-PointsKO-Adjacents,72
Mouriri_pseudogeminata,9,1,8,Points-PointsKO-Adjacents,74
Mouriri_pusa,397,353,44,Alphahull-PointsKO-Adjacents,27443
Mouriri_regeliana,24,10,14,Points-PointsKO-Adjacents,134
Mouriri_retentipetala,14,5,9,Points-PointsKO-Adjacents,122
Mouriri_rhizophorifolia,16,6,10,Points-PointsKO-Adjacents,135
Mouriri_sagotiana,93,38,55,Alphahull-PointsKO-Adjacents,3329
Mouriri_sideroxylon,90,35,55,Alphahull-PointsKO-Adjacents,3013
Mouriri_spruceana,8,1,7,Points-PointsKO-Adjacents,66
Mouriri_steyermarkii,5,5,0,Points-PointsKO-Adjacents,38
Mouriri_subumbellata,67,11,56,Points-PointsKO-Adjacents,513
Mouriri_tessmannii,10,3,7,Points-PointsKO-Adjacents,78
Mouriri_torquata,20,11,9,Points-PointsKO-Adjacents,155
Mouriri_trunciflora,54,21,33,Alphahull-PointsKO-Adjacents,1208
Mouriri_tuberculata,17,11,6,Points-PointsKO-Adjacents,27
Mouriri_uncitheca,15,7,8,Points-PointsKO-Adjacents,50
Mouriri_valenzuelana,7,3,4,Points-PointsKO-Adjacents,60
Mouriri_vernicosa,162,79,83,Alphahull-PointsKO-Adjacents,5663
Moutabea_aculeata,207,128,79,Alphahull-PointsKO-Adjacents,10488
Moutabea_gentryi,42,29,13,Alphahull-PointsKO-Adjacents,283
Moutabea_guianensis,464,389,75,Alphahull-PointsKO-Adjacents,48179
Mucoa_duckei,36,19,17,Points-PointsKO-Adjacents,314
Mucoa_pantchenkoana,3,3,0,Points-PointsKO-Adjacents,20
Mucuna_sempervirens,46,19,27,Points-PointsKO-Adjacents,403
Muellera_amazonica,9,1,8,Points-PointsKO-Adjacents,81
Muellera_broadwayi,22,0,22,Points-PointsKO-Adjacents,167
Muellera_burkartii,5,5,0,Points-PointsKO-Adjacents,45
Muellera_campestris,551,486,65,Alphahull-PointsKO-Adjacents,16148
Muellera_chocoensis,1,1,0,Points-PointsKO-Adjacents,9
Muellera_crucisrubierae,NA,NA,NA,NA,NA
Muellera_denudata,24,5,19,Points-PointsKO-Adjacents,206
Muellera_fendleri,29,17,12,Points-PointsKO-Adjacents,236
Muellera_filipes,14,5,9,Points-PointsKO-Adjacents,98
Muellera_fluvialis,49,27,22,Alphahull-PointsKO-Adjacents,1841
Muellera_gracilliflora,4,3,1,Points-PointsKO-Adjacents,27
Muellera_grazielae,15,6,9,Points-PointsKO-Adjacents,99
Muellera_laticifera,5,5,0,Points-PointsKO-Adjacents,39
Muellera_longiunguiculata,5,4,1,Points-PointsKO-Adjacents,41
Muellera_montana,125,103,22,Alphahull-PointsKO-Adjacents,5086
Muellera_nudiflora,51,34,17,Alphahull-PointsKO-Adjacents,1085
Muellera_obtusa,109,0,109,Points-PointsKO-Adjacents,834
Muellera_sericea,29,10,19,Points-PointsKO-Adjacents,216
Muellera_torrensis,7,4,3,Points-PointsKO-Adjacents,26
Muellera_tubicalyx,4,4,0,Points-PointsKO-Adjacents,36
Muellera_unifoliolata,1,1,0,Points-PointsKO-Adjacents,9
Muellera_variabilis,20,13,7,Points-PointsKO-Adjacents,38
Muellera_virgilioides,26,12,14,Points-PointsKO-Adjacents,146
Multidentia_castanea,3,2,1,Points-PointsKO-Adjacents,17
Multidentia_crassa,106,65,41,Alphahull-PointsKO-Adjacents,6848
Multidentia_dichrophylla,8,0,8,Points-PointsKO-Adjacents,57
Multidentia_exserta,8,0,8,Points-PointsKO-Adjacents,72
Multidentia_fanshawei,16,4,12,Points-PointsKO-Adjacents,86
Multidentia_kingupirensis,6,1,5,Points-PointsKO-Adjacents,36
Multidentia_pobeguinii,23,8,15,Points-PointsKO-Adjacents,156
Multidentia_sclerocarpa,15,10,5,Points-PointsKO-Adjacents,76
Mundulea_antanossarum,46,36,10,Alphahull-PointsKO-Adjacents,461
Mundulea_barclayi,47,34,13,Alphahull-PointsKO-Adjacents,397
Mundulea_chapelieri,19,7,12,Points-PointsKO-Adjacents,102
Mundulea_laxiflora,57,39,18,Alphahull-PointsKO-Adjacents,598
Mundulea_menabeensis,9,1,8,Points-PointsKO-Adjacents,73
Mundulea_micrantha,35,28,7,Alphahull-PointsKO-Adjacents,287
Mundulea_obovata,7,1,6,Points-PointsKO-Adjacents,50
Mundulea_sericea,338,262,76,Alphahull-PointsKO-Adjacents,16195
Mundulea_viridis,60,40,20,Alphahull-PointsKO-Adjacents,2424
Munronia_humilis,3,3,0,Points-PointsKO-Adjacents,27
Munronia_pinnata,15,1,14,Points-PointsKO-Adjacents,118
Muntingia_calabura,2093,1626,467,Alphahull-PointsKO-Adjacents,43913
Muricococcum_sinense,2,2,0,Points-PointsKO-Adjacents,18
Murraya_crenulata,15,2,13,Points-PointsKO-Adjacents,100
Murraya_euchrestifolia,73,52,21,Alphahull-PointsKO-Adjacents,480
Murraya_koenigii,25,0,25,Points-PointsKO-Adjacents,217
Murraya_kwangsiensis,4,4,0,Points-PointsKO-Adjacents,36
Murraya_microphylla,4,4,0,Points-PointsKO-Adjacents,27
Murraya_paniculata,1318,888,430,Alphahull-PointsKO-Adjacents,19673
Murraya_tetramera,1,1,0,Points-PointsKO-Adjacents,9
Musanga_cecropioides,203,144,59,Alphahull-PointsKO-Adjacents,7870
Musanga_leo-errerae,17,9,8,Points-PointsKO-Adjacents,91
Mussaenda_albiflora,2,2,0,Points-PointsKO-Adjacents,15
Mussaenda_anisophylla,0,0,0,NA,0
Mussaenda_attenuifolia,1,1,0,Points-PointsKO-Adjacents,7
Mussaenda_benguetensis,3,2,1,Points-PointsKO-Adjacents,27
Mussaenda_chlorantha,0,0,0,NA,0
Mussaenda_conopharyngiifolia,1,1,0,Points-PointsKO-Adjacents,9
Mussaenda_cylindrocarpa,28,1,27,Points-PointsKO-Adjacents,177
Mussaenda_elegans,322,235,87,Alphahull-PointsKO-Adjacents,12536
Mussaenda_emeiensis,NA,NA,NA,NA,NA
Mussaenda_erythrophylla,198,129,69,Alphahull-PointsKO-Adjacents,6319
Mussaenda_frondosa,8,0,8,Points-PointsKO-Adjacents,62
Mussaenda_grandifolia,NA,NA,NA,NA,NA
Mussaenda_lanata,0,0,0,NA,0
Mussaenda_macrophylla,24,11,13,Points-PointsKO-Adjacents,127
Mussaenda_microdonta,51,37,14,Alphahull-PointsKO-Adjacents,373
Mussaenda_mollissima,5,5,0,Points-PointsKO-Adjacents,45
Mussaenda_monticola,47,0,47,Points-PointsKO-Adjacents,250
Mussaenda_multibracteata,1,1,0,Points-PointsKO-Adjacents,9
Mussaenda_philippica,6,0,6,Points-PointsKO-Adjacents,51
Mussaenda_philippinensis,0,0,0,NA,0
Mussaenda_pinatubensis,2,2,0,Points-PointsKO-Adjacents,18
Mussaenda_raiateensis,13,0,13,Points-PointsKO-Adjacents,44
Mussaenda_roxburghii,1,1,0,Points-PointsKO-Adjacents,9
Mussaenda_setosa,1,1,0,Points-PointsKO-Adjacents,8
Mussaenda_thorelii,1,1,0,Points-PointsKO-Adjacents,9
Mussaenda_ustii,2,2,0,Points-PointsKO-Adjacents,11
Mussaenda_vidalii,2,2,0,Points-PointsKO-Adjacents,18
Mussaendopsis_beccariana,6,0,6,Points-PointsKO-Adjacents,54
Mussaendopsis_celebica,7,3,4,Points-PointsKO-Adjacents,34
Mutisiopersea_costata,1,1,0,Points-PointsKO-Adjacents,9
Mutisiopersea_urbaniana,7,2,5,Points-PointsKO-Adjacents,45
Mycetia_cauliflora,12,0,12,Points-PointsKO-Adjacents,102
Mycetia_malayana,4,4,0,Points-PointsKO-Adjacents,30
Myginda_fasciculata,0,0,0,NA,0
Myodocarpus_crassifolius,15,8,7,Points-PointsKO-Adjacents,72
Myodocarpus_fraxinifolius,18,9,9,Points-PointsKO-Adjacents,71
Myodocarpus_gracilis,4,4,0,Points-PointsKO-Adjacents,18
Myodocarpus_involucratus,15,10,5,Points-PointsKO-Adjacents,61
Myodocarpus_lanceolatus,5,5,0,Points-PointsKO-Adjacents,33
Myodocarpus_pinnatus,11,2,9,Points-PointsKO-Adjacents,89
Myodocarpus_simplicifolius,7,1,6,Points-PointsKO-Adjacents,50
Myodocarpus_vieillardii,9,2,7,Points-PointsKO-Adjacents,53
Myoporum_laetum,515,0,515,Points-PointsKO-Adjacents,1124
Myoporum_sandwicense,65,40,25,Alphahull-PointsKO-Adjacents,230
Myoporum_tenuifolium,3688,3415,273,Alphahull-PointsKO-Adjacents,63336
Myrceugenia_acutiflora,65,42,23,Alphahull-PointsKO-Adjacents,1208
Myrceugenia_alpigena,376,331,45,Alphahull-PointsKO-Adjacents,5101
Myrceugenia_bocaiuvensis,2,2,0,Points-PointsKO-Adjacents,15
Myrceugenia_bracteosa,78,59,19,Alphahull-PointsKO-Adjacents,779
Myrceugenia_brevipedicellata,13,0,13,Points-PointsKO-Adjacents,75
Myrceugenia_camargoana,0,0,0,NA,0
Myrceugenia_campestris,235,197,38,Alphahull-PointsKO-Adjacents,2306
Myrceugenia_correifolia,55,38,17,Alphahull-PointsKO-Adjacents,274
Myrceugenia_cucullata,109,85,24,Alphahull-PointsKO-Adjacents,1530
Myrceugenia_decussata,1,1,0,Points-PointsKO-Adjacents,9
Myrceugenia_euosma,353,325,28,Alphahull-PointsKO-Adjacents,5602
Myrceugenia_exsucca,56,26,30,Alphahull-PointsKO-Adjacents,1340
Myrceugenia_fernandeziana,3,3,0,Points-PointsKO-Adjacents,14
Myrceugenia_foveolata,29,22,7,Alphahull-PointsKO-Adjacents,139
Myrceugenia_franciscensis,16,6,10,Points-PointsKO-Adjacents,93
Myrceugenia_gertii,18,0,18,Points-PointsKO-Adjacents,99
Myrceugenia_glaucescens,432,380,52,Alphahull-PointsKO-Adjacents,8975
Myrceugenia_hatschbachii,4,3,1,Points-PointsKO-Adjacents,34
Myrceugenia_hoehnei,21,10,11,Points-PointsKO-Adjacents,127
Myrceugenia_kleinii,44,19,25,Points-PointsKO-Adjacents,306
Myrceugenia_mesomischa,49,38,11,Alphahull-PointsKO-Adjacents,1083
Myrceugenia_miersiana,434,385,49,Alphahull-PointsKO-Adjacents,6816
Myrceugenia_myrcioides,603,550,53,Alphahull-PointsKO-Adjacents,5410
Myrceugenia_myrtoides,58,39,19,Alphahull-PointsKO-Adjacents,1413
Myrceugenia_obtusa,29,11,18,Points-PointsKO-Adjacents,185
Myrceugenia_ovalifolia,113,84,29,Alphahull-PointsKO-Adjacents,1411
Myrceugenia_ovata,426,368,58,Alphahull-PointsKO-Adjacents,5429
Myrceugenia_oxysepala,124,109,15,Alphahull-PointsKO-Adjacents,2471
Myrceugenia_parvifolia,18,5,13,Points-PointsKO-Adjacents,151
Myrceugenia_pilotantha,163,125,38,Alphahull-PointsKO-Adjacents,2512
Myrceugenia_planipes,51,32,19,Alphahull-PointsKO-Adjacents,885
Myrceugenia_reitzii,61,0,61,Points-PointsKO-Adjacents,364
Myrceugenia_rufescens,82,59,23,Alphahull-PointsKO-Adjacents,1386
Myrceugenia_schulzii,10,6,4,Points-PointsKO-Adjacents,4
Myrceugenia_scutellata,51,26,25,Alphahull-PointsKO-Adjacents,912
Myrceugenia_seriatoramosa,74,54,20,Alphahull-PointsKO-Adjacents,475
Myrceugenia_venosa,47,34,13,Alphahull-PointsKO-Adjacents,456
Myrcia_abbotiana,7,2,5,Points-PointsKO-Adjacents,28
Myrcia_abrantea,5,5,0,Points-PointsKO-Adjacents,41
Myrcia_acunae,1,1,0,Points-PointsKO-Adjacents,9
Myrcia_aethusa,216,174,42,Alphahull-PointsKO-Adjacents,3962
Myrcia_albidotomentosa,4,4,0,Points-PointsKO-Adjacents,32
Myrcia_albobrunnea,3,3,0,Points-PointsKO-Adjacents,27
Myrcia_albotomentosa,198,162,36,Alphahull-PointsKO-Adjacents,17241
Myrcia_aliena,57,18,39,Points-PointsKO-Adjacents,423
Myrcia_almasensis,18,13,5,Points-PointsKO-Adjacents,45
Myrcia_amapensis,10,0,10,Points-PointsKO-Adjacents,78
Myrcia_amazonica,963,806,157,Alphahull-PointsKO-Adjacents,76196
Myrcia_amblyphylla,10,2,8,Points-PointsKO-Adjacents,90
Myrcia_amplexicaulis,163,125,38,Alphahull-PointsKO-Adjacents,3927
Myrcia_anacardiifolia,250,0,250,Points-PointsKO-Adjacents,1210
Myrcia_anceps,89,67,22,Alphahull-PointsKO-Adjacents,1660
Myrcia_angusta,2,2,0,Points-PointsKO-Adjacents,18
Myrcia_anomala,60,35,25,Alphahull-PointsKO-Adjacents,1105
Myrcia_antillana,8,4,4,Points-PointsKO-Adjacents,31
Myrcia_apiocarpa,3,3,0,Points-PointsKO-Adjacents,23
Myrcia_atramentifera,23,6,17,Points-PointsKO-Adjacents,191
Myrcia_atropilosa,3,3,0,Points-PointsKO-Adjacents,27
Myrcia_aurea,11,8,3,Points-PointsKO-Adjacents,16
Myrcia_ayabambensis,1,1,0,Points-PointsKO-Adjacents,9
Myrcia_badia,NA,NA,NA,NA,NA
Myrcia_barituensis,32,18,14,Points-PointsKO-Adjacents,243
Myrcia_bella,425,364,61,Alphahull-PointsKO-Adjacents,20431
Myrcia_bergiana,249,179,70,Alphahull-PointsKO-Adjacents,1975
Myrcia_bicarinata,20,1,19,Points-PointsKO-Adjacents,128
Myrcia_bicolor,50,28,22,Alphahull-PointsKO-Adjacents,955
Myrcia_bicudoensis,NA,NA,NA,NA,NA
Myrcia_billardiana,2,2,0,Points-PointsKO-Adjacents,18
Myrcia_blanchetiana,165,151,14,Alphahull-PointsKO-Adjacents,1835
Myrcia_bolivarensis,52,32,20,Alphahull-PointsKO-Adjacents,1136
Myrcia_bonnetiasylvestris,24,16,8,Points-PointsKO-Adjacents,75
Myrcia_bracteata,696,582,114,Alphahull-PointsKO-Adjacents,76871
Myrcia_brasiliae,7,2,5,Points-PointsKO-Adjacents,61
Myrcia_brasiliensis,375,0,375,Points-PointsKO-Adjacents,1791
Myrcia_bredemeyeriana,0,0,0,NA,0
Myrcia_brunnea,1,1,0,Points-PointsKO-Adjacents,9
Myrcia_calcicola,0,0,0,NA,0
Myrcia_calycampa,64,41,23,Alphahull-PointsKO-Adjacents,2538
Myrcia_calyptranthoides,32,15,17,Points-PointsKO-Adjacents,212
Myrcia_camapuana,NA,NA,NA,NA,NA
Myrcia_camapuanensis,87,67,20,Alphahull-PointsKO-Adjacents,5038
Myrcia_capitata,18,11,7,Points-PointsKO-Adjacents,97
Myrcia_cardiaca,12,5,7,Points-PointsKO-Adjacents,102
Myrcia_catharinensis,123,106,17,Alphahull-PointsKO-Adjacents,1564
Myrcia_cerqueiria,50,31,19,Alphahull-PointsKO-Adjacents,304
Myrcia_chapadensis,4,4,0,Points-PointsKO-Adjacents,32
Myrcia_citrifolia,191,105,86,Alphahull-PointsKO-Adjacents,8354
Myrcia_clausa,6,1,5,Points-PointsKO-Adjacents,54
Myrcia_clusiifolia,102,69,33,Alphahull-PointsKO-Adjacents,3137
Myrcia_coelosepala,34,24,10,Alphahull-PointsKO-Adjacents,495
Myrcia_colpodes,3,3,0,Points-PointsKO-Adjacents,27
Myrcia_compta,3,3,0,Points-PointsKO-Adjacents,23
Myrcia_concava,6,1,5,Points-PointsKO-Adjacents,54
Myrcia_concinna,4,4,0,Points-PointsKO-Adjacents,21
Myrcia_concisa,5,5,0,Points-PointsKO-Adjacents,32
Myrcia_connata,3,3,0,Points-PointsKO-Adjacents,25
Myrcia_cordiformis,4,3,1,Points-PointsKO-Adjacents,28
Myrcia_cordiifolia,24,11,13,Points-PointsKO-Adjacents,171
Myrcia_coumete,47,24,23,Alphahull-PointsKO-Adjacents,1188
Myrcia_crassa,5,5,0,Points-PointsKO-Adjacents,17
Myrcia_crassimarginata,10,3,7,Points-PointsKO-Adjacents,86
Myrcia_crispa,20,9,11,Points-PointsKO-Adjacents,109
Myrcia_cristalensis,3,3,0,Points-PointsKO-Adjacents,23
Myrcia_cujabensis,8,1,7,Points-PointsKO-Adjacents,70
Myrcia_cuprea,191,0,191,Points-PointsKO-Adjacents,1026
Myrcia_curassavica,2,2,0,Points-PointsKO-Adjacents,10
Myrcia_curtipendula,15,12,3,Points-PointsKO-Adjacents,33
Myrcia_decorticans,364,259,105,Alphahull-PointsKO-Adjacents,11257
Myrcia_delicata,0,0,0,NA,0
Myrcia_densa,136,111,25,Alphahull-PointsKO-Adjacents,2210
Myrcia_diaphana,34,16,18,Points-PointsKO-Adjacents,245
Myrcia_dichasialis,66,36,30,Alphahull-PointsKO-Adjacents,1881
Myrcia_dichrophylla,99,0,99,Points-PointsKO-Adjacents,544
Myrcia_didrichseniana,4,2,2,Points-PointsKO-Adjacents,36
Myrcia_directa,1,1,0,Points-PointsKO-Adjacents,9
Myrcia_dispar,7,0,7,Points-PointsKO-Adjacents,60
Myrcia_dolicopetala,1,1,0,Points-PointsKO-Adjacents,9
Myrcia_egensis,9,1,8,Points-PointsKO-Adjacents,81
Myrcia_ehrenbergiana,29,0,29,Points-PointsKO-Adjacents,205
Myrcia_elattophylla,NA,NA,NA,NA,NA
Myrcia_eriocalyx,293,260,33,Alphahull-PointsKO-Adjacents,3376
Myrcia_eugenioides,3,3,0,Points-PointsKO-Adjacents,27
Myrcia_eumecephylla,35,19,16,Points-PointsKO-Adjacents,225
Myrcia_eximia,110,62,48,Alphahull-PointsKO-Adjacents,6335
Myrcia_exploratoris,18,7,11,Points-PointsKO-Adjacents,105
Myrcia_extranea,8,4,4,Points-PointsKO-Adjacents,21
Myrcia_fasciata,2,2,0,Points-PointsKO-Adjacents,18
Myrcia_fascicularis,10,1,9,Points-PointsKO-Adjacents,82
Myrcia_felisbertii,3,2,1,Points-PointsKO-Adjacents,25
Myrcia_fenestrata,69,24,45,Alphahull-PointsKO-Adjacents,3328
Myrcia_fenzliana,544,448,96,Alphahull-PointsKO-Adjacents,21615
Myrcia_ferruginea,156,116,40,Alphahull-PointsKO-Adjacents,1676
Myrcia_filibracteata,1,1,0,Points-PointsKO-Adjacents,9
Myrcia_flagellaris,95,78,17,Alphahull-PointsKO-Adjacents,737
Myrcia_florida,5,5,0,Points-PointsKO-Adjacents,36
Myrcia_floridissima,8,2,6,Points-PointsKO-Adjacents,37
Myrcia_follii,14,9,5,Points-PointsKO-Adjacents,102
Myrcia_fosteri,19,13,6,Points-PointsKO-Adjacents,82
Myrcia_freyreissiana,23,7,16,Points-PointsKO-Adjacents,149
Myrcia_fusca,8,4,4,Points-PointsKO-Adjacents,28
Myrcia_gentryi,1,1,0,Points-PointsKO-Adjacents,9
Myrcia_gestasiana,14,2,12,Points-PointsKO-Adjacents,94
Myrcia_gigantea,20,1,19,Points-PointsKO-Adjacents,113
Myrcia_gigas,32,6,26,Points-PointsKO-Adjacents,230
Myrcia_gilsoniana,4,4,0,Points-PointsKO-Adjacents,23
Myrcia_glabra,221,0,221,Points-PointsKO-Adjacents,1246
Myrcia_glauca,3,3,0,Points-PointsKO-Adjacents,27
Myrcia_glazioviana,13,0,13,Points-PointsKO-Adjacents,97
Myrcia_gollmeriana,1,1,0,Points-PointsKO-Adjacents,9
Myrcia_gomidesioides,8,0,8,Points-PointsKO-Adjacents,54
Myrcia_gonini,4,4,0,Points-PointsKO-Adjacents,30
Myrcia_graciliflora,36,19,17,Points-PointsKO-Adjacents,215
Myrcia_grandifolia,59,31,28,Alphahull-PointsKO-Adjacents,612
Myrcia_grandis,192,145,47,Alphahull-PointsKO-Adjacents,8116
Myrcia_guavira,NA,NA,NA,NA,NA
Myrcia_guavira-mi,NA,NA,NA,NA,NA
Myrcia_guianensis,4276,3994,282,Alphahull-PointsKO-Adjacents,136488
Myrcia_gundlachii,6,1,5,Points-PointsKO-Adjacents,43
Myrcia_haenkeana,15,6,9,Points-PointsKO-Adjacents,78
Myrcia_hartwegiana,445,402,43,Alphahull-PointsKO-Adjacents,9103
Myrcia_hatschbachii,176,148,28,Alphahull-PointsKO-Adjacents,2769
Myrcia_hebepetala,460,405,55,Alphahull-PointsKO-Adjacents,8503
Myrcia_heliandina,NA,NA,NA,NA,NA
Myrcia_heringeriana,69,0,69,Points-PointsKO-Adjacents,536
Myrcia_heringii,53,0,53,Points-PointsKO-Adjacents,325
Myrcia_hernandezii,4,4,0,Points-PointsKO-Adjacents,36
Myrcia_hexasticha,28,0,28,Points-PointsKO-Adjacents,176
Myrcia_hilariana,0,0,0,NA,0
Myrcia_hirtiflora,253,176,77,Alphahull-PointsKO-Adjacents,14277
Myrcia_hoffmannseggii,5,1,4,Points-PointsKO-Adjacents,45
Myrcia_hotteana,1,1,0,Points-PointsKO-Adjacents,9
Myrcia_huallagae,11,1,10,Points-PointsKO-Adjacents,81
Myrcia_hypericoides,3,3,0,Points-PointsKO-Adjacents,27
Myrcia_hypoleuca,5,3,2,Points-PointsKO-Adjacents,45
Myrcia_ilheosensis,335,244,91,Alphahull-PointsKO-Adjacents,3791
Myrcia_imperfecta,1,1,0,Points-PointsKO-Adjacents,9
Myrcia_inaequiloba,297,230,67,Alphahull-PointsKO-Adjacents,12386
Myrcia_induta,3,3,0,Points-PointsKO-Adjacents,18
Myrcia_innovans,23,0,23,Points-PointsKO-Adjacents,138
Myrcia_insularis,70,30,40,Alphahull-PointsKO-Adjacents,528
Myrcia_intonsa,9,0,9,Points-PointsKO-Adjacents,75
Myrcia_isaiana,43,14,29,Points-PointsKO-Adjacents,326
Myrcia_jacobinensis,145,122,23,Alphahull-PointsKO-Adjacents,2589
Myrcia_lacerdaeana,21,5,16,Points-PointsKO-Adjacents,145
Myrcia_lacunosa,18,10,8,Points-PointsKO-Adjacents,127
Myrcia_laevis,2,2,0,Points-PointsKO-Adjacents,18
Myrcia_lajeana,77,65,12,Alphahull-PointsKO-Adjacents,1565
Myrcia_lanuginosa,47,30,17,Alphahull-PointsKO-Adjacents,1450
Myrcia_lapidulosa,7,3,4,Points-PointsKO-Adjacents,18
Myrcia_laricina,25,12,13,Points-PointsKO-Adjacents,197
Myrcia_laruotteana,879,781,98,Alphahull-PointsKO-Adjacents,40400
Myrcia_laxiflora,62,0,62,Points-PointsKO-Adjacents,263
Myrcia_lehmannii,3,3,0,Points-PointsKO-Adjacents,27
Myrcia_liesneri,2,2,0,Points-PointsKO-Adjacents,12
Myrcia_limae,17,10,7,Points-PointsKO-Adjacents,112
Myrcia_linearifolia,69,54,15,Alphahull-PointsKO-Adjacents,778
Myrcia_lineata,40,0,40,Points-PointsKO-Adjacents,287
Myrcia_littoralis,80,28,52,Alphahull-PointsKO-Adjacents,1023
Myrcia_lucida,94,60,34,Alphahull-PointsKO-Adjacents,4039
Myrcia_lundiana,72,43,29,Alphahull-PointsKO-Adjacents,368
Myrcia_luschnathiana,4,4,0,Points-PointsKO-Adjacents,32
Myrcia_lutescens,30,8,22,Points-PointsKO-Adjacents,192
Myrcia_macrocarpa,25,9,16,Points-PointsKO-Adjacents,182
Myrcia_madida,4,4,0,Points-PointsKO-Adjacents,36
Myrcia_maestrensis,3,3,0,Points-PointsKO-Adjacents,26
Myrcia_magnifolia,14,1,13,Points-PointsKO-Adjacents,107
Myrcia_majaguitana,4,4,0,Points-PointsKO-Adjacents,32
Myrcia_manacalensis,4,4,0,Points-PointsKO-Adjacents,30
Myrcia_mansoniana,10,2,8,Points-PointsKO-Adjacents,88
Myrcia_margarettae,3,3,0,Points-PointsKO-Adjacents,24
Myrcia_mathewsiana,8,0,8,Points-PointsKO-Adjacents,72
Myrcia_maximiliana,9,0,9,Points-PointsKO-Adjacents,58
Myrcia_melastomoides,72,24,48,Alphahull-PointsKO-Adjacents,863
Myrcia_micropetala,23,8,15,Points-PointsKO-Adjacents,121
Myrcia_microphylla,12,2,10,Points-PointsKO-Adjacents,86
Myrcia_microstachya,1,1,0,Points-PointsKO-Adjacents,9
Myrcia_minutiflora,141,82,59,Alphahull-PointsKO-Adjacents,10290
Myrcia_mischophylla,177,0,177,Points-PointsKO-Adjacents,816
Myrcia_mollis,138,95,43,Alphahull-PointsKO-Adjacents,2596
Myrcia_montana,93,73,20,Alphahull-PointsKO-Adjacents,1011
Myrcia_morroqueimadensis,5,5,0,Points-PointsKO-Adjacents,30
Myrcia_multiflora,1974,1737,237,Alphahull-PointsKO-Adjacents,107289
Myrcia_mutabilis,296,256,40,Alphahull-PointsKO-Adjacents,8079
Myrcia_myrcioides,1,1,0,Points-PointsKO-Adjacents,9
Myrcia_myriantha,2,1,1,Points-PointsKO-Adjacents,18
Myrcia_nandu-apysa,NA,NA,NA,NA,NA
Myrcia_neesiana,83,32,51,Alphahull-PointsKO-Adjacents,3881
Myrcia_neocambessedeana,6,1,5,Points-PointsKO-Adjacents,44
Myrcia_neodoniana,NA,NA,NA,NA,NA
Myrcia_neorostrata,5,5,0,Points-PointsKO-Adjacents,38
Myrcia_neospruceana,4,4,0,Points-PointsKO-Adjacents,30
Myrcia_nigricans,NA,NA,NA,NA,NA
Myrcia_nigropunctata,5,5,0,Points-PointsKO-Adjacents,45
Myrcia_nobilis,17,7,10,Points-PointsKO-Adjacents,112
Myrcia_nubicola,40,28,12,Alphahull-PointsKO-Adjacents,1313
Myrcia_oblongata,315,272,43,Alphahull-PointsKO-Adjacents,6730
Myrcia_obovata,198,165,33,Alphahull-PointsKO-Adjacents,4943
Myrcia_obumbrans,55,19,36,Points-PointsKO-Adjacents,439
Myrcia_ochroides,54,34,20,Alphahull-PointsKO-Adjacents,2113
Myrcia_oligantha,139,114,25,Alphahull-PointsKO-Adjacents,2893
Myrcia_oreioeca,4,4,0,Points-PointsKO-Adjacents,36
Myrcia_ouropretoensis,7,0,7,Points-PointsKO-Adjacents,48
Myrcia_ovata,76,33,43,Alphahull-PointsKO-Adjacents,673
Myrcia_paganii,2,2,0,Points-PointsKO-Adjacents,12
Myrcia_paivae,535,386,149,Alphahull-PointsKO-Adjacents,42181
Myrcia_palustris,615,533,82,Alphahull-PointsKO-Adjacents,12895
Myrcia_panamensis,7,5,2,Points-PointsKO-Adjacents,18
Myrcia_panicularis,2,2,0,Points-PointsKO-Adjacents,18
Myrcia_pendula,8,1,7,Points-PointsKO-Adjacents,51
Myrcia_pentagona,6,2,4,Points-PointsKO-Adjacents,54
Myrcia_perforata,18,8,10,Points-PointsKO-Adjacents,147
Myrcia_pernambucensis,NA,NA,NA,NA,NA
Myrcia_pertusa,9,1,8,Points-PointsKO-Adjacents,77
Myrcia_picardiae,NA,NA,NA,NA,NA
Myrcia_pineticola,1,1,0,Points-PointsKO-Adjacents,9
Myrcia_pistrinalis,11,3,8,Points-PointsKO-Adjacents,57
Myrcia_platycaula,NA,NA,NA,NA,NA
Myrcia_platyclada,102,49,53,Alphahull-PointsKO-Adjacents,2736
Myrcia_plusiantha,53,0,53,Points-PointsKO-Adjacents,281
Myrcia_poeppigiana,9,1,8,Points-PointsKO-Adjacents,81
Myrcia_polyantha,129,80,49,Alphahull-PointsKO-Adjacents,2833
Myrcia_polyneura,2,2,0,Points-PointsKO-Adjacents,14
Myrcia_popayanensis,129,116,13,Alphahull-PointsKO-Adjacents,1296
Myrcia_portoricensis,4,1,3,Points-PointsKO-Adjacents,21
Myrcia_pseudomarlierea,15,8,7,Points-PointsKO-Adjacents,55
Myrcia_pseudospectabilis,18,10,8,Points-PointsKO-Adjacents,62
Myrcia_ptariensis,7,4,3,Points-PointsKO-Adjacents,44
Myrcia_pubescens,225,179,46,Alphahull-PointsKO-Adjacents,9916
Myrcia_pubiflora,159,106,53,Alphahull-PointsKO-Adjacents,4081
Myrcia_pubipetala,513,426,87,Alphahull-PointsKO-Adjacents,21828
Myrcia_pulchra,476,435,41,Alphahull-PointsKO-Adjacents,7629
Myrcia_pyrifolia,110,65,45,Alphahull-PointsKO-Adjacents,6289
Myrcia_quitarensis,8,0,8,Points-PointsKO-Adjacents,57
Myrcia_racemosa,450,368,82,Alphahull-PointsKO-Adjacents,9832
Myrcia_ramageana,4,4,0,Points-PointsKO-Adjacents,16
Myrcia_ramuliflora,48,26,22,Alphahull-PointsKO-Adjacents,567
Myrcia_recurvata,51,22,29,Alphahull-PointsKO-Adjacents,317
Myrcia_reticulata,35,16,19,Points-PointsKO-Adjacents,191
Myrcia_retorta,371,320,51,Alphahull-PointsKO-Adjacents,7044
Myrcia_revolutifolia,89,64,25,Alphahull-PointsKO-Adjacents,3367
Myrcia_rimosa,6,0,6,Points-PointsKO-Adjacents,54
Myrcia_riodocensis,9,4,5,Points-PointsKO-Adjacents,70
Myrcia_robusta,7,2,5,Points-PointsKO-Adjacents,33
Myrcia_rotundata,46,27,19,Alphahull-PointsKO-Adjacents,202
Myrcia_rotundifolia,48,14,34,Points-PointsKO-Adjacents,268
Myrcia_rubiginosa,4,4,0,Points-PointsKO-Adjacents,36
Myrcia_rufipes,111,74,37,Alphahull-PointsKO-Adjacents,6899
Myrcia_rufipila,57,0,57,Points-PointsKO-Adjacents,425
Myrcia_rupicola,36,25,11,Alphahull-PointsKO-Adjacents,352
Myrcia_rupta,12,5,7,Points-PointsKO-Adjacents,71
Myrcia_saliana,2,2,0,Points-PointsKO-Adjacents,16
Myrcia_salicifolia,18,0,18,Points-PointsKO-Adjacents,161
Myrcia_salticola,3,3,0,Points-PointsKO-Adjacents,21
Myrcia_salzmannii,87,56,31,Alphahull-PointsKO-Adjacents,885
Myrcia_sanisidrensis,4,4,0,Points-PointsKO-Adjacents,25
Myrcia_santateresana,3,3,0,Points-PointsKO-Adjacents,14
Myrcia_saxatilis,57,31,26,Alphahull-PointsKO-Adjacents,1056
Myrcia_selloi,412,349,63,Alphahull-PointsKO-Adjacents,14569
Myrcia_servata,25,5,20,Points-PointsKO-Adjacents,219
Myrcia_sipapensis,4,4,0,Points-PointsKO-Adjacents,25
Myrcia_skeldingii,1,1,0,Points-PointsKO-Adjacents,9
Myrcia_sororopanensis,33,21,12,Alphahull-PointsKO-Adjacents,845
Myrcia_speciosa,5,5,0,Points-PointsKO-Adjacents,32
Myrcia_spectabilis,482,414,68,Alphahull-PointsKO-Adjacents,4559
Myrcia_spinifolia,1,1,0,Points-PointsKO-Adjacents,9
Myrcia_splendens,4739,4440,299,Alphahull-PointsKO-Adjacents,92118
Myrcia_sporadosticta,2,2,0,Points-PointsKO-Adjacents,14
Myrcia_sprengeliana,0,0,0,NA,0
Myrcia_springiana,71,45,26,Alphahull-PointsKO-Adjacents,984
Myrcia_squamata,27,17,10,Points-PointsKO-Adjacents,135
Myrcia_stenocarpa,5,2,3,Points-PointsKO-Adjacents,25
Myrcia_stenocymbia,NA,NA,NA,NA,NA
Myrcia_stewartiana,1,1,0,Points-PointsKO-Adjacents,9
Myrcia_stictophylla,8,2,6,Points-PointsKO-Adjacents,59
Myrcia_stigmatosa,8,0,8,Points-PointsKO-Adjacents,44
Myrcia_stricta,51,30,21,Alphahull-PointsKO-Adjacents,107
Myrcia_subalpestris,31,0,31,Points-PointsKO-Adjacents,227
Myrcia_subavenia,42,26,16,Alphahull-PointsKO-Adjacents,385
Myrcia_subcordata,74,51,23,Alphahull-PointsKO-Adjacents,719
Myrcia_subglabra,33,24,9,Alphahull-PointsKO-Adjacents,115
Myrcia_subobliqua,60,50,10,Alphahull-PointsKO-Adjacents,873
Myrcia_subsericea,33,16,17,Points-PointsKO-Adjacents,213
Myrcia_subsessilis,188,154,34,Alphahull-PointsKO-Adjacents,6727
Myrcia_subverticillaris,76,51,25,Alphahull-PointsKO-Adjacents,1653
Myrcia_susannae,1,1,0,Points-PointsKO-Adjacents,9
Myrcia_sylvatica,1237,1067,170,Alphahull-PointsKO-Adjacents,72420
Myrcia_tafelbergica,21,11,10,Points-PointsKO-Adjacents,87
Myrcia_tenuifolia,40,16,24,Points-PointsKO-Adjacents,278
Myrcia_tenuivenosa,139,103,36,Alphahull-PointsKO-Adjacents,1906
Myrcia_tepuiensis,7,0,7,Points-PointsKO-Adjacents,59
Myrcia_teresensis,6,5,1,Points-PointsKO-Adjacents,12
Myrcia_tetraphylla,27,18,9,Points-PointsKO-Adjacents,104
Myrcia_thomasiana,1,0,1,Points-PointsKO-Adjacents,7
Myrcia_thyrsoidea,41,21,20,Alphahull-PointsKO-Adjacents,251
Myrcia_tiburoniana,2,2,0,Points-PointsKO-Adjacents,12
Myrcia_tijucensis,248,198,50,Alphahull-PointsKO-Adjacents,1919
Myrcia_toaensis,1,1,0,Points-PointsKO-Adjacents,9
Myrcia_tomentosa,2274,2055,219,Alphahull-PointsKO-Adjacents,57979
Myrcia_tovarensis,8,3,5,Points-PointsKO-Adjacents,36
Myrcia_tumida,6,0,6,Points-PointsKO-Adjacents,18
Myrcia_undulata,123,0,123,Points-PointsKO-Adjacents,795
Myrcia_variabilis,470,414,56,Alphahull-PointsKO-Adjacents,18064
Myrcia_vauthiereana,21,12,9,Points-PointsKO-Adjacents,99
Myrcia_velutiflora,5,0,5,Points-PointsKO-Adjacents,36
Myrcia_venulosa,650,600,50,Alphahull-PointsKO-Adjacents,16782
Myrcia_verrucosa,25,8,17,Points-PointsKO-Adjacents,134
Myrcia_vestita,233,193,40,Alphahull-PointsKO-Adjacents,15352
Myrcia_virgata,10,1,9,Points-PointsKO-Adjacents,48
Myrcia_vittoriana,183,120,63,Alphahull-PointsKO-Adjacents,943
Myrcia_warmingiana,11,0,11,Points-PointsKO-Adjacents,70
Myrcia_xylopioides,7,0,7,Points-PointsKO-Adjacents,54
Myrcia_zetekiana,23,13,10,Points-PointsKO-Adjacents,95
Myrcianthes_borealis,6,0,6,Points-PointsKO-Adjacents,54
Myrcianthes_bradeana,NA,NA,NA,NA,NA
Myrcianthes_callicoma,48,27,21,Alphahull-PointsKO-Adjacents,269
Myrcianthes_cavalcantei,2,2,0,Points-PointsKO-Adjacents,18
Myrcianthes_cionei,1,1,0,Points-PointsKO-Adjacents,9
Myrcianthes_cisplatensis,160,127,33,Alphahull-PointsKO-Adjacents,10774
Myrcianthes_crebrifolia,6,0,6,Points-PointsKO-Adjacents,50
Myrcianthes_discolor,36,19,17,Points-PointsKO-Adjacents,258
Myrcianthes_esnardiana,2,2,0,Points-PointsKO-Adjacents,16
Myrcianthes_ferreyrae,4,4,0,Points-PointsKO-Adjacents,17
Myrcianthes_fimbriata,23,12,11,Points-PointsKO-Adjacents,165
Myrcianthes_fragrans,781,600,181,Alphahull-PointsKO-Adjacents,19700
Myrcianthes_gigantea,248,220,28,Alphahull-PointsKO-Adjacents,5927
Myrcianthes_hallii,29,0,29,Points-PointsKO-Adjacents,218
Myrcianthes_indifferens,7,0,7,Points-PointsKO-Adjacents,56
Myrcianthes_irregularis,0,0,0,NA,0
Myrcianthes_karsteniana,9,5,4,Points-PointsKO-Adjacents,63
Myrcianthes_lanosa,3,3,0,Points-PointsKO-Adjacents,27
Myrcianthes_leucoxyla,98,76,22,Alphahull-PointsKO-Adjacents,393
Myrcianthes_lindleyana,8,1,7,Points-PointsKO-Adjacents,72
Myrcianthes_mato,62,38,24,Alphahull-PointsKO-Adjacents,809
Myrcianthes_minimifolia,5,5,0,Points-PointsKO-Adjacents,45
Myrcianthes_myrsinoides,144,90,54,Alphahull-PointsKO-Adjacents,3033
Myrcianthes_oreophila,11,6,5,Points-PointsKO-Adjacents,59
Myrcianthes_orthostemon,102,1,101,Points-PointsKO-Adjacents,635
Myrcianthes_osteomeloides,78,56,22,Alphahull-PointsKO-Adjacents,493
Myrcianthes_prodigiosa,22,0,22,Points-PointsKO-Adjacents,138
Myrcianthes_pseudomato,103,74,29,Alphahull-PointsKO-Adjacents,971
Myrcianthes_pungens,327,265,62,Alphahull-PointsKO-Adjacents,19629
Myrcianthes_quinqueloba,5,5,0,Points-PointsKO-Adjacents,45
Myrcianthes_rhopaloides,334,276,58,Alphahull-PointsKO-Adjacents,4107
Myrcianthes_sessilis,5,5,0,Points-PointsKO-Adjacents,40
Myrcianthes_storkii,46,31,15,Alphahull-PointsKO-Adjacents,102
Myrciaria_borinquena,6,5,1,Points-PointsKO-Adjacents,30
Myrciaria_cordata,2,2,0,Points-PointsKO-Adjacents,18
Myrciaria_cuspidata,449,367,82,Alphahull-PointsKO-Adjacents,30801
Myrciaria_delicatula,369,282,87,Alphahull-PointsKO-Adjacents,15315
Myrciaria_disticha,43,0,43,Points-PointsKO-Adjacents,253
Myrciaria_dubia,545,465,80,Alphahull-PointsKO-Adjacents,68986
Myrciaria_floribunda,2678,2365,313,Alphahull-PointsKO-Adjacents,131397
Myrciaria_glanduliflora,130,97,33,Alphahull-PointsKO-Adjacents,2899
Myrciaria_glazioviana,90,56,34,Alphahull-PointsKO-Adjacents,1275
Myrciaria_glomerata,57,37,20,Alphahull-PointsKO-Adjacents,1329
Myrciaria_guaquiea,68,44,24,Alphahull-PointsKO-Adjacents,2564
Myrciaria_ibarrae,9,3,6,Points-PointsKO-Adjacents,45
Myrciaria_myrtifolia,7,2,5,Points-PointsKO-Adjacents,31
Myrciaria_pallida,10,4,6,Points-PointsKO-Adjacents,81
Myrciaria_pilosa,51,36,15,Alphahull-PointsKO-Adjacents,2546
Myrciaria_plinioides,64,49,15,Alphahull-PointsKO-Adjacents,577
Myrciaria_puberulenta,2,2,0,Points-PointsKO-Adjacents,18
Myrciaria_pumila,6,0,6,Points-PointsKO-Adjacents,48
Myrciaria_rojasii,16,8,8,Points-PointsKO-Adjacents,112
Matricaria_rupestris,NA,NA,NA,NA,NA
Myrciaria_strigipes,60,41,19,Alphahull-PointsKO-Adjacents,957
Myrciaria_tenella,601,444,157,Alphahull-PointsKO-Adjacents,21424
Myrciaria_vexator,9,0,9,Points-PointsKO-Adjacents,81
Myrciaria_vismeifolia,87,0,87,Points-PointsKO-Adjacents,536
Myrianthus_arboreus,171,114,57,Alphahull-PointsKO-Adjacents,5939
Myrianthus_cuneifolius,44,31,13,Alphahull-PointsKO-Adjacents,635
Myrianthus_holstii,73,32,41,Alphahull-PointsKO-Adjacents,902
Myrianthus_libericus,111,85,26,Alphahull-PointsKO-Adjacents,2512
Myrianthus_preussii,90,64,26,Alphahull-PointsKO-Adjacents,2666
Myrianthus_serratus,78,39,39,Alphahull-PointsKO-Adjacents,1595
Myrica_adenophora,43,0,43,Points-PointsKO-Adjacents,197
Morella_cacuminis,NA,NA,NA,NA,NA
Myrica_californica,447,1,446,Points-PointsKO-Adjacents,766
Myrica_esculenta,126,75,51,Alphahull-PointsKO-Adjacents,5356
Myrica_heterophylla,126,95,31,Alphahull-PointsKO-Adjacents,5538
Myrica_holdrigeana,6,1,5,Points-PointsKO-Adjacents,33
Myrica_inodora,23,0,23,Points-PointsKO-Adjacents,177
Morella_javanica,16,0,16,Points-PointsKO-Adjacents,126
Myrica_rubra,0,0,0,NA,0
Morella_shaferi,5,5,0,Points-PointsKO-Adjacents,33
Myricaria_elegans,65,0,65,Points-PointsKO-Adjacents,364
Myriocarpa_bifurca,113,84,29,Alphahull-PointsKO-Adjacents,1609
Myriocarpa_cordifolia,44,19,25,Points-PointsKO-Adjacents,276
Myriocarpa_cubilgueitzensis,3,3,0,Points-PointsKO-Adjacents,21
Myriocarpa_densiflora,0,0,0,NA,0
Myriocarpa_heterospicata,98,75,23,Alphahull-PointsKO-Adjacents,1707
Myriocarpa_laevigata,21,10,11,Points-PointsKO-Adjacents,162
Myriocarpa_longipes,983,852,131,Alphahull-PointsKO-Adjacents,15212
Myriocarpa_obovata,131,102,29,Alphahull-PointsKO-Adjacents,2084
Myriocarpa_stipitata,534,435,99,Alphahull-PointsKO-Adjacents,13062
Myriocarpa_tatei,30,13,17,Points-PointsKO-Adjacents,199
Myriocarpa_trifurca,2,2,0,Points-PointsKO-Adjacents,17
Myristica_fragrans,11,0,11,Points-PointsKO-Adjacents,71
Myristica_glomerata,1,1,0,Points-PointsKO-Adjacents,6
Myristica_iners,24,10,14,Points-PointsKO-Adjacents,203
Myristica_philippensis,1,1,0,Points-PointsKO-Adjacents,5
Myristica_rumphii,3,3,0,Points-PointsKO-Adjacents,15
Myristica_sangowoensis,4,4,0,Points-PointsKO-Adjacents,30
Myristica_simiarum,20,4,16,Points-PointsKO-Adjacents,151
Myristica_yunnanensis,2,2,0,Points-PointsKO-Adjacents,18
Myrmeconauclea_stipulacea,2,2,0,Points-PointsKO-Adjacents,9
Myrmeconauclea_strigosa,56,32,24,Alphahull-PointsKO-Adjacents,3291
Myrocarpus_emarginatus,4,4,0,Points-PointsKO-Adjacents,36
Myrocarpus_fastigiatus,90,0,90,Points-PointsKO-Adjacents,626
Myrocarpus_frondosus,579,515,64,Alphahull-PointsKO-Adjacents,13508
Myrocarpus_leprosus,2,2,0,Points-PointsKO-Adjacents,14
Myrocarpus_venezuelensis,49,18,31,Points-PointsKO-Adjacents,328
Myrospermum_frutescens,273,198,75,Alphahull-PointsKO-Adjacents,7290
Myrospermum_sousanum,7,1,6,Points-PointsKO-Adjacents,37
Myroxylon_balsamum,535,417,118,Alphahull-PointsKO-Adjacents,28529
Myroxylon_pereirae,23,4,19,Points-PointsKO-Adjacents,195
Myroxylon_peruiferum,460,353,107,Alphahull-PointsKO-Adjacents,25883
Myrrhidendron_donnellsmithii,102,84,18,Alphahull-PointsKO-Adjacents,203
Myrrhidendron_maxonii,14,9,5,Points-PointsKO-Adjacents,15
Myrrhinium_atropurpureum,413,324,89,Alphahull-PointsKO-Adjacents,8588
Myrsine_affinis,9,0,9,Points-PointsKO-Adjacents,72
Myrsine_alyxifolia,3,3,0,Points-PointsKO-Adjacents,14
Myrsine_amischocarpa,9,2,7,Points-PointsKO-Adjacents,44
Myrsine_andina,138,108,30,Alphahull-PointsKO-Adjacents,727
Myrsine_arborea,4,4,0,Points-PointsKO-Adjacents,22
Myrsine_asymmetrica,23,11,12,Points-PointsKO-Adjacents,150
Myrsine_balansae,190,159,31,Alphahull-PointsKO-Adjacents,5129
Myrsine_benthamiana,191,171,20,Alphahull-PointsKO-Adjacents,1115
Myrsine_brevis,5,5,0,Points-PointsKO-Adjacents,45
Myrsine_bullata,3,3,0,Points-PointsKO-Adjacents,27
Myrsine_calcarata,7,4,3,Points-PointsKO-Adjacents,42
Myrsine_carolinensis,0,0,0,NA,0
Myrsine_ceylanica,2,2,0,Points-PointsKO-Adjacents,18
Myrsine_citrifolia,16,8,8,Points-PointsKO-Adjacents,93
Myrsine_coriacea,2357,2094,263,Alphahull-PointsKO-Adjacents,23660
Myrsine_degeneri,0,0,0,NA,0
Myrsine_dependens,567,495,72,Alphahull-PointsKO-Adjacents,6729
Myrsine_diazii,5,5,0,Points-PointsKO-Adjacents,45
Myrsine_dilloniana,1,1,0,Points-PointsKO-Adjacents,9
Myrsine_diminuta,15,7,8,Points-PointsKO-Adjacents,86
Myrsine_discocarpa,6,1,5,Points-PointsKO-Adjacents,44
Myrsine_emarginata,32,26,6,Alphahull-PointsKO-Adjacents,192
Myrsine_faberi,17,3,14,Points-PointsKO-Adjacents,144
Myrsine_fernseei,2,2,0,Points-PointsKO-Adjacents,18
Myrsine_forbesii,4,4,0,Points-PointsKO-Adjacents,27
Myrsine_fosteri,6,1,5,Points-PointsKO-Adjacents,43
Myrsine_fusca,2,2,0,Points-PointsKO-Adjacents,6
Myrsine_gardneriana,990,872,118,Alphahull-PointsKO-Adjacents,19994
Myrsine_guianensis,1713,1452,261,Alphahull-PointsKO-Adjacents,64346
Myrsine_hartii,NA,NA,NA,NA,NA
Myrsine_helleri,5,5,0,Points-PointsKO-Adjacents,26
Myrsine_howittiana,1822,1705,117,Alphahull-PointsKO-Adjacents,2989
Myrsine_juergensenii,78,51,27,Alphahull-PointsKO-Adjacents,709
Myrsine_kauaiensis,8,4,4,Points-PointsKO-Adjacents,25
Myrsine_knudsenii,1,1,0,Points-PointsKO-Adjacents,9
Myrsine_kwangsiensis,15,11,4,Points-PointsKO-Adjacents,135
Myrsine_laetevirens,378,0,378,Points-PointsKO-Adjacents,2789
Myrsine_lanaiensis,5,1,4,Points-PointsKO-Adjacents,43
Myrsine_latifolia,221,165,56,Alphahull-PointsKO-Adjacents,4620
Myrsine_lechleri,0,0,0,NA,0
Myrsine_ledermannii,1,1,0,Points-PointsKO-Adjacents,9
Myrsine_lehmannii,2,2,0,Points-PointsKO-Adjacents,18
Myrsine_lessertiana,38,24,14,Alphahull-PointsKO-Adjacents,189
Myrsine_leuconeura,260,203,57,Alphahull-PointsKO-Adjacents,17215
Myrsine_ligustrina,13,5,8,Points-PointsKO-Adjacents,92
Myrsine_linearifolia,9,3,6,Points-PointsKO-Adjacents,24
Myrsine_linearis,24,8,16,Points-PointsKO-Adjacents,203
Myrsine_loefgrenii,274,244,30,Alphahull-PointsKO-Adjacents,9385
Myrsine_luae,3,3,0,Points-PointsKO-Adjacents,14
Myrsine_macrocarpa,4,4,0,Points-PointsKO-Adjacents,36
Myrsine_magnoliifolia,0,0,0,NA,0
Myrsine_manglilla,22,9,13,Points-PointsKO-Adjacents,168
Myrsine_matensis,72,42,30,Alphahull-PointsKO-Adjacents,4123
Myrsine_maximowiczii,2,2,0,Points-PointsKO-Adjacents,5
Myrsine_mccomishii,8,7,1,Points-PointsKO-Adjacents,5
Myrsine_memaoyaensis,2,2,0,Points-PointsKO-Adjacents,14
Myrsine_mezii,0,0,0,NA,0
Myrsine_microdonta,1,1,0,Points-PointsKO-Adjacents,9
Myrsine_minima,12,6,6,Points-PointsKO-Adjacents,84
Myrsine_minutiflora,3,3,0,Points-PointsKO-Adjacents,27
Myrsine_minutifolia,11,1,10,Points-PointsKO-Adjacents,76
Myrsine_mocquerysii,0,0,0,NA,0
Myrsine_modesta,32,13,19,Points-PointsKO-Adjacents,140
Myrsine_nitida,33,13,20,Points-PointsKO-Adjacents,248
Myrsine_novocaledonica,17,10,7,Points-PointsKO-Adjacents,113
Myrsine_oblanceolata,5,5,0,Points-PointsKO-Adjacents,33
Myrsine_obovata,0,0,0,NA,0
Myrsine_orohenensis,NA,NA,NA,NA,NA
Myrsine_ovicarpa,3,3,0,Points-PointsKO-Adjacents,15
Myrsine_palauensis,1,1,0,Points-PointsKO-Adjacents,6
Myrsine_parvicarpa,5,5,0,Points-PointsKO-Adjacents,25
Myrsine_parvifolia,275,178,97,Alphahull-PointsKO-Adjacents,2840
Myrsine_parvula,426,370,56,Alphahull-PointsKO-Adjacents,14066
Myrsine_pearcei,64,39,25,Alphahull-PointsKO-Adjacents,600
Myrsine_pellucida,341,274,67,Alphahull-PointsKO-Adjacents,7275
Myrsine_pellucidopunctata,148,126,22,Alphahull-PointsKO-Adjacents,1527
Myrsine_petiolata,1,1,0,Points-PointsKO-Adjacents,9
Myrsine_picturata,7,1,6,Points-PointsKO-Adjacents,47
Myrsine_pillansii,15,1,14,Points-PointsKO-Adjacents,107
Myrsine_pseudocrenata,28,11,17,Points-PointsKO-Adjacents,183
Myrsine_pukooensis,2,2,0,Points-PointsKO-Adjacents,12
Myrsine_raiateensis,NA,NA,NA,NA,NA
Myrsine_ralstoniae,8,3,5,Points-PointsKO-Adjacents,3
Myrsine_rapensis,1,1,0,Points-PointsKO-Adjacents,4
Myrsine_reynelii,4,4,0,Points-PointsKO-Adjacents,34
Myrsine_rivularis,1,1,0,Points-PointsKO-Adjacents,9
Myrsine_ronuiensis,NA,NA,NA,NA,NA
Myrsine_sandwicensis,19,13,6,Points-PointsKO-Adjacents,100
Myrsine_seguinii,479,293,186,Alphahull-PointsKO-Adjacents,11306
Myrsine_semiserrata,225,183,42,Alphahull-PointsKO-Adjacents,12015
Myrsine_sessiliflora,19,12,7,Points-PointsKO-Adjacents,153
Myrsine_seychellarum,0,0,0,NA,0
Myrsine_sodiroana,26,11,15,Points-PointsKO-Adjacents,186
Myrsine_sprucei,7,0,7,Points-PointsKO-Adjacents,54
Myrsine_striata,1,1,0,Points-PointsKO-Adjacents,9
Myrsine_umbellata,2479,2266,213,Alphahull-PointsKO-Adjacents,42635
Myrsine_venosa,460,401,59,Alphahull-PointsKO-Adjacents,6264
Myrsine_wawraea,4,4,0,Points-PointsKO-Adjacents,24
Myrsine_weberbaueri,7,2,5,Points-PointsKO-Adjacents,54
Myrsine_youngii,3,3,0,Points-PointsKO-Adjacents,27
Myrtastrum_rufopunctatum,46,38,8,Alphahull-PointsKO-Adjacents,111
Myrtella_beccarii,30,22,8,Alphahull-PointsKO-Adjacents,66
Myrtella_bennigseniana,3,3,0,Points-PointsKO-Adjacents,23
Myrtillocactus_cochal,111,92,19,Alphahull-PointsKO-Adjacents,467
Myrtillocactus_eichlamii,1,1,0,Points-PointsKO-Adjacents,9
Myrtillocactus_geometrizans,495,454,41,Alphahull-PointsKO-Adjacents,2812
Myrtillocactus_schenckii,58,52,6,Alphahull-PointsKO-Adjacents,195
Pelea_myrtoidea,12,4,8,Points-PointsKO-Adjacents,62
Myrtus_communis,3512,3076,436,Alphahull-PointsKO-Adjacents,11237
Mystroxylon_aethiopicum,546,388,158,Alphahull-PointsKO-Adjacents,23774
Mytilaria_laosensis,12,4,8,Points-PointsKO-Adjacents,108
Nageia_fleuryi,21,11,10,Points-PointsKO-Adjacents,161
Nageia_maxima,1,1,0,Points-PointsKO-Adjacents,9
Nageia_motleyi,6,0,6,Points-PointsKO-Adjacents,51
Nageia_nagi,199,120,79,Alphahull-PointsKO-Adjacents,4945
Nageia_wallichiana,129,51,78,Alphahull-PointsKO-Adjacents,4332
Nannorrhops_ritchieana,1,1,0,Points-PointsKO-Adjacents,9
Napoleonaea_egertonii,20,6,14,Points-PointsKO-Adjacents,117
Napoleonaea_gabonensis,13,7,6,Points-PointsKO-Adjacents,104
Napoleonaea_heudelotii,24,14,10,Points-PointsKO-Adjacents,187
Napoleonaea_imperialis,47,28,19,Alphahull-PointsKO-Adjacents,1639
Napoleonaea_lutea,0,0,0,NA,0
Napoleonaea_reptans,NA,NA,NA,NA,NA
Napoleonaea_septentrionalis,32,18,14,Points-PointsKO-Adjacents,225
Napoleonaea_talbotii,61,45,16,Alphahull-PointsKO-Adjacents,854
Napoleonaea_vogelii,152,125,27,Alphahull-PointsKO-Adjacents,4103
Nargedia_macrocarpa,0,0,0,NA,0
Nauclea_diderrichii,225,166,59,Alphahull-PointsKO-Adjacents,10653
Nauclea_gilletii,22,9,13,Points-PointsKO-Adjacents,151
Nauclea_officinalis,23,2,21,Points-PointsKO-Adjacents,186
Nauclea_orientalis,668,550,118,Alphahull-PointsKO-Adjacents,12645
Nauclea_parva,0,0,0,NA,0
Nauclea_pobeguinii,32,4,28,Points-PointsKO-Adjacents,264
Nauclea_robinsonii,2,2,0,Points-PointsKO-Adjacents,18
Nauclea_subdita,68,41,27,Alphahull-PointsKO-Adjacents,3522
Nauclea_tenuiflora,11,2,9,Points-PointsKO-Adjacents,77
Nauclea_vanderguchtii,35,6,29,Points-PointsKO-Adjacents,273
Nauclea_xanthoxylon,28,8,20,Points-PointsKO-Adjacents,146
Naucleopsis_caloneura,188,131,57,Alphahull-PointsKO-Adjacents,18974
Naucleopsis_capirensis,99,68,31,Alphahull-PointsKO-Adjacents,818
Naucleopsis_chiguila,16,8,8,Points-PointsKO-Adjacents,110
Naucleopsis_concinna,147,98,49,Alphahull-PointsKO-Adjacents,13808
Naucleopsis_francisci,7,3,4,Points-PointsKO-Adjacents,30
Naucleopsis_glabra,490,427,63,Alphahull-PointsKO-Adjacents,29182
Naucleopsis_guianensis,37,21,16,Alphahull-PointsKO-Adjacents,1105
Naucleopsis_herrerensis,20,10,10,Points-PointsKO-Adjacents,161
Naucleopsis_humilis,37,24,13,Alphahull-PointsKO-Adjacents,2031
Naucleopsis_imitans,110,70,40,Alphahull-PointsKO-Adjacents,1734
Naucleopsis_inaequalis,42,22,20,Alphahull-PointsKO-Adjacents,691
Naucleopsis_jamariensis,7,1,6,Points-PointsKO-Adjacents,62
Naucleopsis_krukovii,276,228,48,Alphahull-PointsKO-Adjacents,22411
Naucleopsis_macrophylla,50,19,31,Points-PointsKO-Adjacents,424
Naucleopsis_naga,150,117,33,Alphahull-PointsKO-Adjacents,1908
Naucleopsis_oblongifolia,142,90,52,Alphahull-PointsKO-Adjacents,4513
Naucleopsis_pseudonaga,65,43,22,Alphahull-PointsKO-Adjacents,3634
Naucleopsis_riparia,8,1,7,Points-PointsKO-Adjacents,72
Naucleopsis_stipularis,52,27,25,Alphahull-PointsKO-Adjacents,3690
Naucleopsis_straminea,18,6,12,Points-PointsKO-Adjacents,157
Naucleopsis_ternstroemiiflora,153,107,46,Alphahull-PointsKO-Adjacents,13600
Naucleopsis_ulei,387,333,54,Alphahull-PointsKO-Adjacents,13964
Naucleopsis_velutina,5,5,0,Points-PointsKO-Adjacents,33
Nayariophyton_zizyphifolium,2,2,0,Points-PointsKO-Adjacents,18
Nealchornea_stipitata,11,1,10,Points-PointsKO-Adjacents,99
Nealchornea_yapurensis,382,328,54,Alphahull-PointsKO-Adjacents,22851
Neblinathamnus_brasiliensis,4,4,0,Points-PointsKO-Adjacents,32
Necepsia_afzelii,63,41,22,Alphahull-PointsKO-Adjacents,1344
Necepsia_castaneifolia,11,4,7,Points-PointsKO-Adjacents,49
Necepsia_zairensis,4,4,0,Points-PointsKO-Adjacents,27
Nectandra_acuminata,41,15,26,Points-PointsKO-Adjacents,334
Nectandra_acutifolia,262,201,61,Alphahull-PointsKO-Adjacents,5518
Nectandra_amazonum,398,311,87,Alphahull-PointsKO-Adjacents,47916
Nectandra_ambigens,5,5,0,Points-PointsKO-Adjacents,27
Nectandra_angusta,74,58,16,Alphahull-PointsKO-Adjacents,740
Nectandra_angustifolia,253,215,38,Alphahull-PointsKO-Adjacents,10032
Nectandra_apiculata,3,3,0,Points-PointsKO-Adjacents,27
Nectandra_astyla,3,3,0,Points-PointsKO-Adjacents,27
Nectandra_aurea,55,37,18,Alphahull-PointsKO-Adjacents,3208
Nectandra_baccans,22,15,7,Points-PointsKO-Adjacents,123
Nectandra_barbellata,75,48,27,Alphahull-PointsKO-Adjacents,506
Nectandra_bartlettiana,9,3,6,Points-PointsKO-Adjacents,81
Nectandra_belizensis,30,14,16,Points-PointsKO-Adjacents,190
Nectandra_bicolor,6,4,2,Points-PointsKO-Adjacents,14
Nectandra_brittonii,7,2,5,Points-PointsKO-Adjacents,62
Nectandra_brochidodroma,19,8,11,Points-PointsKO-Adjacents,144
Nectandra_canaliculata,5,5,0,Points-PointsKO-Adjacents,44
Nectandra_canescens,29,6,23,Points-PointsKO-Adjacents,249
Nectandra_caudato-acuminata,1,1,0,Points-PointsKO-Adjacents,7
Nectandra_cerifolia,0,0,0,NA,0
Nectandra_cissiflora,794,636,158,Alphahull-PointsKO-Adjacents,48077
Nectandra_citrifolia,7,1,6,Points-PointsKO-Adjacents,63
Nectandra_coeloclada,11,5,6,Points-PointsKO-Adjacents,70
Nectandra_cordata,7,1,6,Points-PointsKO-Adjacents,51
Nectandra_coriacea,552,476,76,Alphahull-PointsKO-Adjacents,5594
Nectandra_crassiloba,26,19,7,Points-PointsKO-Adjacents,143
Nectandra_cufodontisii,91,80,11,Alphahull-PointsKO-Adjacents,116
Nectandra_cuneatocordata,79,50,29,Alphahull-PointsKO-Adjacents,5632
Nectandra_cuspidata,1455,1272,183,Alphahull-PointsKO-Adjacents,106818
Nectandra_dasystyla,14,4,10,Points-PointsKO-Adjacents,107
Nectandra_debilis,5,0,5,Points-PointsKO-Adjacents,45
Nectandra_discolor,60,1,59,Points-PointsKO-Adjacents,431
Nectandra_egensis,11,1,10,Points-PointsKO-Adjacents,78
Nectandra_embirensis,19,5,14,Points-PointsKO-Adjacents,164
Nectandra_filiflora,1,1,0,Points-PointsKO-Adjacents,9
Nectandra_fragrans,3,3,0,Points-PointsKO-Adjacents,27
Nectandra_fulva,8,0,8,Points-PointsKO-Adjacents,46
Nectandra_furcata,6,2,4,Points-PointsKO-Adjacents,54
Nectandra_gardneri,145,106,39,Alphahull-PointsKO-Adjacents,13811
Nectandra_globosa,413,271,142,Alphahull-PointsKO-Adjacents,30705
Nectandra_gracilis,31,19,12,Points-PointsKO-Adjacents,186
Nectandra_grandiflora,591,530,61,Alphahull-PointsKO-Adjacents,8080
Nectandra_grisea,9,0,9,Points-PointsKO-Adjacents,72
Nectandra_guadaripo,25,16,9,Points-PointsKO-Adjacents,159
Nectandra_herrerae,8,1,7,Points-PointsKO-Adjacents,46
Nectandra_heterotricha,5,5,0,Points-PointsKO-Adjacents,38
Nectandra_hihua,908,673,235,Alphahull-PointsKO-Adjacents,71501
Nectandra_hirtella,6,0,6,Points-PointsKO-Adjacents,54
Nectandra_hypoleuca,25,17,8,Points-PointsKO-Adjacents,91
Nectandra_impressa,2,2,0,Points-PointsKO-Adjacents,18
Nectandra_japurensis,25,8,17,Points-PointsKO-Adjacents,221
Nectandra_krugii,6,4,2,Points-PointsKO-Adjacents,36
Nectandra_lanceolata,908,829,79,Alphahull-PointsKO-Adjacents,15444
Nectandra_latissima,14,7,7,Points-PointsKO-Adjacents,96
Nectandra_laurel,267,196,71,Alphahull-PointsKO-Adjacents,6305
Nectandra_leucocome,10,5,5,Points-PointsKO-Adjacents,56
Nectandra_lineata,264,199,65,Alphahull-PointsKO-Adjacents,5186
Nectandra_lineatifolia,181,124,57,Alphahull-PointsKO-Adjacents,7499
Nectandra_longicaudata,95,80,15,Alphahull-PointsKO-Adjacents,1730
Nectandra_longipetiolata,11,8,3,Points-PointsKO-Adjacents,45
Nectandra_lundellii,75,55,20,Alphahull-PointsKO-Adjacents,695
Nectandra_martinicensis,124,72,52,Alphahull-PointsKO-Adjacents,1222
Nectandra_matogrossensis,14,6,8,Points-PointsKO-Adjacents,113
Nectandra_matthewsii,56,37,19,Alphahull-PointsKO-Adjacents,974
Nectandra_matudae,14,0,14,Points-PointsKO-Adjacents,109
Nectandra_maynensis,50,19,31,Points-PointsKO-Adjacents,412
Nectandra_megapotamica,1387,1280,107,Alphahull-PointsKO-Adjacents,20957
Nectandra_membranacea,1403,1164,239,Alphahull-PointsKO-Adjacents,35736
Nectandra_micranthera,16,8,8,Points-PointsKO-Adjacents,91
Nectandra_microcarpa,13,2,11,Points-PointsKO-Adjacents,112
Nectandra_minima,4,4,0,Points-PointsKO-Adjacents,35
Nectandra_mirafloris,9,4,5,Points-PointsKO-Adjacents,43
Nectandra_nitida,180,143,37,Alphahull-PointsKO-Adjacents,3247
Nectandra_nitidula,284,229,55,Alphahull-PointsKO-Adjacents,9873
Nectandra_obtusata,91,67,24,Alphahull-PointsKO-Adjacents,1062
Nectandra_olida,34,23,11,Alphahull-PointsKO-Adjacents,312
Nectandra_oppositifolia,1043,920,123,Alphahull-PointsKO-Adjacents,17005
Nectandra_paranaensis,38,1,37,Points-PointsKO-Adjacents,243
Nectandra_parviflora,7,1,6,Points-PointsKO-Adjacents,54
Nectandra_patens,33,15,18,Points-PointsKO-Adjacents,193
Nectandra_paucinervia,69,29,40,Alphahull-PointsKO-Adjacents,1347
Nectandra_pearcei,78,27,51,Alphahull-PointsKO-Adjacents,2085
Nectandra_pichurim,75,51,24,Alphahull-PointsKO-Adjacents,4334
Nectandra_psammophila,37,17,20,Points-PointsKO-Adjacents,286
Nectandra_pseudocotea,28,11,17,Points-PointsKO-Adjacents,227
Nectandra_puberula,326,268,58,Alphahull-PointsKO-Adjacents,3805
Nectandra_pulchra,1,1,0,Points-PointsKO-Adjacents,7
Nectandra_pulverulenta,279,211,68,Alphahull-PointsKO-Adjacents,10283
Nectandra_purpurea,264,179,85,Alphahull-PointsKO-Adjacents,6690
Nectandra_reflexa,23,8,15,Points-PointsKO-Adjacents,185
Nectandra_reticulata,866,695,171,Alphahull-PointsKO-Adjacents,21095
Nectandra_riparia,58,23,35,Alphahull-PointsKO-Adjacents,4027
Nectandra_roberto-andinoi,6,3,3,Points-PointsKO-Adjacents,50
Nectandra_rudis,17,10,7,Points-PointsKO-Adjacents,89
Nectandra_ruforamula,20,9,11,Points-PointsKO-Adjacents,120
Nectandra_salicifolia,1292,1189,103,Alphahull-PointsKO-Adjacents,12509
Nectandra_salicina,72,58,14,Alphahull-PointsKO-Adjacents,195
Nectandra_sanguinea,144,99,45,Alphahull-PointsKO-Adjacents,2984
Nectandra_smithii,30,21,9,Alphahull-PointsKO-Adjacents,92
Nectandra_sordida,17,6,11,Points-PointsKO-Adjacents,147
Nectandra_spicata,11,3,8,Points-PointsKO-Adjacents,73
Nectandra_subbullata,1,1,0,Points-PointsKO-Adjacents,9
Nectandra_truxillensis,15,8,7,Points-PointsKO-Adjacents,114
Nectandra_turbacensis,347,242,105,Alphahull-PointsKO-Adjacents,11278
Nectandra_umbrosa,258,216,42,Alphahull-PointsKO-Adjacents,2771
Nectandra_utilis,5,5,0,Points-PointsKO-Adjacents,45
Nectandra_venulosa,5,5,0,Points-PointsKO-Adjacents,45
Nectandra_viburnoides,66,41,25,Alphahull-PointsKO-Adjacents,1785
Nectandra_warmingii,43,24,19,Alphahull-PointsKO-Adjacents,2006
Nectandra_weddellii,4,4,0,Points-PointsKO-Adjacents,36
Nectandra_wurdackii,9,1,8,Points-PointsKO-Adjacents,81
Nectandra_yarinensis,10,4,6,Points-PointsKO-Adjacents,66
Nectaropetalum_acuminatum,3,3,0,Points-PointsKO-Adjacents,12
Nectaropetalum_capense,8,2,6,Points-PointsKO-Adjacents,61
Nectaropetalum_kaessneri,27,13,14,Points-PointsKO-Adjacents,175
Nectaropetalum_zuluense,15,6,9,Points-PointsKO-Adjacents,96
Neea_acuminatissima,8,3,5,Points-PointsKO-Adjacents,52
Neea_altissima,11,1,10,Points-PointsKO-Adjacents,93
Neea_amaruayensis,3,3,0,Points-PointsKO-Adjacents,27
Neea_amplexicaulis,1,1,0,Points-PointsKO-Adjacents,8
Neea_amplifolia,386,318,68,Alphahull-PointsKO-Adjacents,4191
Neea_anisophylla,15,3,12,Points-PointsKO-Adjacents,127
Neea_bangii,20,13,7,Points-PointsKO-Adjacents,145
Neea_bernardii,2,2,0,Points-PointsKO-Adjacents,18
Neea_boliviana,58,0,58,Points-PointsKO-Adjacents,307
Neea_bracteosa,4,4,0,Points-PointsKO-Adjacents,27
Neea_brevipedunculata,7,0,7,Points-PointsKO-Adjacents,61
Neea_brittonii,0,0,0,NA,0
Neea_buxifolia,17,9,8,Points-PointsKO-Adjacents,91
Neea_cedenensis,1,1,0,Points-PointsKO-Adjacents,9
Neea_choriophylla,151,113,38,Alphahull-PointsKO-Adjacents,3514
Neea_constricta,23,7,16,Points-PointsKO-Adjacents,171
Neea_darienensis,4,4,0,Points-PointsKO-Adjacents,27
Neea_davidsei,13,5,8,Points-PointsKO-Adjacents,111
Neea_delicatula,66,49,17,Alphahull-PointsKO-Adjacents,826
Neea_dimorphophylla,14,7,7,Points-PointsKO-Adjacents,101
Neea_divaricata,236,193,43,Alphahull-PointsKO-Adjacents,12238
Neea_floribunda,498,363,135,Alphahull-PointsKO-Adjacents,72967
Neea_grandis,4,4,0,Points-PointsKO-Adjacents,27
Neea_guaiquinimae,3,3,0,Points-PointsKO-Adjacents,23
Neea_hermaphrodita,359,286,73,Alphahull-PointsKO-Adjacents,35398
Neea_hirsuta,17,3,14,Points-PointsKO-Adjacents,135
Neea_huachamacarae,5,5,0,Points-PointsKO-Adjacents,27
Neea_ignicola,1,1,0,Points-PointsKO-Adjacents,9
Neea_laxa,131,79,52,Alphahull-PointsKO-Adjacents,6400
Neea_liesneri,3,3,0,Points-PointsKO-Adjacents,23
Neea_longipedunculata,6,0,6,Points-PointsKO-Adjacents,45
Neea_macrophylla,381,284,97,Alphahull-PointsKO-Adjacents,31527
Neea_madeirana,52,21,31,Alphahull-PointsKO-Adjacents,1215
Neea_mollis,13,6,7,Points-PointsKO-Adjacents,90
Neea_neblinensis,9,1,8,Points-PointsKO-Adjacents,60
Pisonia_nigricans,3,3,0,Points-PointsKO-Adjacents,19
Neea_obovata,86,46,40,Alphahull-PointsKO-Adjacents,1129
Neea_oppositifolia,345,270,75,Alphahull-PointsKO-Adjacents,41465
Neea_ovalifolia,285,189,96,Alphahull-PointsKO-Adjacents,42886
Neea_parimensis,2,2,0,Points-PointsKO-Adjacents,12
Neea_parviflora,217,160,57,Alphahull-PointsKO-Adjacents,10425
Neea_parvifolia,61,0,61,Points-PointsKO-Adjacents,368
Neea_pendulina,92,66,26,Alphahull-PointsKO-Adjacents,683
Neea_pittieri,52,42,10,Alphahull-PointsKO-Adjacents,211
Neea_psychotrioides,983,878,105,Alphahull-PointsKO-Adjacents,11683
Neea_robusta,33,17,16,Points-PointsKO-Adjacents,230
Neea_sebastianii,4,4,0,Points-PointsKO-Adjacents,36
Neea_speciosa,3,3,0,Points-PointsKO-Adjacents,27
Neea_spruceana,157,106,51,Alphahull-PointsKO-Adjacents,10113
Neea_stenophylla,21,6,15,Points-PointsKO-Adjacents,139
Neea_subglabrata,12,3,9,Points-PointsKO-Adjacents,88
Neea_subpubescens,3,3,0,Points-PointsKO-Adjacents,27
Neea_tenuis,61,37,24,Alphahull-PointsKO-Adjacents,620
Neea_tepuiensis,1,1,0,Points-PointsKO-Adjacents,9
Neea_theifera,507,439,68,Alphahull-PointsKO-Adjacents,21077
Neea_tristis,6,1,5,Points-PointsKO-Adjacents,54
Neea_urophylla,99,87,12,Alphahull-PointsKO-Adjacents,524
Neea_verticillata,170,104,66,Alphahull-PointsKO-Adjacents,11004
Neea_virens,103,62,41,Alphahull-PointsKO-Adjacents,3542
Neesia_altissima,3,0,3,Points-PointsKO-Adjacents,27
Neillia_affinis,34,17,17,Points-PointsKO-Adjacents,287
Neillia_thyrsiflora,88,62,26,Alphahull-PointsKO-Adjacents,1604
Nematolepis_squamea,1942,1849,93,Alphahull-PointsKO-Adjacents,3530
Nemesia_lanceolata,10,5,5,Points-PointsKO-Adjacents,80
Nemopanthus_collinus,2,1,1,Points-PointsKO-Adjacents,18
Nemuaron_vieillardii,29,17,12,Points-PointsKO-Adjacents,126
Nenga_banaensis,7,3,4,Points-PointsKO-Adjacents,45
Nenga_gajah,3,3,0,Points-PointsKO-Adjacents,21
Nenga_grandiflora,0,0,0,NA,0
Nenga_macrocarpa,4,4,0,Points-PointsKO-Adjacents,36
Nenga_pumila,7,0,7,Points-PointsKO-Adjacents,62
Neoapaloxylon_madagascariense,40,25,15,Alphahull-PointsKO-Adjacents,495
Neoapaloxylon_tuberosum,52,27,25,Alphahull-PointsKO-Adjacents,1321
Neobalanocarpus_heimii,3,3,0,Points-PointsKO-Adjacents,21
Neobeguea_ankaranensis,8,3,5,Points-PointsKO-Adjacents,55
Neobeguea_leandriana,12,7,5,Points-PointsKO-Adjacents,55
Neobeguea_mahafaliensis,47,29,18,Alphahull-PointsKO-Adjacents,704
Neoboutonia_macrocalyx,57,27,30,Alphahull-PointsKO-Adjacents,821
Neoboutonia_mannii,45,33,12,Alphahull-PointsKO-Adjacents,1262
Neoboutonia_melleri,49,17,32,Points-PointsKO-Adjacents,362
Neobracea_acunaiana,0,0,0,NA,0
Neobracea_bahamensis,1,1,0,Points-PointsKO-Adjacents,9
Neobracea_ekmanii,7,3,4,Points-PointsKO-Adjacents,20
Neobracea_martiana,NA,NA,NA,NA,NA
Neobracea_susannina,NA,NA,NA,NA,NA
Neobracea_valenzuelana,18,9,9,Points-PointsKO-Adjacents,78
Neobuxbaumia_euphorbioides,19,11,8,Points-PointsKO-Adjacents,83
Neobuxbaumia_macrocephala,55,46,9,Alphahull-PointsKO-Adjacents,34
Neobuxbaumia_mezcalaensis,85,74,11,Alphahull-PointsKO-Adjacents,502
Neobuxbaumia_polylopha,36,29,7,Alphahull-PointsKO-Adjacents,122
Neobuxbaumia_scoparia,42,30,12,Alphahull-PointsKO-Adjacents,100
Neobuxbaumia_squamulosa,9,0,9,Points-PointsKO-Adjacents,61
Neobuxbaumia_tetetzo,117,110,7,Alphahull-PointsKO-Adjacents,199
Neocallitropsis_pancheri,36,27,9,Alphahull-PointsKO-Adjacents,66
Neocalyptrocalyx_eichleriana,5,4,1,Points-PointsKO-Adjacents,39
Neocalyptrocalyx_leprieurii,38,5,33,Points-PointsKO-Adjacents,321
Neocarya_macrophylla,1,1,0,Points-PointsKO-Adjacents,9
Neochevalierodendron_stephanii,90,81,9,Alphahull-PointsKO-Adjacents,945
Neocinnamomum_caudatum,23,7,16,Points-PointsKO-Adjacents,207
Neocinnamomum_delavayi,44,32,12,Alphahull-PointsKO-Adjacents,1450
Neocinnamomum_mekongense,9,5,4,Points-PointsKO-Adjacents,81
Neocouma_parviflora,9,3,6,Points-PointsKO-Adjacents,42
Neocouma_ternstroemiacea,60,37,23,Alphahull-PointsKO-Adjacents,2393
Neofabricia_mjoebergii,51,41,10,Alphahull-PointsKO-Adjacents,387
Neofabricia_myrtifolia,357,264,93,Alphahull-PointsKO-Adjacents,1024
Neofabricia_sericisepala,65,52,13,Alphahull-PointsKO-Adjacents,440
Neoguarea_glomerulata,315,280,35,Alphahull-PointsKO-Adjacents,6363
Neoguillauminia_cleopatra,20,13,7,Points-PointsKO-Adjacents,77
Neoharmsia_baronii,21,14,7,Points-PointsKO-Adjacents,62
Neoharmsia_madagascariensis,6,5,1,Points-PointsKO-Adjacents,24
Neohemsleya_usambarensis,3,3,0,Points-PointsKO-Adjacents,9
Neolamarckia_cadamba,38,9,29,Points-PointsKO-Adjacents,335
Neolamarckia_macrophylla,12,3,9,Points-PointsKO-Adjacents,84
Neolemonniera_batesii,9,0,9,Points-PointsKO-Adjacents,60
Neolemonniera_clitandrifolia,14,3,11,Points-PointsKO-Adjacents,92
Neolemonniera_ogouensis,1,1,0,Points-PointsKO-Adjacents,9
Neolitsea_aciculata,217,147,70,Alphahull-PointsKO-Adjacents,1405
Neolitsea_acuminatissima,213,200,13,Alphahull-PointsKO-Adjacents,235
Neolitsea_alongensis,7,1,6,Points-PointsKO-Adjacents,63
Neolitsea_aurata,117,0,117,Points-PointsKO-Adjacents,909
Neolitsea_brevipes,20,8,12,Points-PointsKO-Adjacents,180
Neolitsea_buisanensis,48,42,6,Alphahull-PointsKO-Adjacents,99
Neolitsea_cambodiana,51,32,19,Alphahull-PointsKO-Adjacents,1850
Neolitsea_chrysotricha,2,2,0,Points-PointsKO-Adjacents,18
Neolitsea_chui,61,47,14,Alphahull-PointsKO-Adjacents,2720
Neolitsea_confertifolia,26,8,18,Points-PointsKO-Adjacents,225
Neolitsea_cuipala,7,1,6,Points-PointsKO-Adjacents,54
Neolitsea_daibuensis,31,24,7,Alphahull-PointsKO-Adjacents,59
Neolitsea_dealbata,1808,0,1808,Points-PointsKO-Adjacents,1857
Neolitsea_ellipsoidea,6,2,4,Points-PointsKO-Adjacents,45
Neolitsea_hainanensis,16,6,10,Points-PointsKO-Adjacents,135
Neolitsea_hiiranensis,29,24,5,Alphahull-PointsKO-Adjacents,25
Neolitsea_homilantha,11,4,7,Points-PointsKO-Adjacents,84
Neolitsea_howii,2,2,0,Points-PointsKO-Adjacents,18
Neolitsea_hsiangkweiensis,4,4,0,Points-PointsKO-Adjacents,36
Neolitsea_impressa,1,1,0,Points-PointsKO-Adjacents,9
Litsea_javanica,0,0,0,NA,0
Tetradenia_kedahensis,2,2,0,Points-PointsKO-Adjacents,18
Neolitsea_konishii,173,155,18,Alphahull-PointsKO-Adjacents,345
Neolitsea_kwangsiensis,3,3,0,Points-PointsKO-Adjacents,27
Neolitsea_lanuginosa,1,1,0,Points-PointsKO-Adjacents,9
Neolitsea_latifolia,1,1,0,Points-PointsKO-Adjacents,8
Neolitsea_levinei,74,48,26,Alphahull-PointsKO-Adjacents,3971
Neolitsea_longipedicellata,9,4,5,Points-PointsKO-Adjacents,81
Neolitsea_lunglingensis,4,4,0,Points-PointsKO-Adjacents,15
Neolitsea_menglaensis,NA,NA,NA,NA,NA
Tetradenia_mollissima,NA,NA,NA,NA,NA
Neolitsea_oblongifolia,7,3,4,Points-PointsKO-Adjacents,54
Neolitsea_obtusifolia,5,5,0,Points-PointsKO-Adjacents,39
Neolitsea_pallens,9,4,5,Points-PointsKO-Adjacents,54
Neolitsea_parvigemma,114,99,15,Alphahull-PointsKO-Adjacents,269
Neolitsea_phanerophlebia,35,22,13,Alphahull-PointsKO-Adjacents,1186
Neolitsea_pinninervis,5,5,0,Points-PointsKO-Adjacents,45
Neolitsea_polycarpa,8,1,7,Points-PointsKO-Adjacents,63
Neolitsea_pulchella,24,12,12,Points-PointsKO-Adjacents,216
Neolitsea_purpurascens,2,2,0,Points-PointsKO-Adjacents,18
Litsea_scrobiculata,13,3,10,Points-PointsKO-Adjacents,90
Neolitsea_sericea,573,334,239,Alphahull-PointsKO-Adjacents,3509
Neolitsea_shingningensis,4,4,0,Points-PointsKO-Adjacents,32
Neolitsea_sutchuanensis,15,3,12,Points-PointsKO-Adjacents,134
Neolitsea_tomentosa,0,0,0,NA,0
Neolitsea_umbrosa,24,1,23,Points-PointsKO-Adjacents,200
Neolitsea_undulatifolia,4,4,0,Points-PointsKO-Adjacents,36
Neolitsea_variabillima,202,183,19,Alphahull-PointsKO-Adjacents,253
Neolitsea_velutina,4,4,0,Points-PointsKO-Adjacents,36
Neolitsea_villosa,9,5,4,Points-PointsKO-Adjacents,6
Neolitsea_wushanica,8,1,7,Points-PointsKO-Adjacents,72
Neolitsea_zeylanica,58,15,43,Points-PointsKO-Adjacents,492
Neoluederitzia_sericocarpa,2,2,0,Points-PointsKO-Adjacents,14
Neomillspaughia_emarginata,379,0,379,Points-PointsKO-Adjacents,836
Neomillspaughia_paniculata,57,43,14,Alphahull-PointsKO-Adjacents,952
Neomirandea_araliifolia,187,145,42,Alphahull-PointsKO-Adjacents,4132
Neomitranthes_amblymitra,6,1,5,Points-PointsKO-Adjacents,42
Neomitranthes_capivariensis,6,0,6,Points-PointsKO-Adjacents,49
Neomitranthes_cordifolia,43,26,17,Alphahull-PointsKO-Adjacents,205
Neomitranthes_gemballae,40,28,12,Alphahull-PointsKO-Adjacents,794
Neomitranthes_glomerata,193,147,46,Alphahull-PointsKO-Adjacents,2880
Neomitranthes_gracilis,20,8,12,Points-PointsKO-Adjacents,171
Neomitranthes_langsdorffii,67,0,67,Points-PointsKO-Adjacents,415
Neomitranthes_obscura,113,55,58,Alphahull-PointsKO-Adjacents,803
Neomitranthes_obtusa,41,16,25,Points-PointsKO-Adjacents,221
Neomitranthes_pedicellata,3,2,1,Points-PointsKO-Adjacents,27
Neomitranthes_pereireana,8,2,6,Points-PointsKO-Adjacents,47
Neomitranthes_regeliana,9,0,9,Points-PointsKO-Adjacents,66
Neomitranthes_riedeliana,7,0,7,Points-PointsKO-Adjacents,57
Neomitranthes_stictophylla,22,0,22,Points-PointsKO-Adjacents,157
Neomitranthes_warmingiana,35,17,18,Points-PointsKO-Adjacents,199
Neomussaenda_xanthophytoides,0,0,0,NA,0
Neomyrtus_pedunculata,5244,5184,60,Alphahull-PointsKO-Adjacents,4265
Neonauclea_acuminata,8,0,8,Points-PointsKO-Adjacents,65
Neonauclea_angustifolia,3,3,0,Points-PointsKO-Adjacents,27
Neonauclea_anthraciticus,0,0,0,NA,0
Neonauclea_artocarpoides,8,0,8,Points-PointsKO-Adjacents,49
Neonauclea_bartlingii,11,4,7,Points-PointsKO-Adjacents,87
Neonauclea_bomberaiensis,1,1,0,Points-PointsKO-Adjacents,9
Neonauclea_borneensis,2,2,0,Points-PointsKO-Adjacents,18
Neonauclea_brassii,8,0,8,Points-PointsKO-Adjacents,57
Neonauclea_butonensis,0,0,0,NA,0
Neonauclea_calcarea,5,5,0,Points-PointsKO-Adjacents,39
Neonauclea_calycina,44,15,29,Points-PointsKO-Adjacents,321
Neonauclea_celebica,9,2,7,Points-PointsKO-Adjacents,77
Neonauclea_ceramensis,6,1,5,Points-PointsKO-Adjacents,46
Neonauclea_circumscissa,1,1,0,Points-PointsKO-Adjacents,6
Neonauclea_clemensiae,8,2,6,Points-PointsKO-Adjacents,59
Neonauclea_colla,2,2,0,Points-PointsKO-Adjacents,18
Neonauclea_coronata,1,1,0,Points-PointsKO-Adjacents,9
Neonauclea_cyclophylla,1,1,0,Points-PointsKO-Adjacents,9
Neonauclea_cyrtopoda,10,1,9,Points-PointsKO-Adjacents,90
Neonauclea_endertii,1,1,0,Points-PointsKO-Adjacents,8
Neonauclea_excelsa,22,0,22,Points-PointsKO-Adjacents,197
Neonauclea_excelsioides,5,5,0,Points-PointsKO-Adjacents,35
Neonauclea_formicaria,5,2,3,Points-PointsKO-Adjacents,39
Neonauclea_forsteri,21,0,21,Points-PointsKO-Adjacents,150
Neonauclea_gageana,0,0,0,NA,0
Neonauclea_gigantea,27,16,11,Points-PointsKO-Adjacents,186
Neonauclea_glabra,77,46,31,Alphahull-PointsKO-Adjacents,294
Neonauclea_glandulifera,1,1,0,Points-PointsKO-Adjacents,9
Neonauclea_griffithii,4,4,0,Points-PointsKO-Adjacents,36
Neonauclea_hagenii,19,7,12,Points-PointsKO-Adjacents,149
Neonauclea_havilandii,9,2,7,Points-PointsKO-Adjacents,72
Neonauclea_intercontinentalis,2,2,0,Points-PointsKO-Adjacents,13
Neonauclea_jagorii,1,1,0,Points-PointsKO-Adjacents,9
Neonauclea_kentii,0,0,0,NA,0
Neonauclea_kraboensis,0,0,0,NA,0
Neonauclea_lanceolata,49,0,49,Points-PointsKO-Adjacents,346
Neonauclea_longipedunculata,11,4,7,Points-PointsKO-Adjacents,88
Neonauclea_maluensis,9,2,7,Points-PointsKO-Adjacents,71
Neonauclea_media,3,3,0,Points-PointsKO-Adjacents,25
Neonauclea_montana,2,2,0,Points-PointsKO-Adjacents,18
Neonauclea_morotaiensis,4,4,0,Points-PointsKO-Adjacents,13
Neonauclea_obversifolia,18,3,15,Points-PointsKO-Adjacents,112
Neonauclea_pallida,7,1,6,Points-PointsKO-Adjacents,62
Neonauclea_paracyrtopoda,3,3,0,Points-PointsKO-Adjacents,27
Neonauclea_parviflora,0,0,0,NA,0
Neonauclea_perspicuinervia,7,0,7,Points-PointsKO-Adjacents,57
Neonauclea_pseudoborneensis,1,1,0,Points-PointsKO-Adjacents,9
Neonauclea_pseudocalycina,5,5,0,Points-PointsKO-Adjacents,41
Neonauclea_pseudopeduncularis,3,3,0,Points-PointsKO-Adjacents,25
Neonauclea_puberula,3,3,0,Points-PointsKO-Adjacents,27
Neonauclea_purpurea,2,2,0,Points-PointsKO-Adjacents,18
Neonauclea_reticulata,3,3,0,Points-PointsKO-Adjacents,24
Neonauclea_rupestris,0,0,0,NA,0
Neonauclea_sericea,0,0,0,NA,0
Neonauclea_sessilifolia,5,5,0,Points-PointsKO-Adjacents,45
Neonauclea_solomonensis,1,1,0,Points-PointsKO-Adjacents,9
Neonauclea_subsessilis,1,1,0,Points-PointsKO-Adjacents,9
Neonauclea_superba,1,1,0,Points-PointsKO-Adjacents,9
Neonauclea_tricephala,1,1,0,Points-PointsKO-Adjacents,8
Neonauclea_truncata,NA,NA,NA,NA,NA
Neonauclea_tsaiana,0,0,0,NA,0
Neonauclea_unicapitulifera,3,3,0,Points-PointsKO-Adjacents,27
Neonauclea_ventricosa,5,5,0,Points-PointsKO-Adjacents,38
Neonauclea_versteeghii,1,1,0,Points-PointsKO-Adjacents,9
Neonauclea_vinkiorum,2,2,0,Points-PointsKO-Adjacents,18
Neonauclea_wenzelii,1,1,0,Points-PointsKO-Adjacents,9
Neopanax_arboreus,4380,4279,101,Alphahull-PointsKO-Adjacents,4414
Neopanax_colensoi,6006,5944,62,Alphahull-PointsKO-Adjacents,4161
Neopanax_kermadecensis,9,0,9,Points-PointsKO-Adjacents,13
Neopanax_laetus,138,112,26,Alphahull-PointsKO-Adjacents,693
Neopanax_macintyrei,56,42,14,Alphahull-PointsKO-Adjacents,282
Neopringlea_trinervia,0,0,0,NA,0
Neoptychocarpus_apodanthus,109,57,52,Alphahull-PointsKO-Adjacents,2452
Neoptychocarpus_chocoensis,46,33,13,Alphahull-PointsKO-Adjacents,316
Neoptychocarpus_killipii,90,57,33,Alphahull-PointsKO-Adjacents,4923
Neoraimondia_arequipensis,17,3,14,Points-PointsKO-Adjacents,104
Neoraimondia_herzogiana,6,2,4,Points-PointsKO-Adjacents,49
Neoraputia_alba,130,104,26,Alphahull-PointsKO-Adjacents,1881
Neoraputia_calliantha,14,10,4,Points-PointsKO-Adjacents,44
Neoraputia_micrantha,4,4,0,Points-PointsKO-Adjacents,24
Neoraputia_paraensis,99,50,49,Alphahull-PointsKO-Adjacents,2317
Neoraputia_trifoliata,27,12,15,Points-PointsKO-Adjacents,110
Neoroepera_banksii,144,128,16,Alphahull-PointsKO-Adjacents,407
Neoroepera_buxifolia,41,35,6,Alphahull-PointsKO-Adjacents,42
Neoscortechinia_angustifolia,1,1,0,Points-PointsKO-Adjacents,9
Neoscortechinia_forbesii,29,9,20,Points-PointsKO-Adjacents,191
Neoscortechinia_kingii,13,4,9,Points-PointsKO-Adjacents,111
Neoscortechinia_nicobarica,6,0,6,Points-PointsKO-Adjacents,54
Neoscortechinia_philippinensis,8,0,8,Points-PointsKO-Adjacents,72
Neoscortechinia_sumatrensis,3,3,0,Points-PointsKO-Adjacents,27
Neoshirakia_japonica,436,348,88,Alphahull-PointsKO-Adjacents,7545
Neosprucea_grandiflora,118,96,22,Alphahull-PointsKO-Adjacents,3075
Neosprucea_montana,30,14,16,Points-PointsKO-Adjacents,216
Neosprucea_paterna,7,2,5,Points-PointsKO-Adjacents,51
Neosprucea_pedicellata,24,16,8,Points-PointsKO-Adjacents,170
Neosprucea_sucumbiensis,10,6,4,Points-PointsKO-Adjacents,88
Neosprucea_wilburiana,20,10,10,Points-PointsKO-Adjacents,111
Neostenanthera_gabonensis,96,78,18,Alphahull-PointsKO-Adjacents,1952
Neostenanthera_hamata,65,46,19,Alphahull-PointsKO-Adjacents,2438
Neostenanthera_myristicifolia,138,93,45,Alphahull-PointsKO-Adjacents,13839
Neostenanthera_neurosericea,4,3,1,Points-PointsKO-Adjacents,36
Neostenanthera_robsonii,23,15,8,Points-PointsKO-Adjacents,155
Neotatea_duidae,4,4,0,Points-PointsKO-Adjacents,12
Neotatea_longifolia,14,6,8,Points-PointsKO-Adjacents,81
Neotatea_neblinae,15,1,14,Points-PointsKO-Adjacents,58
Neotessmannia_uniflora,3,3,0,Points-PointsKO-Adjacents,27
Neotina_isoneura,46,27,19,Alphahull-PointsKO-Adjacents,1128
Neo-uvaria_acuminatissima,14,0,14,Points-PointsKO-Adjacents,115
Neo-uvaria_parallelivenia,0,0,0,NA,0
Neoveitchia_brunnea,1,1,0,Points-PointsKO-Adjacents,6
Neoveitchia_storckii,0,0,0,NA,0
Nephelium_chryseum,20,0,20,Points-PointsKO-Adjacents,174
Nephelium_lappaceum,43,16,27,Points-PointsKO-Adjacents,340
Nephelium_ramboutan-ake,29,9,20,Points-PointsKO-Adjacents,229
Nephelium_topengii,4,0,4,Points-PointsKO-Adjacents,27
Nephrosperma_van-houtteanum,3,3,0,Points-PointsKO-Adjacents,16
Neptunia_plena,459,257,202,Alphahull-PointsKO-Adjacents,11827
Neraudia_melastomifolia,8,1,7,Points-PointsKO-Adjacents,49
Neraudia_ovata,2,2,0,Points-PointsKO-Adjacents,18
Nesiota_elliptica,0,0,0,NA,0
Nesogordonia_abrahamii,18,12,6,Points-PointsKO-Adjacents,96
Nesogordonia_ambalabeensis,16,8,8,Points-PointsKO-Adjacents,124
Nesogordonia_bernieri,9,0,9,Points-PointsKO-Adjacents,76
Nesogordonia_crassipes,53,0,53,Points-PointsKO-Adjacents,243
Nesogordonia_fertilis,13,5,8,Points-PointsKO-Adjacents,76
Nesogordonia_holtzii,25,11,14,Points-PointsKO-Adjacents,113
Nesogordonia_humbertii,19,9,10,Points-PointsKO-Adjacents,80
Nesogordonia_kabingaensis,88,51,37,Alphahull-PointsKO-Adjacents,921
Nesogordonia_leplaei,42,16,26,Points-PointsKO-Adjacents,282
Nesogordonia_macrophylla,35,25,10,Alphahull-PointsKO-Adjacents,391
Nesogordonia_micrantha,12,7,5,Points-PointsKO-Adjacents,42
Nesogordonia_monantha,3,3,0,Points-PointsKO-Adjacents,26
Nesogordonia_normandii,4,4,0,Points-PointsKO-Adjacents,30
Nesogordonia_pachyneura,9,4,5,Points-PointsKO-Adjacents,41
Nesogordonia_papaverifera,60,36,24,Alphahull-PointsKO-Adjacents,1886
Nesogordonia_perpulchra,2,2,0,Points-PointsKO-Adjacents,18
Nesogordonia_stylosa,29,17,12,Points-PointsKO-Adjacents,179
Nesogordonia_thouarsii,18,9,9,Points-PointsKO-Adjacents,79
Nesohedyotis_arborea,0,0,0,NA,0
Nestegis_apetala,21,6,15,Points-PointsKO-Adjacents,55
Nestegis_cunninghamii,1449,1397,52,Alphahull-PointsKO-Adjacents,2288
Nestegis_lanceolata,1418,1372,46,Alphahull-PointsKO-Adjacents,799
Nestegis_montana,549,514,35,Alphahull-PointsKO-Adjacents,1835
Nestegis_sandwicensis,16,8,8,Points-PointsKO-Adjacents,70
Neuburgia_celebica,27,4,23,Points-PointsKO-Adjacents,159
Neuburgia_corynocarpa,135,103,32,Alphahull-PointsKO-Adjacents,2638
Neuburgia_novocaledonica,4,4,0,Points-PointsKO-Adjacents,27
Neurolaena_macrophylla,6,0,6,Points-PointsKO-Adjacents,36
Newbouldia_laevis,487,427,60,Alphahull-PointsKO-Adjacents,6791
Newtonia_aubrevillei,54,41,13,Alphahull-PointsKO-Adjacents,1722
Newtonia_buchananii,97,56,41,Alphahull-PointsKO-Adjacents,1731
Newtonia_camerunensis,4,4,0,Points-PointsKO-Adjacents,25
Newtonia_devredii,5,5,0,Points-PointsKO-Adjacents,36
Newtonia_duncanthomasii,35,23,12,Alphahull-PointsKO-Adjacents,180
Newtonia_duparquetiana,90,50,40,Alphahull-PointsKO-Adjacents,2156
Newtonia_elliotii,8,2,6,Points-PointsKO-Adjacents,68
Newtonia_erlangeri,13,2,11,Points-PointsKO-Adjacents,105
Newtonia_glandulifera,23,0,23,Points-PointsKO-Adjacents,174
Newtonia_grandifolia,10,3,7,Points-PointsKO-Adjacents,68
Newtonia_griffoniana,38,24,14,Alphahull-PointsKO-Adjacents,1337
Newtonia_hildebrandtii,46,26,20,Alphahull-PointsKO-Adjacents,340
Newtonia_leucocarpa,42,29,13,Alphahull-PointsKO-Adjacents,641
Newtonia_paucijuga,29,13,16,Points-PointsKO-Adjacents,174
Nicotiana_africana,3,2,1,Points-PointsKO-Adjacents,27
Nicotiana_glauca,5355,3828,1527,Alphahull-PointsKO-Adjacents,85959
Nicotiana_tomentosa,123,88,35,Alphahull-PointsKO-Adjacents,1476
Nicotiana_tomentosiformis,45,27,18,Alphahull-PointsKO-Adjacents,381
Nicotiana_wigandioides,46,32,14,Alphahull-PointsKO-Adjacents,247
Niemeyera_chartacea,32,24,8,Alphahull-PointsKO-Adjacents,100
Niemeyera_prunifera,139,117,22,Alphahull-PointsKO-Adjacents,433
Niemeyera_whitei,400,0,400,Points-PointsKO-Adjacents,197
Nissolia_fruticosa,700,0,700,Points-PointsKO-Adjacents,3170
Nolina_azureogladiata,1,1,0,Points-PointsKO-Adjacents,9
Nolina_beldingii,41,22,19,Alphahull-PointsKO-Adjacents,168
Nolina_bigelovii,191,172,19,Alphahull-PointsKO-Adjacents,1761
Nolina_hibernica,7,0,7,Points-PointsKO-Adjacents,36
Nolina_matapensis,20,0,20,Points-PointsKO-Adjacents,151
Nolina_nelsonii,24,17,7,Points-PointsKO-Adjacents,95
Nolina_palmeri,60,0,60,Points-PointsKO-Adjacents,196
Nolina_parryi,256,0,256,Points-PointsKO-Adjacents,377
Nolina_parviflora,198,167,31,Alphahull-PointsKO-Adjacents,3551
Noltea_africana,36,2,34,Points-PointsKO-Adjacents,318
Nopalea_cochenillifera,90,53,37,Alphahull-PointsKO-Adjacents,3646
Nopalea_dejecta,145,108,37,Alphahull-PointsKO-Adjacents,2900
Nopalea_guatemalensis,0,0,0,NA,0
Nopalea_lutea,97,50,47,Alphahull-PointsKO-Adjacents,3765
Norantea_goyasensis,108,40,68,Alphahull-PointsKO-Adjacents,12974
Nordenstamia_kingii,7,3,4,Points-PointsKO-Adjacents,63
Nordenstamia_repanda,53,40,13,Alphahull-PointsKO-Adjacents,373
Normanbya_normanbyi,34,0,34,Points-PointsKO-Adjacents,78
Normandia_neocaledonica,16,7,9,Points-PointsKO-Adjacents,105
Normandiodendron_romii,13,1,12,Points-PointsKO-Adjacents,117
Noronhia_africana,66,34,32,Alphahull-PointsKO-Adjacents,712
Noronhia_alleizettei,28,19,9,Points-PointsKO-Adjacents,140
Noronhia_ambrensis,7,2,5,Points-PointsKO-Adjacents,15
Noronhia_battiscombei,22,3,19,Points-PointsKO-Adjacents,183
Noronhia_boinensis,23,12,11,Points-PointsKO-Adjacents,136
Noronhia_boivinii,28,10,18,Points-PointsKO-Adjacents,157
Noronhia_brevituba,29,12,17,Points-PointsKO-Adjacents,167
Noronhia_broomeana,2,2,0,Points-PointsKO-Adjacents,18
Noronhia_camptoneura,6,0,6,Points-PointsKO-Adjacents,54
Noronhia_candicans,25,17,8,Points-PointsKO-Adjacents,124
Noronhia_capuronii,18,11,7,Points-PointsKO-Adjacents,65
Noronhia_cochleata,5,5,0,Points-PointsKO-Adjacents,15
Noronhia_comorensis,4,4,0,Points-PointsKO-Adjacents,28
Noronhia_cordifolia,2,2,0,Points-PointsKO-Adjacents,12
Noronhia_crassinodis,23,14,9,Points-PointsKO-Adjacents,83
Noronhia_crassiramosa,18,12,6,Points-PointsKO-Adjacents,43
Noronhia_cruciata,3,3,0,Points-PointsKO-Adjacents,27
Noronhia_densiflora,11,0,11,Points-PointsKO-Adjacents,46
Noronhia_divaricata,15,0,15,Points-PointsKO-Adjacents,77
Noronhia_ecoronulata,0,0,0,NA,0
Noronhia_emarginata,59,41,18,Alphahull-PointsKO-Adjacents,390
Noronhia_foveolata,76,40,36,Alphahull-PointsKO-Adjacents,2232
Noronhia_gracilipes,37,26,11,Alphahull-PointsKO-Adjacents,127
Noronhia_grandifolia,23,9,14,Points-PointsKO-Adjacents,151
Noronhia_humbertiana,22,14,8,Points-PointsKO-Adjacents,111
Noronhia_incurvifolia,14,10,4,Points-PointsKO-Adjacents,42
Noronhia_insularis,1,1,0,Points-PointsKO-Adjacents,7
Noronhia_introversa,23,9,14,Points-PointsKO-Adjacents,140
Noronhia_jeremii,3,3,0,Points-PointsKO-Adjacents,18
Noronhia_lanceolata,28,15,13,Points-PointsKO-Adjacents,117
Noronhia_leandriana,12,6,6,Points-PointsKO-Adjacents,96
Noronhia_linearifolia,14,8,6,Points-PointsKO-Adjacents,46
Noronhia_linocerioides,83,52,31,Alphahull-PointsKO-Adjacents,1119
Noronhia_longipedicellata,18,0,18,Points-PointsKO-Adjacents,51
Noronhia_louvelii,63,48,15,Alphahull-PointsKO-Adjacents,313
Noronhia_luteola,49,33,16,Alphahull-PointsKO-Adjacents,211
Noronhia_mangorensis,40,26,14,Alphahull-PointsKO-Adjacents,203
Noronhia_mannii,31,10,21,Points-PointsKO-Adjacents,218
Noronhia_mayottensis,0,0,0,NA,0
Noronhia_mildbraedii,29,0,29,Points-PointsKO-Adjacents,237
Noronhia_myrtoides,33,22,11,Alphahull-PointsKO-Adjacents,405
Noronhia_nilotica,109,62,47,Alphahull-PointsKO-Adjacents,2052
Noronhia_oblanceolata,13,1,12,Points-PointsKO-Adjacents,79
Noronhia_obtusifolia,54,30,24,Alphahull-PointsKO-Adjacents,361
Noronhia_peglerae,21,8,13,Points-PointsKO-Adjacents,187
Noronhia_peracuminata,10,0,10,Points-PointsKO-Adjacents,72
Noronhia_pervilleana,41,25,16,Alphahull-PointsKO-Adjacents,230
Noronhia_populifolia,2,2,0,Points-PointsKO-Adjacents,12
Noronhia_richardsiae,1,1,0,Points-PointsKO-Adjacents,9
Noronhia_sambiranensis,27,21,6,Alphahull-PointsKO-Adjacents,119
Noronhia_seyrigii,60,46,14,Alphahull-PointsKO-Adjacents,1380
Noronhia_tetrandra,20,9,11,Points-PointsKO-Adjacents,86
Noronhia_tropophylla,40,25,15,Alphahull-PointsKO-Adjacents,1227
Noronhia_tubulosa,7,2,5,Points-PointsKO-Adjacents,39
Noronhia_urceolata,8,0,8,Points-PointsKO-Adjacents,68
Noronhia_verrucosa,6,1,5,Points-PointsKO-Adjacents,52
Noronhia_verticillata,55,36,19,Alphahull-PointsKO-Adjacents,642
Noronhia_verticilliflora,0,0,0,NA,0
Northia_seychellana,1,1,0,Points-PointsKO-Adjacents,8
Nostolachma_crassifolia,0,0,0,NA,0
Nostolachma_densiflora,1,1,0,Points-PointsKO-Adjacents,9
Notelaea_ligustrina,2270,2229,41,Alphahull-PointsKO-Adjacents,2861
Notelaea_longifolia,3982,3603,379,Alphahull-PointsKO-Adjacents,3360
Notelaea_microcarpa,3279,3226,53,Alphahull-PointsKO-Adjacents,9367
Notelaea_pungens,42,31,11,Alphahull-PointsKO-Adjacents,257
Notelaea_venosa,2756,2640,116,Alphahull-PointsKO-Adjacents,2108
Nothaphoebe_cavaleriei,10,5,5,Points-PointsKO-Adjacents,89
Nothaphoebe_elata,0,0,0,NA,0
Nothaphoebe_foetida,3,0,3,Points-PointsKO-Adjacents,27
Nothaphoebe_konishii,69,55,14,Alphahull-PointsKO-Adjacents,129
Nothaphoebe_umbelliflora,20,1,19,Points-PointsKO-Adjacents,167
Nothapodytes_collina,2,2,0,Points-PointsKO-Adjacents,18
Nothapodytes_montana,2,2,0,Points-PointsKO-Adjacents,17
Nothapodytes_nimmoniana,37,0,37,Points-PointsKO-Adjacents,178
Nothapodytes_obscura,1,1,0,Points-PointsKO-Adjacents,9
Nothapodytes_obtusifolia,4,3,1,Points-PointsKO-Adjacents,28
Nothapodytes_pittosporoides,25,5,20,Points-PointsKO-Adjacents,204
Nothobaccaurea_pulvinata,0,0,0,NA,0
Nothobaccaurea_stylaris,9,1,8,Points-PointsKO-Adjacents,63
Nothocestrum_breviflorum,4,0,4,Points-PointsKO-Adjacents,30
Nothocestrum_latifolium,2,2,0,Points-PointsKO-Adjacents,16
Nothocestrum_longifolium,18,8,10,Points-PointsKO-Adjacents,61
Nothocestrum_peltatum,4,2,2,Points-PointsKO-Adjacents,23
Nothofagus_aequilateralis,27,19,8,Points-PointsKO-Adjacents,67
Nothofagus_alessandrii,6,3,3,Points-PointsKO-Adjacents,35
Nothofagus_alpina,36,23,13,Alphahull-PointsKO-Adjacents,325
Nothofagus_antarctica,135,101,34,Alphahull-PointsKO-Adjacents,4106
Nothofagus_balansae,24,14,10,Points-PointsKO-Adjacents,95
Nothofagus_baumanniae,6,2,4,Points-PointsKO-Adjacents,26
Nothofagus_betuloides,72,40,32,Alphahull-PointsKO-Adjacents,1429
Nothofagus_brassii,13,3,10,Points-PointsKO-Adjacents,60
Nothofagus_carrii,49,24,25,Alphahull-PointsKO-Adjacents,327
Nothofagus_cliffortioides,4319,625,3694,Alphahull-PointsKO-Adjacents,2070
Nothofagus_codonandra,29,21,8,Alphahull-PointsKO-Adjacents,68
Nothofagus_crenata,8,1,7,Points-PointsKO-Adjacents,33
Nothofagus_cunninghamii,3741,3712,29,Alphahull-PointsKO-Adjacents,1545
Nothofagus_discoidea,9,2,7,Points-PointsKO-Adjacents,34
Nothofagus_dombeyi,101,82,19,Alphahull-PointsKO-Adjacents,1933
Nothofagus_flaviramea,42,22,20,Alphahull-PointsKO-Adjacents,542
Nothofagus_fusca,4889,4843,46,Alphahull-PointsKO-Adjacents,3426
Nothofagus_glauca,15,8,7,Points-PointsKO-Adjacents,93
Nothofagus_grandis,107,82,25,Alphahull-PointsKO-Adjacents,645
Nothofagus_gunnii,128,117,11,Alphahull-PointsKO-Adjacents,278
Nothofagus_macrocarpa,6,0,6,Points-PointsKO-Adjacents,35
Nothofagus_menziesii,7281,7218,63,Alphahull-PointsKO-Adjacents,3821
Nothofagus_moorei,315,302,13,Alphahull-PointsKO-Adjacents,752
Nothofagus_nitida,39,0,39,Points-PointsKO-Adjacents,231
Nothofagus_nuda,1,1,0,Points-PointsKO-Adjacents,9
Nothofagus_obliqua,58,40,18,Alphahull-PointsKO-Adjacents,1418
Nothofagus_perryi,68,55,13,Alphahull-PointsKO-Adjacents,257
Nothofagus_pseudoresinosa,18,5,13,Points-PointsKO-Adjacents,94
Nothofagus_pullei,121,95,26,Alphahull-PointsKO-Adjacents,644
Nothofagus_pumilio,103,75,28,Alphahull-PointsKO-Adjacents,1955
Nothofagus_resinosa,19,9,10,Points-PointsKO-Adjacents,116
Nothofagus_rubra,58,39,19,Alphahull-PointsKO-Adjacents,500
Nothofagus_rutila,0,0,0,NA,0
Nothofagus_solandri,3538,3471,67,Alphahull-PointsKO-Adjacents,3861
Nothofagus_stylosa,0,0,0,NA,0
Nothofagus_truncata,2380,2325,55,Alphahull-PointsKO-Adjacents,2425
Nothofagus_womersleyi,1,1,0,Points-PointsKO-Adjacents,9
Notholithocarpus_densiflorus,1051,995,56,Alphahull-PointsKO-Adjacents,3268
Ficus_castaneifolia,NA,NA,NA,NA,NA
Nothopegia_colebrookiana,0,0,0,NA,0
Nothospondias_staudtii,33,15,18,Points-PointsKO-Adjacents,245
Nothotalisia_cancellata,32,24,8,Alphahull-PointsKO-Adjacents,100
Nothotalisia_peruviana,111,73,38,Alphahull-PointsKO-Adjacents,6842
Nothotalisia_piranii,9,4,5,Points-PointsKO-Adjacents,31
Nothotsuga_longibracteata,25,13,12,Points-PointsKO-Adjacents,217
Notobubon_gummiferum,9,3,6,Points-PointsKO-Adjacents,79
Notobubon_tenuifolium,22,11,11,Points-PointsKO-Adjacents,198
Notopleura_capacifolia,168,130,38,Alphahull-PointsKO-Adjacents,2755
Notopleura_montana,38,13,25,Points-PointsKO-Adjacents,300
Notospartium_torulosum,35,24,11,Alphahull-PointsKO-Adjacents,199
Nototrichium_humile,3,1,2,Points-PointsKO-Adjacents,17
Nototrichium_sandwicense,20,0,20,Points-PointsKO-Adjacents,106
Nouelia_insignis,13,7,6,Points-PointsKO-Adjacents,117
Nuxia_allorgeorum,1,1,0,Points-PointsKO-Adjacents,9
Nuxia_ambrensis,6,1,5,Points-PointsKO-Adjacents,27
Nuxia_capitata,23,18,5,Points-PointsKO-Adjacents,143
Nuxia_congesta,312,211,101,Alphahull-PointsKO-Adjacents,16589
Nuxia_coriacea,25,9,16,Points-PointsKO-Adjacents,176
Nuxia_floribunda,138,75,63,Alphahull-PointsKO-Adjacents,1182
Nuxia_glomerulata,9,6,3,Points-PointsKO-Adjacents,81
Nuxia_involucrata,65,43,22,Alphahull-PointsKO-Adjacents,1007
Nuxia_oppositifolia,126,71,55,Alphahull-PointsKO-Adjacents,3502
Nuxia_pachyphylla,41,21,20,Alphahull-PointsKO-Adjacents,1416
Nuxia_pseudodentata,4,4,0,Points-PointsKO-Adjacents,19
Nuxia_sphaerocephala,68,51,17,Alphahull-PointsKO-Adjacents,853
Nuxia_verticillata,4,4,0,Points-PointsKO-Adjacents,32
Nyctanthes_arbor-tristis,7,0,7,Points-PointsKO-Adjacents,63
Nycticalanthus_speciosus,10,1,9,Points-PointsKO-Adjacents,63
Nymania_capensis,254,216,38,Alphahull-PointsKO-Adjacents,6019
Nypa_fruticans,82,18,64,Points-PointsKO-Adjacents,507
Nyssa_aquatica,1894,1733,161,Alphahull-PointsKO-Adjacents,14872
Nyssa_javanica,13,0,13,Points-PointsKO-Adjacents,117
Nyssa_ogeche,341,0,341,Points-PointsKO-Adjacents,1097
Nyssa_shangszeensis,54,30,24,Alphahull-PointsKO-Adjacents,4190
Nyssa_sinensis,110,82,28,Alphahull-PointsKO-Adjacents,9634
Nyssa_sylvatica,32872,31361,1511,Alphahull-PointsKO-Adjacents,34048
Nyssa_talamancana,17,9,8,Points-PointsKO-Adjacents,78
Nyssa_yunnanensis,1,1,0,Points-PointsKO-Adjacents,9
Obetia_carruthersiana,9,0,9,Points-PointsKO-Adjacents,77
Obetia_ficifolia,1,0,1,Points-PointsKO-Adjacents,9
Obetia_madagascariensis,8,0,8,Points-PointsKO-Adjacents,65
Obetia_radula,66,32,34,Alphahull-PointsKO-Adjacents,2795
Obetia_tenax,67,44,23,Alphahull-PointsKO-Adjacents,3575
Ochetophila_trinervis,44,22,22,Alphahull-PointsKO-Adjacents,1280
Ochna_afzelii,134,63,71,Alphahull-PointsKO-Adjacents,4010
Ochna_afzelioides,1,1,0,Points-PointsKO-Adjacents,9
Ochna_angustata,5,4,1,Points-PointsKO-Adjacents,44
Ochna_apetala,14,5,9,Points-PointsKO-Adjacents,74
Ochna_arborea,100,0,100,Points-PointsKO-Adjacents,811
Ochna_atropurpurea,28,11,17,Points-PointsKO-Adjacents,192
Ochna_barbosae,6,0,6,Points-PointsKO-Adjacents,53
Ochna_baronii,7,0,7,Points-PointsKO-Adjacents,51
Ochna_beirensis,1,0,1,Points-PointsKO-Adjacents,8
Ochna_calodendron,3,3,0,Points-PointsKO-Adjacents,27
Ochna_ciliata,62,39,23,Alphahull-PointsKO-Adjacents,2071
Ochna_confusa,18,6,12,Points-PointsKO-Adjacents,147
Ochna_cyanophylla,5,5,0,Points-PointsKO-Adjacents,36
Ochna_emarginata,7,2,5,Points-PointsKO-Adjacents,44
Ochna_gambleoides,5,5,0,Points-PointsKO-Adjacents,45
Ochna_gamostigmata,17,0,17,Points-PointsKO-Adjacents,153
Ochna_glauca,7,2,5,Points-PointsKO-Adjacents,63
Ochna_holstii,104,52,52,Alphahull-PointsKO-Adjacents,4736
Ochna_inermis,21,4,17,Points-PointsKO-Adjacents,160
Ochna_insculpta,5,0,5,Points-PointsKO-Adjacents,39
Ochna_integerrima,34,7,27,Points-PointsKO-Adjacents,258
Ochna_kibbiensis,28,16,12,Points-PointsKO-Adjacents,185
Gomphia_lanceolata,NA,NA,NA,NA,NA
Ochna_leptoclada,27,7,20,Points-PointsKO-Adjacents,224
Ochna_louvelii,17,10,7,Points-PointsKO-Adjacents,23
Ochna_macrantha,28,9,19,Points-PointsKO-Adjacents,175
Ochna_membranacea,144,96,48,Alphahull-PointsKO-Adjacents,3024
Ochna_mossambicensis,87,51,36,Alphahull-PointsKO-Adjacents,743
Ochna_multiflora,48,23,25,Alphahull-PointsKO-Adjacents,1722
Ochna_natalitia,130,99,31,Alphahull-PointsKO-Adjacents,2664
Ochna_ovata,9,1,8,Points-PointsKO-Adjacents,63
Ochna_oxyphylla,8,1,7,Points-PointsKO-Adjacents,59
Ochna_polyneura,7,2,5,Points-PointsKO-Adjacents,48
Ochna_pretoriensis,20,8,12,Points-PointsKO-Adjacents,168
Ochna_pseudoprocera,9,4,5,Points-PointsKO-Adjacents,48
Ochna_puberula,20,4,16,Points-PointsKO-Adjacents,138
Ochna_pulchra,141,109,32,Alphahull-PointsKO-Adjacents,8956
Ochna_rovumensis,3,3,0,Points-PointsKO-Adjacents,27
Diporidium_rufescens,3,3,0,Points-PointsKO-Adjacents,27
Ochna_sambiranensis,26,9,17,Points-PointsKO-Adjacents,157
Ochna_schweinfurthiana,114,65,49,Alphahull-PointsKO-Adjacents,3994
Ochna_serrulata,105,68,37,Alphahull-PointsKO-Adjacents,2061
Ochna_thomasiana,73,0,73,Points-PointsKO-Adjacents,422
Ochna_thouvenotii,5,5,0,Points-PointsKO-Adjacents,26
Ochoterenaea_colombiana,133,102,31,Alphahull-PointsKO-Adjacents,3180
Ochreinauclea_maingayi,8,0,8,Points-PointsKO-Adjacents,66
Ochreinauclea_missionis,0,0,0,NA,0
Ochroma_pyramidale,1020,840,180,Alphahull-PointsKO-Adjacents,36434
Ochrosia_ackeringae,7,0,7,Points-PointsKO-Adjacents,41
Ochrosia_acuminata,5,5,0,Points-PointsKO-Adjacents,36
Ochrosia_alyxioides,1,1,0,Points-PointsKO-Adjacents,9
Ochrosia_apoensis,2,2,0,Points-PointsKO-Adjacents,12
Ochrosia_balansae,4,4,0,Points-PointsKO-Adjacents,33
Ochrosia_basistamina,0,0,0,NA,0
Ochrosia_borbonica,3,3,0,Points-PointsKO-Adjacents,18
Ochrosia_brevituba,5,5,0,Points-PointsKO-Adjacents,27
Ochrosia_brownii,0,0,0,NA,0
Ochrosia_citrodora,40,27,13,Alphahull-PointsKO-Adjacents,784
Ochrosia_coccinea,18,0,18,Points-PointsKO-Adjacents,84
Ochrosia_compta,5,1,4,Points-PointsKO-Adjacents,36
Ochrosia_elliptica,61,34,27,Alphahull-PointsKO-Adjacents,403
Ochrosia_fatuhivensis,NA,NA,NA,NA,NA
Ochrosia_ficifolia,44,22,22,Alphahull-PointsKO-Adjacents,664
Ochrosia_glomerata,33,11,22,Points-PointsKO-Adjacents,191
Ochrosia_grandiflora,3,3,0,Points-PointsKO-Adjacents,11
Ochrosia_haleakalae,1,1,0,Points-PointsKO-Adjacents,9
Ochrosia_hexandra,1,1,0,Points-PointsKO-Adjacents,1
Ochrosia_inventorum,0,0,0,NA,0
Ochrosia_iwasakiana,1,1,0,Points-PointsKO-Adjacents,4
Ochrosia_kauaiensis,3,3,0,Points-PointsKO-Adjacents,15
Ochrosia_kilaueaensis,0,0,0,NA,0
Ochrosia_kilneri,16,9,7,Points-PointsKO-Adjacents,65
Ochrosia_lifuana,5,5,0,Points-PointsKO-Adjacents,26
Ochrosia_mariannensis,0,0,0,NA,0
Ochrosia_miana,9,5,4,Points-PointsKO-Adjacents,61
Ochrosia_minima,47,34,13,Alphahull-PointsKO-Adjacents,142
Ochrosia_moorei,91,83,8,Alphahull-PointsKO-Adjacents,97
Ochrosia_nakaiana,1,1,0,Points-PointsKO-Adjacents,6
Ochrosia_newelliana,73,48,25,Alphahull-PointsKO-Adjacents,212
Ochrosia_oppositifolia,35,2,33,Points-PointsKO-Adjacents,192
Ochrosia_poweri,151,0,151,Points-PointsKO-Adjacents,312
Ochrosia_sciadophylla,2,2,0,Points-PointsKO-Adjacents,17
Ochrosia_sevenetii,2,2,0,Points-PointsKO-Adjacents,9
Ochrosia_silvatica,3,3,0,Points-PointsKO-Adjacents,27
Ochrosia_solomonensis,0,0,0,NA,0
Ochrosia_syncarpa,0,0,0,NA,0
Ochrosia_thiollierei,1,1,0,Points-PointsKO-Adjacents,9
Ochrosia_vitiensis,1,1,0,Points-PointsKO-Adjacents,7
Ochthocosmus_barrae,72,32,40,Alphahull-PointsKO-Adjacents,1616
Ochthocosmus_berryi,7,0,7,Points-PointsKO-Adjacents,54
Ochthocosmus_cuanzensis,0,0,0,NA,0
Ochthocosmus_floribundus,17,11,6,Points-PointsKO-Adjacents,93
Ochthocosmus_multiflorus,49,38,11,Alphahull-PointsKO-Adjacents,266
Ochthocosmus_roraimae,64,43,21,Alphahull-PointsKO-Adjacents,1274
Ocimum_ellenbeckii,0,0,0,NA,0
Ocimum_formosum,1,1,0,Points-PointsKO-Adjacents,9
Ocimum_grandiflorum,19,9,10,Points-PointsKO-Adjacents,129
Ocotea_abbreviata,9,0,9,Points-PointsKO-Adjacents,81
Ocotea_aciphylla,1519,1381,138,Alphahull-PointsKO-Adjacents,113344
Ocotea_acuminatissima,106,84,22,Alphahull-PointsKO-Adjacents,597
Ocotea_acutangula,2,2,0,Points-PointsKO-Adjacents,9
Ocotea_acutifolia,201,162,39,Alphahull-PointsKO-Adjacents,9494
Ocotea_adela,9,1,8,Points-PointsKO-Adjacents,37
Ocotea_adenotrachelium,30,0,30,Points-PointsKO-Adjacents,234
Ocotea_alata,19,13,6,Points-PointsKO-Adjacents,126
Ocotea_albescens,2,2,0,Points-PointsKO-Adjacents,18
Ocotea_albida,55,40,15,Alphahull-PointsKO-Adjacents,226
Ocotea_albigemma,1,1,0,Points-PointsKO-Adjacents,9
Ocotea_albopunctulata,12,0,12,Points-PointsKO-Adjacents,108
Ocotea_alnifolia,8,0,8,Points-PointsKO-Adjacents,57
Ocotea_amazonica,199,125,74,Alphahull-PointsKO-Adjacents,23673
Ocotea_amplifolia,2,1,1,Points-PointsKO-Adjacents,18
Ocotea_amplissima,5,5,0,Points-PointsKO-Adjacents,45
Ocotea_architectorum,13,5,8,Points-PointsKO-Adjacents,93
Ocotea_arcuata,11,8,3,Points-PointsKO-Adjacents,36
Ocotea_arenaria,5,5,0,Points-PointsKO-Adjacents,24
Ocotea_argentea,44,19,25,Points-PointsKO-Adjacents,295
Ocotea_argyrophylla,159,119,40,Alphahull-PointsKO-Adjacents,7339
Ocotea_arnottiana,21,11,10,Points-PointsKO-Adjacents,107
Ocotea_atacta,3,2,1,Points-PointsKO-Adjacents,27
Ocotea_atirrensis,457,428,29,Alphahull-PointsKO-Adjacents,1239
Ocotea_atlantica,20,8,12,Points-PointsKO-Adjacents,96
Ocotea_atrata,15,6,9,Points-PointsKO-Adjacents,87
Ocotea_aurantiodora,99,66,33,Alphahull-PointsKO-Adjacents,2523
Ocotea_auriculata,6,2,4,Points-PointsKO-Adjacents,50
Ocotea_auriculiformis,28,19,9,Points-PointsKO-Adjacents,138
Ocotea_austinii,86,69,17,Alphahull-PointsKO-Adjacents,169
Ocotea_bajapazensis,5,5,0,Points-PointsKO-Adjacents,33
Ocotea_balanocarpa,13,0,13,Points-PointsKO-Adjacents,105
Ocotea_bangii,3,3,0,Points-PointsKO-Adjacents,27
Ocotea_barbatula,5,5,0,Points-PointsKO-Adjacents,26
Ocotea_barbellata,8,2,6,Points-PointsKO-Adjacents,72
Ocotea_basicordatifolia,4,4,0,Points-PointsKO-Adjacents,34
Ocotea_basirecurva,6,2,4,Points-PointsKO-Adjacents,36
Ocotea_benthamiana,27,16,11,Points-PointsKO-Adjacents,139
Ocotea_bernoulliana,2,2,0,Points-PointsKO-Adjacents,18
Ocotea_beulahiae,23,15,8,Points-PointsKO-Adjacents,98
Ocotea_beyrichii,18,5,13,Points-PointsKO-Adjacents,147
Ocotea_bicolor,275,0,275,Points-PointsKO-Adjacents,1438
Ocotea_bijuga,7,4,3,Points-PointsKO-Adjacents,61
Ocotea_bofo,279,226,53,Alphahull-PointsKO-Adjacents,19194
Ocotea_botrantha,83,0,83,Points-PointsKO-Adjacents,385
Ocotea_bourgeauviana,65,40,25,Alphahull-PointsKO-Adjacents,859
Ocotea_brachybotra,83,50,33,Alphahull-PointsKO-Adjacents,1526
Ocotea_bracteosa,3,3,0,Points-PointsKO-Adjacents,27
Ocotea_bragae,0,0,0,NA,0
Ocotea_brenesii,55,44,11,Alphahull-PointsKO-Adjacents,192
Ocotea_brevipes,2,2,0,Points-PointsKO-Adjacents,18
Ocotea_brevipetiolata,18,8,10,Points-PointsKO-Adjacents,102
Ocotea_bullata,34,3,31,Points-PointsKO-Adjacents,291
Ocotea_caesia,4,4,0,Points-PointsKO-Adjacents,36
Ocotea_calliscypha,9,5,4,Points-PointsKO-Adjacents,55
Ocotea_camphoromoea,134,82,52,Alphahull-PointsKO-Adjacents,8938
Ocotea_canaliculata,438,325,113,Alphahull-PointsKO-Adjacents,37719
Ocotea_candidovillosa,9,2,7,Points-PointsKO-Adjacents,46
Ocotea_caniflora,9,3,6,Points-PointsKO-Adjacents,81
Ocotea_cantareirae,1,1,0,Points-PointsKO-Adjacents,9
Ocotea_carabobensis,3,3,0,Points-PointsKO-Adjacents,24
Ocotea_caracasana,6,1,5,Points-PointsKO-Adjacents,54
Ocotea_cardinalis,7,0,7,Points-PointsKO-Adjacents,57
Ocotea_catharinensis,331,0,331,Points-PointsKO-Adjacents,1666
Ocotea_caudatifolia,5,5,0,Points-PointsKO-Adjacents,39
Ocotea_ceanothifolia,57,24,33,Alphahull-PointsKO-Adjacents,407
Ocotea_cernua,1646,1464,182,Alphahull-PointsKO-Adjacents,98818
Ocotea_chiapensis,63,41,22,Alphahull-PointsKO-Adjacents,565
Ocotea_ciliata,14,10,4,Points-PointsKO-Adjacents,67
Ocotea_cinerea,60,31,29,Alphahull-PointsKO-Adjacents,1818
Ocotea_citrosmoides,15,4,11,Points-PointsKO-Adjacents,99
Ocotea_clavigera,2,2,0,Points-PointsKO-Adjacents,18
Ocotea_comata,17,10,7,Points-PointsKO-Adjacents,81
Ocotea_comoriensis,8,2,6,Points-PointsKO-Adjacents,31
Ocotea_complicata,37,14,23,Points-PointsKO-Adjacents,228
Ocotea_confertiflora,24,10,14,Points-PointsKO-Adjacents,183
Ocotea_congestifolia,2,2,0,Points-PointsKO-Adjacents,9
Ocotea_contrerasii,5,5,0,Points-PointsKO-Adjacents,30
Ocotea_corethroides,18,8,10,Points-PointsKO-Adjacents,122
Ocotea_corymbosa,1093,988,105,Alphahull-PointsKO-Adjacents,22935
Ocotea_cowaniana,7,3,4,Points-PointsKO-Adjacents,47
Ocotea_crassifolia,8,3,5,Points-PointsKO-Adjacents,52
Ocotea_crassiramula,1,1,0,Points-PointsKO-Adjacents,9
Ocotea_cryptocarpa,9,6,3,Points-PointsKO-Adjacents,31
Ocotea_cryptocaryoides,24,15,9,Points-PointsKO-Adjacents,146
Ocotea_cujumary,288,226,62,Alphahull-PointsKO-Adjacents,32126
Ocotea_cuneata,36,22,14,Alphahull-PointsKO-Adjacents,332
Ocotea_cuneifolia,51,31,20,Alphahull-PointsKO-Adjacents,1000
Ocotea_curucutuensis,25,16,9,Points-PointsKO-Adjacents,148
Ocotea_cymbarum,244,175,69,Alphahull-PointsKO-Adjacents,31221
Ocotea_cymosa,103,79,24,Alphahull-PointsKO-Adjacents,755
Ocotea_daphnifolia,234,182,52,Alphahull-PointsKO-Adjacents,4410
Ocotea_darcyi,6,2,4,Points-PointsKO-Adjacents,40
Ocotea_debilis,19,6,13,Points-PointsKO-Adjacents,169
Ocotea_deflexa,35,0,35,Points-PointsKO-Adjacents,201
Ocotea_delicata,11,3,8,Points-PointsKO-Adjacents,82
Ocotea_dendrodaphne,303,257,46,Alphahull-PointsKO-Adjacents,2182
Ocotea_densiflora,16,7,9,Points-PointsKO-Adjacents,107
Ocotea_dentata,53,42,11,Alphahull-PointsKO-Adjacents,662
Ocotea_dielsiana,12,5,7,Points-PointsKO-Adjacents,108
Ocotea_diffusa,5,1,4,Points-PointsKO-Adjacents,27
Ocotea_diospyrifolia,1057,970,87,Alphahull-PointsKO-Adjacents,28207
Ocotea_discrepens,35,13,22,Points-PointsKO-Adjacents,266
Ocotea_disjuncta,2,2,0,Points-PointsKO-Adjacents,18
Ocotea_dispersa,356,305,51,Alphahull-PointsKO-Adjacents,3783
Ocotea_divaricata,260,215,45,Alphahull-PointsKO-Adjacents,3236
Ocotea_domatiata,19,7,12,Points-PointsKO-Adjacents,116
Ocotea_dominicana,10,5,5,Points-PointsKO-Adjacents,18
Ocotea_douradensis,23,7,16,Points-PointsKO-Adjacents,166
Ocotea_duidensis,27,13,14,Points-PointsKO-Adjacents,192
Ocotea_duplocolorata,2,2,0,Points-PointsKO-Adjacents,18
Ocotea_effusa,104,84,20,Alphahull-PointsKO-Adjacents,1245
Ocotea_elegans,180,129,51,Alphahull-PointsKO-Adjacents,2084
Ocotea_elliptica,6,1,5,Points-PointsKO-Adjacents,30
Ocotea_endresiana,80,67,13,Alphahull-PointsKO-Adjacents,702
Ocotea_erectifolia,6,1,5,Points-PointsKO-Adjacents,32
Ocotea_eriothyrsa,1,1,0,Points-PointsKO-Adjacents,9
Ocotea_esmeraldana,165,139,26,Alphahull-PointsKO-Adjacents,6043
Ocotea_euvenosa,1,1,0,Points-PointsKO-Adjacents,9
Ocotea_fasciculata,294,196,98,Alphahull-PointsKO-Adjacents,21840
Ocotea_faucherei,6,2,4,Points-PointsKO-Adjacents,48
Ocotea_felix,15,4,11,Points-PointsKO-Adjacents,95
Ocotea_fendleri,18,1,17,Points-PointsKO-Adjacents,116
Ocotea_flavantha,6,1,5,Points-PointsKO-Adjacents,36
Ocotea_floribunda,557,382,175,Alphahull-PointsKO-Adjacents,25072
Ocotea_foeniculacea,29,9,20,Points-PointsKO-Adjacents,194
Ocotea_foetens,61,48,13,Alphahull-PointsKO-Adjacents,139
Ocotea_foveolata,19,7,12,Points-PointsKO-Adjacents,116
Ocotea_fragrantissima,15,1,14,Points-PointsKO-Adjacents,135
Ocotea_froesii,0,0,0,NA,0
Ocotea_frondosa,18,5,13,Points-PointsKO-Adjacents,150
Ocotea_gabonensis,13,6,7,Points-PointsKO-Adjacents,84
Ocotea_gardneri,46,0,46,Points-PointsKO-Adjacents,260
Ocotea_glauca,127,89,38,Alphahull-PointsKO-Adjacents,3891
Ocotea_glaucosericea,36,24,12,Alphahull-PointsKO-Adjacents,157
Ocotea_glaziovii,358,312,46,Alphahull-PointsKO-Adjacents,13428
Ocotea_glomerata,614,466,148,Alphahull-PointsKO-Adjacents,27910
Ocotea_gomezii,43,27,16,Alphahull-PointsKO-Adjacents,192
Ocotea_gordonii,8,2,6,Points-PointsKO-Adjacents,56
Ocotea_gracilis,255,189,66,Alphahull-PointsKO-Adjacents,35799
Ocotea_grayi,49,33,16,Alphahull-PointsKO-Adjacents,355
Ocotea_guatemalensis,30,11,19,Points-PointsKO-Adjacents,177
Ocotea_guianensis,635,531,104,Alphahull-PointsKO-Adjacents,58713
Ocotea_haberi,24,14,10,Points-PointsKO-Adjacents,112
Ocotea_hartshorniana,28,21,7,Alphahull-PointsKO-Adjacents,118
Ocotea_helicterifolia,366,317,49,Alphahull-PointsKO-Adjacents,4141
Ocotea_heribertoi,2,2,0,Points-PointsKO-Adjacents,18
Ocotea_heterochroma,51,32,19,Alphahull-PointsKO-Adjacents,523
Ocotea_hirtostyla,7,1,6,Points-PointsKO-Adjacents,39
Ocotea_holdridgeana,44,34,10,Alphahull-PointsKO-Adjacents,110
Ocotea_hueckii,0,0,0,NA,0
Ocotea_humbertii,4,4,0,Points-PointsKO-Adjacents,30
Ocotea_humblotii,26,16,10,Points-PointsKO-Adjacents,151
Ocotea_hypoglauca,8,0,8,Points-PointsKO-Adjacents,64
Ocotea_ikonyokpe,3,3,0,Points-PointsKO-Adjacents,23
Ocotea_illustris,4,4,0,Points-PointsKO-Adjacents,33
Ocotea_imazensis,3,3,0,Points-PointsKO-Adjacents,27
Ocotea_immersa,14,5,9,Points-PointsKO-Adjacents,88
Ocotea_indecora,747,667,80,Alphahull-PointsKO-Adjacents,12848
Ocotea_indirectinervia,10,4,6,Points-PointsKO-Adjacents,84
Ocotea_infrafoveolata,85,62,23,Alphahull-PointsKO-Adjacents,557
Ocotea_inhauba,0,0,0,NA,0
Ocotea_insignis,44,18,26,Points-PointsKO-Adjacents,275
Ocotea_insularis,497,174,323,Alphahull-PointsKO-Adjacents,3587
Ocotea_involuta,7,1,6,Points-PointsKO-Adjacents,42
Ocotea_iridescens,7,3,4,Points-PointsKO-Adjacents,24
Ocotea_itatiaiae,2,2,0,Points-PointsKO-Adjacents,18
Ocotea_jacquinii,2,2,0,Points-PointsKO-Adjacents,18
Ocotea_javitensis,318,278,40,Alphahull-PointsKO-Adjacents,19300
Ocotea_jefensis,7,2,5,Points-PointsKO-Adjacents,41
Ocotea_jelskii,9,3,6,Points-PointsKO-Adjacents,79
Ocotea_jorge-escobarii,12,7,5,Points-PointsKO-Adjacents,78
Ocotea_julianii,10,6,4,Points-PointsKO-Adjacents,32
Ocotea_jumbillensis,3,3,0,Points-PointsKO-Adjacents,27
Ocotea_karsteniana,36,10,26,Points-PointsKO-Adjacents,301
Ocotea_kenyensis,55,17,38,Points-PointsKO-Adjacents,414
Ocotea_keriana,4,4,0,Points-PointsKO-Adjacents,36
Ocotea_killipii,7,1,6,Points-PointsKO-Adjacents,63
Ocotea_klepperae,1,1,0,Points-PointsKO-Adjacents,9
Ocotea_klotzschiana,109,92,17,Alphahull-PointsKO-Adjacents,296
Ocotea_laetevirens,176,147,29,Alphahull-PointsKO-Adjacents,737
Ocotea_laevigata,0,0,0,NA,0
Ocotea_lanata,143,109,34,Alphahull-PointsKO-Adjacents,3157
Ocotea_lancifolia,758,667,91,Alphahull-PointsKO-Adjacents,20905
Ocotea_lancilimba,NA,NA,NA,NA,NA
Ocotea_langsdorffii,60,42,18,Alphahull-PointsKO-Adjacents,188
Ocotea_laticostata,12,6,6,Points-PointsKO-Adjacents,46
Ocotea_laxa,297,245,52,Alphahull-PointsKO-Adjacents,6967
Ocotea_lenitae,8,2,6,Points-PointsKO-Adjacents,69
Ocotea_lentii,27,19,8,Points-PointsKO-Adjacents,96
Ocotea_leptophylla,2,2,0,Points-PointsKO-Adjacents,18
Ocotea_leucophloea,1,1,0,Points-PointsKO-Adjacents,9
Ocotea_leucoxylon,166,113,53,Alphahull-PointsKO-Adjacents,1323
Ocotea_liesneri,2,2,0,Points-PointsKO-Adjacents,18
Ocotea_ligulata,8,5,3,Points-PointsKO-Adjacents,34
Ocotea_limae,23,14,9,Points-PointsKO-Adjacents,159
Ocotea_lobbii,101,55,46,Alphahull-PointsKO-Adjacents,819
Ocotea_loefgrenii,9,1,8,Points-PointsKO-Adjacents,81
Ocotea_longifolia,811,688,123,Alphahull-PointsKO-Adjacents,57159
Ocotea_macrantha,3,3,0,Points-PointsKO-Adjacents,18
Ocotea_macrocarpa,14,8,6,Points-PointsKO-Adjacents,55
Ocotea_macrophylla,132,102,30,Alphahull-PointsKO-Adjacents,2269
Ocotea_macropoda,63,38,25,Alphahull-PointsKO-Adjacents,507
Ocotea_madagascariensis,5,5,0,Points-PointsKO-Adjacents,39
Ocotea_magnifica,9,1,8,Points-PointsKO-Adjacents,68
Ocotea_malcomberi,12,8,4,Points-PointsKO-Adjacents,32
Ocotea_mandonii,32,22,10,Alphahull-PointsKO-Adjacents,112
Ocotea_maranguapensis,7,1,6,Points-PointsKO-Adjacents,57
Ocotea_marcescens,7,1,6,Points-PointsKO-Adjacents,39
Ocotea_marmellensis,23,6,17,Points-PointsKO-Adjacents,196
Ocotea_mascarena,2,2,0,Points-PointsKO-Adjacents,12
Ocotea_matogrossensis,76,40,36,Alphahull-PointsKO-Adjacents,8486
Ocotea_matudae,7,3,4,Points-PointsKO-Adjacents,30
Ocotea_megacarpa,4,4,0,Points-PointsKO-Adjacents,26
Ocotea_meziana,170,146,24,Alphahull-PointsKO-Adjacents,811
Ocotea_micans,20,10,10,Points-PointsKO-Adjacents,112
Ocotea_michelsonii,15,7,8,Points-PointsKO-Adjacents,90
Ocotea_micrantha,6,2,4,Points-PointsKO-Adjacents,41
Ocotea_microbotrys,9,0,9,Points-PointsKO-Adjacents,65
Ocotea_microneura,14,9,5,Points-PointsKO-Adjacents,92
Ocotea_minarum,311,258,53,Alphahull-PointsKO-Adjacents,12759
Ocotea_minor,32,13,19,Points-PointsKO-Adjacents,240
Ocotea_minutiflora,7,2,5,Points-PointsKO-Adjacents,60
Ocotea_mollicella,43,35,8,Alphahull-PointsKO-Adjacents,115
Ocotea_mollifolia,99,81,18,Alphahull-PointsKO-Adjacents,531
Ocotea_montana,23,9,14,Points-PointsKO-Adjacents,150
Ocotea_monteverdensis,27,0,27,Points-PointsKO-Adjacents,62
Ocotea_morae,10,5,5,Points-PointsKO-Adjacents,69
Ocotea_moschata,3,1,2,Points-PointsKO-Adjacents,25
Ocotea_multiflora,21,14,7,Points-PointsKO-Adjacents,38
Ocotea_multiglandulosa,11,1,10,Points-PointsKO-Adjacents,98
Ocotea_multinervis,13,0,13,Points-PointsKO-Adjacents,100
Ocotea_munacensis,6,0,6,Points-PointsKO-Adjacents,48
Ocotea_myriantha,131,91,40,Alphahull-PointsKO-Adjacents,9365
Ocotea_neblinae,14,4,10,Points-PointsKO-Adjacents,94
Ocotea_nectandrifolia,202,172,30,Alphahull-PointsKO-Adjacents,1717
Ocotea_neesiana,132,83,49,Alphahull-PointsKO-Adjacents,15911
Ocotea_nervosa,20,4,16,Points-PointsKO-Adjacents,152
Ocotea_nigra,23,7,16,Points-PointsKO-Adjacents,157
Ocotea_nigrescens,47,21,26,Alphahull-PointsKO-Adjacents,563
Ocotea_nigrita,5,5,0,Points-PointsKO-Adjacents,39
Ocotea_nitida,280,190,90,Alphahull-PointsKO-Adjacents,20464
Ocotea_notata,645,532,113,Alphahull-PointsKO-Adjacents,10888
Ocotea_nutans,294,219,75,Alphahull-PointsKO-Adjacents,6213
Ocotea_obliqua,89,46,43,Alphahull-PointsKO-Adjacents,2489
Ocotea_oblonga,531,426,105,Alphahull-PointsKO-Adjacents,56382
Ocotea_oblongifolia,1,1,0,Points-PointsKO-Adjacents,9
Ocotea_oblongo-obovata,0,0,0,NA,0
Ocotea_obovata,59,42,17,Alphahull-PointsKO-Adjacents,280
Ocotea_obtusata,0,0,0,NA,0
Ocotea_obtusifolia,1,1,0,Points-PointsKO-Adjacents,9
Ocotea_odorata,12,0,12,Points-PointsKO-Adjacents,89
Ocotea_odorifera,802,710,92,Alphahull-PointsKO-Adjacents,9915
Ocotea_olivacea,131,73,58,Alphahull-PointsKO-Adjacents,5468
Ocotea_oocarpa,3,3,0,Points-PointsKO-Adjacents,27
Ocotea_oppositifolia,66,46,20,Alphahull-PointsKO-Adjacents,2230
Ocotea_ottoschmidtii,5,5,0,Points-PointsKO-Adjacents,45
Ocotea_otuzcensis,2,2,0,Points-PointsKO-Adjacents,18
Ocotea_ovalifolia,27,14,13,Points-PointsKO-Adjacents,175
Ocotea_pachypoda,2,2,0,Points-PointsKO-Adjacents,18
Ocotea_pacifica,19,8,11,Points-PointsKO-Adjacents,148
Ocotea_panurensis,15,4,11,Points-PointsKO-Adjacents,132
Ocotea_parvula,13,0,13,Points-PointsKO-Adjacents,80
Ocotea_patula,8,5,3,Points-PointsKO-Adjacents,39
Ocotea_pauciflora,193,123,70,Alphahull-PointsKO-Adjacents,25919
Ocotea_pausiaca,11,5,6,Points-PointsKO-Adjacents,66
Ocotea_pentagona,124,0,124,Points-PointsKO-Adjacents,360
Ocotea_percoriacea,208,187,21,Alphahull-PointsKO-Adjacents,2792
Ocotea_percurrens,106,63,43,Alphahull-PointsKO-Adjacents,5646
Ocotea_perforata,7,3,4,Points-PointsKO-Adjacents,54
Ocotea_perrobusta,5,5,0,Points-PointsKO-Adjacents,24
Ocotea_petalanthera,5,0,5,Points-PointsKO-Adjacents,45
Ocotea_pharomachrosorum,14,9,5,Points-PointsKO-Adjacents,66
Ocotea_pittieri,23,19,4,Points-PointsKO-Adjacents,93
Ocotea_piurensis,8,2,6,Points-PointsKO-Adjacents,59
Ocotea_platyphylla,21,8,13,Points-PointsKO-Adjacents,111
Ocotea_pluridomatiata,11,4,7,Points-PointsKO-Adjacents,51
Ocotea_polyantha,28,0,28,Points-PointsKO-Adjacents,215
Ocotea_pomaderroides,247,211,36,Alphahull-PointsKO-Adjacents,6600
Ocotea_porosa,346,306,40,Alphahull-PointsKO-Adjacents,4450
Ocotea_porphyria,80,58,22,Alphahull-PointsKO-Adjacents,776
Ocotea_portoricensis,6,1,5,Points-PointsKO-Adjacents,43
Ocotea_praetermissa,69,60,9,Alphahull-PointsKO-Adjacents,113
Ocotea_producta,6,3,3,Points-PointsKO-Adjacents,48
Ocotea_prolifera,33,7,26,Points-PointsKO-Adjacents,205
Ocotea_prunifolia,6,1,5,Points-PointsKO-Adjacents,45
Ocotea_pseudopalmana,40,30,10,Alphahull-PointsKO-Adjacents,126
Ocotea_puberula,1619,1382,237,Alphahull-PointsKO-Adjacents,69553
Ocotea_pulchella,1146,1055,91,Alphahull-PointsKO-Adjacents,22473
Ocotea_purpurea,63,46,17,Alphahull-PointsKO-Adjacents,976
Ocotea_quixos,41,29,12,Alphahull-PointsKO-Adjacents,389
Ocotea_racemiflora,3,3,0,Points-PointsKO-Adjacents,27
Ocotea_racemosa,283,247,36,Alphahull-PointsKO-Adjacents,2964
Ocotea_raimondii,9,3,6,Points-PointsKO-Adjacents,78
Ocotea_reticularis,3,3,0,Points-PointsKO-Adjacents,26
Ocotea_revoluta,5,5,0,Points-PointsKO-Adjacents,42
Ocotea_rhodophylla,58,23,35,Alphahull-PointsKO-Adjacents,1360
Ocotea_rhytidotricha,11,4,7,Points-PointsKO-Adjacents,75
Ocotea_rigens,21,5,16,Points-PointsKO-Adjacents,142
Ocotea_rigidifolia,6,1,5,Points-PointsKO-Adjacents,35
Ocotea_rivularis,31,26,5,Alphahull-PointsKO-Adjacents,57
Ocotea_rotundata,10,6,4,Points-PointsKO-Adjacents,39
Ocotea_rubriflora,14,5,9,Points-PointsKO-Adjacents,95
Ocotea_rubrinervis,59,25,34,Alphahull-PointsKO-Adjacents,445
Ocotea_rufescens,9,4,5,Points-PointsKO-Adjacents,33
Ocotea_rufovestita,10,2,8,Points-PointsKO-Adjacents,84
Ocotea_rugosa,23,11,12,Points-PointsKO-Adjacents,113
Ocotea_salvadorensis,9,4,5,Points-PointsKO-Adjacents,63
Ocotea_salvinii,18,7,11,Points-PointsKO-Adjacents,88
Ocotea_sambiranensis,8,0,8,Points-PointsKO-Adjacents,24
Ocotea_sanariapensis,69,58,11,Alphahull-PointsKO-Adjacents,3049
Ocotea_sandwithii,18,9,9,Points-PointsKO-Adjacents,132
Ocotea_sarcodes,9,6,3,Points-PointsKO-Adjacents,27
Ocotea_sassafras,23,13,10,Points-PointsKO-Adjacents,163
Ocotea_sauroderma,6,2,4,Points-PointsKO-Adjacents,34
Ocotea_scabrella,47,14,33,Points-PointsKO-Adjacents,328
Ocotea_scalariformis,9,4,5,Points-PointsKO-Adjacents,60
Ocotea_scandens,14,4,10,Points-PointsKO-Adjacents,118
Ocotea_schomburgkiana,181,139,42,Alphahull-PointsKO-Adjacents,13187
Ocotea_schwackeana,14,0,14,Points-PointsKO-Adjacents,107
Ocotea_sericea,85,60,25,Alphahull-PointsKO-Adjacents,1103
Ocotea_serrana,26,0,26,Points-PointsKO-Adjacents,109
Ocotea_sessiliflora,5,5,0,Points-PointsKO-Adjacents,35
Ocotea_silvae,5,5,0,Points-PointsKO-Adjacents,45
Ocotea_silvestris,418,0,418,Points-PointsKO-Adjacents,2451
Ocotea_sinaiana,2,2,0,Points-PointsKO-Adjacents,18
Ocotea_sinuata,144,111,33,Alphahull-PointsKO-Adjacents,1950
Ocotea_smithiana,71,47,24,Alphahull-PointsKO-Adjacents,707
Ocotea_sodiroana,25,14,11,Points-PointsKO-Adjacents,159
Ocotea_spathulata,20,10,10,Points-PointsKO-Adjacents,102
Ocotea_spectabilis,92,35,57,Alphahull-PointsKO-Adjacents,4565
Ocotea_spixiana,364,305,59,Alphahull-PointsKO-Adjacents,11010
Ocotea_splendens,213,158,55,Alphahull-PointsKO-Adjacents,18217
Ocotea_sprucei,15,1,14,Points-PointsKO-Adjacents,131
Ocotea_squarrosa,2,1,1,Points-PointsKO-Adjacents,13
Ocotea_staminea,7,4,3,Points-PointsKO-Adjacents,32
Ocotea_standleyi,18,6,12,Points-PointsKO-Adjacents,100
Ocotea_stenoneura,66,40,26,Alphahull-PointsKO-Adjacents,332
Ocotea_stenophylla,6,3,3,Points-PointsKO-Adjacents,45
Ocotea_stuebelii,8,3,5,Points-PointsKO-Adjacents,53
Ocotea_subalata,7,0,7,Points-PointsKO-Adjacents,52
Ocotea_subrutilans,50,26,24,Alphahull-PointsKO-Adjacents,652
Ocotea_subterminalis,52,25,27,Alphahull-PointsKO-Adjacents,1296
Ocotea_sulcata,6,0,6,Points-PointsKO-Adjacents,31
Ocotea_tabacifolia,87,41,46,Alphahull-PointsKO-Adjacents,944
Ocotea_teleiandra,373,322,51,Alphahull-PointsKO-Adjacents,2727
Ocotea_tenella,23,0,23,Points-PointsKO-Adjacents,199
Ocotea_tenera,107,92,15,Alphahull-PointsKO-Adjacents,330
Ocotea_tenuiflora,59,41,18,Alphahull-PointsKO-Adjacents,1140
Ocotea_terciopelo,9,3,6,Points-PointsKO-Adjacents,70
Ocotea_tessmannii,103,63,40,Alphahull-PointsKO-Adjacents,1181
Ocotea_thouvenotii,41,28,13,Alphahull-PointsKO-Adjacents,395
Ocotea_tillettsiana,3,3,0,Points-PointsKO-Adjacents,27
Ocotea_tomentella,50,21,29,Alphahull-PointsKO-Adjacents,1241
Ocotea_tomentosa,8,1,7,Points-PointsKO-Adjacents,59
Ocotea_tonduzii,59,40,19,Alphahull-PointsKO-Adjacents,203
Ocotea_tonii,13,0,13,Points-PointsKO-Adjacents,74
Ocotea_trichantha,17,11,6,Points-PointsKO-Adjacents,96
Ocotea_trichophlebia,26,16,10,Points-PointsKO-Adjacents,153
Ocotea_trinidadensis,0,0,0,NA,0
Ocotea_tristis,282,239,43,Alphahull-PointsKO-Adjacents,6234
Ocotea_truncata,16,6,10,Points-PointsKO-Adjacents,97
Ocotea_tsaratananensis,6,1,5,Points-PointsKO-Adjacents,25
Ocotea_tubulosa,9,1,8,Points-PointsKO-Adjacents,75
Ocotea_ucayalensis,21,9,12,Points-PointsKO-Adjacents,174
Ocotea_urbaniana,38,11,27,Points-PointsKO-Adjacents,262
Ocotea_usambarensis,54,34,20,Alphahull-PointsKO-Adjacents,969
Ocotea_uxpanapana,55,43,12,Alphahull-PointsKO-Adjacents,693
Ocotea_vaccinioides,121,96,25,Alphahull-PointsKO-Adjacents,1488
Ocotea_vaginans,8,4,4,Points-PointsKO-Adjacents,42
Ocotea_valerioana,83,72,11,Alphahull-PointsKO-Adjacents,244
Ocotea_valerioides,38,31,7,Alphahull-PointsKO-Adjacents,194
Ocotea_vanderwerffii,30,18,12,Points-PointsKO-Adjacents,151
Ocotea_vasquezii,7,0,7,Points-PointsKO-Adjacents,49
Ocotea_velloziana,446,372,74,Alphahull-PointsKO-Adjacents,24830
Ocotea_velutina,315,258,57,Alphahull-PointsKO-Adjacents,8119
Ocotea_venosa,5,5,0,Points-PointsKO-Adjacents,30
Ocotea_veraguensis,449,362,87,Alphahull-PointsKO-Adjacents,5581
Ocotea_verapazensis,2,2,0,Points-PointsKO-Adjacents,18
Ocotea_viburnoides,10,3,7,Points-PointsKO-Adjacents,75
Ocotea_villosa,39,23,16,Alphahull-PointsKO-Adjacents,402
Ocotea_virgultosa,19,8,11,Points-PointsKO-Adjacents,155
Ocotea_viridiflora,5,5,0,Points-PointsKO-Adjacents,21
Ocotea_weberbaueri,3,3,0,Points-PointsKO-Adjacents,27
Ocotea_whitei,180,164,16,Alphahull-PointsKO-Adjacents,1176
Ocotea_wrightii,24,12,12,Points-PointsKO-Adjacents,195
Ocotea_wurdackiana,24,15,9,Points-PointsKO-Adjacents,75
Ocotea_xanthocalyx,64,43,21,Alphahull-PointsKO-Adjacents,2870
Ocotea_yutajensis,11,7,4,Points-PointsKO-Adjacents,50
Ocotea_zahamenensis,14,11,3,Points-PointsKO-Adjacents,64
Ocotea_zoque,2,2,0,Points-PointsKO-Adjacents,18
Octamyrtus_arfakensis,5,5,0,Points-PointsKO-Adjacents,44
Octamyrtus_behrmannii,37,22,15,Alphahull-PointsKO-Adjacents,488
Octamyrtus_glomerata,2,2,0,Points-PointsKO-Adjacents,18
Octamyrtus_halmaherensis,0,0,0,NA,0
Octamyrtus_insignis,13,7,6,Points-PointsKO-Adjacents,90
Octamyrtus_pleiopetala,117,88,29,Alphahull-PointsKO-Adjacents,1336
Octoknema_affinis,47,30,17,Alphahull-PointsKO-Adjacents,435
Octoknema_borealis,65,42,23,Alphahull-PointsKO-Adjacents,1192
Octoknema_dinklagei,2,2,0,Points-PointsKO-Adjacents,18
Octoknema_klaineana,6,0,6,Points-PointsKO-Adjacents,42
Octoknema_orientalis,19,12,7,Points-PointsKO-Adjacents,114
Octolepis_aymoniniana,1,1,0,Points-PointsKO-Adjacents,9
Octolepis_dioica,28,17,11,Points-PointsKO-Adjacents,145
Octolepis_ibityensis,2,2,0,Points-PointsKO-Adjacents,9
Octolepis_oblanceolata,9,3,6,Points-PointsKO-Adjacents,47
Octolepis_ratovosonii,9,2,7,Points-PointsKO-Adjacents,60
Octolobus_grandis,1,1,0,Points-PointsKO-Adjacents,9
Octolobus_heteromerus,9,1,8,Points-PointsKO-Adjacents,81
Octolobus_spectabilis,79,45,34,Alphahull-PointsKO-Adjacents,1605
Octotropis_travancorica,1,1,0,Points-PointsKO-Adjacents,9
Oddoniodendron_micranthum,58,38,20,Alphahull-PointsKO-Adjacents,1928
Oddoniodendron_normandii,7,4,3,Points-PointsKO-Adjacents,63
Oddoniodendron_romeroi,6,1,5,Points-PointsKO-Adjacents,42
Oecopetalum_greenmanii,27,11,16,Points-PointsKO-Adjacents,160
Oecopetalum_mexicanum,78,60,18,Alphahull-PointsKO-Adjacents,785
Oedematopus_congestiflorus,1,1,0,Points-PointsKO-Adjacents,9
Oemleria_cerasiformis,957,0,957,Points-PointsKO-Adjacents,2568
Oenocarpus_bacaba,334,270,64,Alphahull-PointsKO-Adjacents,30530
Oenocarpus_balickii,108,74,34,Alphahull-PointsKO-Adjacents,7065
Oenocarpus_bataua,1277,1196,81,Alphahull-PointsKO-Adjacents,65614
Oenocarpus_circumtextus,6,2,4,Points-PointsKO-Adjacents,37
Oenocarpus_distichus,197,153,44,Alphahull-PointsKO-Adjacents,22637
Oenocarpus_makeru,3,3,0,Points-PointsKO-Adjacents,24
Oenocarpus_mapora,821,743,78,Alphahull-PointsKO-Adjacents,30357
Oenocarpus_minor,159,114,45,Alphahull-PointsKO-Adjacents,12098
Oenocarpus_simplex,6,0,6,Points-PointsKO-Adjacents,36
Okoubaka_aubrevillei,40,14,26,Points-PointsKO-Adjacents,309
Okoubaka_michelsonii,4,4,0,Points-PointsKO-Adjacents,30
Olax_dissitiflora,113,65,48,Alphahull-PointsKO-Adjacents,2514
Olax_emirnensis,80,58,22,Alphahull-PointsKO-Adjacents,1346
Olax_gossweileri,0,0,0,NA,0
Olax_imbricata,34,2,32,Points-PointsKO-Adjacents,271
Olax_madagascariensis,58,35,23,Alphahull-PointsKO-Adjacents,1214
Olax_obtusifolia,15,1,14,Points-PointsKO-Adjacents,133
Olax_pentandra,24,14,10,Points-PointsKO-Adjacents,157
Olax_psittacorum,1,1,0,Points-PointsKO-Adjacents,9
Olax_subscorpioides,10,1,9,Points-PointsKO-Adjacents,79
Olax_thouarsii,26,13,13,Points-PointsKO-Adjacents,156
Oldenburgia_grandis,20,12,8,Points-PointsKO-Adjacents,122
Oldfieldia_africana,28,13,15,Points-PointsKO-Adjacents,185
Oldfieldia_dactylophylla,21,3,18,Points-PointsKO-Adjacents,177
Oldfieldia_macrocarpa,3,3,0,Points-PointsKO-Adjacents,27
Oldfieldia_somalensis,25,10,15,Points-PointsKO-Adjacents,182
Olea_ambrensis,7,0,7,Points-PointsKO-Adjacents,60
Olea_borneensis,7,1,6,Points-PointsKO-Adjacents,52
Olea_brachiata,17,1,16,Points-PointsKO-Adjacents,137
Olea_capensis,281,179,102,Alphahull-PointsKO-Adjacents,7508
Olea_caudatilimba,2,2,0,Points-PointsKO-Adjacents,18
Olea_chimanimani,0,0,0,NA,0
Olea_cordatula,0,0,0,NA,0
Olea_dioica,6,0,6,Points-PointsKO-Adjacents,53
Olea_europaea,16043,13475,2568,Alphahull-PointsKO-Adjacents,42638
Olea_exasperata,41,21,20,Alphahull-PointsKO-Adjacents,543
Olea_gagnepainii,0,0,0,NA,0
Olea_gamblei,0,0,0,NA,0
Olea_hainanensis,7,0,7,Points-PointsKO-Adjacents,63
Olea_javanica,0,0,0,NA,0
Olea_lancea,11,1,10,Points-PointsKO-Adjacents,94
Olea_maderensis,3,1,2,Points-PointsKO-Adjacents,24
Olea_moluccensis,NA,NA,NA,NA,NA
Olea_neriifolia,3,3,0,Points-PointsKO-Adjacents,27
Olea_palawanensis,0,0,0,NA,0
Olea_paniculata,672,552,120,Alphahull-PointsKO-Adjacents,4296
Olea_parvilimba,2,2,0,Points-PointsKO-Adjacents,18
Olea_polygama,1,0,1,Points-PointsKO-Adjacents,9
Olea_puberula,NA,NA,NA,NA,NA
Olea_rosea,8,1,7,Points-PointsKO-Adjacents,72
Olea_rubrovenia,8,0,8,Points-PointsKO-Adjacents,40
Olea_salicifolia,4,4,0,Points-PointsKO-Adjacents,36
Olea_schliebenii,4,3,1,Points-PointsKO-Adjacents,32
Olea_tetragonoclada,3,3,0,Points-PointsKO-Adjacents,27
Olea_welwitschii,27,11,16,Points-PointsKO-Adjacents,158
Olea_wightiana,0,0,0,NA,0
Olea_woodiana,46,0,46,Points-PointsKO-Adjacents,333
Olea_yuennanensis,17,11,6,Points-PointsKO-Adjacents,153
Olearia_albida,188,155,33,Alphahull-PointsKO-Adjacents,1645
Olearia_angustifolia,35,30,5,Alphahull-PointsKO-Adjacents,105
Olearia_arborescens,940,897,43,Alphahull-PointsKO-Adjacents,3816
Olearia_avicenniifolia,701,665,36,Alphahull-PointsKO-Adjacents,2606
Olearia_chathamica,15,9,6,Points-PointsKO-Adjacents,25
Olearia_crebra,4,4,0,Points-PointsKO-Adjacents,15
Olearia_fimbriata,44,34,10,Alphahull-PointsKO-Adjacents,544
Olearia_fragrantissima,51,37,14,Alphahull-PointsKO-Adjacents,552
Olearia_furfuracea,469,424,45,Alphahull-PointsKO-Adjacents,1994
Olearia_hectorii,56,42,14,Alphahull-PointsKO-Adjacents,722
Olearia_ilicifolia,1130,1093,37,Alphahull-PointsKO-Adjacents,3386
Olearia_lyallii,13,3,10,Points-PointsKO-Adjacents,51
Olearia_polita,7,2,5,Points-PointsKO-Adjacents,23
Olearia_rani,2856,2798,58,Alphahull-PointsKO-Adjacents,2370
Olearia_thomsonii,21,17,4,Points-PointsKO-Adjacents,113
Olearia_townsonii,55,42,13,Alphahull-PointsKO-Adjacents,302
Olearia_traversii,26,12,14,Points-PointsKO-Adjacents,77
Oliganthes_lecomtei,4,4,0,Points-PointsKO-Adjacents,36
Oliganthes_meranoides,25,13,12,Points-PointsKO-Adjacents,99
Oliganthes_pseudocentauropsis,1,1,0,Points-PointsKO-Adjacents,9
Oliganthes_tsaratananensis,3,3,0,Points-PointsKO-Adjacents,25
Oligoceras_eberhardtii,0,0,0,NA,0
Olinia_emarginata,70,48,22,Alphahull-PointsKO-Adjacents,2006
Olinia_huillensis,14,7,7,Points-PointsKO-Adjacents,126
Olinia_radiata,17,6,11,Points-PointsKO-Adjacents,148
Olinia_rochetiana,69,43,26,Alphahull-PointsKO-Adjacents,1188
Olinia_ruandensis,35,0,35,Points-PointsKO-Adjacents,195
Olinia_usambarensis,2,1,1,Points-PointsKO-Adjacents,18
Olinia_vanguerioides,1,1,0,Points-PointsKO-Adjacents,9
Olinia_ventosa,49,30,19,Alphahull-PointsKO-Adjacents,436
Olmediella_betschleriana,80,61,19,Alphahull-PointsKO-Adjacents,1138
Olneya_tesota,661,622,39,Alphahull-PointsKO-Adjacents,4720
Omphalea_ankaranensis,11,8,3,Points-PointsKO-Adjacents,47
Omphalea_bracteata,19,0,19,Points-PointsKO-Adjacents,157
Omphalea_brasiliensis,8,2,6,Points-PointsKO-Adjacents,62
Omphalea_celata,7,3,4,Points-PointsKO-Adjacents,25
Omphalea_commutata,NA,NA,NA,NA,NA
Omphalea_ekmanii,1,1,0,Points-PointsKO-Adjacents,9
Omphalea_hypoleuca,4,4,0,Points-PointsKO-Adjacents,20
Omphalea_malayana,1,1,0,Points-PointsKO-Adjacents,9
Omphalea_occidentalis,14,9,5,Points-PointsKO-Adjacents,71
Omphalea_oleifera,66,52,14,Alphahull-PointsKO-Adjacents,494
Omphalea_oppositifolia,103,81,22,Alphahull-PointsKO-Adjacents,716
Omphalea_palmata,8,2,6,Points-PointsKO-Adjacents,52
Omphalea_triandra,3,2,1,Points-PointsKO-Adjacents,21
Omphalea_trichotoma,6,2,4,Points-PointsKO-Adjacents,39
Omphalocarpum_adolfi-friederici,NA,NA,NA,NA,NA
Omphalocarpum_agglomeratum,NA,NA,NA,NA,NA
Omphalocarpum_ahia,19,10,9,Points-PointsKO-Adjacents,149
Omphalocarpum_bequaertii,0,0,0,NA,0
Omphalocarpum_boyankombo,1,1,0,Points-PointsKO-Adjacents,9
Omphalocarpum_bracteatum,NA,NA,NA,NA,NA
Omphalocarpum_brieyi,1,1,0,Points-PointsKO-Adjacents,9
Omphalocarpum_busange,0,0,0,NA,0
Omphalocarpum_cabrae,1,1,0,Points-PointsKO-Adjacents,9
Omphalocarpum_claessensii,1,1,0,Points-PointsKO-Adjacents,9
Omphalocarpum_elatum,115,65,50,Alphahull-PointsKO-Adjacents,3787
Omphalocarpum_ghesquierei,2,2,0,Points-PointsKO-Adjacents,18
Omphalocarpum_lecomteanum,31,14,17,Points-PointsKO-Adjacents,198
Omphalocarpum_lescrauwaetii,1,1,0,Points-PointsKO-Adjacents,9
Omphalocarpum_lujai,NA,NA,NA,NA,NA
Omphalocarpum_massoko,NA,NA,NA,NA,NA
Omphalocarpum_mayumbense,0,0,0,NA,0
Omphalocarpum_mortehanii,6,0,6,Points-PointsKO-Adjacents,54
Omphalocarpum_ogouense,0,0,0,NA,0
Omphalocarpum_pachysteloides,67,33,34,Alphahull-PointsKO-Adjacents,1187
Omphalocarpum_pedicellatum,NA,NA,NA,NA,NA
Omphalocarpum_procerum,63,30,33,Alphahull-PointsKO-Adjacents,1751
Omphalocarpum_sankuruense,2,2,0,Points-PointsKO-Adjacents,18
Omphalocarpum_sphaerocarpum,3,3,0,Points-PointsKO-Adjacents,18
Omphalocarpum_strombocarpum,7,2,5,Points-PointsKO-Adjacents,30
Omphalocarpum_torosum,1,1,0,Points-PointsKO-Adjacents,9
Omphalocarpum_vermoesenii,2,2,0,Points-PointsKO-Adjacents,18
Oncoba_brachyanthera,15,0,15,Points-PointsKO-Adjacents,98
Oncoba_bukobensis,138,114,24,Alphahull-PointsKO-Adjacents,1666
Oncoba_dentata,252,193,59,Alphahull-PointsKO-Adjacents,8966
Oncoba_lophocarpa,27,21,6,Alphahull-PointsKO-Adjacents,99
Oncoba_routledgei,17,4,13,Points-PointsKO-Adjacents,138
Oncoba_schweinfurthii,39,17,22,Points-PointsKO-Adjacents,200
Oncoba_spinosa,359,253,106,Alphahull-PointsKO-Adjacents,5653
Oncoba_tettensis,94,61,33,Alphahull-PointsKO-Adjacents,1499
Oncosperma_fasciculatum,1,1,0,Points-PointsKO-Adjacents,9
Oncosperma_gracilipes,1,1,0,Points-PointsKO-Adjacents,9
Oncosperma_horridum,14,0,14,Points-PointsKO-Adjacents,95
Oncosperma_platyphyllum,0,0,0,NA,0
Oncosperma_tigillarium,13,3,10,Points-PointsKO-Adjacents,70
Oncostemum_acuminatum,8,0,8,Points-PointsKO-Adjacents,70
Oncostemum_andreanae,2,2,0,Points-PointsKO-Adjacents,12
Oncostemum_ankifiense,31,18,13,Points-PointsKO-Adjacents,195
Oncostemum_arboreum,8,2,6,Points-PointsKO-Adjacents,65
Oncostemum_arthriticum,1,1,0,Points-PointsKO-Adjacents,9
Oncostemum_botryoides,101,77,24,Alphahull-PointsKO-Adjacents,1924
Oncostemum_capitatum,0,0,0,NA,0
Oncostemum_cauliflorum,8,2,6,Points-PointsKO-Adjacents,53
Oncostemum_commersonianum,2,2,0,Points-PointsKO-Adjacents,18
Oncostemum_divaricatum,1,1,0,Points-PointsKO-Adjacents,9
Oncostemum_evonymoides,23,19,4,Points-PointsKO-Adjacents,56
Oncostemum_fusco-pilosum,8,1,7,Points-PointsKO-Adjacents,68
Oncostemum_humbertianum,2,2,0,Points-PointsKO-Adjacents,18
Oncostemum_laurifolium,18,5,13,Points-PointsKO-Adjacents,123
Oncostemum_leprosum,69,49,20,Alphahull-PointsKO-Adjacents,1049
Oncostemum_lichenophilum,3,3,0,Points-PointsKO-Adjacents,27
Oncostemum_macranthum,3,3,0,Points-PointsKO-Adjacents,21
Oncostemum_macrophyllum,7,0,7,Points-PointsKO-Adjacents,41
Oncostemum_macrostachyum,4,4,0,Points-PointsKO-Adjacents,34
Oncostemum_matitanense,2,2,0,Points-PointsKO-Adjacents,18
Oncostemum_meeusianum,0,0,0,NA,0
Oncostemum_neriifolium,14,4,10,Points-PointsKO-Adjacents,78
Oncostemum_nervosum,9,2,7,Points-PointsKO-Adjacents,72
Oncostemum_nitidulum,15,13,2,Points-PointsKO-Adjacents,31
Oncostemum_oliganthum,8,3,5,Points-PointsKO-Adjacents,15
Oncostemum_ovatoacuminatum,16,5,11,Points-PointsKO-Adjacents,103
Oncostemum_reflexum,9,0,9,Points-PointsKO-Adjacents,76
Oncostemum_subcuspidatum,18,3,15,Points-PointsKO-Adjacents,89
Oncostemum_terniflorum,4,4,0,Points-PointsKO-Adjacents,36
Oncostemum_umbellatum,21,6,15,Points-PointsKO-Adjacents,137
Oncostemum_vaccinifolium,0,0,0,NA,0
Oncostemum_venulosum,33,25,8,Alphahull-PointsKO-Adjacents,96
Oncotheca_humboldtiana,25,14,11,Points-PointsKO-Adjacents,88
Ongokea_gore,163,113,50,Alphahull-PointsKO-Adjacents,7884
Onychopetalum_amazonicum,89,46,43,Alphahull-PointsKO-Adjacents,3541
Onychopetalum_periquino,144,102,42,Alphahull-PointsKO-Adjacents,7038
Oocephalus_piranii,3,3,0,Points-PointsKO-Adjacents,24
Oparanthus_hivoanus,2,2,0,Points-PointsKO-Adjacents,8
Operculicarya_borealis,7,2,5,Points-PointsKO-Adjacents,39
Operculicarya_decaryi,48,0,48,Points-PointsKO-Adjacents,262
Operculicarya_gummifera,64,37,27,Alphahull-PointsKO-Adjacents,1908
Operculicarya_hirsutissima,6,2,4,Points-PointsKO-Adjacents,52
Operculicarya_hyphaenoides,8,3,5,Points-PointsKO-Adjacents,32
Ophellantha_spinosa,16,0,16,Points-PointsKO-Adjacents,104
Ophellantha_steyermarkii,2,2,0,Points-PointsKO-Adjacents,18
Ophiobotrys_zenkeri,39,18,21,Points-PointsKO-Adjacents,305
Ophiocaryon_barnebyanum,5,5,0,Points-PointsKO-Adjacents,45
Ophiocaryon_chironectes,4,4,0,Points-PointsKO-Adjacents,32
Ophiocaryon_duckei,5,5,0,Points-PointsKO-Adjacents,45
Ophiocaryon_heterophyllum,157,120,37,Alphahull-PointsKO-Adjacents,4192
Ophiocaryon_klugii,73,60,13,Alphahull-PointsKO-Adjacents,4387
Ophiocaryon_manausense,92,54,38,Alphahull-PointsKO-Adjacents,4031
Ophiocaryon_paradoxum,3,3,0,Points-PointsKO-Adjacents,27
Ophiocolea_ambrensis,3,3,0,Points-PointsKO-Adjacents,15
Ophiocolea_comorensis,5,5,0,Points-PointsKO-Adjacents,32
Ophiocolea_darainensis,6,1,5,Points-PointsKO-Adjacents,25
Ophiocolea_delphinensis,26,18,8,Points-PointsKO-Adjacents,58
Ophiocolea_floribunda,108,80,28,Alphahull-PointsKO-Adjacents,1242
Ophiocolea_pauciflora,5,5,0,Points-PointsKO-Adjacents,9
Ophiocolea_ratovosonii,4,4,0,Points-PointsKO-Adjacents,31
Ophiocolea_vokoaninensis,2,2,0,Points-PointsKO-Adjacents,16
Ophrypetalum_odoratum,52,39,13,Alphahull-PointsKO-Adjacents,731
Ophthalmoblapton_crassipes,16,0,16,Points-PointsKO-Adjacents,133
Ophthalmoblapton_macrophyllum,13,3,10,Points-PointsKO-Adjacents,105
Ophthalmoblapton_parviflorum,10,3,7,Points-PointsKO-Adjacents,86
Ophthalmoblapton_pedunculare,9,5,4,Points-PointsKO-Adjacents,50
Opilia_campestris,22,3,19,Points-PointsKO-Adjacents,194
Opuntia_aurea,47,44,3,Alphahull-PointsKO-Adjacents,261
Opuntia_basilaris,2,2,0,Points-PointsKO-Adjacents,18
Opuntia_echios,42,35,7,Alphahull-PointsKO-Adjacents,135
Opuntia_eichlamii,0,0,0,NA,0
Opuntia_ficus-indica,249,212,37,Alphahull-PointsKO-Adjacents,4906
Opuntia_galapageia,35,30,5,Alphahull-PointsKO-Adjacents,127
Opuntia_leucotricha,332,304,28,Alphahull-PointsKO-Adjacents,3847
Opuntia_macrocentra,161,126,35,Alphahull-PointsKO-Adjacents,6859
Opuntia_maxima,137,0,137,Points-PointsKO-Adjacents,469
Opuntia_megasperma,42,35,7,Alphahull-PointsKO-Adjacents,135
Opuntia_monacantha,220,0,220,Points-PointsKO-Adjacents,1128
Opuntia_oricola,103,62,41,Alphahull-PointsKO-Adjacents,339
Opuntia_pinkavae,19,15,4,Points-PointsKO-Adjacents,95
Opuntia_quimilo,24,11,13,Points-PointsKO-Adjacents,197
Opuntia_santarita,132,96,36,Alphahull-PointsKO-Adjacents,600
Opuntia_saxicola,42,35,7,Alphahull-PointsKO-Adjacents,135
Opuntia_soederstromiana,55,38,17,Alphahull-PointsKO-Adjacents,154
Opuntia_streptacantha,397,362,35,Alphahull-PointsKO-Adjacents,3280
Opuntia_tomentosa,531,453,78,Alphahull-PointsKO-Adjacents,6033
Opuntia_velutina,257,227,30,Alphahull-PointsKO-Adjacents,3057
Opuntia_wilcoxii,64,43,21,Alphahull-PointsKO-Adjacents,1487
Orania_archboldiana,7,1,6,Points-PointsKO-Adjacents,57
Orania_decipiens,0,0,0,NA,0
Orania_disticha,7,1,6,Points-PointsKO-Adjacents,30
Orania_gagavu,1,1,0,Points-PointsKO-Adjacents,9
Orania_glauca,2,2,0,Points-PointsKO-Adjacents,12
Orania_lauterbachiana,12,2,10,Points-PointsKO-Adjacents,102
Orania_longisquama,21,7,14,Points-PointsKO-Adjacents,131
Orania_macropetala,3,3,0,Points-PointsKO-Adjacents,21
Orania_oreophila,NA,NA,NA,NA,NA
Orania_palindan,8,0,8,Points-PointsKO-Adjacents,67
Orania_paraguanensis,2,2,0,Points-PointsKO-Adjacents,18
Orania_parva,0,0,0,NA,0
Orania_ravaka,12,6,6,Points-PointsKO-Adjacents,70
Orania_regalis,5,5,0,Points-PointsKO-Adjacents,40
Orania_sylvicola,0,0,0,NA,0
Orania_trispatha,16,7,9,Points-PointsKO-Adjacents,83
Oraniopsis_appendiculata,34,25,9,Alphahull-PointsKO-Adjacents,90
Oreocallis_grandiflora,238,208,30,Alphahull-PointsKO-Adjacents,2574
Oreocnide_frutescens,171,93,78,Alphahull-PointsKO-Adjacents,17851
Oreocnide_integrifolia,31,0,31,Points-PointsKO-Adjacents,269
Oreocnide_pedunculata,376,323,53,Alphahull-PointsKO-Adjacents,523
Oreocnide_rubescens,105,41,64,Alphahull-PointsKO-Adjacents,2212
Oreocnide_trinervis,21,0,21,Points-PointsKO-Adjacents,137
Oreomunnea_mexicana,113,78,35,Alphahull-PointsKO-Adjacents,636
Oreomunnea_munchiquensis,4,4,0,Points-PointsKO-Adjacents,26
Oreomunnea_pterocarpa,26,16,10,Points-PointsKO-Adjacents,101
Oreopanax_acerifolius,12,4,8,Points-PointsKO-Adjacents,94
Oreopanax_albanensis,18,8,10,Points-PointsKO-Adjacents,126
Oreopanax_allocophyllus,5,5,0,Points-PointsKO-Adjacents,45
Oreopanax_anchicayanus,10,2,8,Points-PointsKO-Adjacents,72
Oreopanax_andreanus,43,34,9,Alphahull-PointsKO-Adjacents,241
Oreopanax_angularis,0,0,0,NA,0
Oreopanax_anomalus,6,2,4,Points-PointsKO-Adjacents,32
Oreopanax_apurimacensis,4,4,0,Points-PointsKO-Adjacents,36
Oreopanax_aquifolius,1,1,0,Points-PointsKO-Adjacents,9
Oreopanax_arcanus,26,18,8,Points-PointsKO-Adjacents,120
Oreopanax_argentatus,25,7,18,Points-PointsKO-Adjacents,190
Oreopanax_artocarpoides,5,5,0,Points-PointsKO-Adjacents,45
Oreopanax_atopanthus,16,5,11,Points-PointsKO-Adjacents,126
Oreopanax_avicenniifolius,37,31,6,Alphahull-PointsKO-Adjacents,268
Oreopanax_bogotensis,116,95,21,Alphahull-PointsKO-Adjacents,1356
Oreopanax_boliviensis,21,9,12,Points-PointsKO-Adjacents,103
Oreopanax_brachystachyus,1,1,0,Points-PointsKO-Adjacents,9
Oreopanax_brunneus,4,4,0,Points-PointsKO-Adjacents,36
Oreopanax_bullosus,1,1,0,Points-PointsKO-Adjacents,9
Oreopanax_candamoanus,4,4,0,Points-PointsKO-Adjacents,36
Oreopanax_capitatus,1467,1222,245,Alphahull-PointsKO-Adjacents,23443
Oreopanax_catalpifolius,9,2,7,Points-PointsKO-Adjacents,81
Oreopanax_cecropifolius,16,7,9,Points-PointsKO-Adjacents,123
Oreopanax_cheirophyllus,1,1,0,Points-PointsKO-Adjacents,9
Oreopanax_cissoides,NA,NA,NA,NA,NA
Oreopanax_compactus,5,5,0,Points-PointsKO-Adjacents,34
Oreopanax_confusus,101,87,14,Alphahull-PointsKO-Adjacents,1042
Oreopanax_corazonensis,8,2,6,Points-PointsKO-Adjacents,51
Oreopanax_coriaceus,0,0,0,NA,0
Oreopanax_costaricensis,42,26,16,Alphahull-PointsKO-Adjacents,156
Oreopanax_crassinervius,1,1,0,Points-PointsKO-Adjacents,9
Oreopanax_crataegodorus,1,1,0,Points-PointsKO-Adjacents,9
Oreopanax_cumanensis,0,0,0,NA,0
Oreopanax_cuspidatus,2,2,0,Points-PointsKO-Adjacents,18
Oreopanax_cyclophyllus,1,1,0,Points-PointsKO-Adjacents,9
Oreopanax_deinocephalus,NA,NA,NA,NA,NA
Oreopanax_discolor,81,62,19,Alphahull-PointsKO-Adjacents,1216
Oreopanax_divulsus,2,2,0,Points-PointsKO-Adjacents,18
Oreopanax_donnell-smithii,38,30,8,Alphahull-PointsKO-Adjacents,135
Oreopanax_duquei,0,0,0,NA,0
Oreopanax_dussii,1,1,0,Points-PointsKO-Adjacents,9
Oreopanax_echinops,183,133,50,Alphahull-PointsKO-Adjacents,2726
Oreopanax_ecuadoriensis,18,10,8,Points-PointsKO-Adjacents,131
Oreopanax_ellsworthii,18,10,8,Points-PointsKO-Adjacents,131
Oreopanax_epificus,0,0,0,NA,0
Oreopanax_epremesnilianus,0,0,0,NA,0
Oreopanax_eriocephalus,27,14,13,Points-PointsKO-Adjacents,185
Oreopanax_farallonensis,0,0,0,NA,0
Oreopanax_flaccidus,37,27,10,Alphahull-PointsKO-Adjacents,136
Oreopanax_fontqueranus,3,3,0,Points-PointsKO-Adjacents,27
Oreopanax_fulvus,196,167,29,Alphahull-PointsKO-Adjacents,2988
Oreopanax_gargantae,3,3,0,Points-PointsKO-Adjacents,21
Oreopanax_geminatus,49,27,22,Alphahull-PointsKO-Adjacents,1430
Oreopanax_glabrifolius,40,28,12,Alphahull-PointsKO-Adjacents,528
Oreopanax_gnaphalocephalus,0,0,0,NA,0
Oreopanax_grandifolius,11,5,6,Points-PointsKO-Adjacents,51
Oreopanax_guatemalensis,245,219,26,Alphahull-PointsKO-Adjacents,1875
Oreopanax_hederaceus,3,3,0,Points-PointsKO-Adjacents,27
Oreopanax_hedraeostrobilus,10,3,7,Points-PointsKO-Adjacents,78
Oreopanax_herzogii,2,2,0,Points-PointsKO-Adjacents,18
Oreopanax_humboldtianus,NA,NA,NA,NA,NA
Oreopanax_hypargyreus,1,1,0,Points-PointsKO-Adjacents,9
Oreopanax_ilicifolius,3,3,0,Points-PointsKO-Adjacents,27
Oreopanax_impolitus,5,5,0,Points-PointsKO-Adjacents,30
Oreopanax_incisus,243,208,35,Alphahull-PointsKO-Adjacents,2030
Oreopanax_integrifolius,3,3,0,Points-PointsKO-Adjacents,27
Oreopanax_iodophyllus,5,5,0,Points-PointsKO-Adjacents,45
Oreopanax_ischnolobus,1,1,0,Points-PointsKO-Adjacents,9
Oreopanax_jaliscana,86,54,32,Alphahull-PointsKO-Adjacents,1003
Oreopanax_jatrophifolius,0,0,0,NA,0
Oreopanax_jelskii,1,1,0,Points-PointsKO-Adjacents,9
Oreopanax_killipii,1,1,0,Points-PointsKO-Adjacents,9
Oreopanax_klugii,3,3,0,Points-PointsKO-Adjacents,23
Oreopanax_kuntzei,35,11,24,Points-PointsKO-Adjacents,226
Oreopanax_lawrancei,1,1,0,Points-PointsKO-Adjacents,9
Oreopanax_lechleri,0,0,0,NA,0
Oreopanax_lehmannii,1,1,0,Points-PointsKO-Adjacents,9
Oreopanax_lempirianus,NA,NA,NA,NA,NA
Oreopanax_lindenii,1,1,0,Points-PointsKO-Adjacents,9
Oreopanax_macleanii,0,0,0,NA,0
Oreopanax_macrocephalus,19,10,9,Points-PointsKO-Adjacents,121
Oreopanax_mathewsii,1,1,0,Points-PointsKO-Adjacents,9
Oreopanax_membranaceus,49,33,16,Alphahull-PointsKO-Adjacents,267
Oreopanax_microflorus,20,11,9,Points-PointsKO-Adjacents,153
Oreopanax_mutisianus,63,55,8,Alphahull-PointsKO-Adjacents,183
Oreopanax_nicaraguensis,25,19,6,Points-PointsKO-Adjacents,95
Oreopanax_niger,1,1,0,Points-PointsKO-Adjacents,9
Oreopanax_nubigenus,34,27,7,Alphahull-PointsKO-Adjacents,65
Oreopanax_obscurus,11,8,3,Points-PointsKO-Adjacents,47
Oreopanax_obtusilobus,10,2,8,Points-PointsKO-Adjacents,81
Oreopanax_oerstedianus,112,97,15,Alphahull-PointsKO-Adjacents,231
Oreopanax_oroyanus,20,7,13,Points-PointsKO-Adjacents,165
Oreopanax_palamophyllus,43,27,16,Alphahull-PointsKO-Adjacents,381
Oreopanax_pallidus,28,19,9,Points-PointsKO-Adjacents,147
Oreopanax_paramicola,23,17,6,Points-PointsKO-Adjacents,67
Oreopanax_pariahuancae,1,1,0,Points-PointsKO-Adjacents,9
Oreopanax_parviflorus,23,11,12,Points-PointsKO-Adjacents,159
Oreopanax_pavonii,8,0,8,Points-PointsKO-Adjacents,68
Oreopanax_peltatus,241,198,43,Alphahull-PointsKO-Adjacents,2916
Oreopanax_pentlandianus,5,5,0,Points-PointsKO-Adjacents,41
Oreopanax_pes-ursi,1,1,0,Points-PointsKO-Adjacents,9
Oreopanax_platanifolius,1,1,0,Points-PointsKO-Adjacents,9
Oreopanax_platyphyllus,11,3,8,Points-PointsKO-Adjacents,62
Oreopanax_polycephalus,8,5,3,Points-PointsKO-Adjacents,42
Oreopanax_pycnocarpus,53,45,8,Alphahull-PointsKO-Adjacents,123
Oreopanax_raimondii,2,2,0,Points-PointsKO-Adjacents,18
Oreopanax_ramosissimus,1,0,1,Points-PointsKO-Adjacents,8
Oreopanax_reticulatus,15,3,12,Points-PointsKO-Adjacents,106
Oreopanax_robustus,8,0,8,Points-PointsKO-Adjacents,58
Oreopanax_rosei,14,7,7,Points-PointsKO-Adjacents,79
Oreopanax_ruizanus,20,14,6,Points-PointsKO-Adjacents,71
Oreopanax_ruizii,11,2,9,Points-PointsKO-Adjacents,90
Oreopanax_rusbyi,24,14,10,Points-PointsKO-Adjacents,129
Oreopanax_sanderianus,120,92,28,Alphahull-PointsKO-Adjacents,886
Oreopanax_sandianus,0,0,0,NA,0
Oreopanax_santanderianus,2,2,0,Points-PointsKO-Adjacents,18
Oreopanax_schultzei,2,2,0,Points-PointsKO-Adjacents,18
Oreopanax_sectifolius,12,6,6,Points-PointsKO-Adjacents,89
Oreopanax_seemannianus,129,104,25,Alphahull-PointsKO-Adjacents,671
Oreopanax_sessiliflorus,52,41,11,Alphahull-PointsKO-Adjacents,209
Oreopanax_simplicifolius,NA,NA,NA,NA,NA
Oreopanax_spathulatus,4,4,0,Points-PointsKO-Adjacents,12
Oreopanax_standleyi,41,30,11,Alphahull-PointsKO-Adjacents,119
Oreopanax_steinbachianus,60,43,17,Alphahull-PointsKO-Adjacents,488
Oreopanax_stenodactylus,0,0,0,NA,0
Oreopanax_stenophyllus,9,2,7,Points-PointsKO-Adjacents,81
Oreopanax_steyermarkii,4,4,0,Points-PointsKO-Adjacents,36
Oreopanax_sucrensis,1,1,0,Points-PointsKO-Adjacents,9
Oreopanax_superoerstedianus,20,14,6,Points-PointsKO-Adjacents,66
Oreopanax_thaumasiophyllus,8,6,2,Points-PointsKO-Adjacents,30
Oreopanax_tolimanus,15,11,4,Points-PointsKO-Adjacents,88
Oreopanax_trianae,8,1,7,Points-PointsKO-Adjacents,64
Oreopanax_trifidus,9,4,5,Points-PointsKO-Adjacents,41
Oreopanax_trollii,47,32,15,Alphahull-PointsKO-Adjacents,291
Oreopanax_turbacensis,2,2,0,Points-PointsKO-Adjacents,18
Oreopanax_urubambanus,NA,NA,NA,NA,NA
Oreopanax_velutinus,1,1,0,Points-PointsKO-Adjacents,9
Oreopanax_venezuelensis,0,0,0,NA,0
Oreopanax_vestitus,66,47,19,Alphahull-PointsKO-Adjacents,203
Oreopanax_weberbaueri,2,2,0,Points-PointsKO-Adjacents,18
Oreopanax_williamsii,3,3,0,Points-PointsKO-Adjacents,27
Oreopanax_xalapensis,930,857,73,Alphahull-PointsKO-Adjacents,6422
Orfilea_coriacea,45,34,11,Alphahull-PointsKO-Adjacents,309
Orfilea_multispicata,22,15,7,Points-PointsKO-Adjacents,89
Orfilea_neraudiana,0,0,0,NA,0
Oricia_swynnertonii,6,0,6,Points-PointsKO-Adjacents,45
Orixa_japonica,406,275,131,Alphahull-PointsKO-Adjacents,2764
Ormocarpopsis_aspera,72,47,25,Alphahull-PointsKO-Adjacents,2849
Ormocarpopsis_calcicola,8,1,7,Points-PointsKO-Adjacents,59
Ormocarpopsis_itremoensis,4,4,0,Points-PointsKO-Adjacents,30
Ormocarpopsis_mandrarensis,16,0,16,Points-PointsKO-Adjacents,55
Ormocarpopsis_parvifolia,17,12,5,Points-PointsKO-Adjacents,102
Ormocarpopsis_tulearensis,16,9,7,Points-PointsKO-Adjacents,76
Ormocarpum_cochinchinense,60,25,35,Alphahull-PointsKO-Adjacents,796
Ormocarpum_dhofarense,14,8,6,Points-PointsKO-Adjacents,50
Ormocarpum_kirkii,77,41,36,Alphahull-PointsKO-Adjacents,4685
Ormocarpum_pubescens,7,0,7,Points-PointsKO-Adjacents,61
Ormocarpum_schliebenii,9,2,7,Points-PointsKO-Adjacents,70
Ormocarpum_sennoides,766,679,87,Alphahull-PointsKO-Adjacents,16278
Ormocarpum_suberosum,NA,NA,NA,NA,NA
Ormocarpum_trachycarpum,13,4,9,Points-PointsKO-Adjacents,87
Ormocarpum_trichocarpum,142,105,37,Alphahull-PointsKO-Adjacents,5553
Ormocarpum_verrucosum,48,16,32,Points-PointsKO-Adjacents,272
Ormosia_amazonica,134,67,67,Alphahull-PointsKO-Adjacents,7054
Ormosia_antioquensis,17,12,5,Points-PointsKO-Adjacents,113
Ormosia_apiculata,1,1,0,Points-PointsKO-Adjacents,9
Ormosia_arborea,601,0,601,Points-PointsKO-Adjacents,3633
Ormosia_assamica,NA,NA,NA,NA,NA
Ormosia_bahiensis,40,21,19,Alphahull-PointsKO-Adjacents,803
Ormosia_balansae,7,0,7,Points-PointsKO-Adjacents,54
Ormosia_bancana,6,1,5,Points-PointsKO-Adjacents,37
Ormosia_bolivarensis,29,9,20,Points-PointsKO-Adjacents,236
Ormosia_boluoensis,NA,NA,NA,NA,NA
Ormosia_bopiensis,26,13,13,Points-PointsKO-Adjacents,160
Ormosia_calavensis,9,0,9,Points-PointsKO-Adjacents,69
Ormosia_cambodiana,0,0,0,NA,0
Ormosia_chevalieri,1,1,0,Points-PointsKO-Adjacents,9
Ormosia_coarctata,148,80,68,Alphahull-PointsKO-Adjacents,7385
Ormosia_coccinea,419,308,111,Alphahull-PointsKO-Adjacents,45452
Ormosia_colombiana,34,25,9,Alphahull-PointsKO-Adjacents,708
Ormosia_costulata,52,36,16,Alphahull-PointsKO-Adjacents,1041
Ormosia_coutinhoi,95,0,95,Points-PointsKO-Adjacents,692
Ormosia_crassivalvis,2,2,0,Points-PointsKO-Adjacents,12
Ormosia_cruenta,9,2,7,Points-PointsKO-Adjacents,64
Ormosia_cuatrecasasii,8,3,5,Points-PointsKO-Adjacents,49
Ormosia_discolor,56,27,29,Alphahull-PointsKO-Adjacents,1244
Ormosia_elata,18,0,18,Points-PointsKO-Adjacents,161
Ormosia_elliptica,2,2,0,Points-PointsKO-Adjacents,18
Ormosia_emarginata,3,3,0,Points-PointsKO-Adjacents,27
Ormosia_eugeniifolia,NA,NA,NA,NA,NA
Ormosia_excelsa,139,88,51,Alphahull-PointsKO-Adjacents,7732
Ormosia_fastigiata,281,233,48,Alphahull-PointsKO-Adjacents,20102
Ormosia_ferruginea,1,1,0,Points-PointsKO-Adjacents,9
Ormosia_flava,114,60,54,Alphahull-PointsKO-Adjacents,12117
Ormosia_formosana,16,14,2,Points-PointsKO-Adjacents,63
Ormosia_friburgensis,25,15,10,Points-PointsKO-Adjacents,158
Ormosia_froesii,1,1,0,Points-PointsKO-Adjacents,9
Ormosia_glaberrima,13,6,7,Points-PointsKO-Adjacents,117
Ormosia_glauca,1,1,0,Points-PointsKO-Adjacents,9
Ormosia_gracilis,0,0,0,NA,0
Ormosia_grandiflora,62,15,47,Points-PointsKO-Adjacents,509
Ormosia_grandistipulata,0,0,0,NA,0
Ormosia_grossa,44,0,44,Points-PointsKO-Adjacents,303
Ormosia_hekouensis,1,1,0,Points-PointsKO-Adjacents,9
Ormosia_hengchuniana,14,9,5,Points-PointsKO-Adjacents,41
Ormosia_henryi,52,28,24,Alphahull-PointsKO-Adjacents,5292
Ormosia_hoaensis,2,2,0,Points-PointsKO-Adjacents,18
Ormosia_holerythra,20,6,14,Points-PointsKO-Adjacents,168
Ormosia_hosiei,16,3,13,Points-PointsKO-Adjacents,143
Ormosia_howii,2,2,0,Points-PointsKO-Adjacents,18
Ormosia_indurata,2,2,0,Points-PointsKO-Adjacents,18
Ormosia_inflata,1,1,0,Points-PointsKO-Adjacents,9
Ormosia_intermedia,8,5,3,Points-PointsKO-Adjacents,45
Ormosia_isthmensis,60,34,26,Alphahull-PointsKO-Adjacents,669
Ormosia_jamaicensis,0,0,0,NA,0
Ormosia_kerrii,0,0,0,NA,0
Ormosia_krugii,56,37,19,Alphahull-PointsKO-Adjacents,275
Ormosia_laosensis,2,2,0,Points-PointsKO-Adjacents,14
Ormosia_larecajana,7,3,4,Points-PointsKO-Adjacents,63
Ormosia_lignivalvis,47,16,31,Points-PointsKO-Adjacents,355
Ormosia_longipes,3,2,1,Points-PointsKO-Adjacents,27
Ormosia_macrocalyx,252,169,83,Alphahull-PointsKO-Adjacents,17197
Ormosia_macrodisca,13,0,13,Points-PointsKO-Adjacents,115
Ormosia_macrophylla,109,76,33,Alphahull-PointsKO-Adjacents,3790
Ormosia_maguireorum,1,1,0,Points-PointsKO-Adjacents,9
Ormosia_melanocarpa,7,0,7,Points-PointsKO-Adjacents,45
Ormosia_merrilliana,5,5,0,Points-PointsKO-Adjacents,45
Ormosia_microphylla,5,5,0,Points-PointsKO-Adjacents,45
Ormosia_minor,25,0,25,Points-PointsKO-Adjacents,201
Ormosia_monosperma,38,21,17,Alphahull-PointsKO-Adjacents,143
Ormosia_nanningensis,2,2,0,Points-PointsKO-Adjacents,18
Ormosia_napoensis,1,1,0,Points-PointsKO-Adjacents,9
Ormosia_nitida,37,19,18,Points-PointsKO-Adjacents,279
Ormosia_nobilis,148,76,72,Alphahull-PointsKO-Adjacents,15402
Ormosia_nuda,4,4,0,Points-PointsKO-Adjacents,36
Ormosia_oaxacana,8,2,6,Points-PointsKO-Adjacents,54
Ormosia_olivacea,5,5,0,Points-PointsKO-Adjacents,45
Ormosia_ormondii,80,59,21,Alphahull-PointsKO-Adjacents,166
Ormosia_pachycarpa,2,2,0,Points-PointsKO-Adjacents,18
Ormosia_pachyptera,1,1,0,Points-PointsKO-Adjacents,9
Ormosia_paniculata,1,1,0,Points-PointsKO-Adjacents,9
Ormosia_paraensis,164,99,65,Alphahull-PointsKO-Adjacents,25208
Ormosia_penangensis,1,0,1,Points-PointsKO-Adjacents,9
Ormosia_peruviana,5,5,0,Points-PointsKO-Adjacents,45
Ormosia_pingbianensis,1,1,0,Points-PointsKO-Adjacents,9
Ormosia_pinnata,12,1,11,Points-PointsKO-Adjacents,99
Ormosia_poilanei,0,0,0,NA,0
Ormosia_polita,NA,NA,NA,NA,NA
Ormosia_pubescens,NA,NA,NA,NA,NA
Ormosia_purpureiflora,2,2,0,Points-PointsKO-Adjacents,18
Ormosia_revoluta,4,4,0,Points-PointsKO-Adjacents,34
Ormosia_robusta,0,0,0,NA,0
Ormosia_ruddiana,3,3,0,Points-PointsKO-Adjacents,21
Ormosia_saxatilis,NA,NA,NA,NA,NA
Ormosia_schippii,24,16,8,Points-PointsKO-Adjacents,175
Ormosia_schunkei,7,3,4,Points-PointsKO-Adjacents,57
Ormosia_semicastrata,43,30,13,Alphahull-PointsKO-Adjacents,2310
Ormosia_sericeolucida,3,3,0,Points-PointsKO-Adjacents,27
Ormosia_simplicifolia,1,1,0,Points-PointsKO-Adjacents,9
Ormosia_smithii,67,42,25,Alphahull-PointsKO-Adjacents,1947
Ormosia_solimoesensis,5,5,0,Points-PointsKO-Adjacents,45
Ormosia_steyermarkii,7,0,7,Points-PointsKO-Adjacents,61
Ormosia_stipulacea,2,2,0,Points-PointsKO-Adjacents,18
Ormosia_stipularis,44,8,36,Points-PointsKO-Adjacents,355
Ormosia_striata,0,0,0,NA,0
Ormosia_subsessilis,3,3,0,Points-PointsKO-Adjacents,24
Ormosia_sumatrana,8,1,7,Points-PointsKO-Adjacents,68
Ormosia_surigaensis,0,0,0,NA,0
Ormosia_tavoyana,NA,NA,NA,NA,NA
Ormosia_tonkinensis,0,0,0,NA,0
Ormosia_tovarensis,36,22,14,Alphahull-PointsKO-Adjacents,611
Ormosia_travancorica,0,0,0,NA,0
Ormosia_tsangii,0,0,0,NA,0
Ormosia_velutina,35,18,17,Points-PointsKO-Adjacents,225
Ormosia_venezolana,5,5,0,Points-PointsKO-Adjacents,39
Ormosia_venosa,1,1,0,Points-PointsKO-Adjacents,9
Ormosia_vicosana,17,6,11,Points-PointsKO-Adjacents,125
Ormosia_williamsii,21,0,21,Points-PointsKO-Adjacents,164
Ormosia_xylocarpa,49,33,16,Alphahull-PointsKO-Adjacents,2986
Ormosia_yunnanensis,4,4,0,Points-PointsKO-Adjacents,36
Orophea_acuminata,0,0,0,NA,0
Orophea_alba,2,2,0,Points-PointsKO-Adjacents,18
Orophea_brandisii,3,3,0,Points-PointsKO-Adjacents,24
Orophea_celebica,11,2,9,Points-PointsKO-Adjacents,78
Orophea_chrysantha,0,0,0,NA,0
Orophea_clemensiana,1,1,0,Points-PointsKO-Adjacents,9
Orophea_corymbosa,5,0,5,Points-PointsKO-Adjacents,45
Orophea_creaghii,30,10,20,Points-PointsKO-Adjacents,231
Orophea_cumingiana,14,1,13,Points-PointsKO-Adjacents,118
Orophea_cuneiformis,14,2,12,Points-PointsKO-Adjacents,113
Orophea_dodecandra,3,3,0,Points-PointsKO-Adjacents,27
Orophea_enneandra,5,0,5,Points-PointsKO-Adjacents,45
Orophea_enterocarpa,21,8,13,Points-PointsKO-Adjacents,166
Orophea_erythrocarpa,1,0,1,Points-PointsKO-Adjacents,9
Orophea_flagellaris,1,1,0,Points-PointsKO-Adjacents,9
Orophea_hainanensis,4,4,0,Points-PointsKO-Adjacents,27
Orophea_hastata,9,2,7,Points-PointsKO-Adjacents,75
Orophea_hexandra,1,1,0,Points-PointsKO-Adjacents,9
Orophea_hirsuta,3,3,0,Points-PointsKO-Adjacents,27
Orophea_katschallica,0,0,0,NA,0
Orophea_kerrii,6,0,6,Points-PointsKO-Adjacents,48
Orophea_kingiana,3,3,0,Points-PointsKO-Adjacents,25
Orophea_kostermansiana,0,0,0,NA,0
Orophea_laui,2,2,0,Points-PointsKO-Adjacents,12
Orophea_maculata,4,4,0,Points-PointsKO-Adjacents,36
Orophea_merrillii,3,3,0,Points-PointsKO-Adjacents,27
Orophea_myriantha,4,4,0,Points-PointsKO-Adjacents,30
Orophea_polycarpa,23,5,18,Points-PointsKO-Adjacents,201
Orophea_rubra,1,1,0,Points-PointsKO-Adjacents,9
Orophea_sarawakensis,0,0,0,NA,0
Orophea_thomsonii,1,1,0,Points-PointsKO-Adjacents,9
Orophea_trigyna,6,0,6,Points-PointsKO-Adjacents,54
Orophea_uniflora,0,0,0,NA,0
Orophea_zeylanica,0,0,0,NA,0
Oroxylum_indicum,58,16,42,Points-PointsKO-Adjacents,502
Orphanodendron_bernalii,14,9,5,Points-PointsKO-Adjacents,55
Orthion_guatemalense,9,0,9,Points-PointsKO-Adjacents,78
Orthion_oblanceolatum,33,18,15,Points-PointsKO-Adjacents,118
Orthion_subsessile,103,88,15,Alphahull-PointsKO-Adjacents,1227
Orthopterygium_huaucui,9,4,5,Points-PointsKO-Adjacents,60
Orthosiphon_adenocaulis,9,3,6,Points-PointsKO-Adjacents,71
Osa_pulchra,9,7,2,Points-PointsKO-Adjacents,32
Osbornia_octodonta,257,155,102,Alphahull-PointsKO-Adjacents,2447
Osmanthus_armatus,16,7,9,Points-PointsKO-Adjacents,144
Osmanthus_attenuatus,4,4,0,Points-PointsKO-Adjacents,36
Osmanthus_austrocaledonicus,184,165,19,Alphahull-PointsKO-Adjacents,246
Osmanthus_cooperi,15,5,10,Points-PointsKO-Adjacents,135
Osmanthus_cymosus,9,2,7,Points-PointsKO-Adjacents,36
Osmanthus_didymopetalus,5,0,5,Points-PointsKO-Adjacents,36
Osmanthus_fragrans,124,80,44,Alphahull-PointsKO-Adjacents,11870
Osmanthus_gracilinervis,8,1,7,Points-PointsKO-Adjacents,72
Osmanthus_hainanensis,4,3,1,Points-PointsKO-Adjacents,36
Osmanthus_henryi,9,2,7,Points-PointsKO-Adjacents,81
Osmanthus_heterophyllus,331,187,144,Alphahull-PointsKO-Adjacents,1044
Osmanthus_insularis,5,4,1,Points-PointsKO-Adjacents,11
Osmanthus_kaoi,15,8,7,Points-PointsKO-Adjacents,83
Osmanthus_lanceolatus,57,47,10,Alphahull-PointsKO-Adjacents,187
Osmanthus_marginatus,150,109,41,Alphahull-PointsKO-Adjacents,3576
Osmanthus_matsumuranus,234,187,47,Alphahull-PointsKO-Adjacents,8507
Osmanthus_minor,10,4,6,Points-PointsKO-Adjacents,90
Osmanthus_monticola,28,18,10,Points-PointsKO-Adjacents,71
Osmanthus_reticulatus,15,7,8,Points-PointsKO-Adjacents,135
Osmanthus_rigidus,0,0,0,NA,0
Osmanthus_scortechinii,1,1,0,Points-PointsKO-Adjacents,9
Osmanthus_serrulatus,6,1,5,Points-PointsKO-Adjacents,54
Osmanthus_suavis,3,3,0,Points-PointsKO-Adjacents,27
Osmanthus_venosus,4,4,0,Points-PointsKO-Adjacents,36
Osmanthus_yunnanensis,68,46,22,Alphahull-PointsKO-Adjacents,2878
Stachycrater_philippinus,64,19,45,Points-PointsKO-Adjacents,485
Osmoxylon_arrhenicum,0,0,0,NA,0
Osmoxylon_articulatum,2,2,0,Points-PointsKO-Adjacents,18
Osmoxylon_barbatum,NA,NA,NA,NA,NA
Osmoxylon_boerlagei,22,0,22,Points-PointsKO-Adjacents,120
Osmoxylon_celebicum,1,1,0,Points-PointsKO-Adjacents,9
Osmoxylon_chrysanthum,0,0,0,NA,0
Osmoxylon_confertiflorum,0,0,0,NA,0
Osmoxylon_corneri,NA,NA,NA,NA,NA
Osmoxylon_ellipsoideum,1,1,0,Points-PointsKO-Adjacents,6
Osmoxylon_eminens,4,4,0,Points-PointsKO-Adjacents,34
Osmoxylon_globulare,1,1,0,Points-PointsKO-Adjacents,9
Osmoxylon_heterophyllum,1,1,0,Points-PointsKO-Adjacents,9
Osmoxylon_insidiator,14,5,9,Points-PointsKO-Adjacents,53
Osmoxylon_insigne,2,2,0,Points-PointsKO-Adjacents,15
Osmoxylon_kostermansii,0,0,0,NA,0
Osmoxylon_lanceolatum,2,2,0,Points-PointsKO-Adjacents,8
Osmoxylon_luzoniense,4,4,0,Points-PointsKO-Adjacents,34
Osmoxylon_mariannense,0,0,0,NA,0
Osmoxylon_masarangense,0,0,0,NA,0
Osmoxylon_micranthum,67,54,13,Alphahull-PointsKO-Adjacents,483
Osmoxylon_miquelii,1,1,0,Points-PointsKO-Adjacents,9
Osmoxylon_novoguineense,33,12,21,Points-PointsKO-Adjacents,191
Osmoxylon_orientale,6,0,6,Points-PointsKO-Adjacents,38
Osmoxylon_pachyphyllum,1,1,0,Points-PointsKO-Adjacents,6
Osmoxylon_palmatum,5,5,0,Points-PointsKO-Adjacents,30
Osmoxylon_pectinatum,11,0,11,Points-PointsKO-Adjacents,19
Osmoxylon_pfeilii,7,2,5,Points-PointsKO-Adjacents,41
Osmoxylon_pseudofoliatum,0,0,0,NA,0
Osmoxylon_pulcherrimum,5,5,0,Points-PointsKO-Adjacents,42
Osmoxylon_puniceopolleniferum,0,0,0,NA,0
Osmoxylon_ramosii,0,0,0,NA,0
Osmoxylon_reburrum,0,0,0,NA,0
Osmoxylon_rectibrachiatum,1,1,0,Points-PointsKO-Adjacents,8
Osmoxylon_serratifolium,0,0,0,NA,0
Osmoxylon_sessiliflorum,17,4,13,Points-PointsKO-Adjacents,87
Osmoxylon_simplicifolium,4,4,0,Points-PointsKO-Adjacents,35
Osmoxylon_soelaense,0,0,0,NA,0
Osmoxylon_spathipedunculatum,0,0,0,NA,0
Osmoxylon_striatifructum,0,0,0,NA,0
Osmoxylon_superantiflorum,0,0,0,NA,0
Osmoxylon_talaudense,0,0,0,NA,0
Osmoxylon_tetrandrum,0,0,0,NA,0
Osmoxylon_teysmannii,5,5,0,Points-PointsKO-Adjacents,37
Osmoxylon_trilobatum,1,1,0,Points-PointsKO-Adjacents,9
Osmoxylon_truncatum,3,3,0,Points-PointsKO-Adjacents,8
Osmoxylon_umbelliferum,NA,NA,NA,NA,NA
Osmoxylon_whitmorei,0,0,0,NA,0
Ossaea_angustifolia,148,99,49,Alphahull-PointsKO-Adjacents,2368
Ossaea_bracteata,119,93,26,Alphahull-PointsKO-Adjacents,891
Ossaea_cogniauxii,3,3,0,Points-PointsKO-Adjacents,18
Ossaea_cucullata,44,25,19,Alphahull-PointsKO-Adjacents,2505
Ossaea_krugiana,14,10,4,Points-PointsKO-Adjacents,44
Ossaea_laxivenula,144,111,33,Alphahull-PointsKO-Adjacents,1472
Ossaea_macrophylla,212,165,47,Alphahull-PointsKO-Adjacents,2665
Ossaea_mavacana,5,5,0,Points-PointsKO-Adjacents,36
Ossaea_spicata,67,41,26,Alphahull-PointsKO-Adjacents,670
Osteophloeum_platyspermum,685,603,82,Alphahull-PointsKO-Adjacents,49682
Ostodes_kuangii,0,0,0,NA,0
Ostodes_paniculata,44,0,44,Points-PointsKO-Adjacents,337
Ostrya_carpinifolia,568,447,121,Alphahull-PointsKO-Adjacents,11104
Ostrya_chisosensis,42,24,18,Alphahull-PointsKO-Adjacents,126
Ostrya_japonica,142,94,48,Alphahull-PointsKO-Adjacents,1665
Ostrya_knowltonii,57,42,15,Alphahull-PointsKO-Adjacents,684
Ostrya_rehderiana,1,1,0,Points-PointsKO-Adjacents,9
Ostrya_trichocarpa,1,1,0,Points-PointsKO-Adjacents,9
Ostrya_virginiana,14823,13843,980,Alphahull-PointsKO-Adjacents,72172
Ostrya_yunnanensis,1,1,0,Points-PointsKO-Adjacents,9
Ostryopsis_davidiana,26,4,22,Points-PointsKO-Adjacents,234
Ostryopsis_intermedia,NA,NA,NA,NA,NA
Ostryopsis_nobilis,15,8,7,Points-PointsKO-Adjacents,102
Colpoon_compressum,152,0,152,Points-PointsKO-Adjacents,815
Osyris_lanceolata,1036,783,253,Alphahull-PointsKO-Adjacents,3630
Otholobium_arborescens,19,9,10,Points-PointsKO-Adjacents,149
Otholobium_brachystachyum,28,16,12,Points-PointsKO-Adjacents,185
Otholobium_glandulosum,21,0,21,Points-PointsKO-Adjacents,181
Otholobium_striatum,40,27,13,Alphahull-PointsKO-Adjacents,608
Otholobium_wilmsii,51,40,11,Alphahull-PointsKO-Adjacents,410
Othonna_clavifolia,3,3,0,Points-PointsKO-Adjacents,27
Otoba_acuminata,48,38,10,Alphahull-PointsKO-Adjacents,245
Otoba_cyclobasis,6,2,4,Points-PointsKO-Adjacents,37
Otoba_glycycarpa,149,114,35,Alphahull-PointsKO-Adjacents,9953
Otoba_gordoniifolia,88,70,18,Alphahull-PointsKO-Adjacents,850
Otoba_gracilipes,49,35,14,Alphahull-PointsKO-Adjacents,906
Otoba_latialata,103,78,25,Alphahull-PointsKO-Adjacents,1234
Otoba_lehmannii,90,78,12,Alphahull-PointsKO-Adjacents,1162
Otoba_novogranatensis,366,319,47,Alphahull-PointsKO-Adjacents,6860
Otoba_parvifolia,548,495,53,Alphahull-PointsKO-Adjacents,21681
Otomeria_volubilis,54,34,20,Alphahull-PointsKO-Adjacents,2212
Otonephelium_stipulaceum,1,0,1,Points-PointsKO-Adjacents,9
Otostegia_tomentosa,41,28,13,Alphahull-PointsKO-Adjacents,820
Ottoschulzia_cubensis,1,1,0,Points-PointsKO-Adjacents,8
Ottoschulzia_domingensis,7,3,4,Points-PointsKO-Adjacents,45
Ottoschulzia_pallida,45,34,11,Alphahull-PointsKO-Adjacents,576
Ottoschulzia_rhodoxylon,13,7,6,Points-PointsKO-Adjacents,65
Oubanguia_africana,68,47,21,Alphahull-PointsKO-Adjacents,2379
Oubanguia_alata,36,0,36,Points-PointsKO-Adjacents,107
Oubanguia_laurifolia,21,6,15,Points-PointsKO-Adjacents,120
Ouratea_acuminata,51,3,48,Points-PointsKO-Adjacents,424
Ouratea_acuta,8,0,8,Points-PointsKO-Adjacents,54
Ouratea_affinis,51,0,51,Points-PointsKO-Adjacents,331
Ouratea_amplifolia,59,31,28,Alphahull-PointsKO-Adjacents,2746
Ouratea_andongensis,7,1,6,Points-PointsKO-Adjacents,46
Ouratea_apurensis,3,3,0,Points-PointsKO-Adjacents,27
Ouratea_aquatica,79,30,49,Alphahull-PointsKO-Adjacents,710
Ouratea_arbobrevicalyx,4,4,0,Points-PointsKO-Adjacents,36
Ouratea_arnoldiana,22,5,17,Points-PointsKO-Adjacents,138
Ouratea_aromatica,45,0,45,Points-PointsKO-Adjacents,353
Ouratea_attenuata,8,1,7,Points-PointsKO-Adjacents,72
Ouratea_boliviana,11,5,6,Points-PointsKO-Adjacents,61
Ouratea_brevicalyx,7,1,6,Points-PointsKO-Adjacents,57
Ouratea_brevipedicellata,9,5,4,Points-PointsKO-Adjacents,63
Ouratea_calantha,43,33,10,Alphahull-PointsKO-Adjacents,465
Ouratea_calophylla,80,54,26,Alphahull-PointsKO-Adjacents,1677
Ouratea_candollei,17,9,8,Points-PointsKO-Adjacents,93
Ouratea_caracasana,7,0,7,Points-PointsKO-Adjacents,63
Ouratea_cardiosperma,14,4,10,Points-PointsKO-Adjacents,102
Ouratea_castaneifolia,1162,1019,143,Alphahull-PointsKO-Adjacents,86967
Ouratea_claessensii,9,3,6,Points-PointsKO-Adjacents,62
Ouratea_claudei,19,1,18,Points-PointsKO-Adjacents,154
Ouratea_coccinea,69,33,36,Alphahull-PointsKO-Adjacents,1642
Ouratea_crassa,60,35,25,Alphahull-PointsKO-Adjacents,288
Ouratea_croizatii,0,0,0,NA,0
Ouratea_culminicola,3,3,0,Points-PointsKO-Adjacents,18
Ouratea_cuspidata,113,60,53,Alphahull-PointsKO-Adjacents,1763
Ouratea_darienensis,4,4,0,Points-PointsKO-Adjacents,27
Ouratea_davidsei,8,3,5,Points-PointsKO-Adjacents,68
Ouratea_decagyna,5,1,4,Points-PointsKO-Adjacents,39
Ouratea_discophora,161,107,54,Alphahull-PointsKO-Adjacents,14734
Ouratea_dybovskii,55,28,27,Alphahull-PointsKO-Adjacents,2615
Ouratea_elegans,1,1,0,Points-PointsKO-Adjacents,9
Ouratea_engleri,9,0,9,Points-PointsKO-Adjacents,67
Ouratea_evoluta,7,2,5,Points-PointsKO-Adjacents,54
Ouratea_ferruginea,218,133,85,Alphahull-PointsKO-Adjacents,17324
Ouratea_fieldingiana,152,0,152,Points-PointsKO-Adjacents,829
Ouratea_flexipedicellata,2,2,0,Points-PointsKO-Adjacents,18
Ouratea_fusiformis,5,5,0,Points-PointsKO-Adjacents,45
Ouratea_glaucescens,90,74,16,Alphahull-PointsKO-Adjacents,3048
Ouratea_grandiflora,15,10,5,Points-PointsKO-Adjacents,90
Ouratea_grosourdyi,46,29,17,Alphahull-PointsKO-Adjacents,1228
Ouratea_guianensis,42,18,24,Points-PointsKO-Adjacents,352
Ouratea_guildingii,71,0,71,Points-PointsKO-Adjacents,498
Ouratea_guriensis,4,4,0,Points-PointsKO-Adjacents,17
Ouratea_heterobracteata,0,0,0,NA,0
Ouratea_hexasperma,865,758,107,Alphahull-PointsKO-Adjacents,41793
Ouratea_insulae,51,37,14,Alphahull-PointsKO-Adjacents,913
Ouratea_inundata,18,6,12,Points-PointsKO-Adjacents,139
Ouratea_iquitosensis,87,49,38,Alphahull-PointsKO-Adjacents,3023
Ouratea_jamaicensis,6,1,5,Points-PointsKO-Adjacents,44
Ouratea_jefensis,7,5,2,Points-PointsKO-Adjacents,24
Ouratea_kanukuensis,2,2,0,Points-PointsKO-Adjacents,9
Ouratea_knappiae,23,16,7,Points-PointsKO-Adjacents,70
Ouratea_laevis,0,0,0,NA,0
Ouratea_lajaensis,0,0,0,NA,0
Ouratea_larae,NA,NA,NA,NA,NA
Ouratea_laurifolia,4,4,0,Points-PointsKO-Adjacents,35
Ouratea_laxiflora,2,2,0,Points-PointsKO-Adjacents,12
Ouratea_leblondii,39,27,12,Alphahull-PointsKO-Adjacents,804
Ouratea_lecomtei,1,1,0,Points-PointsKO-Adjacents,9
Ouratea_littoralis,27,8,19,Points-PointsKO-Adjacents,77
Ouratea_lucens,47,29,18,Alphahull-PointsKO-Adjacents,1470
Ouratea_macrocarpa,5,1,4,Points-PointsKO-Adjacents,45
Ouratea_maguirei,2,2,0,Points-PointsKO-Adjacents,9
Ouratea_maigualidae,2,2,0,Points-PointsKO-Adjacents,9
Ouratea_marahuacensis,3,3,0,Points-PointsKO-Adjacents,25
Ouratea_medinae,1,1,0,Points-PointsKO-Adjacents,9
Ouratea_megaphylla,1,1,0,Points-PointsKO-Adjacents,9
Ouratea_melinonii,5,3,2,Points-PointsKO-Adjacents,35
Ouratea_microdonta,12,2,10,Points-PointsKO-Adjacents,101
Ouratea_multibracteata,2,2,0,Points-PointsKO-Adjacents,12
Ouratea_multiflora,55,37,18,Alphahull-PointsKO-Adjacents,393
Ouratea_nitida,218,160,58,Alphahull-PointsKO-Adjacents,3842
Ouratea_oleosa,20,5,15,Points-PointsKO-Adjacents,142
Ouratea_oliveriana,1,1,0,Points-PointsKO-Adjacents,9
Ouratea_orbignyana,37,17,20,Points-PointsKO-Adjacents,316
Ouratea_orisina,3,3,0,Points-PointsKO-Adjacents,27
Ouratea_ovalis,33,23,10,Alphahull-PointsKO-Adjacents,551
Ouratea_paraguayensis,15,4,11,Points-PointsKO-Adjacents,77
Ouratea_paratatei,1,1,0,Points-PointsKO-Adjacents,9
Ouratea_parviflora,506,423,83,Alphahull-PointsKO-Adjacents,6023
Ouratea_pendula,117,84,33,Alphahull-PointsKO-Adjacents,12507
Ouratea_pendulosepala,7,3,4,Points-PointsKO-Adjacents,63
Ouratea_polyantha,123,98,25,Alphahull-PointsKO-Adjacents,5891
Ouratea_polygyna,124,66,58,Alphahull-PointsKO-Adjacents,2445
Ouratea_prominens,143,122,21,Alphahull-PointsKO-Adjacents,717
Ouratea_pseudoguildingii,4,4,0,Points-PointsKO-Adjacents,32
Ouratea_pulverulenta,2,2,0,Points-PointsKO-Adjacents,12
Ouratea_purdieana,1,1,0,Points-PointsKO-Adjacents,9
Rhabdophyllum_quintasii,52,28,24,Alphahull-PointsKO-Adjacents,2192
Ouratea_racemiformis,9,0,9,Points-PointsKO-Adjacents,75
Ouratea_ramosissima,71,55,16,Alphahull-PointsKO-Adjacents,3071
Ouratea_rigida,15,7,8,Points-PointsKO-Adjacents,122
Ouratea_rinconensis,35,29,6,Alphahull-PointsKO-Adjacents,55
Ouratea_riparia,4,4,0,Points-PointsKO-Adjacents,36
Ouratea_roraimae,68,41,27,Alphahull-PointsKO-Adjacents,5663
Ouratea_rorida,5,5,0,Points-PointsKO-Adjacents,45
Ouratea_rotundipetala,4,3,1,Points-PointsKO-Adjacents,36
Ouratea_rubricyanea,15,6,9,Points-PointsKO-Adjacents,88
Ouratea_rupununiensis,12,5,7,Points-PointsKO-Adjacents,81
Ouratea_saldariagae,2,2,0,Points-PointsKO-Adjacents,18
Ouratea_salicifolia,253,178,75,Alphahull-PointsKO-Adjacents,13781
Ouratea_schomburgkii,45,21,24,Alphahull-PointsKO-Adjacents,1142
Ouratea_scottii,40,15,25,Points-PointsKO-Adjacents,297
Ouratea_sellowii,40,0,40,Points-PointsKO-Adjacents,250
Ouratea_semiserrata,296,252,44,Alphahull-PointsKO-Adjacents,4758
Ouratea_soderstromii,11,5,6,Points-PointsKO-Adjacents,70
Ouratea_spectabilis,462,398,64,Alphahull-PointsKO-Adjacents,24050
Ouratea_spruceana,194,141,53,Alphahull-PointsKO-Adjacents,11220
Ouratea_squamata,1,1,0,Points-PointsKO-Adjacents,9
Ouratea_staudtii,9,4,5,Points-PointsKO-Adjacents,66
Ouratea_stipulata,35,0,35,Points-PointsKO-Adjacents,174
Ouratea_striata,26,1,25,Points-PointsKO-Adjacents,126
Ouratea_subamplexicaulis,5,5,0,Points-PointsKO-Adjacents,34
Ouratea_sulcata,46,30,16,Alphahull-PointsKO-Adjacents,475
Ouratea_sulcatinervia,25,17,8,Points-PointsKO-Adjacents,73
Ouratea_superba,193,135,58,Alphahull-PointsKO-Adjacents,23808
Ouratea_tarapotensis,11,3,8,Points-PointsKO-Adjacents,98
Ouratea_tatei,6,0,6,Points-PointsKO-Adjacents,51
Ouratea_thyrsoidea,15,6,9,Points-PointsKO-Adjacents,122
Ouratea_tristis,3,3,0,Points-PointsKO-Adjacents,12
Ouratea_vaccinioides,157,129,28,Alphahull-PointsKO-Adjacents,1669
Ouratea_valerioi,71,53,18,Alphahull-PointsKO-Adjacents,699
Ouratea_verruculosa,5,5,0,Points-PointsKO-Adjacents,45
Ouratea_wallnoeferiana,1,1,0,Points-PointsKO-Adjacents,9
Ouratea_welwitschii,24,2,22,Points-PointsKO-Adjacents,201
Ouratea_werdermannii,0,0,0,NA,0
Ouratea_williamsii,55,31,24,Alphahull-PointsKO-Adjacents,1151
Ovidia_sericea,12,7,5,Points-PointsKO-Adjacents,77
Oxalis_xantha,2,2,0,Points-PointsKO-Adjacents,18
Oxalis_zeekoevleyensis,13,8,5,Points-PointsKO-Adjacents,113
Oxalis_zeyheri,7,2,5,Points-PointsKO-Adjacents,54
Oxandra_acuminata,122,82,40,Alphahull-PointsKO-Adjacents,3374
Oxandra_asbeckii,48,0,48,Points-PointsKO-Adjacents,281
Oxandra_belizensis,4,2,2,Points-PointsKO-Adjacents,21
Oxandra_espintana,175,125,50,Alphahull-PointsKO-Adjacents,5725
Oxandra_euneura,170,121,49,Alphahull-PointsKO-Adjacents,7214
Oxandra_krukoffii,21,3,18,Points-PointsKO-Adjacents,172
Oxandra_lanceolata,83,38,45,Alphahull-PointsKO-Adjacents,976
Oxandra_laurifolia,48,21,27,Alphahull-PointsKO-Adjacents,724
Oxandra_leucodermis,9,0,9,Points-PointsKO-Adjacents,53
Oxandra_longipetala,38,24,14,Alphahull-PointsKO-Adjacents,640
Oxandra_macrophylla,23,14,9,Points-PointsKO-Adjacents,162
Oxandra_major,26,7,19,Points-PointsKO-Adjacents,215
Oxandra_martiana,52,37,15,Alphahull-PointsKO-Adjacents,1158
Oxandra_mediocris,207,165,42,Alphahull-PointsKO-Adjacents,12456
Oxandra_nitida,72,44,28,Alphahull-PointsKO-Adjacents,1099
Oxandra_polyantha,118,77,41,Alphahull-PointsKO-Adjacents,6029
Oxandra_reticulata,151,125,26,Alphahull-PointsKO-Adjacents,12656
Oxandra_riedeliana,157,108,49,Alphahull-PointsKO-Adjacents,15226
Oxandra_sphaerocarpa,29,11,18,Points-PointsKO-Adjacents,226
Oxandra_venezuelana,81,53,28,Alphahull-PointsKO-Adjacents,1491
Oxandra_weberbaueri,1,1,0,Points-PointsKO-Adjacents,9
Oxandra_xylopioides,315,258,57,Alphahull-PointsKO-Adjacents,23716
Citrus_neocaledonica,3,3,0,Points-PointsKO-Adjacents,25
Citrus_undulata,0,0,0,NA,0
Oxera_baladica,28,21,7,Alphahull-PointsKO-Adjacents,127
Oxera_coriacea,12,4,8,Points-PointsKO-Adjacents,66
Oxera_crassifolia,5,5,0,Points-PointsKO-Adjacents,23
Oxera_microcalyx,6,3,3,Points-PointsKO-Adjacents,14
Oxera_neriifolia,165,142,23,Alphahull-PointsKO-Adjacents,265
Oxera_rugosa,2,2,0,Points-PointsKO-Adjacents,15
Oxera_sessilifolia,14,6,8,Points-PointsKO-Adjacents,58
Oxera_sulfurea,27,19,8,Points-PointsKO-Adjacents,104
Oxera_vanuatuensis,2,2,0,Points-PointsKO-Adjacents,13
Oxyanthus_formosus,233,158,75,Alphahull-PointsKO-Adjacents,14189
Oxyanthus_latifolius,13,4,9,Points-PointsKO-Adjacents,102
Oxyanthus_lepidus,35,16,19,Points-PointsKO-Adjacents,221
Oxyanthus_letouzeyanus,6,2,4,Points-PointsKO-Adjacents,43
Oxyanthus_montanus,14,8,6,Points-PointsKO-Adjacents,54
Oxyanthus_okuensis,10,5,5,Points-PointsKO-Adjacents,28
Oxyanthus_pallidus,155,100,55,Alphahull-PointsKO-Adjacents,9479
Oxyanthus_pyriformis,76,54,22,Alphahull-PointsKO-Adjacents,2059
Oxyanthus_querimbensis,NA,NA,NA,NA,NA
Oxyanthus_racemosus,99,69,30,Alphahull-PointsKO-Adjacents,1331
Oxyanthus_speciosus,467,343,124,Alphahull-PointsKO-Adjacents,32986
Oxyanthus_subpunctatus,152,94,58,Alphahull-PointsKO-Adjacents,13346
Oxyanthus_troupinii,33,25,8,Alphahull-PointsKO-Adjacents,154
Oxyanthus_unilocularis,302,233,69,Alphahull-PointsKO-Adjacents,31950
Oxyanthus_zanguebaricus,49,30,19,Alphahull-PointsKO-Adjacents,432
Oxyceros_longiflorus,19,2,17,Points-PointsKO-Adjacents,153
Oxydendrum_arboreum,13879,13287,592,Alphahull-PointsKO-Adjacents,17318
Oxystigma_mannii,14,8,6,Points-PointsKO-Adjacents,100
Oyedaea_boliviana,104,79,25,Alphahull-PointsKO-Adjacents,898
Oyedaea_verbesinoides,122,105,17,Alphahull-PointsKO-Adjacents,384
Ozoroa_albicans,22,0,22,Points-PointsKO-Adjacents,198
Ozoroa_benguellensis,0,0,0,NA,0
Ozoroa_cinerea,NA,NA,NA,NA,NA
Ozoroa_concolor,16,8,8,Points-PointsKO-Adjacents,124
Ozoroa_crassinervia,34,14,20,Points-PointsKO-Adjacents,294
Ozoroa_dispar,39,28,11,Alphahull-PointsKO-Adjacents,848
Ozoroa_engleri,44,34,10,Alphahull-PointsKO-Adjacents,615
Ozoroa_insignis,407,291,116,Alphahull-PointsKO-Adjacents,21082
Ozoroa_kaessneri,7,3,4,Points-PointsKO-Adjacents,63
Ozoroa_longipes,21,9,12,Points-PointsKO-Adjacents,167
Ozoroa_longipetiolata,1,1,0,Points-PointsKO-Adjacents,9
Ozoroa_mucronata,8,2,6,Points-PointsKO-Adjacents,64
Ozoroa_namaensis,10,4,6,Points-PointsKO-Adjacents,86
Ozoroa_namaquensis,3,3,0,Points-PointsKO-Adjacents,27
Heeria_nigricans,3,3,0,Points-PointsKO-Adjacents,27
Ozoroa_obovata,61,27,34,Alphahull-PointsKO-Adjacents,863
Ozoroa_paniculosa,166,132,34,Alphahull-PointsKO-Adjacents,5270
Ozoroa_schinzii,15,2,13,Points-PointsKO-Adjacents,123
Ozoroa_sphaerocarpa,45,33,12,Alphahull-PointsKO-Adjacents,879
Heeria_uelensis,3,3,0,Points-PointsKO-Adjacents,27
Pachira_amazonica,37,24,13,Alphahull-PointsKO-Adjacents,858
Pachira_aquatica,1301,1037,264,Alphahull-PointsKO-Adjacents,64376
Pachira_aracamuniana,3,3,0,Points-PointsKO-Adjacents,15
Pachira_brevipes,35,19,16,Points-PointsKO-Adjacents,217
Pachira_calophylla,9,1,8,Points-PointsKO-Adjacents,48
Pachira_coriacea,55,39,16,Alphahull-PointsKO-Adjacents,906
Pachira_cowanii,1,1,0,Points-PointsKO-Adjacents,9
Pachira_cubensis,5,5,0,Points-PointsKO-Adjacents,25
Pachira_dolichocalyx,4,4,0,Points-PointsKO-Adjacents,36
Pachira_duckei,58,27,31,Alphahull-PointsKO-Adjacents,977
Pachira_dugandeana,9,3,6,Points-PointsKO-Adjacents,78
Pachira_emarginata,16,7,9,Points-PointsKO-Adjacents,126
Pachira_faroensis,29,8,21,Points-PointsKO-Adjacents,226
Pachira_flaviflora,51,37,14,Alphahull-PointsKO-Adjacents,1601
Pachira_fuscolepidota,15,2,13,Points-PointsKO-Adjacents,120
Pachira_glabra,131,0,131,Points-PointsKO-Adjacents,930
Pachira_gracilis,40,22,18,Alphahull-PointsKO-Adjacents,930
Pachira_humilis,38,26,12,Alphahull-PointsKO-Adjacents,347
Pachira_insignis,286,204,82,Alphahull-PointsKO-Adjacents,47750
Pachira_liesneri,8,1,7,Points-PointsKO-Adjacents,60
Pachira_macrocalyx,34,6,28,Points-PointsKO-Adjacents,267
Pachira_mawarinumae,3,3,0,Points-PointsKO-Adjacents,21
Pachira_minor,125,0,125,Points-PointsKO-Adjacents,846
Pachira_nervosa,36,16,20,Points-PointsKO-Adjacents,235
Pachira_nitida,192,125,67,Alphahull-PointsKO-Adjacents,16973
Pachira_obovata,19,8,11,Points-PointsKO-Adjacents,112
Pachira_orinocensis,17,5,12,Points-PointsKO-Adjacents,141
Pachira_paraensis,92,34,58,Alphahull-PointsKO-Adjacents,1762
Pachira_patinoi,34,26,8,Alphahull-PointsKO-Adjacents,364
Pachira_pseudofaroensis,6,1,5,Points-PointsKO-Adjacents,53
Pachira_pulchra,3,3,0,Points-PointsKO-Adjacents,27
Pachira_punga-schunkei,26,17,9,Points-PointsKO-Adjacents,153
Pachira_quinata,246,192,54,Alphahull-PointsKO-Adjacents,10712
Pachira_retusa,85,67,18,Alphahull-PointsKO-Adjacents,1779
Pachira_robynsii,1,1,0,Points-PointsKO-Adjacents,9
Pachira_rupicola,25,8,17,Points-PointsKO-Adjacents,177
Pachira_rurrenabaqueana,35,0,35,Points-PointsKO-Adjacents,200
Pachira_sessilis,105,84,21,Alphahull-PointsKO-Adjacents,680
Pachira_sordida,40,28,12,Alphahull-PointsKO-Adjacents,571
Pachira_speciosa,55,35,20,Alphahull-PointsKO-Adjacents,2049
Pachira_subandina,6,0,6,Points-PointsKO-Adjacents,54
Pachira_tepuiensis,2,2,0,Points-PointsKO-Adjacents,9
Pachira_tocantina,9,1,8,Points-PointsKO-Adjacents,81
Pachira_trinitensis,33,9,24,Points-PointsKO-Adjacents,264
Pachira_yapacanae,3,3,0,Points-PointsKO-Adjacents,27
Pachycereus_grandis,26,0,26,Points-PointsKO-Adjacents,134
Pachycereus_lepidanthus,2,2,0,Points-PointsKO-Adjacents,18
Pachycereus_pecten-aboriginum,255,201,54,Alphahull-PointsKO-Adjacents,4758
Pachycereus_pringlei,318,0,318,Points-PointsKO-Adjacents,981
Pachycereus_tepamo,6,2,4,Points-PointsKO-Adjacents,36
Pachycereus_weberi,163,150,13,Alphahull-PointsKO-Adjacents,594
Pachycormus_discolor,146,124,22,Alphahull-PointsKO-Adjacents,1272
Pachyelasma_tessmannii,41,27,14,Alphahull-PointsKO-Adjacents,3232
Pachyloma_coriaceum,58,36,22,Alphahull-PointsKO-Adjacents,634
Pachypodium_geayi,30,0,30,Points-PointsKO-Adjacents,161
Pachypodium_lamerei,69,51,18,Alphahull-PointsKO-Adjacents,1719
Pachypodium_lealii,24,13,11,Points-PointsKO-Adjacents,194
Pachypodium_menabeum,59,44,15,Alphahull-PointsKO-Adjacents,1099
Pachypodium_namaquanum,37,32,5,Alphahull-PointsKO-Adjacents,158
Pachypodium_rutenbergianum,98,75,23,Alphahull-PointsKO-Adjacents,1253
Pachypodium_sofiense,17,10,7,Points-PointsKO-Adjacents,94
Pachystachys_rosea,4,4,0,Points-PointsKO-Adjacents,36
Pachystroma_longifolium,381,304,77,Alphahull-PointsKO-Adjacents,10366
Pachystylus_henningsianus,NA,NA,NA,NA,NA
Pachystylus_zippelianus,10,4,6,Points-PointsKO-Adjacents,76
Padus_brunnescens,4,4,0,Points-PointsKO-Adjacents,36
Padus_integrifolia,1,1,0,Points-PointsKO-Adjacents,9
Padus_laxiflora,NA,NA,NA,NA,NA
Padus_napaulensis,51,22,29,Alphahull-PointsKO-Adjacents,2472
Paederia_foetida,1240,0,1240,Points-PointsKO-Adjacents,5163
Paederia_majungensis,6,0,6,Points-PointsKO-Adjacents,46
Paederia_pospischilii,13,2,11,Points-PointsKO-Adjacents,102
Paederia_sambiranensis,17,12,5,Points-PointsKO-Adjacents,86
Pagamea_acrensis,56,28,28,Alphahull-PointsKO-Adjacents,1088
Pagamea_anisophylla,19,12,7,Points-PointsKO-Adjacents,145
Pagamea_capitata,183,140,43,Alphahull-PointsKO-Adjacents,3859
Pagamea_coriacea,433,0,433,Points-PointsKO-Adjacents,2799
Pagamea_diceras,3,3,0,Points-PointsKO-Adjacents,14
Pagamea_duckei,41,24,17,Alphahull-PointsKO-Adjacents,256
Pagamea_duidana,7,2,5,Points-PointsKO-Adjacents,50
Pagamea_guianensis,898,782,116,Alphahull-PointsKO-Adjacents,76646
Pagamea_harleyi,52,33,19,Alphahull-PointsKO-Adjacents,408
Pagamea_hirsuta,33,24,9,Alphahull-PointsKO-Adjacents,1072
Pagamea_jauaensis,9,6,3,Points-PointsKO-Adjacents,57
Pagamea_macrophylla,33,14,19,Points-PointsKO-Adjacents,217
Pagamea_montana,56,41,15,Alphahull-PointsKO-Adjacents,2038
Pagamea_pilosa,3,3,0,Points-PointsKO-Adjacents,27
Pagamea_plicata,196,129,67,Alphahull-PointsKO-Adjacents,7635
Pagamea_plicatiformis,23,10,13,Points-PointsKO-Adjacents,148
Pagamea_puberula,9,0,9,Points-PointsKO-Adjacents,72
Pagamea_sessiliflora,11,5,6,Points-PointsKO-Adjacents,57
Pagamea_standleyana,21,16,5,Points-PointsKO-Adjacents,104
Pagamea_thyrsiflora,175,130,45,Alphahull-PointsKO-Adjacents,10726
Pagamea_velutina,7,3,4,Points-PointsKO-Adjacents,36
Pagameopsis_garryoides,15,6,9,Points-PointsKO-Adjacents,114
Pagameopsis_maguirei,39,30,9,Alphahull-PointsKO-Adjacents,90
Painteria_nitida,2,2,0,Points-PointsKO-Adjacents,17
Pajanelia_longifolia,4,0,4,Points-PointsKO-Adjacents,36
Pakaraimaea_dipterocarpacea,39,30,9,Alphahull-PointsKO-Adjacents,640
Palaquium_abundantiflorum,1,1,0,Points-PointsKO-Adjacents,9
Palaquium_amboinense,19,5,14,Points-PointsKO-Adjacents,119
Palaquium_annamense,0,0,0,NA,0
Palaquium_barnesii,1,1,0,Points-PointsKO-Adjacents,9
Palaquium_bataanense,0,0,0,NA,0
Palaquium_beccarianum,4,0,4,Points-PointsKO-Adjacents,36
Palaquium_bourdillonii,0,0,0,NA,0
Palaquium_brassii,1,1,0,Points-PointsKO-Adjacents,9
Palaquium_burckii,1,1,0,Points-PointsKO-Adjacents,9
Palaquium_calophyllum,15,5,10,Points-PointsKO-Adjacents,133
Palaquium_canaliculatum,1,1,0,Points-PointsKO-Adjacents,9
Palaquium_clarkeanum,2,2,0,Points-PointsKO-Adjacents,18
Palaquium_cochleariifolium,3,3,0,Points-PointsKO-Adjacents,18
Palaquium_confertum,0,0,0,NA,0
Palaquium_crassifolium,0,0,0,NA,0
Palaquium_cryptocariifolium,2,0,2,Points-PointsKO-Adjacents,18
Palaquium_cuprifolium,1,1,0,Points-PointsKO-Adjacents,7
Palaquium_dasyphyllum,10,6,4,Points-PointsKO-Adjacents,82
Palaquium_decurrens,2,2,0,Points-PointsKO-Adjacents,18
Palaquium_densivenium,NA,NA,NA,NA,NA
Palaquium_dubardii,6,1,5,Points-PointsKO-Adjacents,34
Palaquium_edenii,0,0,0,NA,0
Palaquium_elegans,0,0,0,NA,0
Palaquium_ellipticum,0,0,0,NA,0
Palaquium_elliptilimbum,0,0,0,NA,0
Palaquium_elongatum,0,0,0,NA,0
Palaquium_eriocalyx,0,0,0,NA,0
Palaquium_erythrospermum,3,3,0,Points-PointsKO-Adjacents,27
Palaquium_ferrugineum,1,0,1,Points-PointsKO-Adjacents,9
Palaquium_fidjiense,2,2,0,Points-PointsKO-Adjacents,3
Palaquium_firmum,0,0,0,NA,0
Palaquium_formosanum,12,7,5,Points-PointsKO-Adjacents,21
Palaquium_foxworthyi,0,0,0,NA,0
Palaquium_galactoxylum,95,61,34,Alphahull-PointsKO-Adjacents,1215
Palaquium_garrettii,0,0,0,NA,0
Palaquium_gigantifolium,0,0,0,NA,0
Palaquium_glabrifolium,0,0,0,NA,0
Palaquium_glabrum,0,0,0,NA,0
Palaquium_globosum,2,1,1,Points-PointsKO-Adjacents,14
Palaquium_grande,4,4,0,Points-PointsKO-Adjacents,26
Palaquium_gutta,16,1,15,Points-PointsKO-Adjacents,120
Palaquium_hansenii,0,0,0,NA,0
Palaquium_herveyi,1,1,0,Points-PointsKO-Adjacents,9
Palaquium_heterosepalum,1,1,0,Points-PointsKO-Adjacents,9
Palaquium_hexandrum,10,0,10,Points-PointsKO-Adjacents,76
Palaquium_hinmolpedda,2,2,0,Points-PointsKO-Adjacents,18
Palaquium_hispidum,2,0,2,Points-PointsKO-Adjacents,17
Palaquium_hornei,1,1,0,Points-PointsKO-Adjacents,9
Palaquium_impressionervium,1,1,0,Points-PointsKO-Adjacents,9
Palaquium_karrak,3,3,0,Points-PointsKO-Adjacents,10
Palaquium_kinabaluense,3,3,0,Points-PointsKO-Adjacents,21
Palaquium_laevifolium,1,1,0,Points-PointsKO-Adjacents,9
Palaquium_lanceolatum,1,1,0,Points-PointsKO-Adjacents,5
Palaquium_leiocarpum,9,2,7,Points-PointsKO-Adjacents,72
Palaquium_lisophyllum,0,0,0,NA,0
Palaquium_lobbianum,8,1,7,Points-PointsKO-Adjacents,47
Palaquium_loheri,0,0,0,NA,0
Palaquium_luzoniense,1,1,0,Points-PointsKO-Adjacents,9
Palaquium_macrocarpum,1,1,0,Points-PointsKO-Adjacents,9
Palaquium_maingayi,7,2,5,Points-PointsKO-Adjacents,54
Palaquium_majas,3,3,0,Points-PointsKO-Adjacents,27
Palaquium_maliliense,5,5,0,Points-PointsKO-Adjacents,34
Palaquium_masuui,0,0,0,NA,0
Palaquium_merrillii,0,0,0,NA,0
Palaquium_microphyllum,7,1,6,Points-PointsKO-Adjacents,48
Palaquium_mindanaense,0,0,0,NA,0
Palaquium_montanum,2,2,0,Points-PointsKO-Adjacents,18
Palaquium_morobense,3,3,0,Points-PointsKO-Adjacents,27
Palaquium_multiflorum,1,0,1,Points-PointsKO-Adjacents,9
Palaquium_neoebudicum,8,0,8,Points-PointsKO-Adjacents,51
Palaquium_njatoh,NA,NA,NA,NA,NA
Palaquium_obovatum,17,4,13,Points-PointsKO-Adjacents,120
Palaquium_obtusifolium,18,0,18,Points-PointsKO-Adjacents,146
Palaquium_oleosum,NA,NA,NA,NA,NA
Palaquium_ottolanderi,3,2,1,Points-PointsKO-Adjacents,27
Palaquium_oxleyanum,6,0,6,Points-PointsKO-Adjacents,27
Palaquium_oxyspermum,NA,NA,NA,NA,NA
Palaquium_pauciflorum,2,2,0,Points-PointsKO-Adjacents,14
Palaquium_petiolare,2,2,0,Points-PointsKO-Adjacents,18
Palaquium_philippense,2,2,0,Points-PointsKO-Adjacents,18
Palaquium_pierrei,0,0,0,NA,0
Palaquium_pinnatinervium,1,1,0,Points-PointsKO-Adjacents,9
Palaquium_polyandrum,1,1,0,Points-PointsKO-Adjacents,9
Palaquium_polyanthum,1,1,0,Points-PointsKO-Adjacents,9
Palaquium_porphyreum,0,0,0,NA,0
Palaquium_pseudocalophyllum,1,1,0,Points-PointsKO-Adjacents,9
Palaquium_pseudocuneatum,1,1,0,Points-PointsKO-Adjacents,9
Palaquium_pseudorostratum,0,0,0,NA,0
Palaquium_quercifolium,3,0,3,Points-PointsKO-Adjacents,27
Palaquium_ravii,NA,NA,NA,NA,NA
Palaquium_regina-montium,1,1,0,Points-PointsKO-Adjacents,9
Palaquium_ridleyi,10,1,9,Points-PointsKO-Adjacents,86
Palaquium_rigidum,0,0,0,NA,0
Palaquium_rioense,0,0,0,NA,0
Palaquium_rivulare,0,0,0,NA,0
Palaquium_rostratum,9,0,9,Points-PointsKO-Adjacents,72
Palaquium_rubiginosum,3,3,0,Points-PointsKO-Adjacents,27
Palaquium_rufolanigerum,1,1,0,Points-PointsKO-Adjacents,9
Palaquium_sambasense,0,0,0,NA,0
Palaquium_semaram,1,1,0,Points-PointsKO-Adjacents,9
Palaquium_sericeum,18,4,14,Points-PointsKO-Adjacents,143
Palaquium_simun,3,3,0,Points-PointsKO-Adjacents,26
Palaquium_sorsogonense,1,1,0,Points-PointsKO-Adjacents,9
Palaquium_stehlinii,9,4,5,Points-PointsKO-Adjacents,34
Palaquium_stellatum,2,0,2,Points-PointsKO-Adjacents,18
Palaquium_stipulare,0,0,0,NA,0
Palaquium_sukoei,0,0,0,NA,0
Palaquium_sumatranum,1,1,0,Points-PointsKO-Adjacents,9
Palaquium_supfianum,6,0,6,Points-PointsKO-Adjacents,51
Palaquium_tenuifolium,NA,NA,NA,NA,NA
Palaquium_tenuipetiolatum,1,1,0,Points-PointsKO-Adjacents,9
Palaquium_thwaitesii,2,2,0,Points-PointsKO-Adjacents,12
Palaquium_tjipetirense,0,0,0,NA,0
Palaquium_vexillatum,0,0,0,NA,0
Palaquium_vidalii,NA,NA,NA,NA,NA
Palaquium_vitilevuense,0,0,0,NA,0
Palaquium_walsurifolium,2,0,2,Points-PointsKO-Adjacents,18
Palaquium_warburgianum,10,3,7,Points-PointsKO-Adjacents,81
Palaquium_xanthochymum,1,1,0,Points-PointsKO-Adjacents,9
Palaquium_zeylanicum,NA,NA,NA,NA,NA
Palicourea_acanthacea,72,54,18,Alphahull-PointsKO-Adjacents,486
Palicourea_acetosoides,174,143,31,Alphahull-PointsKO-Adjacents,1742
Palicourea_acuminata,1082,935,147,Alphahull-PointsKO-Adjacents,49603
Palicourea_adusta,133,114,19,Alphahull-PointsKO-Adjacents,231
Palicourea_alajuelensis,62,47,15,Alphahull-PointsKO-Adjacents,262
Palicourea_albocaerulea,28,1,27,Points-PointsKO-Adjacents,81
Palicourea_alpina,80,51,29,Alphahull-PointsKO-Adjacents,482
Palicourea_amapaensis,85,44,41,Alphahull-PointsKO-Adjacents,2472
Palicourea_amethystina,387,342,45,Alphahull-PointsKO-Adjacents,4895
Palicourea_amplissima,16,10,6,Points-PointsKO-Adjacents,119
Palicourea_andaluciana,68,50,18,Alphahull-PointsKO-Adjacents,1288
Palicourea_anderssoniana,17,10,7,Points-PointsKO-Adjacents,85
Palicourea_andina,69,35,34,Alphahull-PointsKO-Adjacents,812
Palicourea_andrei,82,55,27,Alphahull-PointsKO-Adjacents,1608
Palicourea_angustifolia,821,740,81,Alphahull-PointsKO-Adjacents,7050
Palicourea_anianguana,7,2,5,Points-PointsKO-Adjacents,39
Palicourea_antioquiana,14,8,6,Points-PointsKO-Adjacents,75
Palicourea_aphthosa,3,3,0,Points-PointsKO-Adjacents,27
Palicourea_apicata,190,157,33,Alphahull-PointsKO-Adjacents,2149
Palicourea_asplundii,7,2,5,Points-PointsKO-Adjacents,38
Palicourea_attenuata,48,29,19,Alphahull-PointsKO-Adjacents,408
Palicourea_azurea,8,3,5,Points-PointsKO-Adjacents,51
Palicourea_beachiana,41,30,11,Alphahull-PointsKO-Adjacents,238
Palicourea_bella,10,6,4,Points-PointsKO-Adjacents,30
Palicourea_bellula,14,11,3,Points-PointsKO-Adjacents,25
Palicourea_blanchetiana,253,0,253,Points-PointsKO-Adjacents,1103
Palicourea_boraginoides,23,16,7,Points-PointsKO-Adjacents,78
Palicourea_bostrychostachya,1,1,0,Points-PointsKO-Adjacents,9
Palicourea_breedlovei,11,1,10,Points-PointsKO-Adjacents,66
Palicourea_brenesii,12,9,3,Points-PointsKO-Adjacents,43
Palicourea_buntingii,23,13,10,Points-PointsKO-Adjacents,161
Palicourea_calidicola,82,70,12,Alphahull-PointsKO-Adjacents,480
Palicourea_calophlebia,51,35,16,Alphahull-PointsKO-Adjacents,1067
Palicourea_calophylla,184,125,59,Alphahull-PointsKO-Adjacents,8280
Palicourea_calycina,22,12,10,Points-PointsKO-Adjacents,98
Palicourea_canaguensis,1,1,0,Points-PointsKO-Adjacents,9
Palicourea_canarina,35,23,12,Alphahull-PointsKO-Adjacents,182
Palicourea_candida,15,11,4,Points-PointsKO-Adjacents,80
Palicourea_cardonae,3,3,0,Points-PointsKO-Adjacents,27
Palicourea_ceratantha,64,48,16,Alphahull-PointsKO-Adjacents,1460
Palicourea_chignul,23,16,7,Points-PointsKO-Adjacents,105
Palicourea_chimboracensis,65,44,21,Alphahull-PointsKO-Adjacents,856
Palicourea_chiriquina,26,21,5,Alphahull-PointsKO-Adjacents,68
Palicourea_clerodendroides,28,15,13,Points-PointsKO-Adjacents,174
Palicourea_cogolloi,48,37,11,Alphahull-PointsKO-Adjacents,677
Palicourea_compta,23,10,13,Points-PointsKO-Adjacents,160
Palicourea_condorica,18,9,9,Points-PointsKO-Adjacents,115
Palicourea_conferta,109,80,29,Alphahull-PointsKO-Adjacents,3663
Palicourea_consobrina,3,3,0,Points-PointsKO-Adjacents,27
Palicourea_corniculata,19,13,6,Points-PointsKO-Adjacents,79
Palicourea_cornigera,13,4,9,Points-PointsKO-Adjacents,72
Palicourea_corymbifera,543,478,65,Alphahull-PointsKO-Adjacents,53069
Palicourea_croceoides,935,742,193,Alphahull-PointsKO-Adjacents,76952
Palicourea_ctenocalyx,0,0,0,NA,0
Palicourea_cuatrecasasii,69,53,16,Alphahull-PointsKO-Adjacents,1225
Palicourea_cutucuana,20,13,7,Points-PointsKO-Adjacents,139
Palicourea_demissa,477,430,47,Alphahull-PointsKO-Adjacents,5031
Palicourea_denslowiae,16,11,5,Points-PointsKO-Adjacents,95
Palicourea_deviae,50,35,15,Alphahull-PointsKO-Adjacents,284
Palicourea_diguana,19,12,7,Points-PointsKO-Adjacents,118
Palicourea_domingensis,230,149,81,Alphahull-PointsKO-Adjacents,2873
Palicourea_dunstervilleorum,0,0,0,NA,0
Palicourea_eburnea,9,6,3,Points-PointsKO-Adjacents,64
Palicourea_eriantha,49,43,6,Alphahull-PointsKO-Adjacents,229
Palicourea_eurycarpa,96,78,18,Alphahull-PointsKO-Adjacents,512
Palicourea_fastigiata,203,129,74,Alphahull-PointsKO-Adjacents,16966
Palicourea_faxlucens,27,0,27,Points-PointsKO-Adjacents,93
Palicourea_flavescens,60,41,19,Alphahull-PointsKO-Adjacents,515
Palicourea_flexiramea,0,0,0,NA,0
Palicourea_frontinoensis,20,9,11,Points-PointsKO-Adjacents,118
Palicourea_garciae,266,214,52,Alphahull-PointsKO-Adjacents,2376
Palicourea_garcioides,13,4,9,Points-PointsKO-Adjacents,76
Palicourea_gentryi,2,2,0,Points-PointsKO-Adjacents,12
Palicourea_glandulifera,22,15,7,Points-PointsKO-Adjacents,87
Palicourea_gomezii,135,96,39,Alphahull-PointsKO-Adjacents,1141
Palicourea_grandiflora,414,337,77,Alphahull-PointsKO-Adjacents,44786
Palicourea_grandifolia,97,42,55,Alphahull-PointsKO-Adjacents,3602
Palicourea_grandifructa,17,11,6,Points-PointsKO-Adjacents,35
Palicourea_grandistipula,57,44,13,Alphahull-PointsKO-Adjacents,1092
Palicourea_guianensis,2459,2217,242,Alphahull-PointsKO-Adjacents,101145
Palicourea_hammelii,24,15,9,Points-PointsKO-Adjacents,102
Palicourea_harlingii,16,10,6,Points-PointsKO-Adjacents,85
Palicourea_herrerae,14,6,8,Points-PointsKO-Adjacents,115
Palicourea_heterochroma,93,58,35,Alphahull-PointsKO-Adjacents,1879
Palicourea_heydei,15,8,7,Points-PointsKO-Adjacents,83
Palicourea_hondensis,146,130,16,Alphahull-PointsKO-Adjacents,522
Palicourea_huampamiensis,93,70,23,Alphahull-PointsKO-Adjacents,5851
Palicourea_insignis,1,1,0,Points-PointsKO-Adjacents,9
Palicourea_irwinii,2,2,0,Points-PointsKO-Adjacents,18
Palicourea_jahnii,23,16,7,Points-PointsKO-Adjacents,68
Palicourea_jauaensis,13,9,4,Points-PointsKO-Adjacents,41
Palicourea_jelskii,6,1,5,Points-PointsKO-Adjacents,48
Palicourea_justicioides,9,1,8,Points-PointsKO-Adjacents,68
Palicourea_kanehirae,5,5,0,Points-PointsKO-Adjacents,34
Palicourea_killipii,11,3,8,Points-PointsKO-Adjacents,77
Palicourea_kirkbrideae,4,4,0,Points-PointsKO-Adjacents,30
Palicourea_lachnantha,50,38,12,Alphahull-PointsKO-Adjacents,786
Palicourea_lancifera,28,16,12,Points-PointsKO-Adjacents,134
Palicourea_lasiantha,580,523,57,Alphahull-PointsKO-Adjacents,29833
Palicourea_lasiorrhachis,348,296,52,Alphahull-PointsKO-Adjacents,2910
Palicourea_lasseri,0,0,0,NA,0
Palicourea_latifolia,10,0,10,Points-PointsKO-Adjacents,69
Palicourea_leucantha,24,14,10,Points-PointsKO-Adjacents,90
Palicourea_leuconeura,29,0,29,Points-PointsKO-Adjacents,183
Palicourea_lineata,143,107,36,Alphahull-PointsKO-Adjacents,2229
Palicourea_longiflora,380,310,70,Alphahull-PointsKO-Adjacents,30347
Palicourea_longistipulata,222,139,83,Alphahull-PointsKO-Adjacents,22751
Palicourea_lopeziana,1,1,0,Points-PointsKO-Adjacents,9
Palicourea_lugoana,39,24,15,Alphahull-PointsKO-Adjacents,857
Palicourea_luteonivea,101,71,30,Alphahull-PointsKO-Adjacents,948
Palicourea_lutulenta,8,2,6,Points-PointsKO-Adjacents,64
Palicourea_lyristipula,127,93,34,Alphahull-PointsKO-Adjacents,2127
Palicourea_macbridei,17,11,6,Points-PointsKO-Adjacents,81
Palicourea_macrantha,31,18,13,Points-PointsKO-Adjacents,170
Palicourea_macrobotrys,378,282,96,Alphahull-PointsKO-Adjacents,20224
Palicourea_macrocalyx,27,21,6,Alphahull-PointsKO-Adjacents,85
Palicourea_mansoana,248,197,51,Alphahull-PointsKO-Adjacents,10388
Palicourea_matamana,2,2,0,Points-PointsKO-Adjacents,9
Palicourea_mediocris,8,1,7,Points-PointsKO-Adjacents,61
Palicourea_megalantha,27,22,5,Alphahull-PointsKO-Adjacents,76
Palicourea_microcarpa,86,64,22,Alphahull-PointsKO-Adjacents,490
Palicourea_myrtifolia,21,16,5,Points-PointsKO-Adjacents,86
Palicourea_nebulosa,26,16,10,Points-PointsKO-Adjacents,121
Palicourea_neopurpusii,8,0,8,Points-PointsKO-Adjacents,72
Palicourea_nigricans,324,0,324,Points-PointsKO-Adjacents,1799
Palicourea_nitidella,453,408,45,Alphahull-PointsKO-Adjacents,32109
Palicourea_nubigena,16,9,7,Points-PointsKO-Adjacents,88
Palicourea_obovata,76,53,23,Alphahull-PointsKO-Adjacents,275
Palicourea_obtusata,35,24,11,Alphahull-PointsKO-Adjacents,415
Palicourea_ochnoides,10,5,5,Points-PointsKO-Adjacents,46
Palicourea_orosiana,25,18,7,Points-PointsKO-Adjacents,99
Palicourea_orquidea,3,3,0,Points-PointsKO-Adjacents,21
Palicourea_ovalis,88,60,28,Alphahull-PointsKO-Adjacents,1544
Palicourea_pachycalyx,35,11,24,Points-PointsKO-Adjacents,278
Palicourea_padifolia,888,815,73,Alphahull-PointsKO-Adjacents,6009
Palicourea_palustris,8,5,3,Points-PointsKO-Adjacents,18
Palicourea_paniculata,127,1,126,Points-PointsKO-Adjacents,777
Palicourea_pauciflora,9,0,9,Points-PointsKO-Adjacents,49
Palicourea_pedunculosa,2,2,0,Points-PointsKO-Adjacents,18
Palicourea_pendula,45,34,11,Alphahull-PointsKO-Adjacents,267
Palicourea_pereziana,14,11,3,Points-PointsKO-Adjacents,49
Palicourea_perquadrangularis,210,154,56,Alphahull-PointsKO-Adjacents,10734
Palicourea_petiolaris,68,47,21,Alphahull-PointsKO-Adjacents,557
Palicourea_pittieri,22,6,16,Points-PointsKO-Adjacents,137
Palicourea_ponasae,51,24,27,Alphahull-PointsKO-Adjacents,427
Palicourea_prodiga,11,0,11,Points-PointsKO-Adjacents,61
Palicourea_psychotrioides,46,37,9,Alphahull-PointsKO-Adjacents,414
Palicourea_pulchra,8,4,4,Points-PointsKO-Adjacents,47
Palicourea_punicea,159,0,159,Points-PointsKO-Adjacents,1026
Palicourea_purpurea,131,118,13,Alphahull-PointsKO-Adjacents,278
Palicourea_pyramidalis,139,121,18,Alphahull-PointsKO-Adjacents,2308
Palicourea_quadrifolia,184,112,72,Alphahull-PointsKO-Adjacents,6013
Palicourea_quadrilateralis,59,52,7,Alphahull-PointsKO-Adjacents,167
Palicourea_remyana,19,10,9,Points-PointsKO-Adjacents,124
Palicourea_rigida,1418,1262,156,Alphahull-PointsKO-Adjacents,53847
Palicourea_rigidifolia,59,40,19,Alphahull-PointsKO-Adjacents,1241
Palicourea_roseocremea,19,14,5,Points-PointsKO-Adjacents,54
Palicourea_roseofaucis,9,1,8,Points-PointsKO-Adjacents,39
Palicourea_salicifolia,84,73,11,Alphahull-PointsKO-Adjacents,113
Palicourea_seemannii,62,41,21,Alphahull-PointsKO-Adjacents,431
Palicourea_semirasa,41,0,41,Points-PointsKO-Adjacents,275
Palicourea_skotakii,18,11,7,Points-PointsKO-Adjacents,81
Palicourea_sopkinii,10,7,3,Points-PointsKO-Adjacents,64
Palicourea_sousae,4,4,0,Points-PointsKO-Adjacents,36
Palicourea_spathacea,31,25,6,Alphahull-PointsKO-Adjacents,58
Palicourea_standleyana,104,72,32,Alphahull-PointsKO-Adjacents,733
Palicourea_stipularis,234,183,51,Alphahull-PointsKO-Adjacents,5571
Palicourea_subalata,37,19,18,Points-PointsKO-Adjacents,210
Palicourea_subalatoides,28,19,9,Points-PointsKO-Adjacents,113
Palicourea_subspicata,161,121,40,Alphahull-PointsKO-Adjacents,7058
Palicourea_subtomentosa,99,75,24,Alphahull-PointsKO-Adjacents,694
Palicourea_sulphurea,53,28,25,Alphahull-PointsKO-Adjacents,755
Palicourea_tectoneura,6,0,6,Points-PointsKO-Adjacents,45
Palicourea_tepuicola,13,6,7,Points-PointsKO-Adjacents,97
Palicourea_thermydri,42,31,11,Alphahull-PointsKO-Adjacents,136
Palicourea_thyrsiflora,483,401,82,Alphahull-PointsKO-Adjacents,7406
Palicourea_tilaranensis,22,18,4,Points-PointsKO-Adjacents,93
Palicourea_toroi,11,3,8,Points-PointsKO-Adjacents,68
Palicourea_triphylla,614,461,153,Alphahull-PointsKO-Adjacents,39092
Palicourea_tubuliflora,9,5,4,Points-PointsKO-Adjacents,25
Palicourea_tumidonodosa,5,5,0,Points-PointsKO-Adjacents,41
Palicourea_tutensis,7,3,4,Points-PointsKO-Adjacents,34
Palicourea_ulloana,31,19,12,Points-PointsKO-Adjacents,182
Palicourea_umbelliformis,69,53,16,Alphahull-PointsKO-Adjacents,492
Palicourea_vestita,40,29,11,Alphahull-PointsKO-Adjacents,168
Palicourea_virens,103,63,40,Alphahull-PointsKO-Adjacents,9178
Palicourea_vogelii,2,2,0,Points-PointsKO-Adjacents,12
Palicourea_vulcanalis,11,0,11,Points-PointsKO-Adjacents,73
Palicourea_wilesii,2,2,0,Points-PointsKO-Adjacents,18
Palicourea_zarucchii,63,55,8,Alphahull-PointsKO-Adjacents,149
Paliurus_hemsleyanus,40,17,23,Points-PointsKO-Adjacents,355
Paliurus_hirsutus,16,3,13,Points-PointsKO-Adjacents,144
Paliurus_orientalis,15,7,8,Points-PointsKO-Adjacents,129
Paliurus_ramosissimus,92,53,39,Alphahull-PointsKO-Adjacents,5969
Paliurus_spina-christi,775,598,177,Alphahull-PointsKO-Adjacents,13954
Paloue_brasiliensis,15,4,11,Points-PointsKO-Adjacents,104
Paloue_guianensis,46,24,22,Alphahull-PointsKO-Adjacents,2867
Paloue_induta,5,5,0,Points-PointsKO-Adjacents,45
Paloue_riparia,40,27,13,Alphahull-PointsKO-Adjacents,2058
Paloveopsis_emarginata,6,0,6,Points-PointsKO-Adjacents,54
Pamburus_missionis,0,0,0,NA,0
Pamphilia_vilcabambae,14,6,8,Points-PointsKO-Adjacents,70
Pancovia_bijuga,153,121,32,Alphahull-PointsKO-Adjacents,666
Pancovia_floribunda,51,38,13,Alphahull-PointsKO-Adjacents,1349
Pancovia_golungensis,56,34,22,Alphahull-PointsKO-Adjacents,878
Pancovia_harmsiana,52,30,22,Alphahull-PointsKO-Adjacents,2634
Pancovia_holtzii,34,22,12,Alphahull-PointsKO-Adjacents,647
Pancovia_laurentii,54,26,28,Alphahull-PointsKO-Adjacents,3529
Pancovia_pedicellaris,29,8,21,Points-PointsKO-Adjacents,180
Pancovia_turbinata,123,76,47,Alphahull-PointsKO-Adjacents,3563
Panda_oleosa,333,281,52,Alphahull-PointsKO-Adjacents,8585
Pandanus_abbiwii,2,2,0,Points-PointsKO-Adjacents,12
Pandanus_acanthostylus,1,1,0,Points-PointsKO-Adjacents,9
Pandanus_acaulescens,3,3,0,Points-PointsKO-Adjacents,27
Pandanus_acladus,0,0,0,NA,0
Pandanus_adpressus,NA,NA,NA,NA,NA
Pandanus_aecuatus,0,0,0,NA,0
Pandanus_aggregatus,2,2,0,Points-PointsKO-Adjacents,18
Pandanus_akeassii,0,0,0,NA,0
Pandanus_ala-kai,0,0,0,NA,0
Pandanus_alatus,0,0,0,NA,0
Pandanus_albifrons,2,2,0,Points-PointsKO-Adjacents,18
Pandanus_aldabraensis,0,0,0,NA,0
Pandanus_alifer,NA,NA,NA,NA,NA
Pandanus_alkemadei,NA,NA,NA,NA,NA
Pandanus_alpestris,9,3,6,Points-PointsKO-Adjacents,53
Pandanus_alticola,6,0,6,Points-PointsKO-Adjacents,47
Pandanus_alticonvexus,0,0,0,NA,0
Pandanus_altissimus,9,0,9,Points-PointsKO-Adjacents,57
Pandanus_alveatus,0,0,0,NA,0
Pandanus_alveolatus,9,2,7,Points-PointsKO-Adjacents,61
Pandanus_amaryllifolius,0,0,0,NA,0
Pandanus_ambalavaoensis,1,1,0,Points-PointsKO-Adjacents,9
Pandanus_ambohitantelensis,NA,NA,NA,NA,NA
Pandanus_ambongensis,14,5,9,Points-PointsKO-Adjacents,108
Pandanus_amicalis,NA,NA,NA,NA,NA
Pandanus_amissus,NA,NA,NA,NA,NA
Pandanus_amnicola,0,0,0,NA,0
Pandanus_analamazaotrensis,5,5,0,Points-PointsKO-Adjacents,28
Pandanus_analamerensis,20,12,8,Points-PointsKO-Adjacents,81
Pandanus_ananas,NA,NA,NA,NA,NA
Pandanus_andringitrensis,6,3,3,Points-PointsKO-Adjacents,38
Pandanus_angolensis,1,1,0,Points-PointsKO-Adjacents,9
Pandanus_ankaranensis,4,4,0,Points-PointsKO-Adjacents,18
Pandanus_anomesos,NA,NA,NA,NA,NA
Pandanus_antaresensis,1,1,0,Points-PointsKO-Adjacents,9
Pandanus_apiculatus,0,0,0,NA,0
Pandanus_apoensis,2,2,0,Points-PointsKO-Adjacents,12
Pandanus_aprilensis,NA,NA,NA,NA,NA
Pandanus_aquaticus,270,240,30,Alphahull-PointsKO-Adjacents,5580
Pandanus_aragoensis,3,3,0,Points-PointsKO-Adjacents,13
Pandanus_archboldianus,3,3,0,Points-PointsKO-Adjacents,27
Pandanus_arenicola,3,3,0,Points-PointsKO-Adjacents,23
Pandanus_aridus,21,14,7,Points-PointsKO-Adjacents,148
Pandanus_arrectialatus,0,0,0,NA,0
Pandanus_assamensis,NA,NA,NA,NA,NA
Pandanus_associatus,0,0,0,NA,0
Pandanus_atropurpureus,5,5,0,Points-PointsKO-Adjacents,24
Pandanus_augustianus,NA,NA,NA,NA,NA
Pandanus_austrosinensis,2,2,0,Points-PointsKO-Adjacents,18
Pandanus_bakeri,10,5,5,Points-PointsKO-Adjacents,66
Pandanus_balansae,13,6,7,Points-PointsKO-Adjacents,62
Pandanus_balenii,4,4,0,Points-PointsKO-Adjacents,36
Pandanus_balfourii,1,1,0,Points-PointsKO-Adjacents,6
Pandanus_barai,2,2,0,Points-PointsKO-Adjacents,12
Pandanus_barbellatus,3,3,0,Points-PointsKO-Adjacents,9
Pandanus_barkleyi,1,1,0,Points-PointsKO-Adjacents,9
Pandanus_basalticola,1,1,0,Points-PointsKO-Adjacents,5
Pandanus_basedowii,40,31,9,Alphahull-PointsKO-Adjacents,119
Pandanus_basilocularis,1,1,0,Points-PointsKO-Adjacents,9
Pandanus_bathiei,0,0,0,NA,0
Pandanus_beccarii,1,1,0,Points-PointsKO-Adjacents,9
Pandanus_bemarahensis,NA,NA,NA,NA,NA
Pandanus_biceps,10,9,1,Points-PointsKO-Adjacents,18
Pandanus_bicornis,1,1,0,Points-PointsKO-Adjacents,9
Pandanus_bifidus,1,1,0,Points-PointsKO-Adjacents,9
Pandanus_bilinearis,3,3,0,Points-PointsKO-Adjacents,18
Pandanus_biliranensis,0,0,0,NA,0
Pandanus_bilobatus,NA,NA,NA,NA,NA
Pandanus_bintuniensis,1,1,0,Points-PointsKO-Adjacents,9
Pandanus_bipyramidatus,8,0,8,Points-PointsKO-Adjacents,51
Pandanus_bismarckensis,NA,NA,NA,NA,NA
Pandanus_boemiensis,0,0,0,NA,0
Pandanus_boivinii,25,16,9,Points-PointsKO-Adjacents,127
Pandanus_boninensis,1,1,0,Points-PointsKO-Adjacents,1
Pandanus_borneensis,5,4,1,Points-PointsKO-Adjacents,44
Pandanus_bowersiae,3,3,0,Points-PointsKO-Adjacents,27
Pandanus_brachus,1,1,0,Points-PointsKO-Adjacents,5
Pandanus_brachycarpus,NA,NA,NA,NA,NA
Pandanus_brachyphyllus,0,0,0,NA,0
Pandanus_brachyspathus,1,1,0,Points-PointsKO-Adjacents,9
Pandanus_bracteosus,0,0,0,NA,0
Pandanus_brassii,7,1,6,Points-PointsKO-Adjacents,49
Pandanus_brevicornutus,0,0,0,NA,0
Pandanus_breviendocarpicus,NA,NA,NA,NA,NA
Pandanus_brevifrugalis,3,3,0,Points-PointsKO-Adjacents,18
Pandanus_brevistipes,NA,NA,NA,NA,NA
Pandanus_brongniartii,NA,NA,NA,NA,NA
Pandanus_brookei,12,4,8,Points-PointsKO-Adjacents,82
Pandanus_brosimos,7,0,7,Points-PointsKO-Adjacents,63
Pandanus_bryanii,NA,NA,NA,NA,NA
Pandanus_buinensis,0,0,0,NA,0
Pandanus_bullii,NA,NA,NA,NA,NA
Pandanus_burkillianus,NA,NA,NA,NA,NA
Pandanus_burmanicus,0,0,0,NA,0
Pandanus_busuangaensis,0,0,0,NA,0
Pandanus_butayei,NA,NA,NA,NA,NA
Pandanus_calamianensis,0,0,0,NA,0
Pandanus_calathiphorus,0,0,0,NA,0
Pandanus_calceiformis,1,1,0,Points-PointsKO-Adjacents,9
Pandanus_calcicola,0,0,0,NA,0
Pandanus_calcis,3,3,0,Points-PointsKO-Adjacents,27
Pandanus_callmanderiana,9,5,4,Points-PointsKO-Adjacents,43
Pandanus_calostigma,0,0,0,NA,0
Pandanus_calvus,0,0,0,NA,0
Pandanus_camarinensis,0,0,0,NA,0
Pandanus_canaranus,1,1,0,Points-PointsKO-Adjacents,9
Pandanus_candelabrum,38,12,26,Points-PointsKO-Adjacents,289
Pandanus_capitellatus,0,0,0,NA,0
Pandanus_capusii,4,4,0,Points-PointsKO-Adjacents,33
Pandanus_caricosus,0,0,0,NA,0
Pandanus_carmichaelii,1,1,0,Points-PointsKO-Adjacents,9
Pandanus_carrii,0,0,0,NA,0
Pandanus_caudatus,1,1,0,Points-PointsKO-Adjacents,9
Pandanus_cavatus,NA,NA,NA,NA,NA
Pandanus_cephalotus,0,0,0,NA,0
Pandanus_ceratostigma,0,0,0,NA,0
Pandanus_cheilostigma,0,0,0,NA,0
Pandanus_chevalieri,0,0,0,NA,0
Pandanus_chiliocarpus,8,3,5,Points-PointsKO-Adjacents,62
Pandanus_christmatensis,1,1,0,Points-PointsKO-Adjacents,5
Pandanus_cissei,NA,NA,NA,NA,NA
Pandanus_clandestinus,6,2,4,Points-PointsKO-Adjacents,20
Pandanus_clarkei,0,0,0,NA,0
Pandanus_clausus,0,0,0,NA,0
Pandanus_clementis,1,1,0,Points-PointsKO-Adjacents,9
Pandanus_columellatus,0,0,0,NA,0
Pandanus_columnaris,5,5,0,Points-PointsKO-Adjacents,26
Pandanus_comatus,5,5,0,Points-PointsKO-Adjacents,39
Pandanus_concavus,1,1,0,Points-PointsKO-Adjacents,9
Pandanus_concinnus,2,2,0,Points-PointsKO-Adjacents,18
Pandanus_concretus,22,13,9,Points-PointsKO-Adjacents,137
Pandanus_conglomeratus,NA,NA,NA,NA,NA
Pandanus_conicus,52,40,12,Alphahull-PointsKO-Adjacents,163
Pandanus_connatus,9,6,3,Points-PointsKO-Adjacents,27
Pandanus_conoideus,23,4,19,Points-PointsKO-Adjacents,133
Pandanus_cookii,92,62,30,Alphahull-PointsKO-Adjacents,1257
Pandanus_coriaceus,12,0,12,Points-PointsKO-Adjacents,62
Pandanus_corneri,0,0,0,NA,0
Pandanus_corniferus,1,1,0,Points-PointsKO-Adjacents,7
Pandanus_crassicollis,NA,NA,NA,NA,NA
Pandanus_crassilix,NA,NA,NA,NA,NA
Pandanus_crenifer,0,0,0,NA,0
Pandanus_crinifolius,2,2,0,Points-PointsKO-Adjacents,12
Pandanus_crustatus,0,0,0,NA,0
Pandanus_cubicus,1,1,0,Points-PointsKO-Adjacents,8
Pandanus_cumingianus,2,2,0,Points-PointsKO-Adjacents,18
Pandanus_cuneatus,0,0,0,NA,0
Pandanus_cuneiformis,0,0,0,NA,0
Pandanus_cupribasalis,0,0,0,NA,0
Pandanus_cyaneoglaucescens,0,0,0,NA,0
Pandanus_daenikeri,0,0,0,NA,0
Pandanus_daitoensis,NA,NA,NA,NA,NA
Pandanus_dammannii,7,0,7,Points-PointsKO-Adjacents,59
Pandanus_darwinensis,15,5,10,Points-PointsKO-Adjacents,106
Pandanus_dasodes,1,1,0,Points-PointsKO-Adjacents,9
Pandanus_dasystigma,0,0,0,NA,0
Pandanus_dauphinensis,6,3,3,Points-PointsKO-Adjacents,27
Pandanus_daymanensis,0,0,0,NA,0
Pandanus_decastigma,2,2,0,Points-PointsKO-Adjacents,16
Pandanus_decipiens,3,3,0,Points-PointsKO-Adjacents,25
Pandanus_decumbens,15,8,7,Points-PointsKO-Adjacents,92
Pandanus_decus-montium,0,0,0,NA,0
Pandanus_denudatus,NA,NA,NA,NA,NA
Pandanus_depauperatus,0,0,0,NA,0
Pandanus_dictyotus,NA,NA,NA,NA,NA
Pandanus_diffusus,10,3,7,Points-PointsKO-Adjacents,76
Pandanus_dinagatensis,0,0,0,NA,0
Pandanus_distentus,NA,NA,NA,NA,NA
Pandanus_diversus,1,1,0,Points-PointsKO-Adjacents,9
Pandanus_djalonensis,NA,NA,NA,NA,NA
Pandanus_dolichopodus,1,1,0,Points-PointsKO-Adjacents,9
Pandanus_dorystigma,3,3,0,Points-PointsKO-Adjacents,27
Pandanus_drupaceus,NA,NA,NA,NA,NA
Pandanus_dubius,11,2,9,Points-PointsKO-Adjacents,63
Pandanus_durio,NA,NA,NA,NA,NA
Pandanus_dyckioides,34,24,10,Alphahull-PointsKO-Adjacents,296
Pandanus_dyeri,NA,NA,NA,NA,NA
Pandanus_echinodermops,NA,NA,NA,NA,NA
Pandanus_echinops,NA,NA,NA,NA,NA
Pandanus_edulis,NA,NA,NA,NA,NA
Pandanus_efateensis,0,0,0,NA,0
Pandanus_elatus,0,0,0,NA,0
Pandanus_emarginatus,1,1,0,Points-PointsKO-Adjacents,9
Pandanus_ensifolius,0,0,0,NA,0
Pandanus_erectus,3,3,0,Points-PointsKO-Adjacents,11
Pandanus_esculentus,3,3,0,Points-PointsKO-Adjacents,27
Pandanus_evexus,0,0,0,NA,0
Pandanus_exaltatus,3,2,1,Points-PointsKO-Adjacents,24
Pandanus_exiguus,0,0,0,NA,0
Pandanus_eydouxia,1,1,0,Points-PointsKO-Adjacents,9
Pandanus_fanningensis,NA,NA,NA,NA,NA
Pandanus_farakoensis,NA,NA,NA,NA,NA
Pandanus_faviger,0,0,0,NA,0
Pandanus_fetosus,0,0,0,NA,0
Pandanus_fidelis,NA,NA,NA,NA,NA
Pandanus_flagellaris,5,5,0,Points-PointsKO-Adjacents,36
Pandanus_flagellibracteatus,16,11,5,Points-PointsKO-Adjacents,75
Pandanus_flintinsularis,0,0,0,NA,0
Pandanus_floribundus,1,1,0,Points-PointsKO-Adjacents,9
Pandanus_forbesii,0,0,0,NA,0
Pandanus_forsteri,13,0,13,Points-PointsKO-Adjacents,5
Pandanus_foveolatus,5,5,0,Points-PointsKO-Adjacents,44
Pandanus_freetownensis,NA,NA,NA,NA,NA
Pandanus_fruticosus,0,0,0,NA,0
Pandanus_furcatus,5,5,0,Points-PointsKO-Adjacents,36
Pandanus_fusinus,7,0,7,Points-PointsKO-Adjacents,54
Pandanus_gabonensis,7,2,5,Points-PointsKO-Adjacents,35
Pandanus_galeatus,0,0,0,NA,0
Pandanus_galorei,1,1,0,Points-PointsKO-Adjacents,9
Pandanus_gazelleensis,NA,NA,NA,NA,NA
Pandanus_gemmiferus,6,1,5,Points-PointsKO-Adjacents,39
Pandanus_gibberosus,NA,NA,NA,NA,NA
Pandanus_gilbertanus,NA,NA,NA,NA,NA
Pandanus_gillespiei,NA,NA,NA,NA,NA
Pandanus_gladiifolius,NA,NA,NA,NA,NA
Pandanus_glaphyros,NA,NA,NA,NA,NA
Pandanus_glauciferus,0,0,0,NA,0
Pandanus_glaucocephalus,1,1,0,Points-PointsKO-Adjacents,9
Pandanus_globatus,5,5,0,Points-PointsKO-Adjacents,35
Pandanus_gossweileri,0,0,0,NA,0
Pandanus_gracilialatus,0,0,0,NA,0
Pandanus_gracilis,1,1,0,Points-PointsKO-Adjacents,9
Pandanus_grallatus,4,4,0,Points-PointsKO-Adjacents,27
Pandanus_graminifolius,1,1,0,Points-PointsKO-Adjacents,9
Pandanus_granulosus,NA,NA,NA,NA,NA
Pandanus_grusonianus,NA,NA,NA,NA,NA
Pandanus_guillaumetii,18,6,12,Points-PointsKO-Adjacents,94
Pandanus_guineabissauensis,0,0,0,NA,0
Pandanus_halleorum,3,3,0,Points-PointsKO-Adjacents,22
Pandanus_hata,1,1,0,Points-PointsKO-Adjacents,5
Pandanus_helicopus,1,1,0,Points-PointsKO-Adjacents,9
Pandanus_hemisphaericus,1,1,0,Points-PointsKO-Adjacents,9
Pandanus_hermaphroditus,NA,NA,NA,NA,NA
Pandanus_hermesii,NA,NA,NA,NA,NA
Pandanus_hermsianus,0,0,0,NA,0
Pandanus_heterocarpus,0,0,0,NA,0
Pandanus_heterostigma,NA,NA,NA,NA,NA
Pandanus_hooglandii,2,2,0,Points-PointsKO-Adjacents,9
Pandanus_houlletii,2,1,1,Points-PointsKO-Adjacents,18
Pandanus_humericus,0,0,0,NA,0
Pandanus_huynhii,0,0,0,NA,0
Pandanus_hystrix,0,0,0,NA,0
Pandanus_iceryi,1,1,0,Points-PointsKO-Adjacents,9
Pandanus_ijzermannii,NA,NA,NA,NA,NA
Pandanus_imerinensis,6,0,6,Points-PointsKO-Adjacents,30
Pandanus_immersus,0,0,0,NA,0
Pandanus_induratus,NA,NA,NA,NA,NA
Pandanus_insolitus,NA,NA,NA,NA,NA
Pandanus_insuetus,2,2,0,Points-PointsKO-Adjacents,16
Pandanus_interior,0,0,0,NA,0
Pandanus_intricatus,0,0,0,NA,0
Pandanus_inundatus,NA,NA,NA,NA,NA
Pandanus_involutus,0,0,0,NA,0
Pandanus_irregularis,0,0,0,NA,0
Pandanus_isalicus,1,1,0,Points-PointsKO-Adjacents,9
Pandanus_isis,NA,NA,NA,NA,NA
Pandanus_iwen,NA,NA,NA,NA,NA
Pandanus_jaffrei,NA,NA,NA,NA,NA
Pandanus_johorensis,NA,NA,NA,NA,NA
Pandanus_joskei,2,2,0,Points-PointsKO-Adjacents,18
Pandanus_julianettii,4,4,0,Points-PointsKO-Adjacents,32
Pandanus_juliferus,0,0,0,NA,0
Pandanus_kabaenaensis,NA,NA,NA,NA,NA
Pandanus_kaernbachii,9,0,9,Points-PointsKO-Adjacents,62
Pandanus_kaida,4,4,0,Points-PointsKO-Adjacents,36
Pandanus_kajewskii,0,0,0,NA,0
Pandanus_kajui,3,3,0,Points-PointsKO-Adjacents,26
Pandanus_kamiae,3,3,0,Points-PointsKO-Adjacents,27
Pandanus_kanehirae,0,0,0,NA,0
Pandanus_katatonos,NA,NA,NA,NA,NA
Pandanus_kaviengensis,0,0,0,NA,0
Pandanus_kedahensis,0,0,0,NA,0
Pandanus_kerchovei,NA,NA,NA,NA,NA
Pandanus_kimlangii,9,3,6,Points-PointsKO-Adjacents,72
Pandanus_kinabaluensis,4,4,0,Points-PointsKO-Adjacents,18
Pandanus_kirkii,10,0,10,Points-PointsKO-Adjacents,58
Pandanus_klossii,1,1,0,Points-PointsKO-Adjacents,9
Pandanus_koordersii,0,0,0,NA,0
Pandanus_krauelianus,54,21,33,Alphahull-PointsKO-Adjacents,385
Pandanus_kuepferi,2,2,0,Points-PointsKO-Adjacents,18
Pandanus_kusaicolus,0,0,0,NA,0
Pandanus_labyrinthicus,0,0,0,NA,0
Pandanus_lachaisei,0,0,0,NA,0
Pandanus_lacuum,6,2,4,Points-PointsKO-Adjacents,16
Pandanus_laferrerei,NA,NA,NA,NA,NA
Pandanus_lageniformis,NA,NA,NA,NA,NA
Pandanus_lais,1,1,0,Points-PointsKO-Adjacents,9
Pandanus_lamekotensis,NA,NA,NA,NA,NA
Pandanus_lamprocephalus,0,0,0,NA,0
Pandanus_lanutooensis,NA,NA,NA,NA,NA
Pandanus_lateralis,0,0,0,NA,0
Pandanus_laticonvexus,0,0,0,NA,0
Pandanus_latiloculatus,2,1,1,Points-PointsKO-Adjacents,16
Pandanus_latior,0,0,0,NA,0
Pandanus_latistigmaticus,6,2,4,Points-PointsKO-Adjacents,24
Pandanus_laxespicatus,3,3,0,Points-PointsKO-Adjacents,23
Pandanus_leiophyllus,0,0,0,NA,0
Pandanus_leptocarpus,0,0,0,NA,0
Pandanus_leptocaulis,1,1,0,Points-PointsKO-Adjacents,9
Pandanus_leptopodus,30,15,15,Points-PointsKO-Adjacents,152
Pandanus_leram,0,0,0,NA,0
Pandanus_leuconotus,2,2,0,Points-PointsKO-Adjacents,18
Pandanus_levuensis,2,2,0,Points-PointsKO-Adjacents,17
Pandanus_liberiensis,0,0,0,NA,0
Pandanus_lifouensis,0,0,0,NA,0
Pandanus_ligulatus,NA,NA,NA,NA,NA
Pandanus_limbatus,4,4,0,Points-PointsKO-Adjacents,36
Pandanus_linguiformis,5,5,0,Points-PointsKO-Adjacents,27
Pandanus_livingstonianus,5,5,0,Points-PointsKO-Adjacents,45
Pandanus_loherianus,0,0,0,NA,0
Pandanus_longicaudatus,1,1,0,Points-PointsKO-Adjacents,9
Pandanus_longicuspidatus,NA,NA,NA,NA,NA
Pandanus_longipedunculatus,0,0,0,NA,0
Pandanus_longipes,6,1,5,Points-PointsKO-Adjacents,52
Pandanus_longissimipedunculatus,NA,NA,NA,NA,NA
Pandanus_longissimus,NA,NA,NA,NA,NA
Pandanus_longistylus,7,1,6,Points-PointsKO-Adjacents,31
Pandanus_lorencei,0,0,0,NA,0
Pandanus_luzonensis,3,3,0,Points-PointsKO-Adjacents,27
Pandanus_macrophyllus,1,1,0,Points-PointsKO-Adjacents,9
Pandanus_maevaranensis,NA,NA,NA,NA,NA
Pandanus_magnicavernosus,0,0,0,NA,0
Pandanus_majungensis,0,0,0,NA,0
Pandanus_malgassicus,20,5,15,Points-PointsKO-Adjacents,91
Pandanus_mammillaris,9,4,5,Points-PointsKO-Adjacents,53
Pandanus_manamboloensis,8,5,3,Points-PointsKO-Adjacents,46
Pandanus_manensis,0,0,0,NA,0
Pandanus_mangokensis,9,0,9,Points-PointsKO-Adjacents,68
Pandanus_mapola,1,1,0,Points-PointsKO-Adjacents,8
Pandanus_mareensis,0,0,0,NA,0
Pandanus_marginatus,0,0,0,NA,0
Pandanus_marinus,1,1,0,Points-PointsKO-Adjacents,6
Pandanus_marojejicus,3,3,0,Points-PointsKO-Adjacents,14
Pandanus_maromokotrensis,3,3,0,Points-PointsKO-Adjacents,18
Pandanus_martellii,3,2,1,Points-PointsKO-Adjacents,25
Pandanus_mauricei,NA,NA,NA,NA,NA
Pandanus_maximus,0,0,0,NA,0
Pandanus_mayotteensis,1,1,0,Points-PointsKO-Adjacents,9
Pandanus_mc-keei,0,0,0,NA,0
Pandanus_medialis,NA,NA,NA,NA,NA
Pandanus_megacarpus,NA,NA,NA,NA,NA
Pandanus_membranaceus,2,2,0,Points-PointsKO-Adjacents,9
Pandanus_menicostigma,1,1,0,Points-PointsKO-Adjacents,9
Pandanus_mesos,NA,NA,NA,NA,NA
Pandanus_metaceus,NA,NA,NA,NA,NA
Pandanus_micracanthus,NA,NA,NA,NA,NA
Pandanus_microcarpus,1,1,0,Points-PointsKO-Adjacents,9
Pandanus_microcephalus,6,2,4,Points-PointsKO-Adjacents,42
Pandanus_microstigma,0,0,0,NA,0
Pandanus_militaris,1,0,1,Points-PointsKO-Adjacents,9
Pandanus_mindanaensis,1,1,0,Points-PointsKO-Adjacents,9
Pandanus_minimus,0,0,0,NA,0
Pandanus_moalaensis,0,0,0,NA,0
Pandanus_monophalanx,0,0,0,NA,0
Pandanus_montanus,1,1,0,Points-PointsKO-Adjacents,9
Pandanus_multibracteatus,0,0,0,NA,0
Pandanus_multidentatus,NA,NA,NA,NA,NA
Pandanus_multidrupaceus,1,1,0,Points-PointsKO-Adjacents,9
Pandanus_multifurcatus,0,0,0,NA,0
Pandanus_multispicatus,2,1,1,Points-PointsKO-Adjacents,7
Pandanus_muralis,NA,NA,NA,NA,NA
Pandanus_muricatus,20,7,13,Points-PointsKO-Adjacents,116
Pandanus_mussauensis,NA,NA,NA,NA,NA
Pandanus_myriocarpus,12,4,8,Points-PointsKO-Adjacents,79
Pandanus_namakiensis,7,2,5,Points-PointsKO-Adjacents,54
Pandanus_navicularis,NA,NA,NA,NA,NA
Pandanus_navigatorum,0,0,0,NA,0
Pandanus_nemoralis,0,0,0,NA,0
Pandanus_neoleptopodus,10,1,9,Points-PointsKO-Adjacents,61
Pandanus_neomecklenburgensis,NA,NA,NA,NA,NA
Pandanus_nervosus,0,0,0,NA,0
Pandanus_ngunaensis,0,0,0,NA,0
Pandanus_nitidus,0,0,0,NA,0
Pandanus_nobilis,0,0,0,NA,0
Pandanus_nogarete,1,1,0,Points-PointsKO-Adjacents,9
Pandanus_noumeaensis,0,0,0,NA,0
Pandanus_novibritannicus,0,0,0,NA,0
Pandanus_novohibernicus,0,0,0,NA,0
Pandanus_nusbaumeri,2,2,0,Points-PointsKO-Adjacents,18
Pandanus_obconicus,NA,NA,NA,NA,NA
Pandanus_obeliscus,NA,NA,NA,NA,NA
Pandanus_oblatus,11,3,8,Points-PointsKO-Adjacents,37
Pandanus_oblongicapitellatus,NA,NA,NA,NA,NA
Pandanus_oblongus,NA,NA,NA,NA,NA
Pandanus_obovatus,2,2,0,Points-PointsKO-Adjacents,18
Pandanus_obsoletus,0,0,0,NA,0
Pandanus_occultus,0,0,0,NA,0
Pandanus_odorifer,37,14,23,Points-PointsKO-Adjacents,177
Pandanus_oligocarpus,25,12,13,Points-PointsKO-Adjacents,136
Pandanus_oligocephalus,19,8,11,Points-PointsKO-Adjacents,106
Pandanus_onesuaensis,0,0,0,NA,0
Pandanus_orculiformis,0,0,0,NA,0
Pandanus_ornatus,0,0,0,NA,0
Pandanus_ouveaensis,0,0,0,NA,0
Pandanus_pakari,0,0,0,NA,0
Pandanus_palawensis,NA,NA,NA,NA,NA
Pandanus_pallidus,1,0,1,Points-PointsKO-Adjacents,9
Pandanus_paloensis,1,1,0,Points-PointsKO-Adjacents,9
Pandanus_paludosus,0,0,0,NA,0
Pandanus_palustris,1,1,0,Points-PointsKO-Adjacents,9
Pandanus_panayensis,0,0,0,NA,0
Pandanus_pancheri,22,14,8,Points-PointsKO-Adjacents,79
Pandanus_papuanus,9,1,8,Points-PointsKO-Adjacents,79
Pandanus_paracalensis,0,0,0,NA,0
Pandanus_parachevalieri,0,0,0,NA,0
Pandanus_parou,0,0,0,NA,0
Pandanus_parvicentralis,1,1,0,Points-PointsKO-Adjacents,9
Pandanus_patelliformis,0,0,0,NA,0
Pandanus_patina,0,0,0,NA,0
Pandanus_paucicarpellatus,NA,NA,NA,NA,NA
Pandanus_peekelii,NA,NA,NA,NA,NA
Pandanus_penangensis,0,0,0,NA,0
Pandanus_pendulinus,0,0,0,NA,0
Pandanus_penetrans,3,3,0,Points-PointsKO-Adjacents,27
Pandanus_penicillus,1,1,0,Points-PointsKO-Adjacents,9
Pandanus_pentodon,0,0,0,NA,0
Pandanus_perrieri,6,0,6,Points-PointsKO-Adjacents,27
Pandanus_pervilleanus,34,13,21,Points-PointsKO-Adjacents,175
Pandanus_petrosus,1,1,0,Points-PointsKO-Adjacents,9
Pandanus_peyrierasii,6,0,6,Points-PointsKO-Adjacents,33
Pandanus_philippinensis,0,0,0,NA,0
Pandanus_pinensis,0,0,0,NA,0
Pandanus_piniformis,1,1,0,Points-PointsKO-Adjacents,9
Pandanus_piricus,0,0,0,NA,0
Pandanus_pistikos,0,0,0,NA,0
Pandanus_pistos,NA,NA,NA,NA,NA
Pandanus_pitcairnensis,NA,NA,NA,NA,NA
Pandanus_planatus,NA,NA,NA,NA,NA
Pandanus_platycarpus,NA,NA,NA,NA,NA
Pandanus_platyphyllus,8,0,8,Points-PointsKO-Adjacents,45
Pandanus_pleiocephalus,0,0,0,NA,0
Pandanus_pluriaculeatus,9,6,3,Points-PointsKO-Adjacents,36
Pandanus_pluriloculatus,5,5,0,Points-PointsKO-Adjacents,26
Pandanus_polyacris,0,0,0,NA,0
Pandanus_polycephalus,19,0,19,Points-PointsKO-Adjacents,127
Pandanus_polyglossus,4,4,0,Points-PointsKO-Adjacents,12
Pandanus_prainii,NA,NA,NA,NA,NA
Pandanus_princeps,3,3,0,Points-PointsKO-Adjacents,19
Pandanus_pristis,6,3,3,Points-PointsKO-Adjacents,26
Pandanus_pritchardiae,NA,NA,NA,NA,NA
Pandanus_problematicus,NA,NA,NA,NA,NA
Pandanus_prostratus,1,1,0,Points-PointsKO-Adjacents,9
Pandanus_pseudobathiei,9,5,4,Points-PointsKO-Adjacents,66
Pandanus_pseudochevalieri,NA,NA,NA,NA,NA
Pandanus_pugnax,2,2,0,Points-PointsKO-Adjacents,18
Pandanus_pukapukaensis,NA,NA,NA,NA,NA
Pandanus_pulcher,0,0,0,NA,0
Pandanus_punctulatus,NA,NA,NA,NA,NA
Pandanus_pungens,NA,NA,NA,NA,NA
Pandanus_puniceus,NA,NA,NA,NA,NA
Pandanus_purpurascens,0,0,0,NA,0
Pandanus_pweleensis,0,0,0,NA,0
Pandanus_pyramidalis,0,0,0,NA,0
Pandanus_pyramidos,NA,NA,NA,NA,NA
Pandanus_quadrifidus,0,0,0,NA,0
Pandanus_quinarius,0,0,0,NA,0
Pandanus_rabaiensis,20,6,14,Points-PointsKO-Adjacents,125
Pandanus_rabaulensis,0,0,0,NA,0
Pandanus_radicans,1,1,0,Points-PointsKO-Adjacents,9
Pandanus_radifer,0,0,0,NA,0
Pandanus_radula,1,1,0,Points-PointsKO-Adjacents,9
Pandanus_ramosii,0,0,0,NA,0
Pandanus_rapensis,NA,NA,NA,NA,NA
Pandanus_raynalii,6,2,4,Points-PointsKO-Adjacents,32
Pandanus_recavilapideus,NA,NA,NA,NA,NA
Pandanus_recavisaxosus,NA,NA,NA,NA,NA
Pandanus_rechingeri,0,0,0,NA,0
Pandanus_reclinatus,1,1,0,Points-PointsKO-Adjacents,9
Pandanus_rectus,NA,NA,NA,NA,NA
Pandanus_regalis,NA,NA,NA,NA,NA
Pandanus_reineckei,1,1,0,Points-PointsKO-Adjacents,6
Pandanus_reticulatus,5,3,2,Points-PointsKO-Adjacents,41
Pandanus_reticulosus,1,1,0,Points-PointsKO-Adjacents,9
Pandanus_retusus,NA,NA,NA,NA,NA
Pandanus_rex,NA,NA,NA,NA,NA
Pandanus_rheophilus,2,2,0,Points-PointsKO-Adjacents,12
Pandanus_robinsonii,0,0,0,NA,0
Pandanus_rollotii,10,1,9,Points-PointsKO-Adjacents,53
Pandanus_rostratus,1,1,0,Points-PointsKO-Adjacents,9
Pandanus_rotumaensis,1,1,0,Points-PointsKO-Adjacents,5
Pandanus_rubricinctus,1,1,0,Points-PointsKO-Adjacents,5
Pandanus_salailuaensis,0,0,0,NA,0
Pandanus_sambiranensis,17,11,6,Points-PointsKO-Adjacents,63
Pandanus_samoensis,1,1,0,Points-PointsKO-Adjacents,5
Pandanus_sandakanensis,0,0,0,NA,0
Pandanus_sarasinorum,6,0,6,Points-PointsKO-Adjacents,54
Pandanus_satabiei,2,2,0,Points-PointsKO-Adjacents,16
Pandanus_saxatilis,14,10,4,Points-PointsKO-Adjacents,61
Pandanus_schoddei,0,0,0,NA,0
Pandanus_scopula,NA,NA,NA,NA,NA
Pandanus_scopulorum,NA,NA,NA,NA,NA
Pandanus_scortechini,0,0,0,NA,0
Pandanus_sechellarum,1,0,1,Points-PointsKO-Adjacents,7
Pandanus_semiarmatus,8,3,5,Points-PointsKO-Adjacents,54
Pandanus_semipilaris,NA,NA,NA,NA,NA
Pandanus_senegalensis,0,0,0,NA,0
Pandanus_sermollianus,4,4,0,Points-PointsKO-Adjacents,29
Pandanus_serpentinicus,2,2,0,Points-PointsKO-Adjacents,17
Pandanus_serratus,NA,NA,NA,NA,NA
Pandanus_sibuyanensis,1,1,0,Points-PointsKO-Adjacents,8
Pandanus_sierraleonensis,1,1,0,Points-PointsKO-Adjacents,7
Pandanus_sikassoensis,NA,NA,NA,NA,NA
Pandanus_silvanus,NA,NA,NA,NA,NA
Pandanus_simplex,4,3,1,Points-PointsKO-Adjacents,33
Pandanus_singaporensis,0,0,0,NA,0
Pandanus_sinicola,0,0,0,NA,0
Pandanus_solms-laubachii,64,0,64,Points-PointsKO-Adjacents,262
Pandanus_solomonensis,0,0,0,NA,0
Pandanus_sparganioides,1,1,0,Points-PointsKO-Adjacents,9
Pandanus_spathulatus,0,0,0,NA,0
Pandanus_sphaerocephalus,3,3,0,Points-PointsKO-Adjacents,25
Pandanus_sphaeroideus,3,3,0,Points-PointsKO-Adjacents,12
Pandanus_spheniskos,1,1,0,Points-PointsKO-Adjacents,9
Pandanus_spicatus,3,3,0,Points-PointsKO-Adjacents,12
Pandanus_spinifer,9,2,7,Points-PointsKO-Adjacents,57
Pandanus_spinistigmaticus,0,0,0,NA,0
Pandanus_spiralis,2219,2153,66,Alphahull-PointsKO-Adjacents,9045
Pandanus_spissus,0,0,0,NA,0
Pandanus_spondiophyllus,NA,NA,NA,NA,NA
Pandanus_stellatus,3,3,0,Points-PointsKO-Adjacents,27
Pandanus_stelliger,0,0,0,NA,0
Pandanus_stipiformis,NA,NA,NA,NA,NA
Pandanus_subacaulis,0,0,0,NA,0
Pandanus_subcylindricus,NA,NA,NA,NA,NA
Pandanus_subglobosus,0,0,0,NA,0
Pandanus_subulorum,0,0,0,NA,0
Pandanus_sulawesicus,0,0,0,NA,0
Pandanus_sulcatus,NA,NA,NA,NA,NA
Pandanus_sumatranus,0,0,0,NA,0
Pandanus_sykesii,0,0,0,NA,0
Pandanus_sylvestris,0,0,0,NA,0
Pandanus_sylvicola,6,0,6,Points-PointsKO-Adjacents,18
Pandanus_tabellarius,3,3,0,Points-PointsKO-Adjacents,27
Pandanus_taveuniensis,1,1,0,Points-PointsKO-Adjacents,9
Pandanus_tazoanii,3,3,0,Points-PointsKO-Adjacents,21
Pandanus_tectorius,164,59,105,Alphahull-PointsKO-Adjacents,906
Pandanus_tenuiflagellatus,0,0,0,NA,0
Pandanus_tenuifolius,0,0,0,NA,0
Pandanus_tenuimarginatus,NA,NA,NA,NA,NA
Pandanus_tenuipedunculatus,0,0,0,NA,0
Pandanus_teuszii,0,0,0,NA,0
Pandanus_thomensis,1,1,0,Points-PointsKO-Adjacents,8
Pandanus_tiassaleensis,0,0,0,NA,0
Pandanus_tolanarensis,8,5,3,Points-PointsKO-Adjacents,46
Pandanus_toliarensis,0,0,0,NA,0
Pandanus_tongatapuensis,NA,NA,NA,NA,NA
Pandanus_triangularis,0,0,0,NA,0
Pandanus_tsaratananensis,9,6,3,Points-PointsKO-Adjacents,31
Pandanus_tubulatus,NA,NA,NA,NA,NA
Pandanus_turritus,9,4,5,Points-PointsKO-Adjacents,23
Pandanus_tutuilaensis,0,0,0,NA,0
Pandanus_umbonatus,0,0,0,NA,0
Pandanus_unguifer,1,1,0,Points-PointsKO-Adjacents,9
Pandanus_unicornutus,2,2,0,Points-PointsKO-Adjacents,18
Pandanus_urophyllus,2,2,0,Points-PointsKO-Adjacents,18
Pandanus_utilis,21,11,10,Points-PointsKO-Adjacents,57
Pandanus_validus,NA,NA,NA,NA,NA
Pandanus_vandamii,8,4,4,Points-PointsKO-Adjacents,50
Pandanus_vandermeeschii,1,1,0,Points-PointsKO-Adjacents,6
Pandanus_variabilis,16,9,7,Points-PointsKO-Adjacents,107
Pandanus_vavauensis,0,0,0,NA,0
Pandanus_veillonii,NA,NA,NA,NA,NA
Pandanus_verecundus,1,1,0,Points-PointsKO-Adjacents,9
Pandanus_verticalis,NA,NA,NA,NA,NA
Pandanus_vinaceus,0,0,0,NA,0
Pandanus_viscidus,4,4,0,Points-PointsKO-Adjacents,34
Pandanus_vitiensis,4,4,0,Points-PointsKO-Adjacents,35
Pandanus_vogelensis,0,0,0,NA,0
Pandanus_welwitschii,1,1,0,Points-PointsKO-Adjacents,9
Pandanus_whitmeeanus,3,3,0,Points-PointsKO-Adjacents,25
Pandanus_wiehei,0,0,0,NA,0
Pandanus_wilderi,0,0,0,NA,0
Pandanus_yandeensis,NA,NA,NA,NA,NA
Pandanus_yasawaensis,NA,NA,NA,NA,NA
Pandanus_yirrkalaensis,2,2,0,Points-PointsKO-Adjacents,9
Pandanus_yoshioi,NA,NA,NA,NA,NA
Pandanus_yuleensis,1,1,0,Points-PointsKO-Adjacents,8
Pandanus_yvanii,8,0,8,Points-PointsKO-Adjacents,69
Pandanus_zamboangensis,1,1,0,Points-PointsKO-Adjacents,9
Pangium_edule,98,47,51,Alphahull-PointsKO-Adjacents,1756
Panopsis_acostana,33,26,7,Alphahull-PointsKO-Adjacents,135
Panopsis_antioquensis,22,11,11,Points-PointsKO-Adjacents,135
Panopsis_cinnamomea,5,5,0,Points-PointsKO-Adjacents,42
Panopsis_costaricensis,82,67,15,Alphahull-PointsKO-Adjacents,195
Panopsis_macrocarpa,3,3,0,Points-PointsKO-Adjacents,26
Panopsis_megistosperma,17,8,9,Points-PointsKO-Adjacents,126
Panopsis_mucronata,24,9,15,Points-PointsKO-Adjacents,171
Panopsis_multiflora,29,8,21,Points-PointsKO-Adjacents,211
Panopsis_pearcei,27,14,13,Points-PointsKO-Adjacents,135
Panopsis_polystachya,65,38,27,Alphahull-PointsKO-Adjacents,1871
Panopsis_rectistyla,3,3,0,Points-PointsKO-Adjacents,27
Panopsis_roldosii,21,12,9,Points-PointsKO-Adjacents,87
Panopsis_rubescens,622,539,83,Alphahull-PointsKO-Adjacents,64466
Panopsis_sessilifolia,144,93,51,Alphahull-PointsKO-Adjacents,6994
Panopsis_suaveolens,74,42,32,Alphahull-PointsKO-Adjacents,2262
Panopsis_tepuiana,8,3,5,Points-PointsKO-Adjacents,51
Panopsis_yolombo,52,39,13,Alphahull-PointsKO-Adjacents,514
Panopsis_yungasensis,12,7,5,Points-PointsKO-Adjacents,87
Pantadenia_chauvetiae,4,4,0,Points-PointsKO-Adjacents,30
Panurea_longifolia,12,7,5,Points-PointsKO-Adjacents,82
Agapetes_vitiensis,1,1,0,Points-PointsKO-Adjacents,9
Pappea_capensis,263,190,73,Alphahull-PointsKO-Adjacents,14329
Pappobolus_sanchezii,1,1,0,Points-PointsKO-Adjacents,9
Papuacedrus_papuana,208,175,33,Alphahull-PointsKO-Adjacents,2735
Paracalyx_balfouri,4,4,0,Points-PointsKO-Adjacents,27
Paracephaelis_cinerea,26,9,17,Points-PointsKO-Adjacents,157
Paracephaelis_saxatilis,21,15,6,Points-PointsKO-Adjacents,94
Paracephaelis_trichantha,9,1,8,Points-PointsKO-Adjacents,51
Parachimarrhis_breviloba,30,8,22,Points-PointsKO-Adjacents,255
Paracorynanthe_antankarana,20,14,6,Points-PointsKO-Adjacents,66
Paracorynanthe_uropetala,5,5,0,Points-PointsKO-Adjacents,33
Paracroton_integrifolius,NA,NA,NA,NA,NA
Paracroton_pendulus,35,7,28,Points-PointsKO-Adjacents,267
Paracroton_sterrhopodus,NA,NA,NA,NA,NA
Paracroton_zeylanicus,3,3,0,Points-PointsKO-Adjacents,27
Paracryphia_alticola,20,7,13,Points-PointsKO-Adjacents,93
Paradombeya_sinensis,6,1,5,Points-PointsKO-Adjacents,51
Paradrypetes_ilicifolia,46,0,46,Points-PointsKO-Adjacents,310
Paradrypetes_subintegrifolia,11,0,11,Points-PointsKO-Adjacents,89
Paragenipa_lancifolia,2,2,0,Points-PointsKO-Adjacents,16
Paragynoxys_martingrantii,11,4,7,Points-PointsKO-Adjacents,63
Paragynoxys_neodendroides,18,11,7,Points-PointsKO-Adjacents,83
Paragynoxys_regis,6,1,5,Points-PointsKO-Adjacents,48
Paragynoxys_undatifolia,3,3,0,Points-PointsKO-Adjacents,12
Paragynoxys_uribei,18,12,6,Points-PointsKO-Adjacents,96
Parahancornia_amara,16,3,13,Points-PointsKO-Adjacents,135
Parahancornia_fasciculata,150,84,66,Alphahull-PointsKO-Adjacents,13064
Parahancornia_krukovii,28,5,23,Points-PointsKO-Adjacents,205
Parahancornia_negroensis,52,39,13,Alphahull-PointsKO-Adjacents,1171
Parahancornia_oblonga,122,86,36,Alphahull-PointsKO-Adjacents,6230
Parahancornia_peruviana,42,29,13,Alphahull-PointsKO-Adjacents,753
Parahancornia_surrogata,106,85,21,Alphahull-PointsKO-Adjacents,3173
Paraia_bracteata,42,13,29,Points-PointsKO-Adjacents,284
Parajubaea_cocoides,11,2,9,Points-PointsKO-Adjacents,97
Parajubaea_sunkha,5,5,0,Points-PointsKO-Adjacents,21
Parajubaea_torallyi,9,5,4,Points-PointsKO-Adjacents,43
Paralychnophora_atkinsiae,10,7,3,Points-PointsKO-Adjacents,18
Paralychnophora_bicolor,132,108,24,Alphahull-PointsKO-Adjacents,1063
Paralychnophora_harleyi,101,93,8,Alphahull-PointsKO-Adjacents,378
Paralychnophora_patriciana,10,5,5,Points-PointsKO-Adjacents,46
Paralychnophora_reflexoauriculata,81,68,13,Alphahull-PointsKO-Adjacents,910
Paramachaerium_gruberi,12,6,6,Points-PointsKO-Adjacents,50
Paramachaerium_krukovii,8,0,8,Points-PointsKO-Adjacents,62
Paramachaerium_ormosioides,32,13,19,Points-PointsKO-Adjacents,218
Paramachaerium_schomburgkii,16,5,11,Points-PointsKO-Adjacents,105
Paramachaerium_schunkei,4,4,0,Points-PointsKO-Adjacents,36
Paramacrolobium_coeruleum,59,23,36,Alphahull-PointsKO-Adjacents,735
Parameria_laevigata,52,5,47,Points-PointsKO-Adjacents,418
Parameria_polyneura,7,0,7,Points-PointsKO-Adjacents,52
Paranecepsia_alchorneifolia,15,9,6,Points-PointsKO-Adjacents,110
Paranephelium_hainanense,NA,NA,NA,NA,NA
Paranephelium_hystrix,0,0,0,NA,0
Paranephelium_spirei,15,2,13,Points-PointsKO-Adjacents,105
Parapiptadenia_blanchetii,55,40,15,Alphahull-PointsKO-Adjacents,2029
Parapiptadenia_excelsa,151,107,44,Alphahull-PointsKO-Adjacents,2378
Parapiptadenia_ilheusana,5,5,0,Points-PointsKO-Adjacents,33
Parapiptadenia_pterosperma,146,0,146,Points-PointsKO-Adjacents,773
Parapiptadenia_rigida,760,680,80,Alphahull-PointsKO-Adjacents,14920
Parapiptadenia_zehntneri,347,0,347,Points-PointsKO-Adjacents,2028
Pararchidendron_pruinosum,624,533,91,Alphahull-PointsKO-Adjacents,2699
Parasassafras_confertiflorum,12,5,7,Points-PointsKO-Adjacents,65
Paraserianthes_lophantha,597,454,143,Alphahull-PointsKO-Adjacents,6655
Shorea_buchananii,0,0,0,NA,0
Parashorea_chinensis,9,3,6,Points-PointsKO-Adjacents,81
Shorea_lucida,3,0,3,Points-PointsKO-Adjacents,27
Shorea_malaanonan,3,0,3,Points-PointsKO-Adjacents,27
Parastemon_grandifructus,7,0,7,Points-PointsKO-Adjacents,63
Parastemon_urophyllus,45,19,26,Points-PointsKO-Adjacents,349
Parastemon_versteeghii,35,7,28,Points-PointsKO-Adjacents,197
Parastyrax_lacei,3,3,0,Points-PointsKO-Adjacents,27
Parastyrax_macrophyllus,NA,NA,NA,NA,NA
Paratecoma_peroba,56,0,56,Points-PointsKO-Adjacents,393
Parathesis_acostensis,31,24,7,Alphahull-PointsKO-Adjacents,163
Parathesis_adenanthera,75,42,33,Alphahull-PointsKO-Adjacents,3439
Parathesis_aeruginosa,16,3,13,Points-PointsKO-Adjacents,120
Parathesis_agostiniana,3,3,0,Points-PointsKO-Adjacents,27
Parathesis_amazonica,30,11,19,Points-PointsKO-Adjacents,261
Parathesis_amplifolia,43,33,10,Alphahull-PointsKO-Adjacents,206
Parathesis_angustifolia,6,1,5,Points-PointsKO-Adjacents,46
Parathesis_aurantiaca,9,3,6,Points-PointsKO-Adjacents,55
Parathesis_breedlovei,9,6,3,Points-PointsKO-Adjacents,37
Parathesis_calophylla,15,1,14,Points-PointsKO-Adjacents,117
Parathesis_candolleana,25,15,10,Points-PointsKO-Adjacents,166
Parathesis_cartagoana,16,9,7,Points-PointsKO-Adjacents,76
Parathesis_chiapensis,126,105,21,Alphahull-PointsKO-Adjacents,1396
Parathesis_cintalapana,8,1,7,Points-PointsKO-Adjacents,42
Parathesis_columnaris,26,13,13,Points-PointsKO-Adjacents,182
Parathesis_costaricensis,30,22,8,Alphahull-PointsKO-Adjacents,146
Parathesis_crassiramea,19,13,6,Points-PointsKO-Adjacents,90
Parathesis_crenulata,30,16,14,Points-PointsKO-Adjacents,154
Parathesis_croatii,2,1,1,Points-PointsKO-Adjacents,16
Parathesis_cubana,241,213,28,Alphahull-PointsKO-Adjacents,2698
Parathesis_donnell-smithii,238,201,37,Alphahull-PointsKO-Adjacents,4835
Parathesis_eggersiana,2,2,0,Points-PointsKO-Adjacents,18
Parathesis_fusca,39,25,14,Alphahull-PointsKO-Adjacents,538
Parathesis_glaberrima,2,1,1,Points-PointsKO-Adjacents,16
Parathesis_glabra,94,80,14,Alphahull-PointsKO-Adjacents,191
Parathesis_glendae,6,1,5,Points-PointsKO-Adjacents,28
Parathesis_kallunkiae,3,3,0,Points-PointsKO-Adjacents,27
Parathesis_lanceolata,15,6,9,Points-PointsKO-Adjacents,107
Parathesis_laxa,1,1,0,Points-PointsKO-Adjacents,9
Parathesis_leptopa,83,62,21,Alphahull-PointsKO-Adjacents,701
Parathesis_longipedicellata,12,8,4,Points-PointsKO-Adjacents,48
Parathesis_macrantha,15,7,8,Points-PointsKO-Adjacents,103
Parathesis_macronema,40,23,17,Alphahull-PointsKO-Adjacents,723
Parathesis_melanosticta,151,117,34,Alphahull-PointsKO-Adjacents,2577
Parathesis_microcalyx,36,14,22,Points-PointsKO-Adjacents,236
Parathesis_montana,5,5,0,Points-PointsKO-Adjacents,33
Parathesis_moritziana,4,4,0,Points-PointsKO-Adjacents,30
Parathesis_multiflora,4,4,0,Points-PointsKO-Adjacents,36
Parathesis_palaciosii,5,5,0,Points-PointsKO-Adjacents,36
Parathesis_panamensis,13,4,9,Points-PointsKO-Adjacents,94
Parathesis_papillosa,8,3,5,Points-PointsKO-Adjacents,59
Parathesis_perpunctata,7,2,5,Points-PointsKO-Adjacents,45
Parathesis_pipolyana,2,2,0,Points-PointsKO-Adjacents,18
Parathesis_pleurobotryosa,9,6,3,Points-PointsKO-Adjacents,54
Parathesis_pseudocalophylla,1,1,0,Points-PointsKO-Adjacents,9
Parathesis_pseudocrassiramea,3,3,0,Points-PointsKO-Adjacents,26
Parathesis_reflexa,13,9,4,Points-PointsKO-Adjacents,65
Parathesis_rothschuhiana,17,11,6,Points-PointsKO-Adjacents,122
Parathesis_rufa,15,7,8,Points-PointsKO-Adjacents,109
Parathesis_seibertii,18,10,8,Points-PointsKO-Adjacents,62
Parathesis_serrulata,11,5,6,Points-PointsKO-Adjacents,81
Parathesis_sessilifolia,60,0,60,Points-PointsKO-Adjacents,277
Parathesis_skutchii,7,3,4,Points-PointsKO-Adjacents,44
Parathesis_subcoriacea,9,4,5,Points-PointsKO-Adjacents,59
Parathesis_subulata,22,15,7,Points-PointsKO-Adjacents,108
Parathesis_tartarea,10,4,6,Points-PointsKO-Adjacents,72
Parathesis_tomentosa,6,0,6,Points-PointsKO-Adjacents,50
Parathesis_trichogyne,89,68,21,Alphahull-PointsKO-Adjacents,1438
Parathesis_vestita,6,2,4,Points-PointsKO-Adjacents,33
Parathesis_vulgata,27,16,11,Points-PointsKO-Adjacents,145
Parathesis_williamsii,3,3,0,Points-PointsKO-Adjacents,21
Parathesis_zuliana,4,4,0,Points-PointsKO-Adjacents,12
Parinari_alvimii,25,14,11,Points-PointsKO-Adjacents,88
Parinari_anamensis,30,14,16,Points-PointsKO-Adjacents,226
Parinari_argenteosericea,2,2,0,Points-PointsKO-Adjacents,18
Parinari_brasiliensis,14,0,14,Points-PointsKO-Adjacents,108
Parinari_campestris,266,212,54,Alphahull-PointsKO-Adjacents,18932
Parinari_canarioides,8,0,8,Points-PointsKO-Adjacents,72
Parinari_cardiophylla,8,0,8,Points-PointsKO-Adjacents,55
Parinari_chocoensis,20,10,10,Points-PointsKO-Adjacents,118
Parinari_congensis,159,116,43,Alphahull-PointsKO-Adjacents,6177
Parinari_congolana,6,1,5,Points-PointsKO-Adjacents,54
Parinari_costata,27,3,24,Points-PointsKO-Adjacents,226
Parinari_curatellifolia,805,666,139,Alphahull-PointsKO-Adjacents,31595
Parinari_elmeri,5,0,5,Points-PointsKO-Adjacents,39
Parinari_excelsa,946,734,212,Alphahull-PointsKO-Adjacents,68894
Parinari_gigantea,1,1,0,Points-PointsKO-Adjacents,9
Parinari_hypochrysea,27,18,9,Points-PointsKO-Adjacents,200
Parinari_insularum,25,13,12,Points-PointsKO-Adjacents,133
Parinari_klugii,114,78,36,Alphahull-PointsKO-Adjacents,7782
Parinari_leontopitheci,12,4,8,Points-PointsKO-Adjacents,71
Parinari_littoralis,40,23,17,Alphahull-PointsKO-Adjacents,224
Parinari_maguirei,21,11,10,Points-PointsKO-Adjacents,137
Parinari_metallica,1,1,0,Points-PointsKO-Adjacents,9
Parinari_montana,88,38,50,Alphahull-PointsKO-Adjacents,2177
Parinari_nonda,400,344,56,Alphahull-PointsKO-Adjacents,5204
Parinari_oblongifolia,26,12,14,Points-PointsKO-Adjacents,219
Parinari_obtusifolia,261,193,68,Alphahull-PointsKO-Adjacents,12367
Parinari_occidentalis,93,52,41,Alphahull-PointsKO-Adjacents,5239
Parinari_pachyphylla,117,92,25,Alphahull-PointsKO-Adjacents,6350
Parinari_papuana,44,17,27,Points-PointsKO-Adjacents,239
Parinari_parilis,89,61,28,Alphahull-PointsKO-Adjacents,2602
Parinari_parva,16,8,8,Points-PointsKO-Adjacents,137
Parinari_parvifolia,35,7,28,Points-PointsKO-Adjacents,277
Parinari_prancei,1,1,0,Points-PointsKO-Adjacents,9
Parinari_rigida,8,0,8,Points-PointsKO-Adjacents,71
Parinari_rodolphii,98,63,35,Alphahull-PointsKO-Adjacents,8056
Parinari_romeroi,6,0,6,Points-PointsKO-Adjacents,48
Parinari_sprucei,105,77,28,Alphahull-PointsKO-Adjacents,5463
Parinari_sumatrana,3,0,3,Points-PointsKO-Adjacents,26
Parkia_bahiae,28,14,14,Points-PointsKO-Adjacents,113
Parkia_balslevii,74,62,12,Alphahull-PointsKO-Adjacents,606
Parkia_barnebyana,9,2,7,Points-PointsKO-Adjacents,75
Parkia_bicolor,216,166,50,Alphahull-PointsKO-Adjacents,4628
Parkia_biglandulosa,2,1,1,Points-PointsKO-Adjacents,18
Parkia_biglobosa,441,388,53,Alphahull-PointsKO-Adjacents,8530
Parkia_cachimboensis,21,17,4,Points-PointsKO-Adjacents,120
Parkia_decussata,68,31,37,Alphahull-PointsKO-Adjacents,1794
Parkia_discolor,195,155,40,Alphahull-PointsKO-Adjacents,7793
Parkia_filicina,0,0,0,NA,0
Parkia_filicoidea,39,9,30,Points-PointsKO-Adjacents,303
Parkia_gigantocarpa,59,25,34,Alphahull-PointsKO-Adjacents,951
Parkia_igneiflora,161,120,41,Alphahull-PointsKO-Adjacents,6981
Parkia_intermedia,0,0,0,NA,0
Parkia_javanica,0,0,0,NA,0
Parkia_korom,1,1,0,Points-PointsKO-Adjacents,8
Parkia_leiophylla,4,4,0,Points-PointsKO-Adjacents,35
Parkia_lutea,8,2,6,Points-PointsKO-Adjacents,64
Parkia_madagascariensis,12,7,5,Points-PointsKO-Adjacents,84
Parkia_multijuga,285,214,71,Alphahull-PointsKO-Adjacents,36325
Parkia_nitida,547,464,83,Alphahull-PointsKO-Adjacents,51076
Parkia_panurensis,257,198,59,Alphahull-PointsKO-Adjacents,18563
Parkia_paraensis,11,2,9,Points-PointsKO-Adjacents,99
Parkia_parrii,0,0,0,NA,0
Parkia_parvifoliola,0,0,0,NA,0
Parkia_paya,NA,NA,NA,NA,NA
Parkia_pendula,717,570,147,Alphahull-PointsKO-Adjacents,66333
Parkia_platycephala,372,329,43,Alphahull-PointsKO-Adjacents,13940
Parkia_reticulata,17,2,15,Points-PointsKO-Adjacents,124
Parkia_sherfeseei,0,0,0,NA,0
Parkia_singularis,10,0,10,Points-PointsKO-Adjacents,75
Parkia_speciosa,29,7,22,Points-PointsKO-Adjacents,208
Parkia_sumatrana,5,0,5,Points-PointsKO-Adjacents,44
Parkia_timoriana,15,1,14,Points-PointsKO-Adjacents,124
Parkia_truncata,1,1,0,Points-PointsKO-Adjacents,9
Parkia_ulei,183,129,54,Alphahull-PointsKO-Adjacents,18648
Parkia_velutina,156,98,58,Alphahull-PointsKO-Adjacents,15634
Parkia_versteeghii,6,1,5,Points-PointsKO-Adjacents,29
Parkinsonia_aculeata,1211,831,380,Alphahull-PointsKO-Adjacents,40361
Parkinsonia_africana,90,65,25,Alphahull-PointsKO-Adjacents,3062
Parkinsonia_anacantha,5,5,0,Points-PointsKO-Adjacents,45
Parkinsonia_peruviana,4,4,0,Points-PointsKO-Adjacents,21
Parkinsonia_raimondoi,NA,NA,NA,NA,NA
Parkinsonia_scioana,4,4,0,Points-PointsKO-Adjacents,36
Parmentiera_aculeata,507,417,90,Alphahull-PointsKO-Adjacents,8313
Parmentiera_cereifera,9,6,3,Points-PointsKO-Adjacents,31
Parmentiera_dressleri,4,4,0,Points-PointsKO-Adjacents,26
Parmentiera_macrophylla,51,35,16,Alphahull-PointsKO-Adjacents,287
Parmentiera_millspaughiana,95,71,24,Alphahull-PointsKO-Adjacents,669
Parmentiera_morii,2,2,0,Points-PointsKO-Adjacents,9
Parmentiera_parviflora,11,1,10,Points-PointsKO-Adjacents,68
Parmentiera_stenocarpa,10,7,3,Points-PointsKO-Adjacents,71
Parmentiera_trunciflora,6,2,4,Points-PointsKO-Adjacents,37
Parmentiera_valerii,3,3,0,Points-PointsKO-Adjacents,18
Parodiodendron_marginivillosum,21,6,15,Points-PointsKO-Adjacents,174
Paropsia_braunii,34,14,20,Points-PointsKO-Adjacents,257
Paropsia_edulis,75,52,23,Alphahull-PointsKO-Adjacents,737
Paropsia_grandiflora,13,8,5,Points-PointsKO-Adjacents,58
Paropsia_grewioides,43,0,43,Points-PointsKO-Adjacents,271
Paropsia_guineensis,41,10,31,Points-PointsKO-Adjacents,254
Paropsia_humblotii,29,12,17,Points-PointsKO-Adjacents,160
Paropsia_madagascariensis,9,3,6,Points-PointsKO-Adjacents,61
Paropsia_obscura,14,8,6,Points-PointsKO-Adjacents,59
Paropsia_perrieri,3,3,0,Points-PointsKO-Adjacents,18
Paropsia_varecifomis,3,1,2,Points-PointsKO-Adjacents,21
Paropsiopsis_decandra,44,31,13,Alphahull-PointsKO-Adjacents,1012
Parrotia_persica,9,0,9,Points-PointsKO-Adjacents,62
Parrotia_subaequalis,1,1,0,Points-PointsKO-Adjacents,9
Parrotiopsis_jacquemontiana,8,3,5,Points-PointsKO-Adjacents,66
Parthenium_fruticosum,54,43,11,Alphahull-PointsKO-Adjacents,652
Parthenium_schottii,49,32,17,Alphahull-PointsKO-Adjacents,83
Passerina_falcifolia,34,23,11,Alphahull-PointsKO-Adjacents,212
Passiflora_arborea,156,123,33,Alphahull-PointsKO-Adjacents,2286
Passiflora_linearistipula,4,4,0,Points-PointsKO-Adjacents,21
Passiflora_macrophylla,106,82,24,Alphahull-PointsKO-Adjacents,1630
Passiflora_putumayensis,12,5,7,Points-PointsKO-Adjacents,75
Passiflora_sphaerocarpa,50,34,16,Alphahull-PointsKO-Adjacents,452
Passiflora_tica,96,75,21,Alphahull-PointsKO-Adjacents,621
Passiflora_tina,4,3,1,Points-PointsKO-Adjacents,27
Patinoa_almirajo,26,11,15,Points-PointsKO-Adjacents,200
Patinoa_ichthyotoxica,12,0,12,Points-PointsKO-Adjacents,95
Patinoa_paraensis,45,21,24,Alphahull-PointsKO-Adjacents,838
Patinoa_sphaerocarpa,11,0,11,Points-PointsKO-Adjacents,99
Pauldopia_ghorta,9,0,9,Points-PointsKO-Adjacents,81
Paullinia_allenii,4,3,1,Points-PointsKO-Adjacents,34
Paullinia_cuneata,63,34,29,Alphahull-PointsKO-Adjacents,4583
Paullinia_gigantea,31,10,21,Points-PointsKO-Adjacents,237
Paullinia_pterocarpa,104,56,48,Alphahull-PointsKO-Adjacents,1924
Paulownia_catalpifolia,0,0,0,NA,0
Paulownia_elongata,6,1,5,Points-PointsKO-Adjacents,54
Paulownia_fargesii,39,21,18,Alphahull-PointsKO-Adjacents,2286
Paulownia_fortunei,97,64,33,Alphahull-PointsKO-Adjacents,9535
Paulownia_kawakamii,15,9,6,Points-PointsKO-Adjacents,85
Paulownia_taiwaniana,9,3,6,Points-PointsKO-Adjacents,66
Paulownia_tomentosa,902,596,306,Alphahull-PointsKO-Adjacents,18142
Pauridiantha_afzelii,57,35,22,Alphahull-PointsKO-Adjacents,3130
Pauridiantha_arcuata,8,5,3,Points-PointsKO-Adjacents,65
Pauridiantha_bequaertii,11,1,10,Points-PointsKO-Adjacents,84
Pauridiantha_bridelioides,17,8,9,Points-PointsKO-Adjacents,95
Pauridiantha_callicarpoides,146,101,45,Alphahull-PointsKO-Adjacents,9156
Pauridiantha_canthiiflora,115,96,19,Alphahull-PointsKO-Adjacents,3122
Pauridiantha_coalescens,22,14,8,Points-PointsKO-Adjacents,66
Pauridiantha_dewevrei,145,96,49,Alphahull-PointsKO-Adjacents,13421
Pauridiantha_efferata,20,12,8,Points-PointsKO-Adjacents,156
Pauridiantha_floribunda,118,91,27,Alphahull-PointsKO-Adjacents,3138
Pauridiantha_hirsuta,2,2,0,Points-PointsKO-Adjacents,18
Pauridiantha_hirtella,101,61,40,Alphahull-PointsKO-Adjacents,1079
Pauridiantha_insularis,1,1,0,Points-PointsKO-Adjacents,9
Pauridiantha_kizuensis,1,1,0,Points-PointsKO-Adjacents,9
Pauridiantha_liebrechtsiana,50,27,23,Alphahull-PointsKO-Adjacents,4293
Pauridiantha_longistipula,6,1,5,Points-PointsKO-Adjacents,36
Pauridiantha_microphylla,3,3,0,Points-PointsKO-Adjacents,27
Pauridiantha_multiflora,20,12,8,Points-PointsKO-Adjacents,130
Pauridiantha_paucinervis,410,335,75,Alphahull-PointsKO-Adjacents,11847
Pauridiantha_pleiantha,5,5,0,Points-PointsKO-Adjacents,29
Pauridiantha_pyramidata,89,61,28,Alphahull-PointsKO-Adjacents,12134
Pauridiantha_rubens,33,8,25,Points-PointsKO-Adjacents,233
Pauridiantha_smetsiana,11,9,2,Points-PointsKO-Adjacents,27
Pauridiantha_stipulosa,19,9,10,Points-PointsKO-Adjacents,128
Pauridiantha_sylvicola,58,38,20,Alphahull-PointsKO-Adjacents,1256
Pauridiantha_symplocoides,20,9,11,Points-PointsKO-Adjacents,105
Pauridiantha_talbotii,80,64,16,Alphahull-PointsKO-Adjacents,837
Pauridiantha_udzungwaensis,8,0,8,Points-PointsKO-Adjacents,48
Pauridiantha_viridiflora,93,57,36,Alphahull-PointsKO-Adjacents,6442
Pauridiantha_ziamaeana,35,27,8,Alphahull-PointsKO-Adjacents,911
Pausandra_fordii,20,13,7,Points-PointsKO-Adjacents,113
Pausandra_hirsuta,62,23,39,Alphahull-PointsKO-Adjacents,2810
Pausandra_macropetala,73,44,29,Alphahull-PointsKO-Adjacents,4603
Pausandra_macrostachya,20,0,20,Points-PointsKO-Adjacents,80
Pausandra_martini,120,67,53,Alphahull-PointsKO-Adjacents,4765
Pausandra_megalophylla,30,0,30,Points-PointsKO-Adjacents,189
Pausandra_morisiana,291,1,290,Points-PointsKO-Adjacents,1544
Pausandra_trianae,120,62,58,Alphahull-PointsKO-Adjacents,5564
Pausinystalia_brachythyrsum,7,2,5,Points-PointsKO-Adjacents,55
Pavetta_abyssinica,73,42,31,Alphahull-PointsKO-Adjacents,2531
Pavetta_akeassii,16,7,9,Points-PointsKO-Adjacents,113
Pavetta_ankolensis,6,2,4,Points-PointsKO-Adjacents,36
Pavetta_axillipara,9,5,4,Points-PointsKO-Adjacents,21
Pavetta_bagshawei,31,0,31,Points-PointsKO-Adjacents,231
Pavetta_barbertonensis,10,5,5,Points-PointsKO-Adjacents,72
Pavetta_barnesii,0,0,0,NA,0
Pavetta_bilineata,1,1,0,Points-PointsKO-Adjacents,9
Pavetta_birmahica,0,0,0,NA,0
Pavetta_brachyantha,0,0,0,NA,0
Pavetta_breviflora,0,0,0,NA,0
Pavetta_capensis,50,29,21,Alphahull-PointsKO-Adjacents,802
Pavetta_cellulosa,9,0,9,Points-PointsKO-Adjacents,57
Pavetta_chapmanii,4,4,0,Points-PointsKO-Adjacents,25
Pavetta_comostyla,32,15,17,Points-PointsKO-Adjacents,173
Pavetta_cooperi,53,43,10,Alphahull-PointsKO-Adjacents,996
Pavetta_corymbosa,282,222,60,Alphahull-PointsKO-Adjacents,4962
Pavetta_crassicaulis,0,0,0,NA,0
Pavetta_crassipes,407,341,66,Alphahull-PointsKO-Adjacents,5817
Pavetta_delicatifolia,1,1,0,Points-PointsKO-Adjacents,9
Pavetta_diversicalyx,8,4,4,Points-PointsKO-Adjacents,36
Pavetta_edentula,46,33,13,Alphahull-PointsKO-Adjacents,529
Pavetta_eylesii,47,31,16,Alphahull-PointsKO-Adjacents,1720
Pavetta_gardeniifolia,293,194,99,Alphahull-PointsKO-Adjacents,20677
Pavetta_gerstneri,9,0,9,Points-PointsKO-Adjacents,73
Pavetta_gossweileri,1,1,0,Points-PointsKO-Adjacents,9
Pavetta_graciliflora,0,0,0,NA,0
Pavetta_greenwayi,2,2,0,Points-PointsKO-Adjacents,12
Pavetta_haareri,1,1,0,Points-PointsKO-Adjacents,9
Pavetta_hispidula,0,0,0,NA,0
Pavetta_holstii,35,29,6,Alphahull-PointsKO-Adjacents,292
Pavetta_hongkongensis,43,24,19,Alphahull-PointsKO-Adjacents,2386
Pavetta_hookeriana,29,22,7,Alphahull-PointsKO-Adjacents,123
Pavetta_hymenophylla,51,34,17,Alphahull-PointsKO-Adjacents,537
Pavetta_inandensis,41,1,40,Points-PointsKO-Adjacents,353
Pavetta_indica,5,1,4,Points-PointsKO-Adjacents,44
Pavetta_intermedia,30,15,15,Points-PointsKO-Adjacents,249
Pavetta_involucrata,1,1,0,Points-PointsKO-Adjacents,9
Pavetta_johnstonii,18,6,12,Points-PointsKO-Adjacents,108
Pavetta_kedahica,0,0,0,NA,0
Pavetta_kimberleyana,83,68,15,Alphahull-PointsKO-Adjacents,2070
Pavetta_kupensis,13,10,3,Points-PointsKO-Adjacents,21
Pavetta_kyimbilensis,36,25,11,Alphahull-PointsKO-Adjacents,362
Pavetta_lanceolata,83,51,32,Alphahull-PointsKO-Adjacents,2169
Pavetta_lasioclada,39,14,25,Points-PointsKO-Adjacents,253
Pavetta_laxa,2,2,0,Points-PointsKO-Adjacents,18
Pavetta_leonensis,2,2,0,Points-PointsKO-Adjacents,18
Pavetta_linearifolia,15,5,10,Points-PointsKO-Adjacents,102
Pavetta_longibrachiata,17,11,6,Points-PointsKO-Adjacents,117
Pavetta_luzonica,0,0,0,NA,0
Pavetta_lynesii,48,38,10,Alphahull-PointsKO-Adjacents,207
Pavetta_macrosepala,15,8,7,Points-PointsKO-Adjacents,96
Pavetta_manyanguensis,4,4,0,Points-PointsKO-Adjacents,26
Pavetta_micheliana,8,3,5,Points-PointsKO-Adjacents,63
Pavetta_micropunctata,3,3,0,Points-PointsKO-Adjacents,23
Pavetta_mollissima,9,6,3,Points-PointsKO-Adjacents,65
Pavetta_molundensis,37,22,15,Alphahull-PointsKO-Adjacents,684
Pavetta_montana,4,4,0,Points-PointsKO-Adjacents,36
Pavetta_monticola,8,4,4,Points-PointsKO-Adjacents,14
Pavetta_muelleri,89,70,19,Alphahull-PointsKO-Adjacents,1565
Pavetta_namatae,2,2,0,Points-PointsKO-Adjacents,9
Pavetta_natalensis,9,2,7,Points-PointsKO-Adjacents,79
Pavetta_naucleiflora,2,2,0,Points-PointsKO-Adjacents,18
Pavetta_neurocarpa,62,54,8,Alphahull-PointsKO-Adjacents,241
Pavetta_nitidissima,7,4,3,Points-PointsKO-Adjacents,35
Pavetta_nitidula,82,40,42,Alphahull-PointsKO-Adjacents,3897
Pavetta_novoguineensis,3,3,0,Points-PointsKO-Adjacents,27
Pavetta_oliveriana,72,40,32,Alphahull-PointsKO-Adjacents,3361
Pavetta_opulina,20,8,12,Points-PointsKO-Adjacents,111
Pavetta_owariensis,82,57,25,Alphahull-PointsKO-Adjacents,2129
Pavetta_pitardii,0,0,0,NA,0
Pavetta_platycalyx,21,13,8,Points-PointsKO-Adjacents,121
Pavetta_platyclada,1,1,0,Points-PointsKO-Adjacents,9
Pavetta_pleiantha,NA,NA,NA,NA,NA
Pavetta_pseudoalbicaulis,9,3,6,Points-PointsKO-Adjacents,70
Pavetta_revoluta,69,33,36,Alphahull-PointsKO-Adjacents,1320
Pavetta_robusta,5,5,0,Points-PointsKO-Adjacents,45
Pavetta_ruttenii,1,1,0,Points-PointsKO-Adjacents,9
Pavetta_salicina,7,1,6,Points-PointsKO-Adjacents,52
Pavetta_sansibarica,24,18,6,Points-PointsKO-Adjacents,75
Pavetta_schumanniana,163,100,63,Alphahull-PointsKO-Adjacents,13477
Pavetta_siamica,2,2,0,Points-PointsKO-Adjacents,18
Pavetta_siphonantha,0,0,0,NA,0
Pavetta_sparsipila,14,9,5,Points-PointsKO-Adjacents,53
Pavetta_sphaerobotrys,25,13,12,Points-PointsKO-Adjacents,136
Pavetta_staudtii,36,27,9,Alphahull-PointsKO-Adjacents,577
Pavetta_subcana,18,7,11,Points-PointsKO-Adjacents,128
Pavetta_subcapitata,0,0,0,NA,0
Pavetta_subumbellata,31,19,12,Points-PointsKO-Adjacents,179
Pavetta_subvelutina,NA,NA,NA,NA,NA
Pavetta_sylvatica,8,0,8,Points-PointsKO-Adjacents,72
Pavetta_tarennoides,11,8,3,Points-PointsKO-Adjacents,26
Pavetta_teitana,20,11,9,Points-PointsKO-Adjacents,138
Pavetta_tendagurensis,8,2,6,Points-PointsKO-Adjacents,59
Pavetta_termitaria,0,0,0,NA,0
Pavetta_ternifolia,52,40,12,Alphahull-PointsKO-Adjacents,531
Pavetta_tomentosa,7,1,6,Points-PointsKO-Adjacents,63
Pavetta_travancorica,0,0,0,NA,0
Pavetta_trichardtensis,21,14,7,Points-PointsKO-Adjacents,154
Pavetta_umtalensis,3,3,0,Points-PointsKO-Adjacents,21
Pavetta_uniflora,7,0,7,Points-PointsKO-Adjacents,63
Pavetta_urundensis,21,14,7,Points-PointsKO-Adjacents,90
Pavetta_williamsii,0,0,0,NA,0
Pavetta_yambatensis,1,1,0,Points-PointsKO-Adjacents,9
Pavetta_zeyheri,82,0,82,Points-PointsKO-Adjacents,686
Pavieasia_anamensis,5,1,4,Points-PointsKO-Adjacents,45
Pavieasia_kwangsiensis,1,1,0,Points-PointsKO-Adjacents,9
Pavieasia_yunnanensis,2,2,0,Points-PointsKO-Adjacents,18
Pavonia_alnifolia,27,0,27,Points-PointsKO-Adjacents,127
Pavonia_aurantia,0,0,0,NA,0
Pavonia_bahamensis,2,2,0,Points-PointsKO-Adjacents,14
Pavonia_calyculosa,32,1,31,Points-PointsKO-Adjacents,212
Pavonia_candida,95,64,31,Alphahull-PointsKO-Adjacents,1765
Pavonia_cauliflora,2,2,0,Points-PointsKO-Adjacents,15
Pavonia_ciliata,3,3,0,Points-PointsKO-Adjacents,20
Pavonia_commutata,6,2,4,Points-PointsKO-Adjacents,54
Pavonia_crassipedicellata,6,2,4,Points-PointsKO-Adjacents,49
Pavonia_crispa,1,1,0,Points-PointsKO-Adjacents,9
Pavonia_dasypetala,88,60,28,Alphahull-PointsKO-Adjacents,732
Pavonia_ducke-limae,7,0,7,Points-PointsKO-Adjacents,38
Pavonia_goetheoides,5,5,0,Points-PointsKO-Adjacents,34
Pavonia_leucantha,42,16,26,Points-PointsKO-Adjacents,311
Pavonia_makoyana,85,66,19,Alphahull-PointsKO-Adjacents,344
Pavonia_malacophylla,603,30,573,Alphahull-PointsKO-Adjacents,3823
Pavonia_morii,23,15,8,Points-PointsKO-Adjacents,100
Pavonia_paludicola,89,31,58,Alphahull-PointsKO-Adjacents,607
Pavonia_pleuranthera,40,25,15,Alphahull-PointsKO-Adjacents,375
Pavonia_sancti,6,1,5,Points-PointsKO-Adjacents,48
Pavonia_semiserrata,10,7,3,Points-PointsKO-Adjacents,64
Pavonia_spectabilis,1,1,0,Points-PointsKO-Adjacents,9
Pavonia_spinifex,54,19,35,Points-PointsKO-Adjacents,341
Pavonia_stipularis,7,1,6,Points-PointsKO-Adjacents,29
Pavonia_troyana,5,5,0,Points-PointsKO-Adjacents,30
Payena_acuminata,11,1,10,Points-PointsKO-Adjacents,90
Payena_annamensis,0,0,0,NA,0
Payena_dantung,0,0,0,NA,0
Payena_dasyphylla,3,3,0,Points-PointsKO-Adjacents,27
Payena_endertii,0,0,0,NA,0
Payena_ferruginea,2,2,0,Points-PointsKO-Adjacents,18
Payena_gigas,3,2,1,Points-PointsKO-Adjacents,27
Payena_grandistipula,0,0,0,NA,0
Payena_kapitensis,0,0,0,NA,0
Payena_khoonmengiana,1,1,0,Points-PointsKO-Adjacents,9
Payena_kinabaluensis,0,0,0,NA,0
Payena_lamii,0,0,0,NA,0
Payena_leerii,3,1,2,Points-PointsKO-Adjacents,27
Payena_longipedicellata,1,0,1,Points-PointsKO-Adjacents,9
Payena_lucida,13,7,6,Points-PointsKO-Adjacents,90
Payena_maingayi,7,1,6,Points-PointsKO-Adjacents,45
Payena_microphylla,3,2,1,Points-PointsKO-Adjacents,27
Payena_obscura,3,0,3,Points-PointsKO-Adjacents,27
Payena_pseudoterminalis,1,1,0,Points-PointsKO-Adjacents,9
Payena_selangorica,0,0,0,NA,0
Payera_bakeriana,8,1,7,Points-PointsKO-Adjacents,58
Payera_conspicua,0,0,0,NA,0
Payera_decaryi,13,9,4,Points-PointsKO-Adjacents,38
Payera_glabrifolia,3,3,0,Points-PointsKO-Adjacents,27
Payera_madagascariensis,3,3,0,Points-PointsKO-Adjacents,27
Payera_mandrarensis,20,8,12,Points-PointsKO-Adjacents,139
Paypayrola_blanchetiana,164,0,164,Points-PointsKO-Adjacents,712
Paypayrola_grandiflora,370,284,86,Alphahull-PointsKO-Adjacents,20320
Paypayrola_guianensis,101,63,38,Alphahull-PointsKO-Adjacents,3166
Paypayrola_hulkiana,24,19,5,Points-PointsKO-Adjacents,180
Paypayrola_longifolia,174,144,30,Alphahull-PointsKO-Adjacents,5993
Peddiea_africana,187,93,94,Alphahull-PointsKO-Adjacents,2756
Peddiea_arborescens,0,0,0,NA,0
Peddiea_fischeri,94,54,40,Alphahull-PointsKO-Adjacents,1405
Peddiea_involucrata,104,78,26,Alphahull-PointsKO-Adjacents,1122
Peddiea_kivuensis,12,5,7,Points-PointsKO-Adjacents,77
Peddiea_orophila,18,10,8,Points-PointsKO-Adjacents,113
Peddiea_polyantha,30,0,30,Points-PointsKO-Adjacents,130
Peddiea_puberula,6,1,5,Points-PointsKO-Adjacents,32
Peddiea_rapaneoides,22,14,8,Points-PointsKO-Adjacents,143
Peddiea_subcordata,28,17,11,Points-PointsKO-Adjacents,105
Peddiea_thulinii,2,2,0,Points-PointsKO-Adjacents,9
Pehria_compacta,195,163,32,Alphahull-PointsKO-Adjacents,3263
Pelagodoxa_henryana,1,1,0,Points-PointsKO-Adjacents,6
Pelea_elliptica,2,2,0,Points-PointsKO-Adjacents,15
Plaesiantha_lobbii,12,0,12,Points-PointsKO-Adjacents,79
Pellacalyx_yunnanensis,1,1,0,Points-PointsKO-Adjacents,9
Pelliciera_rhizophorae,115,69,46,Alphahull-PointsKO-Adjacents,2232
Peltanthera_floribunda,61,1,60,Points-PointsKO-Adjacents,357
Peltogyne_altissima,5,5,0,Points-PointsKO-Adjacents,43
Peltogyne_angustiflora,45,27,18,Alphahull-PointsKO-Adjacents,561
Peltogyne_campestris,46,21,25,Alphahull-PointsKO-Adjacents,2385
Peltogyne_catingae,62,0,62,Points-PointsKO-Adjacents,446
Peltogyne_chrysopis,13,7,6,Points-PointsKO-Adjacents,71
Peltogyne_discolor,67,37,30,Alphahull-PointsKO-Adjacents,1522
Peltogyne_excelsa,12,4,8,Points-PointsKO-Adjacents,91
Peltogyne_floribunda,42,0,42,Points-PointsKO-Adjacents,313
Peltogyne_gracilipes,10,1,9,Points-PointsKO-Adjacents,67
Peltogyne_heterophylla,37,19,18,Points-PointsKO-Adjacents,305
Peltogyne_lecointei,8,0,8,Points-PointsKO-Adjacents,66
Peltogyne_maranhensis,29,10,19,Points-PointsKO-Adjacents,257
Peltogyne_mattosiana,7,1,6,Points-PointsKO-Adjacents,62
Peltogyne_mexicana,11,4,7,Points-PointsKO-Adjacents,79
Peltogyne_paniculata,313,258,55,Alphahull-PointsKO-Adjacents,29904
Peltogyne_paradoxa,11,3,8,Points-PointsKO-Adjacents,93
Peltogyne_parvifolia,19,0,19,Points-PointsKO-Adjacents,170
Peltogyne_pauciflora,230,206,24,Alphahull-PointsKO-Adjacents,7605
Peltogyne_prancei,15,0,15,Points-PointsKO-Adjacents,113
Peltogyne_purpurea,62,39,23,Alphahull-PointsKO-Adjacents,298
Peltogyne_recifensis,23,8,15,Points-PointsKO-Adjacents,169
Peltogyne_subsessilis,17,0,17,Points-PointsKO-Adjacents,134
Peltogyne_venosa,400,0,400,Points-PointsKO-Adjacents,2820
Peltophorum_acutifolium,5,5,0,Points-PointsKO-Adjacents,36
Peltophorum_africanum,255,202,53,Alphahull-PointsKO-Adjacents,14944
Peltophorum_dubium,1232,1110,122,Alphahull-PointsKO-Adjacents,32888
Peltophorum_pterocarpum,264,116,148,Alphahull-PointsKO-Adjacents,1816
Peltophorum_racemosum,7,0,7,Points-PointsKO-Adjacents,52
Peltophorum_venezuelense,1,1,0,Points-PointsKO-Adjacents,9
Peltostigma_guatemalense,69,48,21,Alphahull-PointsKO-Adjacents,294
Peltostigma_pteleoides,89,55,34,Alphahull-PointsKO-Adjacents,604
Pemphis_acidula,283,158,125,Alphahull-PointsKO-Adjacents,3518
Penianthus_longifolius,207,181,26,Alphahull-PointsKO-Adjacents,5720
Penianthus_zenkeri,43,24,19,Alphahull-PointsKO-Adjacents,592
Plectomirtha_baylisiana,NA,NA,NA,NA,NA
Pentabrachion_reticulatum,82,60,22,Alphahull-PointsKO-Adjacents,1327
Pentacalia_tolimensis,21,14,7,Points-PointsKO-Adjacents,106
Pentacalia_trichopus,22,12,10,Points-PointsKO-Adjacents,115
Pentaceras_australis,36,25,11,Alphahull-PointsKO-Adjacents,219
Pentachlaena_betamponensis,6,2,4,Points-PointsKO-Adjacents,12
Pentachlaena_latifolia,20,0,20,Points-PointsKO-Adjacents,21
Pentachlaena_orientalis,18,0,18,Points-PointsKO-Adjacents,76
Pentaclethra_eetveldeana,100,81,19,Alphahull-PointsKO-Adjacents,3162
Pentaclethra_macroloba,506,418,88,Alphahull-PointsKO-Adjacents,16992
Pentaclethra_macrophylla,315,235,80,Alphahull-PointsKO-Adjacents,10286
Pentactina_rupicola,0,0,0,NA,0
Pentadesma_butyracea,315,260,55,Alphahull-PointsKO-Adjacents,5877
Pentadesma_grandifolia,42,26,16,Alphahull-PointsKO-Adjacents,824
Pentagonia_amazonica,126,101,25,Alphahull-PointsKO-Adjacents,8768
Pentagonia_angustifolia,5,5,0,Points-PointsKO-Adjacents,21
Pentagonia_bonifaziana,2,2,0,Points-PointsKO-Adjacents,18
Pentagonia_breviloba,5,5,0,Points-PointsKO-Adjacents,41
Pentagonia_clementinensis,10,2,8,Points-PointsKO-Adjacents,57
Pentagonia_costaricensis,113,93,20,Alphahull-PointsKO-Adjacents,593
Pentagonia_donnell-smithii,110,79,31,Alphahull-PointsKO-Adjacents,1075
Pentagonia_dwyeriana,4,4,0,Points-PointsKO-Adjacents,25
Pentagonia_gigantifolia,29,16,13,Points-PointsKO-Adjacents,163
Pentagonia_grandiflora,21,15,6,Points-PointsKO-Adjacents,149
Pentagonia_gymnopoda,22,14,8,Points-PointsKO-Adjacents,97
Pentagonia_hirsuta,9,4,5,Points-PointsKO-Adjacents,55
Pentagonia_involucrata,4,4,0,Points-PointsKO-Adjacents,31
Pentagonia_lobata,29,21,8,Alphahull-PointsKO-Adjacents,94
Pentagonia_macrophylla,339,295,44,Alphahull-PointsKO-Adjacents,5648
Pentagonia_magnifica,18,0,18,Points-PointsKO-Adjacents,125
Pentagonia_microcarpa,6,2,4,Points-PointsKO-Adjacents,54
Pentagonia_nuciformis,21,15,6,Points-PointsKO-Adjacents,79
Pentagonia_osaensis,22,18,4,Points-PointsKO-Adjacents,66
Pentagonia_pachiteana,3,3,0,Points-PointsKO-Adjacents,27
Pentagonia_parvifolia,20,1,19,Points-PointsKO-Adjacents,163
Pentagonia_pinnatifida,68,56,12,Alphahull-PointsKO-Adjacents,568
Pentagonia_rubriflora,7,1,6,Points-PointsKO-Adjacents,59
Pentagonia_sanblasensis,8,3,5,Points-PointsKO-Adjacents,30
Pentagonia_spathicalyx,260,226,34,Alphahull-PointsKO-Adjacents,10422
Pentagonia_subauriculata,38,18,20,Points-PointsKO-Adjacents,319
Pentagonia_subsessilis,7,2,5,Points-PointsKO-Adjacents,54
Pentagonia_tapacula,4,1,3,Points-PointsKO-Adjacents,18
Pentagonia_tinajita,64,56,8,Alphahull-PointsKO-Adjacents,150
Pentagonia_villosula,2,2,0,Points-PointsKO-Adjacents,18
Pentagonia_wendlandii,52,31,21,Alphahull-PointsKO-Adjacents,560
Pentagonia_williamsii,41,25,16,Alphahull-PointsKO-Adjacents,1326
Pentagonia_wurdackii,60,29,31,Alphahull-PointsKO-Adjacents,4455
Pentamerista_neotropica,40,25,15,Alphahull-PointsKO-Adjacents,553
Pentaphylax_euryoides,57,33,24,Alphahull-PointsKO-Adjacents,3519
Pentaplaris_davidsmithii,72,60,12,Alphahull-PointsKO-Adjacents,227
Pentaplaris_doroteae,10,3,7,Points-PointsKO-Adjacents,63
Pentaplaris_huaoranica,17,12,5,Points-PointsKO-Adjacents,66
Pentarhopalopilia_umbellulata,19,8,11,Points-PointsKO-Adjacents,136
Pentascyphus_thyrsiflorus,21,3,18,Points-PointsKO-Adjacents,147
Microstemon_curtisii,1,1,0,Points-PointsKO-Adjacents,9
Microstemon_velutinus,2,2,0,Points-PointsKO-Adjacents,18
Peponidium_andringitrense,6,0,6,Points-PointsKO-Adjacents,45
Peponidium_arenesianum,7,2,5,Points-PointsKO-Adjacents,40
Peponidium_buxifolium,89,69,20,Alphahull-PointsKO-Adjacents,952
Peponidium_capuronii,4,4,0,Points-PointsKO-Adjacents,19
Peponidium_crassifolium,20,10,10,Points-PointsKO-Adjacents,108
Peponidium_cuspidatum,23,11,12,Points-PointsKO-Adjacents,93
Peponidium_cystiporon,6,0,6,Points-PointsKO-Adjacents,51
Peponidium_densiflorum,17,11,6,Points-PointsKO-Adjacents,52
Peponidium_flavum,11,7,4,Points-PointsKO-Adjacents,84
Peponidium_homolleae,5,5,0,Points-PointsKO-Adjacents,30
Peponidium_horridum,34,21,13,Alphahull-PointsKO-Adjacents,306
Peponidium_humbertianum,57,38,19,Alphahull-PointsKO-Adjacents,824
Peponidium_humbertii,9,3,6,Points-PointsKO-Adjacents,77
Peponidium_ihosyense,1,1,0,Points-PointsKO-Adjacents,9
Peponidium_mandrarense,23,8,15,Points-PointsKO-Adjacents,143
Peponidium_micranthum,82,65,17,Alphahull-PointsKO-Adjacents,532
Peponidium_montanum,18,9,9,Points-PointsKO-Adjacents,83
Peponidium_orientale,2,2,0,Points-PointsKO-Adjacents,16
Peponidium_ovato-oblongum,4,4,0,Points-PointsKO-Adjacents,10
Peponidium_pallens,2,2,0,Points-PointsKO-Adjacents,8
Peponidium_pallidum,5,5,0,Points-PointsKO-Adjacents,32
Peponidium_perrieri,6,0,6,Points-PointsKO-Adjacents,25
Peponidium_pervilleanoides,4,4,0,Points-PointsKO-Adjacents,36
Peponidium_pervilleanum,13,5,8,Points-PointsKO-Adjacents,72
Peponidium_tamatavense,84,66,18,Alphahull-PointsKO-Adjacents,1071
Peponidium_velutinum,23,14,9,Points-PointsKO-Adjacents,87
Peponidium_viguieri,4,4,0,Points-PointsKO-Adjacents,30
Pera_androgyna,1,1,0,Points-PointsKO-Adjacents,9
Pera_anisotricha,100,54,46,Alphahull-PointsKO-Adjacents,3840
Pera_aperta,5,5,0,Points-PointsKO-Adjacents,33
Pera_arborea,201,154,47,Alphahull-PointsKO-Adjacents,6021
Pera_benensis,81,45,36,Alphahull-PointsKO-Adjacents,5537
Pera_bicolor,324,272,52,Alphahull-PointsKO-Adjacents,28989
Pera_bumeliifolia,24,9,15,Points-PointsKO-Adjacents,197
Pera_citriodora,34,11,23,Points-PointsKO-Adjacents,235
Pera_coccinea,84,45,39,Alphahull-PointsKO-Adjacents,7174
Pera_colombiana,34,31,3,Alphahull-PointsKO-Adjacents,140
Pera_decipiens,321,269,52,Alphahull-PointsKO-Adjacents,29295
Pera_distichophylla,372,312,60,Alphahull-PointsKO-Adjacents,28252
Pera_eiteniorum,39,21,18,Alphahull-PointsKO-Adjacents,1812
Pera_ekmanii,4,4,0,Points-PointsKO-Adjacents,32
Pera_furfuracea,43,24,19,Alphahull-PointsKO-Adjacents,2396
Pera_glabrata,2592,2333,259,Alphahull-PointsKO-Adjacents,97378
Pera_glomerata,1,1,0,Points-PointsKO-Adjacents,7
Pera_heteranthera,280,216,64,Alphahull-PointsKO-Adjacents,4829
Pera_longipes,2,2,0,Points-PointsKO-Adjacents,11
Pera_manausensis,7,3,4,Points-PointsKO-Adjacents,43
Pera_membranacea,20,6,14,Points-PointsKO-Adjacents,180
Pera_microcarpa,0,0,0,NA,0
Pera_oppositifolia,2,2,0,Points-PointsKO-Adjacents,17
Pera_orientensis,2,2,0,Points-PointsKO-Adjacents,18
Pera_ovalifolia,0,0,0,NA,0
Pera_pallidifolia,1,1,0,Points-PointsKO-Adjacents,7
Pera_polylepis,6,1,5,Points-PointsKO-Adjacents,34
Pera_pulchrifolia,9,2,7,Points-PointsKO-Adjacents,65
Pera_tomentosa,83,32,51,Alphahull-PointsKO-Adjacents,946
Perakanthus_velutinus,0,0,0,NA,0
Perebea_angustifolia,264,200,64,Alphahull-PointsKO-Adjacents,16035
Perebea_guianensis,829,737,92,Alphahull-PointsKO-Adjacents,54982
Perebea_hispidula,195,0,195,Points-PointsKO-Adjacents,824
Perebea_humilis,38,13,25,Points-PointsKO-Adjacents,275
Perebea_longepedunculata,26,15,11,Points-PointsKO-Adjacents,204
Perebea_mennegae,59,42,17,Alphahull-PointsKO-Adjacents,1466
Perebea_mollis,291,234,57,Alphahull-PointsKO-Adjacents,34581
Perebea_rubra,55,16,39,Points-PointsKO-Adjacents,403
Perebea_tessmannii,127,90,37,Alphahull-PointsKO-Adjacents,6786
Perebea_xanthochyma,744,673,71,Alphahull-PointsKO-Adjacents,23289
Pereskia_aculeata,0,0,0,NA,0
Pereskia_aureiflora,19,10,9,Points-PointsKO-Adjacents,144
Pereskia_bahiensis,189,172,17,Alphahull-PointsKO-Adjacents,3120
Pereskia_grandifolia,215,158,57,Alphahull-PointsKO-Adjacents,12925
Pereskia_horrida,6,4,2,Points-PointsKO-Adjacents,43
Pereskia_nemorosa,59,36,23,Alphahull-PointsKO-Adjacents,4047
Pereskia_portulacifolia,5,5,0,Points-PointsKO-Adjacents,30
Pereskia_quisqueyana,0,0,0,NA,0
Pereskia_sacharosa,126,103,23,Alphahull-PointsKO-Adjacents,6067
Pereskia_stenantha,67,57,10,Alphahull-PointsKO-Adjacents,1206
Pereskia_zinniiflora,4,4,0,Points-PointsKO-Adjacents,32
Pereskiopsis_diguetii,97,65,32,Alphahull-PointsKO-Adjacents,1375
Pereskiopsis_rotundifolia,28,16,12,Points-PointsKO-Adjacents,165
Periandra_heterophylla,84,46,38,Alphahull-PointsKO-Adjacents,5423
Pericopsis_angolensis,159,107,52,Alphahull-PointsKO-Adjacents,12468
Pericopsis_elata,120,90,30,Alphahull-PointsKO-Adjacents,608
Pericopsis_laxiflora,578,540,38,Alphahull-PointsKO-Adjacents,8581
Pericopsis_mooniana,8,0,8,Points-PointsKO-Adjacents,27
Peridiscus_lucidus,41,21,20,Alphahull-PointsKO-Adjacents,457
Wittsteinia_balansae,53,45,8,Alphahull-PointsKO-Adjacents,96
Periploca_aphylla,80,0,80,Points-PointsKO-Adjacents,377
Perissocarpa_ondox,15,4,11,Points-PointsKO-Adjacents,116
Perissocarpa_steyermarkii,24,9,15,Points-PointsKO-Adjacents,141
Perissocarpa_umbellifera,20,10,10,Points-PointsKO-Adjacents,106
Peritassa_dulcis,90,41,49,Alphahull-PointsKO-Adjacents,4557
Peritassa_killipii,5,5,0,Points-PointsKO-Adjacents,39
Peritassa_laevigata,229,107,122,Alphahull-PointsKO-Adjacents,22588
Peritassa_peruviana,61,23,38,Alphahull-PointsKO-Adjacents,530
Peronema_canescens,31,10,21,Points-PointsKO-Adjacents,236
Perriera_madagascariensis,17,9,8,Points-PointsKO-Adjacents,135
Perriera_orientalis,4,4,0,Points-PointsKO-Adjacents,27
Perrierodendron_boinense,18,12,6,Points-PointsKO-Adjacents,102
Perrierodendron_capuronii,6,1,5,Points-PointsKO-Adjacents,33
Perrierodendron_occidentale,25,13,12,Points-PointsKO-Adjacents,143
Perrierodendron_quartzitorum,12,11,1,Points-PointsKO-Adjacents,28
Perrierodendron_rodoense,2,2,0,Points-PointsKO-Adjacents,9
Perrottetia_alpestris,262,178,84,Alphahull-PointsKO-Adjacents,1740
Perrottetia_arisanensis,136,122,14,Alphahull-PointsKO-Adjacents,260
Perrottetia_caliensis,12,3,9,Points-PointsKO-Adjacents,78
Perrottetia_calva,8,2,6,Points-PointsKO-Adjacents,63
Perrottetia_colorata,2,2,0,Points-PointsKO-Adjacents,18
Perrottetia_distichophylla,9,4,5,Points-PointsKO-Adjacents,74
Perrottetia_excelsa,4,4,0,Points-PointsKO-Adjacents,20
Perrottetia_gentryi,51,22,29,Alphahull-PointsKO-Adjacents,556
Perrottetia_guacharana,3,3,0,Points-PointsKO-Adjacents,25
Perrottetia_lanceolata,13,3,10,Points-PointsKO-Adjacents,87
Perrottetia_longistylis,202,166,36,Alphahull-PointsKO-Adjacents,4023
Perrottetia_maxima,10,6,4,Points-PointsKO-Adjacents,78
Perrottetia_multiflora,82,0,82,Points-PointsKO-Adjacents,264
Perrottetia_ovata,196,156,40,Alphahull-PointsKO-Adjacents,1090
Perrottetia_quinduensis,30,0,30,Points-PointsKO-Adjacents,216
Perrottetia_sandwicensis,13,4,9,Points-PointsKO-Adjacents,61
Perrottetia_sessiliflora,121,81,40,Alphahull-PointsKO-Adjacents,1074
Perrottetia_simplicissima,3,3,0,Points-PointsKO-Adjacents,18
Persea_alba,150,109,41,Alphahull-PointsKO-Adjacents,2649
Persea_albida,22,5,17,Points-PointsKO-Adjacents,162
Persea_albiramea,9,3,6,Points-PointsKO-Adjacents,42
Persea_americana,313,276,37,Alphahull-PointsKO-Adjacents,3924
Persea_areolatocostae,191,152,39,Alphahull-PointsKO-Adjacents,4877
Persea_aurata,53,22,31,Alphahull-PointsKO-Adjacents,4273
Persea_benthamiana,5,5,0,Points-PointsKO-Adjacents,35
Persea_bernardii,10,4,6,Points-PointsKO-Adjacents,83
Persea_bilocularis,8,3,5,Points-PointsKO-Adjacents,72
Persea_boldufolia,6,2,4,Points-PointsKO-Adjacents,30
Persea_borbonia,4948,0,4948,Points-PointsKO-Adjacents,6544
Persea_brenesii,15,8,7,Points-PointsKO-Adjacents,55
Persea_brevipes,19,14,5,Points-PointsKO-Adjacents,71
Persea_buchtienii,25,7,18,Points-PointsKO-Adjacents,200
Persea_bullata,9,5,4,Points-PointsKO-Adjacents,53
Persea_caerulea,449,342,107,Alphahull-PointsKO-Adjacents,8288
Persea_caesia,39,18,21,Points-PointsKO-Adjacents,257
Persea_campii,7,2,5,Points-PointsKO-Adjacents,51
Persea_chamissonis,26,16,10,Points-PointsKO-Adjacents,186
Persea_chrysantha,1,1,0,Points-PointsKO-Adjacents,9
Persea_chrysophylla,58,49,9,Alphahull-PointsKO-Adjacents,129
Persea_corymbosa,8,1,7,Points-PointsKO-Adjacents,58
Persea_croatii,2,2,0,Points-PointsKO-Adjacents,14
Persea_croizatii,5,5,0,Points-PointsKO-Adjacents,45
Persea_cuneata,110,81,29,Alphahull-PointsKO-Adjacents,982
Persea_declinata,12,0,12,Points-PointsKO-Adjacents,99
Persea_donnell-smithii,89,54,35,Alphahull-PointsKO-Adjacents,836
Persea_excelsa,1,1,0,Points-PointsKO-Adjacents,9
Persea_fastigiata,36,17,19,Points-PointsKO-Adjacents,204
Persea_fendleri,14,6,8,Points-PointsKO-Adjacents,90
Persea_fluviatilis,8,1,7,Points-PointsKO-Adjacents,37
Persea_fruticosa,1,1,0,Points-PointsKO-Adjacents,9
Persea_fulva,159,113,46,Alphahull-PointsKO-Adjacents,2949
Persea_fusca,13,5,8,Points-PointsKO-Adjacents,109
Persea_glabra,7,3,4,Points-PointsKO-Adjacents,35
Persea_grandiflora,22,6,16,Points-PointsKO-Adjacents,170
Persea_haenkeana,32,12,20,Points-PointsKO-Adjacents,222
Persea_hexanthera,34,19,15,Points-PointsKO-Adjacents,236
Persea_hintonii,99,75,24,Alphahull-PointsKO-Adjacents,1848
Persea_humilis,50,0,50,Points-PointsKO-Adjacents,289
Persea_indica,110,81,29,Alphahull-PointsKO-Adjacents,200
Persea_jariensis,3,3,0,Points-PointsKO-Adjacents,27
Persea_julianae,3,3,0,Points-PointsKO-Adjacents,23
Persea_krugii,51,41,10,Alphahull-PointsKO-Adjacents,322
Persea_laevifolia,8,3,5,Points-PointsKO-Adjacents,18
Persea_liebmannii,7,1,6,Points-PointsKO-Adjacents,50
Persea_lingue,50,29,21,Alphahull-PointsKO-Adjacents,1166
Persea_longipes,33,14,19,Points-PointsKO-Adjacents,162
Persea_macrantha,1,0,1,Points-PointsKO-Adjacents,9
Persea_major,243,205,38,Alphahull-PointsKO-Adjacents,4423
Persea_meridensis,7,0,7,Points-PointsKO-Adjacents,55
Persea_microphylla,8,2,6,Points-PointsKO-Adjacents,61
Machilus_parviflora,3,3,0,Points-PointsKO-Adjacents,27
Persea_mutisii,188,149,39,Alphahull-PointsKO-Adjacents,2715
Persea_negracotensis,0,0,0,NA,0
Persea_nivea,9,4,5,Points-PointsKO-Adjacents,71
Persea_nudigemma,16,5,11,Points-PointsKO-Adjacents,108
Persea_obovata,8,3,5,Points-PointsKO-Adjacents,40
Persea_obscura,5,5,0,Points-PointsKO-Adjacents,35
Persea_obtusifolia,32,21,11,Alphahull-PointsKO-Adjacents,68
Persea_odoratissima,72,23,49,Alphahull-PointsKO-Adjacents,2653
Persea_pajonalis,12,7,5,Points-PointsKO-Adjacents,52
Persea_pallescens,21,0,21,Points-PointsKO-Adjacents,111
Persea_pallida,1,1,0,Points-PointsKO-Adjacents,9
Persea_palustris,641,558,83,Alphahull-PointsKO-Adjacents,6361
Persea_pedunculosa,10,0,10,Points-PointsKO-Adjacents,57
Persea_perglauca,5,5,0,Points-PointsKO-Adjacents,29
Persea_perseiphylla,18,11,7,Points-PointsKO-Adjacents,99
Persea_peruviana,58,37,21,Alphahull-PointsKO-Adjacents,1086
Persea_povedae,32,21,11,Alphahull-PointsKO-Adjacents,107
Persea_pseudofasciculata,107,0,107,Points-PointsKO-Adjacents,700
Persea_punctata,11,0,11,Points-PointsKO-Adjacents,99
Persea_raimondii,5,5,0,Points-PointsKO-Adjacents,45
Persea_rigens,92,56,36,Alphahull-PointsKO-Adjacents,1610
Persea_rigida,4,3,1,Points-PointsKO-Adjacents,27
Persea_rufescens,16,9,7,Points-PointsKO-Adjacents,93
Persea_rufotomentosa,126,0,126,Points-PointsKO-Adjacents,727
Persea_ruizii,29,10,19,Points-PointsKO-Adjacents,155
Persea_schiedeana,274,230,44,Alphahull-PointsKO-Adjacents,3999
Persea_sessilis,4,4,0,Points-PointsKO-Adjacents,27
Persea_silvatica,16,10,6,Points-PointsKO-Adjacents,66
Persea_sphaerocarpa,20,11,9,Points-PointsKO-Adjacents,157
Persea_splendens,77,36,41,Alphahull-PointsKO-Adjacents,6226
Persea_standleyi,5,5,0,Points-PointsKO-Adjacents,39
Persea_stricta,0,0,0,NA,0
Persea_subcordata,128,83,45,Alphahull-PointsKO-Adjacents,1984
Persea_trollii,3,2,1,Points-PointsKO-Adjacents,27
Persea_venosa,269,211,58,Alphahull-PointsKO-Adjacents,6050
Persea_veraguasensis,190,161,29,Alphahull-PointsKO-Adjacents,633
Persea_vesticula,68,46,22,Alphahull-PointsKO-Adjacents,517
Persea_willdenovii,432,379,53,Alphahull-PointsKO-Adjacents,7239
Persoonia_elliptica,125,113,12,Alphahull-PointsKO-Adjacents,589
Perymenium_colombianum,1,1,0,Points-PointsKO-Adjacents,9
Perymenium_grande,225,186,39,Alphahull-PointsKO-Adjacents,2149
Perymenium_jelskii,27,9,18,Points-PointsKO-Adjacents,215
Petaladenium_urceoliferum,9,3,6,Points-PointsKO-Adjacents,49
Petalostigma_banksii,690,650,40,Alphahull-PointsKO-Adjacents,9998
Petalostigma_pubescens,3530,3431,99,Alphahull-PointsKO-Adjacents,28868
Petalostigma_quadriloculare,2732,2676,56,Alphahull-PointsKO-Adjacents,9056
Petalostigma_triloculare,169,134,35,Alphahull-PointsKO-Adjacents,1812
Petchia_cryptophlebia,46,36,10,Alphahull-PointsKO-Adjacents,294
Petchia_erythrocarpa,236,209,27,Alphahull-PointsKO-Adjacents,4424
Petchia_madagascariensis,154,124,30,Alphahull-PointsKO-Adjacents,2051
Petchia_montana,14,3,11,Points-PointsKO-Adjacents,99
Petchia_plectaneiifolia,10,0,10,Points-PointsKO-Adjacents,69
Petenaea_cordata,143,126,17,Alphahull-PointsKO-Adjacents,841
Peterodendron_ovatum,20,13,7,Points-PointsKO-Adjacents,117
Petersianthus_macrocarpus,235,176,59,Alphahull-PointsKO-Adjacents,14650
Petersianthus_quadrialatus,2,2,0,Points-PointsKO-Adjacents,16
Petitia_domingensis,84,46,38,Alphahull-PointsKO-Adjacents,1258
Petitia_urbanii,2,2,0,Points-PointsKO-Adjacents,16
Petitiocodon_parviflorum,53,43,10,Alphahull-PointsKO-Adjacents,404
Petrea_campinae,2,2,0,Points-PointsKO-Adjacents,9
Petrea_pubescens,52,27,25,Alphahull-PointsKO-Adjacents,1361
Petrea_rugosa,28,19,9,Points-PointsKO-Adjacents,172
Petrea_volubilis,708,616,92,Alphahull-PointsKO-Adjacents,6372
Petrobium_arboreum,0,0,0,NA,0
Peucephyllum_schottii,669,642,27,Alphahull-PointsKO-Adjacents,3807
Peumus_boldus,45,23,22,Alphahull-PointsKO-Adjacents,701
Phaeanthus_ophthalmicus,117,55,62,Alphahull-PointsKO-Adjacents,2366
Phaeanthus_splendens,34,9,25,Points-PointsKO-Adjacents,278
Phaeanthus_tephrocarpus,1,0,1,Points-PointsKO-Adjacents,9
Phaleria_acuminata,2,2,0,Points-PointsKO-Adjacents,11
Phaleria_angustifolia,0,0,0,NA,0
Phaleria_biflora,14,10,4,Points-PointsKO-Adjacents,27
Phaleria_capitata,38,6,32,Points-PointsKO-Adjacents,295
Phaleria_chermsideana,95,79,16,Alphahull-PointsKO-Adjacents,391
Phaleria_coccinea,16,0,16,Points-PointsKO-Adjacents,112
Phaleria_glabra,3,3,0,Points-PointsKO-Adjacents,21
Phaleria_ixoroides,2,2,0,Points-PointsKO-Adjacents,3
Phaleria_montana,2,2,0,Points-PointsKO-Adjacents,11
Phaleria_octandra,232,167,65,Alphahull-PointsKO-Adjacents,1165
Phaleria_perrottetiana,23,0,23,Points-PointsKO-Adjacents,173
Phaleria_pulchra,1,1,0,Points-PointsKO-Adjacents,9
Phanerodiscus_diospyroidea,19,12,7,Points-PointsKO-Adjacents,101
Phanerodiscus_perrieri,9,3,6,Points-PointsKO-Adjacents,63
Phaulothamnus_spinescens,136,92,44,Alphahull-PointsKO-Adjacents,2391
Phellocalyx_vollescenii,1,1,0,Points-PointsKO-Adjacents,9
Phellodendron_amurense,259,198,61,Alphahull-PointsKO-Adjacents,3364
Phellodendron_chinense,35,10,25,Points-PointsKO-Adjacents,314
Phellodendron_japonicum,43,23,20,Alphahull-PointsKO-Adjacents,382
Phellodendron_lavallei,38,18,20,Points-PointsKO-Adjacents,236
Phellodendron_sachalinense,42,18,24,Points-PointsKO-Adjacents,269
Phenakospermum_guyannense,383,301,82,Alphahull-PointsKO-Adjacents,63294
Phenax_angustifolius,97,50,47,Alphahull-PointsKO-Adjacents,1242
Phenax_hirtus,486,357,129,Alphahull-PointsKO-Adjacents,8469
Phenax_laevigatus,64,24,40,Alphahull-PointsKO-Adjacents,662
Phenax_laxiflorus,5,5,0,Points-PointsKO-Adjacents,45
Phenax_mexicanus,205,132,73,Alphahull-PointsKO-Adjacents,1730
Phenax_rugosus,196,147,49,Alphahull-PointsKO-Adjacents,3012
Phialanthus_acunae,2,2,0,Points-PointsKO-Adjacents,14
Phialanthus_alainii,NA,NA,NA,NA,NA
Phialanthus_bissei,NA,NA,NA,NA,NA
Phialanthus_ellipticus,0,0,0,NA,0
Phialanthus_glaberrimus,NA,NA,NA,NA,NA
Phialanthus_grandifolius,4,2,2,Points-PointsKO-Adjacents,14
Phialanthus_guantanamensis,NA,NA,NA,NA,NA
Phialanthus_hispaniolae,1,0,1,Points-PointsKO-Adjacents,9
Phialanthus_inflatus,NA,NA,NA,NA,NA
Phialanthus_jamaicensis,3,2,1,Points-PointsKO-Adjacents,24
Phialanthus_linearis,0,0,0,NA,0
Phialanthus_macrocalyx,0,0,0,NA,0
Phialanthus_macrostemon,0,0,0,NA,0
Phialanthus_marianus,NA,NA,NA,NA,NA
Phialanthus_myrtilloides,7,2,5,Points-PointsKO-Adjacents,51
Phialanthus_oblongatus,0,0,0,NA,0
Phialanthus_parvifolius,1,1,0,Points-PointsKO-Adjacents,8
Phialanthus_peduncularis,NA,NA,NA,NA,NA
Phialanthus_resinifluus,1,1,0,Points-PointsKO-Adjacents,8
Phialanthus_revolutus,1,1,0,Points-PointsKO-Adjacents,9
Phialanthus_rigidus,1,1,0,Points-PointsKO-Adjacents,8
Phialanthus_stillans,3,3,0,Points-PointsKO-Adjacents,17
Philacra_auriculata,13,8,5,Points-PointsKO-Adjacents,49
Philacra_longifolia,19,11,8,Points-PointsKO-Adjacents,96
Philenoptera_bussei,71,31,40,Alphahull-PointsKO-Adjacents,2796
Philenoptera_eriocalyx,19,8,11,Points-PointsKO-Adjacents,135
Philenoptera_katangensis,9,2,7,Points-PointsKO-Adjacents,48
Philenoptera_laxiflora,130,77,53,Alphahull-PointsKO-Adjacents,2475
Philenoptera_nelsii,75,55,20,Alphahull-PointsKO-Adjacents,4509
Philenoptera_pallescens,17,8,9,Points-PointsKO-Adjacents,126
Philenoptera_violacea,215,156,59,Alphahull-PointsKO-Adjacents,13732
Philenoptera_wankieensis,0,0,0,NA,0
Philippia_simii,15,2,13,Points-PointsKO-Adjacents,135
Phillyrea_latifolia,4051,3685,366,Alphahull-PointsKO-Adjacents,20193
Philodendron_angustilobum,22,7,15,Points-PointsKO-Adjacents,134
Philyra_brasiliensis,84,45,39,Alphahull-PointsKO-Adjacents,2453
Phoebe_angustifolia,3,3,0,Points-PointsKO-Adjacents,27
Phoebe_attenuata,2,2,0,Points-PointsKO-Adjacents,18
Phoebe_bournei,41,26,15,Alphahull-PointsKO-Adjacents,3120
Phoebe_calcarea,7,3,4,Points-PointsKO-Adjacents,63
Phoebe_cathia,7,1,6,Points-PointsKO-Adjacents,60
Phoebe_chekiangensis,9,1,8,Points-PointsKO-Adjacents,76
Phoebe_chinensis,14,0,14,Points-PointsKO-Adjacents,125
Phoebe_crassipedicella,4,4,0,Points-PointsKO-Adjacents,36
Phoebe_faberi,14,6,8,Points-PointsKO-Adjacents,125
Phoebe_formosana,160,0,160,Points-PointsKO-Adjacents,337
Phoebe_glaucifolia,1,1,0,Points-PointsKO-Adjacents,9
Phoebe_glaucophylla,2,2,0,Points-PointsKO-Adjacents,18
Phoebe_grandis,11,2,9,Points-PointsKO-Adjacents,97
Phoebe_hainanensis,2,2,0,Points-PointsKO-Adjacents,18
Phoebe_hui,6,1,5,Points-PointsKO-Adjacents,54
Phoebe_hunanensis,24,14,10,Points-PointsKO-Adjacents,213
Phoebe_hungmoensis,0,0,0,NA,0
Phoebe_kwangsiensis,3,3,0,Points-PointsKO-Adjacents,27
Phoebe_lanceolata,44,12,32,Points-PointsKO-Adjacents,372
Phoebe_legendrei,10,2,8,Points-PointsKO-Adjacents,90
Phoebe_lichuanensis,0,0,0,NA,0
Phoebe_macrocarpa,5,5,0,Points-PointsKO-Adjacents,45
Phoebe_megacalyx,1,1,0,Points-PointsKO-Adjacents,9
Phoebe_motuonan,NA,NA,NA,NA,NA
Phoebe_neurantha,69,32,37,Alphahull-PointsKO-Adjacents,5452
Phoebe_neuranthoides,20,4,16,Points-PointsKO-Adjacents,180
Phoebe_nigrifolia,5,5,0,Points-PointsKO-Adjacents,45
Phoebe_paniculata,2,2,0,Points-PointsKO-Adjacents,18
Phoebe_puwenensis,9,0,9,Points-PointsKO-Adjacents,81
Phoebe_rufescens,2,2,0,Points-PointsKO-Adjacents,18
Phoebe_sheareri,106,75,31,Alphahull-PointsKO-Adjacents,4226
Phoebe_sterculioides,5,5,0,Points-PointsKO-Adjacents,44
Phoebe_tavoyana,29,7,22,Points-PointsKO-Adjacents,208
Phoebe_yaiensis,3,3,0,Points-PointsKO-Adjacents,27
Phoebe_yunnanensis,3,3,0,Points-PointsKO-Adjacents,27
Phoebe_zhennan,17,6,11,Points-PointsKO-Adjacents,153
Phoenicanthus_coriacea,1,1,0,Points-PointsKO-Adjacents,9
Phoenicanthus_obliquus,1,1,0,Points-PointsKO-Adjacents,9
Phoenicophorium_borsigianum,7,3,4,Points-PointsKO-Adjacents,21
Phoenix_atlantica,1,1,0,Points-PointsKO-Adjacents,9
Phoenix_canariensis,392,256,136,Alphahull-PointsKO-Adjacents,1683
Phoenix_dactylifera,30,4,26,Points-PointsKO-Adjacents,217
Phoenix_loureiroi,48,0,48,Points-PointsKO-Adjacents,370
Phoenix_paludosa,9,0,9,Points-PointsKO-Adjacents,74
Phoenix_pusilla,1,1,0,Points-PointsKO-Adjacents,9
Phoenix_reclinata,664,450,214,Alphahull-PointsKO-Adjacents,33154
Phoenix_rupicola,0,0,0,NA,0
Phoenix_sylvestris,4,2,2,Points-PointsKO-Adjacents,35
Phoenix_theophrasti,6,2,4,Points-PointsKO-Adjacents,17
Pholidocarpus_ihur,2,2,0,Points-PointsKO-Adjacents,18
Pholidocarpus_kingianus,1,0,1,Points-PointsKO-Adjacents,9
Pholidocarpus_macrocarpus,1,1,0,Points-PointsKO-Adjacents,9
Pholidocarpus_majadum,4,3,1,Points-PointsKO-Adjacents,36
Pholidocarpus_mucronatus,NA,NA,NA,NA,NA
Pholidocarpus_sumatranus,0,0,0,NA,0
Pholidostachys_dactyloides,107,89,18,Alphahull-PointsKO-Adjacents,1097
Pholidostachys_pulchra,113,83,30,Alphahull-PointsKO-Adjacents,944
Pholidostachys_synanthera,238,193,45,Alphahull-PointsKO-Adjacents,9326
Photinia_arguta,23,5,18,Points-PointsKO-Adjacents,159
Photinia_beauverdiana,209,160,49,Alphahull-PointsKO-Adjacents,17534
Photinia_beckii,6,2,4,Points-PointsKO-Adjacents,48
Photinia_benthamiana,35,7,28,Points-PointsKO-Adjacents,295
Photinia_bodinieri,95,63,32,Alphahull-PointsKO-Adjacents,12651
Photinia_calleryana,0,0,0,NA,0
Photinia_callosa,12,5,7,Points-PointsKO-Adjacents,108
Photinia_chihsiniana,4,4,0,Points-PointsKO-Adjacents,36
Photinia_chingiana,NA,NA,NA,NA,NA
Photinia_davidiana,91,65,26,Alphahull-PointsKO-Adjacents,285
Photinia_fokienensis,2,2,0,Points-PointsKO-Adjacents,18
Photinia_glabra,189,119,70,Alphahull-PointsKO-Adjacents,10015
Photinia_glomerata,63,0,63,Points-PointsKO-Adjacents,514
Photinia_hirsuta,21,11,10,Points-PointsKO-Adjacents,189
Photinia_impressivena,22,9,13,Points-PointsKO-Adjacents,198
Photinia_integrifolia,145,119,26,Alphahull-PointsKO-Adjacents,2973
Photinia_kwangsiensis,4,4,0,Points-PointsKO-Adjacents,36
Photinia_lanuginosa,1,1,0,Points-PointsKO-Adjacents,9
Photinia_lasiogyna,60,31,29,Alphahull-PointsKO-Adjacents,2948
Photinia_lochengensis,2,2,0,Points-PointsKO-Adjacents,18
Photinia_loriformis,4,4,0,Points-PointsKO-Adjacents,36
Photinia_lucida,172,136,36,Alphahull-PointsKO-Adjacents,376
Photinia_mexicana,41,25,16,Alphahull-PointsKO-Adjacents,137
Photinia_microcarpa,26,15,11,Points-PointsKO-Adjacents,159
Photinia_prionophylla,17,11,6,Points-PointsKO-Adjacents,120
Photinia_prunifolia,94,0,94,Points-PointsKO-Adjacents,831
Photinia_raupingensis,7,0,7,Points-PointsKO-Adjacents,63
Photinia_schneideriana,49,28,21,Alphahull-PointsKO-Adjacents,4619
Photinia_serratifolia,298,237,61,Alphahull-PointsKO-Adjacents,16646
Photinia_stenophylla,4,4,0,Points-PointsKO-Adjacents,36
Photinia_tsaii,2,2,0,Points-PointsKO-Adjacents,12
Photinia_villosa,634,414,220,Alphahull-PointsKO-Adjacents,8663
Phragmotheca_ecuadorensis,25,16,9,Points-PointsKO-Adjacents,141
Phragmotheca_fuchsii,2,2,0,Points-PointsKO-Adjacents,12
Phragmotheca_leucoflora,5,5,0,Points-PointsKO-Adjacents,45
Phragmotheca_mammosa,75,48,27,Alphahull-PointsKO-Adjacents,1121
Phragmotheca_rubriflora,4,4,0,Points-PointsKO-Adjacents,32
Phragmotheca_siderosa,24,17,7,Points-PointsKO-Adjacents,128
Phylica_buxifolia,23,10,13,Points-PointsKO-Adjacents,79
Phylica_paniculata,133,95,38,Alphahull-PointsKO-Adjacents,3708
Phylica_ramosissima,0,0,0,NA,0
Phylica_purpurea,48,40,8,Alphahull-PointsKO-Adjacents,508
Phyllanoa_colombiana,0,0,0,NA,0
Phyllanthus_acacioides,1,1,0,Points-PointsKO-Adjacents,9
Phyllanthus_acidus,4,3,1,Points-PointsKO-Adjacents,36
Phyllanthus_actephilifolius,0,0,0,NA,0
Phyllanthus_acuminatus,821,611,210,Alphahull-PointsKO-Adjacents,41051
Phyllanthus_aeneus,58,45,13,Alphahull-PointsKO-Adjacents,196
Phyllanthus_albidiscus,1,1,0,Points-PointsKO-Adjacents,9
Phyllanthus_albizzioides,0,0,0,NA,0
Phyllanthus_albus,15,6,9,Points-PointsKO-Adjacents,120
Phyllanthus_ambatovolana,7,0,7,Points-PointsKO-Adjacents,44
Phyllanthus_amentuliger,1,1,0,Points-PointsKO-Adjacents,9
Phyllanthus_amicorum,0,0,0,NA,0
Phyllanthus_analamerae,3,3,0,Points-PointsKO-Adjacents,27
Phyllanthus_anamalayanus,0,0,0,NA,0
Phyllanthus_anfractuosus,1,1,0,Points-PointsKO-Adjacents,7
Phyllanthus_angkorensis,5,5,0,Points-PointsKO-Adjacents,39
Phyllanthus_angustifolius,14,5,9,Points-PointsKO-Adjacents,87
Phyllanthus_anisolobus,137,98,39,Alphahull-PointsKO-Adjacents,1672
Phyllanthus_aphanostylus,13,5,8,Points-PointsKO-Adjacents,84
Phyllanthus_arbuscula,7,3,4,Points-PointsKO-Adjacents,36
Phyllanthus_archboldianus,7,0,7,Points-PointsKO-Adjacents,54
Phyllanthus_ardisianthus,1,1,0,Points-PointsKO-Adjacents,9
Phyllanthus_armstrongii,1,1,0,Points-PointsKO-Adjacents,9
Phyllanthus_atabapoensis,30,16,14,Points-PointsKO-Adjacents,236
Phyllanthus_atalotrichus,0,0,0,NA,0
Phyllanthus_atrovirens,0,0,0,NA,0
Phyllanthus_attenuatus,253,180,73,Alphahull-PointsKO-Adjacents,21142
Phyllanthus_axillaris,2,2,0,Points-PointsKO-Adjacents,18
Phyllanthus_biantherifer,14,1,13,Points-PointsKO-Adjacents,116
Phyllanthus_billardierei,89,73,16,Alphahull-PointsKO-Adjacents,316
Phyllanthus_bolivianus,3,3,0,Points-PointsKO-Adjacents,27
Phyllanthus_borenensis,2,2,0,Points-PointsKO-Adjacents,9
Phyllanthus_borneensis,22,4,18,Points-PointsKO-Adjacents,185
Phyllanthus_botryanthus,71,41,30,Alphahull-PointsKO-Adjacents,886
Phyllanthus_bracteatus,0,0,0,NA,0
Phyllanthus_brothersonii,2,2,0,Points-PointsKO-Adjacents,7
Phyllanthus_brunnescens,0,0,0,NA,0
Phyllanthus_buxifolius,5,0,5,Points-PointsKO-Adjacents,41
Phyllanthus_caesius,8,1,7,Points-PointsKO-Adjacents,41
Phyllanthus_calcicola,3,3,0,Points-PointsKO-Adjacents,19
Phyllanthus_callejasii,7,1,6,Points-PointsKO-Adjacents,53
Phyllanthus_carlottae,3,3,0,Points-PointsKO-Adjacents,16
Phyllanthus_casticum,97,69,28,Alphahull-PointsKO-Adjacents,4716
Phyllanthus_caudatus,7,4,3,Points-PointsKO-Adjacents,29
Phyllanthus_cauliflorus,1,1,0,Points-PointsKO-Adjacents,9
Phyllanthus_caymanensis,0,0,0,NA,0
Phyllanthus_cedrelifolius,4,3,1,Points-PointsKO-Adjacents,36
Phyllanthus_chacoensis,94,60,34,Alphahull-PointsKO-Adjacents,3774
Phyllanthus_ciccoides,179,129,50,Alphahull-PointsKO-Adjacents,5268
Phyllanthus_cladanthus,3,3,0,Points-PointsKO-Adjacents,24
Phyllanthus_cladotrichus,37,17,20,Points-PointsKO-Adjacents,229
Phyllanthus_clamboides,113,77,36,Alphahull-PointsKO-Adjacents,1081
Phyllanthus_coalcomanensis,9,0,9,Points-PointsKO-Adjacents,63
Phyllanthus_collinsiae,2,2,0,Points-PointsKO-Adjacents,18
Phyllanthus_columnaris,13,0,13,Points-PointsKO-Adjacents,108
Phyllanthus_comitus,NA,NA,NA,NA,NA
Phyllanthus_comptonii,1,1,0,Points-PointsKO-Adjacents,9
Phyllanthus_cuneifolius,12,7,5,Points-PointsKO-Adjacents,37
Phyllanthus_cuscutiflorus,92,70,22,Alphahull-PointsKO-Adjacents,334
Phyllanthus_deplanchei,10,4,6,Points-PointsKO-Adjacents,38
Phyllanthus_distichus,9,4,5,Points-PointsKO-Adjacents,51
Phyllanthus_dunnianus,4,4,0,Points-PointsKO-Adjacents,36
Phyllanthus_dzumacensis,6,3,3,Points-PointsKO-Adjacents,21
Phyllanthus_effusus,6,0,6,Points-PointsKO-Adjacents,34
Phyllanthus_elsiae,161,92,69,Alphahull-PointsKO-Adjacents,6020
Phyllanthus_emarginatus,1,1,0,Points-PointsKO-Adjacents,6
Phyllanthus_emblica,154,94,60,Alphahull-PointsKO-Adjacents,12860
Phyllanthus_engleri,15,6,9,Points-PointsKO-Adjacents,114
Phyllanthus_epiphyllanthus,50,13,37,Points-PointsKO-Adjacents,201
Phyllanthus_euryoides,0,0,0,NA,0
Phyllanthus_eximius,0,0,0,NA,0
Phyllanthus_fadyenii,0,0,0,NA,0
Phyllanthus_finschii,7,1,6,Points-PointsKO-Adjacents,42
Phyllanthus_flaviflorus,25,18,7,Points-PointsKO-Adjacents,134
Phyllanthus_florencei,4,4,0,Points-PointsKO-Adjacents,13
Phyllanthus_frodinii,2,2,0,Points-PointsKO-Adjacents,12
Phyllanthus_fuscoluridus,41,28,13,Alphahull-PointsKO-Adjacents,947
Phyllanthus_gentryi,8,4,4,Points-PointsKO-Adjacents,22
Phyllanthus_gillespiei,2,2,0,Points-PointsKO-Adjacents,12
Phyllanthus_glaziovii,15,0,15,Points-PointsKO-Adjacents,86
Phyllanthus_grandifolius,137,102,35,Alphahull-PointsKO-Adjacents,2312
Phyllanthus_grantii,2,2,0,Points-PointsKO-Adjacents,10
Phyllanthus_heterodoxus,1,1,0,Points-PointsKO-Adjacents,9
Phyllanthus_hivaoaensis,2,2,0,Points-PointsKO-Adjacents,5
Phyllanthus_huahineensis,3,3,0,Points-PointsKO-Adjacents,4
Phyllanthus_huallagensis,3,3,0,Points-PointsKO-Adjacents,27
Phyllanthus_indofischeri,0,0,0,NA,0
Phyllanthus_insignis,6,0,6,Points-PointsKO-Adjacents,45
Phyllanthus_juglandifolius,205,69,136,Alphahull-PointsKO-Adjacents,6218
Phyllanthus_kaessneri,31,13,18,Points-PointsKO-Adjacents,205
Phyllanthus_koghiensis,5,5,0,Points-PointsKO-Adjacents,12
Phyllanthus_koniamboensis,10,8,2,Points-PointsKO-Adjacents,26
Phyllanthus_kostermansii,0,0,0,NA,0
Phyllanthus_lanceilimbus,32,2,30,Points-PointsKO-Adjacents,234
Phyllanthus_lasiogynus,0,0,0,NA,0
Phyllanthus_latifolius,3,3,0,Points-PointsKO-Adjacents,17
Phyllanthus_laxiflorus,21,7,14,Points-PointsKO-Adjacents,132
Phyllanthus_liesneri,2,2,0,Points-PointsKO-Adjacents,18
Phyllanthus_madeirensis,20,6,14,Points-PointsKO-Adjacents,152
Phyllanthus_maleolens,4,4,0,Points-PointsKO-Adjacents,15
Phyllanthus_manausensis,6,1,5,Points-PointsKO-Adjacents,46
Phyllanthus_mangenotii,5,5,0,Points-PointsKO-Adjacents,14
Phyllanthus_marchionicus,17,9,8,Points-PointsKO-Adjacents,32
Phyllanthus_mariannensis,1,1,0,Points-PointsKO-Adjacents,7
Phyllanthus_martii,7,1,6,Points-PointsKO-Adjacents,63
Phyllanthus_megapodus,2,1,1,Points-PointsKO-Adjacents,14
Phyllanthus_melvilleorum,NA,NA,NA,NA,NA
Phyllanthus_merinthopodus,1,1,0,Points-PointsKO-Adjacents,9
Phyllanthus_microcarpus,10,0,10,Points-PointsKO-Adjacents,85
Phyllanthus_microdendron,2,2,0,Points-PointsKO-Adjacents,18
Phyllanthus_mimosoides,31,21,10,Alphahull-PointsKO-Adjacents,72
Phyllanthus_mirabilis,1,1,0,Points-PointsKO-Adjacents,9
Phyllanthus_mocinianus,200,153,47,Alphahull-PointsKO-Adjacents,7453
Phyllanthus_mollis,15,1,14,Points-PointsKO-Adjacents,127
Phyllanthus_montanus,5,5,0,Points-PointsKO-Adjacents,25
Phyllanthus_montis-fontium,3,3,0,Points-PointsKO-Adjacents,21
Phyllanthus_montrouzieri,9,4,5,Points-PointsKO-Adjacents,37
Phyllanthus_moorei,8,1,7,Points-PointsKO-Adjacents,40
Phyllanthus_multilobus,NA,NA,NA,NA,NA
Phyllanthus_myriophyllus,4,4,0,Points-PointsKO-Adjacents,19
Phyllanthus_myrsinites,78,23,55,Alphahull-PointsKO-Adjacents,4115
Phyllanthus_nadeaudii,3,3,0,Points-PointsKO-Adjacents,6
Phyllanthus_nutans,19,9,10,Points-PointsKO-Adjacents,130
Phyllanthus_orbicularis,22,8,14,Points-PointsKO-Adjacents,105
Phyllanthus_oreichtitus,10,2,8,Points-PointsKO-Adjacents,63
Phyllanthus_orientalis,0,0,0,NA,0
Phyllanthus_orohenensis,0,0,0,NA,0
Phyllanthus_otobedii,7,4,3,Points-PointsKO-Adjacents,17
Phyllanthus_ovalifolius,76,31,45,Alphahull-PointsKO-Adjacents,4830
Phyllanthus_oxyphyllus,6,1,5,Points-PointsKO-Adjacents,54
Phyllanthus_pachyphyllus,9,0,9,Points-PointsKO-Adjacents,81
Phyllanthus_pacificus,11,5,6,Points-PointsKO-Adjacents,30
Phyllanthus_papenooensis,1,1,0,Points-PointsKO-Adjacents,9
Phyllanthus_pectinatus,0,0,0,NA,0
Phyllanthus_pervilleanus,14,5,9,Points-PointsKO-Adjacents,93
Phyllanthus_physocarpus,35,5,30,Points-PointsKO-Adjacents,239
Phyllanthus_pinnatus,12,0,12,Points-PointsKO-Adjacents,103
Phyllanthus_pitcairnensis,5,2,3,Points-PointsKO-Adjacents,6
Phyllanthus_poliborealis,0,0,0,NA,0
Phyllanthus_polyanthus,42,11,31,Points-PointsKO-Adjacents,288
Phyllanthus_polygynus,1,1,0,Points-PointsKO-Adjacents,8
Phyllanthus_polyphyllus,2,0,2,Points-PointsKO-Adjacents,14
Phyllanthus_pomiferus,0,0,0,NA,0
Phyllanthus_ponapensis,0,0,0,NA,0
Phyllanthus_popayanensis,11,5,6,Points-PointsKO-Adjacents,73
Phyllanthus_praelongipes,33,21,12,Alphahull-PointsKO-Adjacents,72
Phyllanthus_prainianus,0,0,0,NA,0
Phyllanthus_profusus,11,2,9,Points-PointsKO-Adjacents,93
Phyllanthus_pterocladus,8,4,4,Points-PointsKO-Adjacents,27
Phyllanthus_pullenii,3,3,0,Points-PointsKO-Adjacents,24
Phyllanthus_puntii,3,3,0,Points-PointsKO-Adjacents,26
Phyllanthus_purpusii,27,14,13,Points-PointsKO-Adjacents,98
Phyllanthus_raiateaensis,0,0,0,NA,0
Phyllanthus_raivavensis,5,5,0,Points-PointsKO-Adjacents,11
Phyllanthus_ramosii,3,3,0,Points-PointsKO-Adjacents,22
Phyllanthus_ramosus,0,0,0,NA,0
Phyllanthus_rapaensis,1,1,0,Points-PointsKO-Adjacents,4
Phyllanthus_reticulatus,195,91,104,Alphahull-PointsKO-Adjacents,7741
Phyllanthus_ridleyanus,2,2,0,Points-PointsKO-Adjacents,18
Phyllanthus_riedelianus,37,14,23,Points-PointsKO-Adjacents,289
Phyllanthus_roseus,25,7,18,Points-PointsKO-Adjacents,156
Phyllanthus_ruber,6,0,6,Points-PointsKO-Adjacents,54
Phyllanthus_rubriflorus,6,1,5,Points-PointsKO-Adjacents,38
Phyllanthus_rupestris,27,12,15,Points-PointsKO-Adjacents,182
Phyllanthus_salomonis,NA,NA,NA,NA,NA
Phyllanthus_salviifolius,209,154,55,Alphahull-PointsKO-Adjacents,3719
Phyllanthus_samoanus,2,2,0,Points-PointsKO-Adjacents,11
Phyllanthus_senyavinianus,4,4,0,Points-PointsKO-Adjacents,13
Phyllanthus_sikkimensis,8,0,8,Points-PointsKO-Adjacents,72
Phyllanthus_skutchii,37,30,7,Alphahull-PointsKO-Adjacents,253
Phyllanthus_smithianus,0,0,0,NA,0
Phyllanthus_st-johnii,21,15,6,Points-PointsKO-Adjacents,16
Phyllanthus_strobilaceus,5,5,0,Points-PointsKO-Adjacents,41
Phyllanthus_subcarnosus,1,1,0,Points-PointsKO-Adjacents,8
Phyllanthus_superbus,1,0,1,Points-PointsKO-Adjacents,9
Phyllanthus_symphoricarpoides,29,17,12,Points-PointsKO-Adjacents,179
Phyllanthus_tagulae,2,2,0,Points-PointsKO-Adjacents,8
Phyllanthus_temehaniensis,9,4,5,Points-PointsKO-Adjacents,14
Phyllanthus_tequilensis,38,24,14,Alphahull-PointsKO-Adjacents,829
Phyllanthus_tessmannii,1,1,0,Points-PointsKO-Adjacents,9
Phyllanthus_tireliae,4,4,0,Points-PointsKO-Adjacents,12
Phyllanthus_trichopodus,2,2,0,Points-PointsKO-Adjacents,6
Phyllanthus_tuamotuensis,1,1,0,Points-PointsKO-Adjacents,4
Phyllanthus_tuerckheimii,13,8,5,Points-PointsKO-Adjacents,58
Phyllanthus_umbratus,28,11,17,Points-PointsKO-Adjacents,190
Phyllanthus_utricularis,1,1,0,Points-PointsKO-Adjacents,9
Phyllanthus_verrucicaulis,4,4,0,Points-PointsKO-Adjacents,9
Phyllanthus_vitilevuensis,0,0,0,NA,0
Phyllanthus_watsonii,0,0,0,NA,0
Phyllanthus_websteri,NA,NA,NA,NA,NA
Phyllanthus_wilderi,2,2,0,Points-PointsKO-Adjacents,4
Phyllanthus_wilkesianus,1,1,0,Points-PointsKO-Adjacents,9
Phyllanthus_yunnanensis,NA,NA,NA,NA,NA
Phyllarthron_antongiliense,4,4,0,Points-PointsKO-Adjacents,23
Phyllarthron_articulatum,18,7,11,Points-PointsKO-Adjacents,143
Phyllarthron_bilabiatum,3,3,0,Points-PointsKO-Adjacents,18
Phyllarthron_bojeranum,70,48,22,Alphahull-PointsKO-Adjacents,1704
Phyllarthron_cauliflorum,6,3,3,Points-PointsKO-Adjacents,34
Phyllarthron_comorense,1,1,0,Points-PointsKO-Adjacents,5
Phyllarthron_ilicifolium,25,17,8,Points-PointsKO-Adjacents,72
Phyllarthron_laxinervium,1,1,0,Points-PointsKO-Adjacents,9
Phyllarthron_megaphyllum,8,4,4,Points-PointsKO-Adjacents,51
Phyllarthron_multiflorum,7,1,6,Points-PointsKO-Adjacents,57
Phyllarthron_nocturnum,1,1,0,Points-PointsKO-Adjacents,9
Phyllarthron_sahamalazensis,1,1,0,Points-PointsKO-Adjacents,8
Phyllarthron_suarezense,5,5,0,Points-PointsKO-Adjacents,45
Phyllarthron_vokoaninensis,1,1,0,Points-PointsKO-Adjacents,8
Phyllocladus_aspleniifolius,1596,1569,27,Alphahull-PointsKO-Adjacents,1057
Phyllocladus_hypophyllus,205,144,61,Alphahull-PointsKO-Adjacents,2212
Phyllocladus_toatoa,712,680,32,Alphahull-PointsKO-Adjacents,2064
Phyllocladus_trichomanoides,5478,5392,86,Alphahull-PointsKO-Adjacents,4246
Phyllocosmus_africanus,130,80,50,Alphahull-PointsKO-Adjacents,4702
Phyllocosmus_congolensis,15,6,9,Points-PointsKO-Adjacents,103
Phyllocosmus_lemaireanus,32,13,19,Points-PointsKO-Adjacents,223
Phyllocosmus_sessiliflorus,53,35,18,Alphahull-PointsKO-Adjacents,895
Phyllomelia_coronata,6,0,6,Points-PointsKO-Adjacents,26
Phyllonoma_cacuminis,1,1,0,Points-PointsKO-Adjacents,9
Phyllonoma_laticuspis,270,221,49,Alphahull-PointsKO-Adjacents,2938
Phyllonoma_ruscifolia,122,66,56,Alphahull-PointsKO-Adjacents,1688
Phyllonoma_weberbaueri,9,0,9,Points-PointsKO-Adjacents,81
Phyllopentas_elata,8,2,6,Points-PointsKO-Adjacents,62
Phyllopentas_mussaendoides,17,11,6,Points-PointsKO-Adjacents,92
Phyllostemonodaphne_geminiflora,62,38,24,Alphahull-PointsKO-Adjacents,1154
Phyllostylon_brasiliense,34,10,24,Points-PointsKO-Adjacents,296
Phyllostylon_rhamnoides,352,238,114,Alphahull-PointsKO-Adjacents,18737
Phylloxylon_arenicola,6,2,4,Points-PointsKO-Adjacents,24
Phylloxylon_decipiens,8,4,4,Points-PointsKO-Adjacents,44
Phylloxylon_perrieri,55,41,14,Alphahull-PointsKO-Adjacents,1097
Phylloxylon_phillipsonii,3,3,0,Points-PointsKO-Adjacents,21
Phylloxylon_spinosa,10,5,5,Points-PointsKO-Adjacents,45
Phylloxylon_xiphoclada,11,6,5,Points-PointsKO-Adjacents,51
Phylloxylon_xylophylloides,144,119,25,Alphahull-PointsKO-Adjacents,861
Phymosia_rosea,105,73,32,Alphahull-PointsKO-Adjacents,1850
Phymosia_umbellata,141,98,43,Alphahull-PointsKO-Adjacents,1087
Physena_madagascariensis,206,177,29,Alphahull-PointsKO-Adjacents,2762
Physena_sessiliflora,73,52,21,Alphahull-PointsKO-Adjacents,633
Physocalymma_scaberrimum,487,424,63,Alphahull-PointsKO-Adjacents,26125
Physokentia_avia,1,1,0,Points-PointsKO-Adjacents,9
Physokentia_dennisii,0,0,0,NA,0
Physokentia_insolita,3,3,0,Points-PointsKO-Adjacents,24
Physokentia_petiolata,0,0,0,NA,0
Physokentia_tete,0,0,0,NA,0
Physokentia_thurstonii,0,0,0,NA,0
Physokentia_whitmorei,0,0,0,NA,0
Physominthe_vitifolia,72,56,16,Alphahull-PointsKO-Adjacents,958
Phytelephas_aequatorialis,57,41,16,Alphahull-PointsKO-Adjacents,603
Phytelephas_macrocarpa,171,146,25,Alphahull-PointsKO-Adjacents,6142
Phytelephas_tenuicaulis,149,127,22,Alphahull-PointsKO-Adjacents,2062
Phytelephas_tumacana,1,1,0,Points-PointsKO-Adjacents,9
Phytolacca_americana,7586,4846,2740,Alphahull-PointsKO-Adjacents,86927
Phytolacca_dioica,666,560,106,Alphahull-PointsKO-Adjacents,19198
Phytolacca_weberbaueri,14,1,13,Points-PointsKO-Adjacents,94
Picardaea_cubensis,8,1,7,Points-PointsKO-Adjacents,44
Picconia_azorica,2,2,0,Points-PointsKO-Adjacents,16
Picconia_excelsa,64,56,8,Alphahull-PointsKO-Adjacents,118
Picea_abies,65478,59976,5502,Alphahull-PointsKO-Adjacents,88995
Picea_alcoquiana,15,8,7,Points-PointsKO-Adjacents,68
Picea_asperata,51,35,16,Alphahull-PointsKO-Adjacents,2166
Picea_aurantiaca,9,2,7,Points-PointsKO-Adjacents,62
Picea_austropanlanica,0,0,0,NA,0
Picea_brachytyla,95,70,25,Alphahull-PointsKO-Adjacents,2869
Picea_breweriana,179,0,179,Points-PointsKO-Adjacents,330
Picea_chihuahuana,43,30,13,Alphahull-PointsKO-Adjacents,287
Picea_crassifolia,20,11,9,Points-PointsKO-Adjacents,167
Picea_engelmannii,11148,11059,89,Alphahull-PointsKO-Adjacents,30488
Picea_farreri,2,2,0,Points-PointsKO-Adjacents,18
Picea_glauca,6100,5687,413,Alphahull-PointsKO-Adjacents,109899
Picea_glehnii,41,22,19,Alphahull-PointsKO-Adjacents,707
Picea_jezoensis,312,0,312,Points-PointsKO-Adjacents,1927
Picea_koraiensis,9,1,8,Points-PointsKO-Adjacents,81
Picea_koyamae,4,4,0,Points-PointsKO-Adjacents,12
Picea_likiangensis,128,106,22,Alphahull-PointsKO-Adjacents,3985
Picea_mariana,4340,4069,271,Alphahull-PointsKO-Adjacents,70521
Picea_maximowiczii,8,1,7,Points-PointsKO-Adjacents,33
Picea_meyeri,12,1,11,Points-PointsKO-Adjacents,108
Picea_morrisonicola,41,34,7,Alphahull-PointsKO-Adjacents,77
Picea_neoveitchii,7,1,6,Points-PointsKO-Adjacents,57
Picea_obovata,94,29,65,Alphahull-PointsKO-Adjacents,1937
Picea_omorika,23,19,4,Points-PointsKO-Adjacents,55
Picea_orientalis,31,21,10,Alphahull-PointsKO-Adjacents,563
Picea_polita,37,18,19,Points-PointsKO-Adjacents,201
Picea_pungens,971,906,65,Alphahull-PointsKO-Adjacents,11776
Picea_purpurea,49,34,15,Alphahull-PointsKO-Adjacents,2650
Picea_retroflexa,8,1,7,Points-PointsKO-Adjacents,64
Picea_rubens,5818,0,5818,Points-PointsKO-Adjacents,4903
Picea_schrenkiana,34,13,21,Points-PointsKO-Adjacents,256
Picea_sitchensis,2122,1959,163,Alphahull-PointsKO-Adjacents,7572
Picea_smithiana,21,0,21,Points-PointsKO-Adjacents,168
Picea_spinulosa,13,8,5,Points-PointsKO-Adjacents,67
Picea_torano,35,16,19,Points-PointsKO-Adjacents,194
Picea_wilsonii,209,159,50,Alphahull-PointsKO-Adjacents,6885
Pichonia_balansana,5,5,0,Points-PointsKO-Adjacents,34
Pichonia_daenikeri,18,12,6,Points-PointsKO-Adjacents,64
Pichonia_lauterbachiana,8,0,8,Points-PointsKO-Adjacents,48
Pichonia_lecomtei,8,6,2,Points-PointsKO-Adjacents,23
Pichonia_occidentalis,3,3,0,Points-PointsKO-Adjacents,25
Pichonia_sessiliflora,0,0,0,NA,0
Picralima_nitida,212,152,60,Alphahull-PointsKO-Adjacents,8458
Picramnia_antidesma,749,631,118,Alphahull-PointsKO-Adjacents,10766
Picramnia_antidesmoides,4,3,1,Points-PointsKO-Adjacents,24
Picramnia_bullata,6,0,6,Points-PointsKO-Adjacents,36
Picramnia_caracasana,8,2,6,Points-PointsKO-Adjacents,60
Picramnia_ciliata,126,89,37,Alphahull-PointsKO-Adjacents,2620
Trichilia_dictyoneura,4,4,0,Points-PointsKO-Adjacents,18
Picramnia_elliptica,31,10,21,Points-PointsKO-Adjacents,222
Picramnia_excelsa,33,7,26,Points-PointsKO-Adjacents,245
Picramnia_gardneri,99,60,39,Alphahull-PointsKO-Adjacents,1623
Picramnia_glazioviana,365,303,62,Alphahull-PointsKO-Adjacents,8250
Picramnia_gracilis,144,114,30,Alphahull-PointsKO-Adjacents,2895
Picramnia_guerrerensis,24,0,24,Points-PointsKO-Adjacents,85
Picramnia_guianensis,25,10,15,Points-PointsKO-Adjacents,207
Picramnia_juniniana,54,11,43,Points-PointsKO-Adjacents,426
Picramnia_killipii,4,4,0,Points-PointsKO-Adjacents,36
Picramnia_latifolia,595,443,152,Alphahull-PointsKO-Adjacents,39737
Picramnia_magnifolia,251,188,63,Alphahull-PointsKO-Adjacents,14611
Picramnia_nuriensis,8,2,6,Points-PointsKO-Adjacents,66
Picramnia_parvifolia,305,0,305,Points-PointsKO-Adjacents,2176
Picramnia_pentandra,213,141,72,Alphahull-PointsKO-Adjacents,2581
Picramnia_polyantha,34,13,21,Points-PointsKO-Adjacents,215
Picramnia_ramiflora,229,176,53,Alphahull-PointsKO-Adjacents,5954
Picramnia_sellowii,798,657,141,Alphahull-PointsKO-Adjacents,61703
Picramnia_sphaerocarpa,113,75,38,Alphahull-PointsKO-Adjacents,1978
Picramnia_spruceana,562,456,106,Alphahull-PointsKO-Adjacents,57485
Picramnia_teapensis,209,158,51,Alphahull-PointsKO-Adjacents,2436
Picramnia_tumbesina,2,2,0,Points-PointsKO-Adjacents,12
Picramnia_villosa,2,2,0,Points-PointsKO-Adjacents,18
Picramnia_xalapensis,87,67,20,Alphahull-PointsKO-Adjacents,251
Picrasma_chinensis,8,0,8,Points-PointsKO-Adjacents,72
Picrasma_crenata,275,223,52,Alphahull-PointsKO-Adjacents,5986
Picrasma_excelsa,69,30,39,Alphahull-PointsKO-Adjacents,846
Picrasma_javanica,50,8,42,Points-PointsKO-Adjacents,357
Picrasma_quassioides,525,307,218,Alphahull-PointsKO-Adjacents,20098
Picrasma_tetramera,1,1,0,Points-PointsKO-Adjacents,8
Picrella_ignambiensis,11,5,6,Points-PointsKO-Adjacents,38
Picrodendron_baccatum,42,25,17,Alphahull-PointsKO-Adjacents,865
Picrolemma_huberi,33,25,8,Alphahull-PointsKO-Adjacents,232
Picrolemma_sprucei,134,92,42,Alphahull-PointsKO-Adjacents,14217
Pictetia_aculeata,37,22,15,Alphahull-PointsKO-Adjacents,123
Pictetia_angustifolia,7,0,7,Points-PointsKO-Adjacents,55
Pictetia_mucronata,8,2,6,Points-PointsKO-Adjacents,67
Pictetia_nipensis,0,0,0,NA,0
Pictetia_obcordata,8,5,3,Points-PointsKO-Adjacents,25
Pictetia_spinosa,6,0,6,Points-PointsKO-Adjacents,50
Pictetia_sulcata,32,25,7,Alphahull-PointsKO-Adjacents,439
Pieris_formosa,149,95,54,Alphahull-PointsKO-Adjacents,10229
Pieris_japonica,587,446,141,Alphahull-PointsKO-Adjacents,4139
Pierreodendron_africanum,16,5,11,Points-PointsKO-Adjacents,99
Pierreodendron_kerstingii,47,28,19,Alphahull-PointsKO-Adjacents,587
Pierrina_zenkeri,15,11,4,Points-PointsKO-Adjacents,81
Pigafetta_elata,0,0,0,NA,0
Pigafetta_filaris,9,0,9,Points-PointsKO-Adjacents,60
Pilea_melastomoides,124,84,40,Alphahull-PointsKO-Adjacents,460
Pilea_multiflora,86,51,35,Alphahull-PointsKO-Adjacents,1002
Pilea_rusbyi,40,17,23,Points-PointsKO-Adjacents,222
Pilgerodendron_uviferum,61,46,15,Alphahull-PointsKO-Adjacents,752
Pilidiostigma_glabrum,460,429,31,Alphahull-PointsKO-Adjacents,501
Pilidiostigma_rhytispermum,129,110,19,Alphahull-PointsKO-Adjacents,201
Pilidiostigma_sessile,36,28,8,Alphahull-PointsKO-Adjacents,80
Pilidiostigma_tropicum,118,112,6,Alphahull-PointsKO-Adjacents,165
Piliocalyx_boudoninii,0,0,0,NA,0
Piliocalyx_bullatus,15,6,9,Points-PointsKO-Adjacents,66
Piliocalyx_eugenioides,6,2,4,Points-PointsKO-Adjacents,48
Piliocalyx_francii,12,7,5,Points-PointsKO-Adjacents,66
Piliocalyx_laurifolius,23,10,13,Points-PointsKO-Adjacents,111
Piliocalyx_micranthus,1,1,0,Points-PointsKO-Adjacents,9
Piliocalyx_robustus,8,3,5,Points-PointsKO-Adjacents,39
Piliocalyx_wagapensis,26,10,16,Points-PointsKO-Adjacents,127
Pilocarpus_alatus,8,1,7,Points-PointsKO-Adjacents,66
Pilocarpus_carajaensis,21,13,8,Points-PointsKO-Adjacents,166
Pilocarpus_demerarae,3,3,0,Points-PointsKO-Adjacents,27
Pilocarpus_giganteus,83,57,26,Alphahull-PointsKO-Adjacents,1785
Pilocarpus_goudotianus,8,0,8,Points-PointsKO-Adjacents,57
Pilocarpus_grandiflorus,55,28,27,Alphahull-PointsKO-Adjacents,337
Pilocarpus_jaborandi,29,14,15,Points-PointsKO-Adjacents,247
Pilocarpus_manuensis,12,5,7,Points-PointsKO-Adjacents,86
Pilocarpus_microphyllus,54,32,22,Alphahull-PointsKO-Adjacents,2413
Pilocarpus_pauciflorus,142,94,48,Alphahull-PointsKO-Adjacents,3913
Pilocarpus_pennatifolius,559,509,50,Alphahull-PointsKO-Adjacents,13146
Pilocarpus_peruvianus,66,31,35,Alphahull-PointsKO-Adjacents,2290
Pilocarpus_racemosus,210,112,98,Alphahull-PointsKO-Adjacents,3266
Pilocarpus_riedelianus,148,100,48,Alphahull-PointsKO-Adjacents,2543
Pilocarpus_spicatus,311,255,56,Alphahull-PointsKO-Adjacents,10473
Pilocarpus_sulcatus,37,25,12,Alphahull-PointsKO-Adjacents,744
Pilocarpus_trachylophus,123,95,28,Alphahull-PointsKO-Adjacents,3659
Pilosocereus_albisummus,2,2,0,Points-PointsKO-Adjacents,18
Pilosocereus_alensis,55,32,23,Alphahull-PointsKO-Adjacents,959
Pilosocereus_aureispinus,3,3,0,Points-PointsKO-Adjacents,21
Pilosocereus_azulensis,4,4,0,Points-PointsKO-Adjacents,32
Pilosocereus_catingicola,147,120,27,Alphahull-PointsKO-Adjacents,3592
Pilosocereus_chrysacanthus,127,108,19,Alphahull-PointsKO-Adjacents,298
Pilosocereus_chrysostele,53,41,12,Alphahull-PointsKO-Adjacents,1600
Pilosocereus_collinsii,19,8,11,Points-PointsKO-Adjacents,111
Pilosocereus_densiareolatus,32,21,11,Alphahull-PointsKO-Adjacents,750
Pilosocereus_flavipulvinatus,17,4,13,Points-PointsKO-Adjacents,147
Pilosocereus_fulvilanatus,17,11,6,Points-PointsKO-Adjacents,82
Pilosocereus_glaucescens,5,5,0,Points-PointsKO-Adjacents,40
Pilosocereus_kanukuensis,0,0,0,NA,0
Pilosocereus_lanuginosus,25,0,25,Points-PointsKO-Adjacents,152
Pilosocereus_leucocephalus,73,46,27,Alphahull-PointsKO-Adjacents,487
Pilosocereus_magnificus,9,5,4,Points-PointsKO-Adjacents,72
Pilosocereus_moritzianus,28,5,23,Points-PointsKO-Adjacents,166
Pilosocereus_oligolepis,3,3,0,Points-PointsKO-Adjacents,27
Pilosocereus_pachycladus,176,154,22,Alphahull-PointsKO-Adjacents,5886
Pilosocereus_piauhyensis,15,4,11,Points-PointsKO-Adjacents,125
Pilosocereus_polygonus,8,1,7,Points-PointsKO-Adjacents,39
Pilosocereus_purpusii,44,21,23,Alphahull-PointsKO-Adjacents,800
Pilosocereus_quadricentralis,12,6,6,Points-PointsKO-Adjacents,79
Pilosocereus_royenii,84,0,84,Points-PointsKO-Adjacents,338
Pseudopilocereus_splendidus,NA,NA,NA,NA,NA
Pilosocereus_tillianus,28,5,23,Points-PointsKO-Adjacents,166
Pilosocereus_tuberculatus,71,61,10,Alphahull-PointsKO-Adjacents,1458
Pilosperma_quadratum,9,2,7,Points-PointsKO-Adjacents,66
Pimelea_mesoa,16,11,5,Points-PointsKO-Adjacents,56
Pimelodendron_amboinicum,196,0,196,Points-PointsKO-Adjacents,1009
Pimelodendron_griffithianum,36,16,20,Points-PointsKO-Adjacents,254
Pimelodendron_macrocarpum,2,2,0,Points-PointsKO-Adjacents,18
Pimelodendron_zoanthogyne,5,0,5,Points-PointsKO-Adjacents,36
Pimenta_adenoclada,2,2,0,Points-PointsKO-Adjacents,14
Pimenta_cainitoides,5,5,0,Points-PointsKO-Adjacents,44
Pimenta_dioica,465,381,84,Alphahull-PointsKO-Adjacents,6980
Pimenta_ferruginea,1,1,0,Points-PointsKO-Adjacents,8
Pimenta_filipes,6,1,5,Points-PointsKO-Adjacents,49
Pimenta_guatemalensis,42,23,19,Alphahull-PointsKO-Adjacents,191
Pimenta_haitiensis,6,2,4,Points-PointsKO-Adjacents,22
Pimenta_jamaicensis,7,2,5,Points-PointsKO-Adjacents,40
Pimenta_obscura,1,1,0,Points-PointsKO-Adjacents,9
Pimenta_odiolens,5,5,0,Points-PointsKO-Adjacents,35
Pimenta_oligantha,4,4,0,Points-PointsKO-Adjacents,34
Pimenta_podocarpoides,0,0,0,NA,0
Pimenta_pseudocaryophyllus,709,621,88,Alphahull-PointsKO-Adjacents,14156
Pimenta_racemosa,134,0,134,Points-PointsKO-Adjacents,610
Pimenta_richardii,0,0,0,NA,0
Pimentelia_glomerata,30,13,17,Points-PointsKO-Adjacents,155
Pinacopodium_congolense,37,26,11,Alphahull-PointsKO-Adjacents,894
Pinacopodium_gabonense,2,2,0,Points-PointsKO-Adjacents,18
Pinanga_acuminata,3,3,0,Points-PointsKO-Adjacents,27
Pinanga_adangensis,0,0,0,NA,0
Pinanga_annamensis,10,5,5,Points-PointsKO-Adjacents,77
Pinanga_auriculata,2,2,0,Points-PointsKO-Adjacents,18
Pinanga_batanensis,0,0,0,NA,0
Pinanga_baviensis,49,27,22,Alphahull-PointsKO-Adjacents,3349
Pinanga_bicolana,0,0,0,NA,0
Pinanga_chaiana,0,0,0,NA,0
Pinanga_declinata,12,6,6,Points-PointsKO-Adjacents,57
Pinanga_dicksonii,0,0,0,NA,0
Pinanga_forbesii,1,1,0,Points-PointsKO-Adjacents,9
Pinanga_fractiflexa,NA,NA,NA,NA,NA
Pinanga_glaucifolia,NA,NA,NA,NA,NA
Pinanga_gracilis,5,5,0,Points-PointsKO-Adjacents,45
Pinanga_hexasticha,0,0,0,NA,0
Pinanga_hymenospatha,0,0,0,NA,0
Pinanga_insignis,13,2,11,Points-PointsKO-Adjacents,88
Pinanga_jamariensis,NA,NA,NA,NA,NA
Pinanga_javana,4,4,0,Points-PointsKO-Adjacents,26
Pinanga_johorensis,NA,NA,NA,NA,NA
Pinanga_malaiana,4,3,1,Points-PointsKO-Adjacents,36
Pinanga_manii,0,0,0,NA,0
Pinanga_mooreana,0,0,0,NA,0
Pinanga_nuichuensis,2,2,0,Points-PointsKO-Adjacents,11
Pinanga_pantiensis,0,0,0,NA,0
Pinanga_patula,9,0,9,Points-PointsKO-Adjacents,80
Pinanga_riparia,0,0,0,NA,0
Pinanga_rivularis,0,0,0,NA,0
Pinanga_samarana,1,1,0,Points-PointsKO-Adjacents,9
Pinanga_sclerophylla,NA,NA,NA,NA,NA
Pinanga_scortechinii,2,2,0,Points-PointsKO-Adjacents,17
Pinanga_sibuyanensis,1,1,0,Points-PointsKO-Adjacents,8
Pinanga_singaporensis,NA,NA,NA,NA,NA
Pinanga_sobolifera,NA,NA,NA,NA,NA
Pinanga_subruminata,1,1,0,Points-PointsKO-Adjacents,7
Pinanga_sylvestris,9,0,9,Points-PointsKO-Adjacents,81
Pinanga_tashiroi,2,2,0,Points-PointsKO-Adjacents,6
Pinanga_tenacinervis,0,0,0,NA,0
Pinanga_versicolor,6,0,6,Points-PointsKO-Adjacents,41
Pinckneya_pubens,10,1,9,Points-PointsKO-Adjacents,88
Pinochia_corymbosa,51,28,23,Alphahull-PointsKO-Adjacents,573
Pinus_albicaulis,458,0,458,Points-PointsKO-Adjacents,1912
Pinus_amamiana,2,2,0,Points-PointsKO-Adjacents,17
Pinus_aristata,327,0,327,Points-PointsKO-Adjacents,998
Pinus_arizonica,555,0,555,Points-PointsKO-Adjacents,1872
Pinus_armandii,290,231,59,Alphahull-PointsKO-Adjacents,13690
Pinus_attenuata,558,509,49,Alphahull-PointsKO-Adjacents,4410
Pinus_ayacahuite,317,277,40,Alphahull-PointsKO-Adjacents,7841
Pinus_balfouriana,205,188,17,Alphahull-PointsKO-Adjacents,391
Pinus_banksiana,3066,2826,240,Alphahull-PointsKO-Adjacents,48723
Pinus_bhutanica,10,5,5,Points-PointsKO-Adjacents,48
Pinus_brutia,122,85,37,Alphahull-PointsKO-Adjacents,5771
Pinus_bungeana,23,7,16,Points-PointsKO-Adjacents,199
Pinus_canariensis,296,254,42,Alphahull-PointsKO-Adjacents,667
Pinus_caribaea,198,148,50,Alphahull-PointsKO-Adjacents,2949
Pinus_cembra,306,273,33,Alphahull-PointsKO-Adjacents,4358
Pinus_cembroides,937,898,39,Alphahull-PointsKO-Adjacents,12216
Pinus_clausa,842,759,83,Alphahull-PointsKO-Adjacents,3101
Pinus_contorta,13393,0,13393,Points-PointsKO-Adjacents,13938
Pinus_coulteri,442,407,35,Alphahull-PointsKO-Adjacents,2225
Pinus_cubensis,35,25,10,Alphahull-PointsKO-Adjacents,181
Pinus_culminicola,79,70,9,Alphahull-PointsKO-Adjacents,205
Pinus_dalatensis,24,12,12,Points-PointsKO-Adjacents,86
Pinus_densata,121,75,46,Alphahull-PointsKO-Adjacents,6874
Pinus_densiflora,422,265,157,Alphahull-PointsKO-Adjacents,6986
Pinus_devoniana,381,345,36,Alphahull-PointsKO-Adjacents,4723
Pinus_douglasiana,212,185,27,Alphahull-PointsKO-Adjacents,3689
Pinus_durangensis,226,209,17,Alphahull-PointsKO-Adjacents,3082
Pinus_echinata,22132,21237,895,Alphahull-PointsKO-Adjacents,22777
Pinus_edulis,10970,10910,60,Alphahull-PointsKO-Adjacents,13688
Pinus_elliottii,12717,12080,637,Alphahull-PointsKO-Adjacents,10696
Pinus_engelmannii,304,278,26,Alphahull-PointsKO-Adjacents,5409
Pinus_fenzeliana,63,40,23,Alphahull-PointsKO-Adjacents,2724
Pinus_flexilis,2658,2584,74,Alphahull-PointsKO-Adjacents,29805
Pinus_georginae,4,4,0,Points-PointsKO-Adjacents,32
Pinus_gerardiana,31,15,16,Points-PointsKO-Adjacents,239
Pinus_glabra,1301,1220,81,Alphahull-PointsKO-Adjacents,4286
Pinus_greggii,173,152,21,Alphahull-PointsKO-Adjacents,886
Pinus_halepensis,26772,24012,2760,Alphahull-PointsKO-Adjacents,13964
Pinus_hartwegii,511,457,54,Alphahull-PointsKO-Adjacents,7073
Pinus_henryi,13,3,10,Points-PointsKO-Adjacents,108
Pinus_herrerae,161,142,19,Alphahull-PointsKO-Adjacents,3394
Pinus_hwangshanensis,6,0,6,Points-PointsKO-Adjacents,54
Pinus_jaliscana,38,31,7,Alphahull-PointsKO-Adjacents,183
Pinus_jeffreyi,1508,1466,42,Alphahull-PointsKO-Adjacents,4399
Pinus_kesiya,29,9,20,Points-PointsKO-Adjacents,223
Pinus_koraiensis,63,35,28,Alphahull-PointsKO-Adjacents,3349
Pinus_krempfii,12,8,4,Points-PointsKO-Adjacents,31
Pinus_lambertiana,1809,1766,43,Alphahull-PointsKO-Adjacents,5534
Pinus_latteri,23,3,20,Points-PointsKO-Adjacents,198
Pinus_lawsonii,186,166,20,Alphahull-PointsKO-Adjacents,2128
Pinus_leiophylla,1234,1,1233,Points-PointsKO-Adjacents,3193
Pinus_longaeva,249,231,18,Alphahull-PointsKO-Adjacents,3362
Pinus_luchuensis,14,0,14,Points-PointsKO-Adjacents,82
Pinus_lumholtzii,244,225,19,Alphahull-PointsKO-Adjacents,2280
Pinus_luzmariae,35,21,14,Alphahull-PointsKO-Adjacents,555
Pinus_massoniana,356,300,56,Alphahull-PointsKO-Adjacents,20232
Pinus_maximartinezii,35,26,9,Alphahull-PointsKO-Adjacents,79
Pinus_maximinoi,279,221,58,Alphahull-PointsKO-Adjacents,4879
Pinus_merkusii,24,4,20,Points-PointsKO-Adjacents,203
Pinus_monophylla,4237,4196,41,Alphahull-PointsKO-Adjacents,13404
Pinus_montezumae,534,493,41,Alphahull-PointsKO-Adjacents,7054
Pinus_monticola,2311,2265,46,Alphahull-PointsKO-Adjacents,11963
Pinus_morrisonicola,55,44,11,Alphahull-PointsKO-Adjacents,191
Pinus_mugo,1580,1450,130,Alphahull-PointsKO-Adjacents,21331
Pinus_muricata,269,222,47,Alphahull-PointsKO-Adjacents,1007
Pinus_nelsonii,123,116,7,Alphahull-PointsKO-Adjacents,257
Pinus_nigra,12196,11766,430,Alphahull-PointsKO-Adjacents,34854
Pinus_occidentalis,33,23,10,Alphahull-PointsKO-Adjacents,246
Pinus_oocarpa,623,565,58,Alphahull-PointsKO-Adjacents,9847
Pinus_palustris,399,321,78,Alphahull-PointsKO-Adjacents,8241
Pinus_parviflora,213,159,54,Alphahull-PointsKO-Adjacents,2353
Pinus_patula,404,364,40,Alphahull-PointsKO-Adjacents,2651
Pinus_peuce,18,13,5,Points-PointsKO-Adjacents,106
Pinus_pinaster,18109,17194,915,Alphahull-PointsKO-Adjacents,22348
Pinus_pinceana,152,138,14,Alphahull-PointsKO-Adjacents,1089
Pinus_pinea,6755,5996,759,Alphahull-PointsKO-Adjacents,13677
Pinus_ponderosa,17931,17722,209,Alphahull-PointsKO-Adjacents,51878
Pinus_praetermissa,31,23,8,Alphahull-PointsKO-Adjacents,194
Pinus_pringlei,170,151,19,Alphahull-PointsKO-Adjacents,1576
Pinus_pseudostrobus,1044,970,74,Alphahull-PointsKO-Adjacents,9675
Pinus_pungens,672,626,46,Alphahull-PointsKO-Adjacents,3204
Pinus_quadrifolia,190,172,18,Alphahull-PointsKO-Adjacents,411
Pinus_radiata,300,200,100,Alphahull-PointsKO-Adjacents,1447
Pinus_remota,85,71,14,Alphahull-PointsKO-Adjacents,1596
Pinus_resinosa,4012,3785,227,Alphahull-PointsKO-Adjacents,27154
Pinus_rigida,2846,0,2846,Points-PointsKO-Adjacents,6140
Pinus_roxburghii,22,5,17,Points-PointsKO-Adjacents,174
Pinus_rzedowskii,28,22,6,Alphahull-PointsKO-Adjacents,41
Pinus_sabiniana,1065,996,69,Alphahull-PointsKO-Adjacents,2973
Pinus_serotina,3467,3226,241,Alphahull-PointsKO-Adjacents,5404
Pinus_sibirica,54,16,38,Points-PointsKO-Adjacents,461
Pinus_squamata,2,2,0,Points-PointsKO-Adjacents,12
Pinus_strobiformis,768,729,39,Alphahull-PointsKO-Adjacents,16540
Pinus_strobus,14352,13423,929,Alphahull-PointsKO-Adjacents,43204
Pinus_sylvestris,14570,13321,1249,Alphahull-PointsKO-Adjacents,121387
Pinus_tabuliformis,237,190,47,Alphahull-PointsKO-Adjacents,8055
Pinus_taeda,40941,39051,1890,Alphahull-PointsKO-Adjacents,21620
Pinus_taiwanensis,164,150,14,Alphahull-PointsKO-Adjacents,212
Pinus_tecunumanii,234,205,29,Alphahull-PointsKO-Adjacents,2774
Pinus_teocote,671,629,42,Alphahull-PointsKO-Adjacents,7903
Pinus_thunbergii,161,58,103,Alphahull-PointsKO-Adjacents,1613
Pinus_torreyana,90,0,90,Points-PointsKO-Adjacents,219
Pinus_tropicalis,19,10,9,Points-PointsKO-Adjacents,86
Pinus_uncinata,1584,1537,47,Alphahull-PointsKO-Adjacents,9234
Pinus_virginiana,9952,9367,585,Alphahull-PointsKO-Adjacents,21320
Pinus_wallichiana,97,59,38,Alphahull-PointsKO-Adjacents,1315
Pinus_wangii,6,1,5,Points-PointsKO-Adjacents,54
Pinus_yunnanensis,155,132,23,Alphahull-PointsKO-Adjacents,4127
Piper_acutifolium,70,34,36,Alphahull-PointsKO-Adjacents,623
Piper_acutulum,0,0,0,NA,0
Piper_admirabile,0,0,0,NA,0
Piper_aduncum,4401,3934,467,Alphahull-PointsKO-Adjacents,172645
Piper_aequale,694,552,142,Alphahull-PointsKO-Adjacents,25963
Piper_aereum,32,19,13,Points-PointsKO-Adjacents,143
Piper_agostiniorum,0,0,0,NA,0
Piper_amalago,3162,2751,411,Alphahull-PointsKO-Adjacents,101480
Piper_andreanum,71,53,18,Alphahull-PointsKO-Adjacents,698
Piper_apodum,1,1,0,Points-PointsKO-Adjacents,9
Piper_araneatum,1,1,0,Points-PointsKO-Adjacents,9
Piper_arboreum,121,96,25,Alphahull-PointsKO-Adjacents,4941
Piper_archeri,34,26,8,Alphahull-PointsKO-Adjacents,447
Piper_arreptum,0,0,0,NA,0
Piper_asterotrichum,23,0,23,Points-PointsKO-Adjacents,183
Piper_asymmetricum,50,29,21,Alphahull-PointsKO-Adjacents,413
Piper_attenuatamentum,0,0,0,NA,0
Piper_augustum,580,490,90,Alphahull-PointsKO-Adjacents,21062
Piper_auritum,1242,1094,148,Alphahull-PointsKO-Adjacents,13312
Piper_azupizuanum,1,1,0,Points-PointsKO-Adjacents,9
Piper_baezanum,2,2,0,Points-PointsKO-Adjacents,18
Piper_barbicuspe,8,4,4,Points-PointsKO-Adjacents,72
Piper_basilobatum,7,0,7,Points-PointsKO-Adjacents,48
Piper_begoniicolor,17,8,9,Points-PointsKO-Adjacents,109
Piper_bellidifolium,50,23,27,Alphahull-PointsKO-Adjacents,1895
Piper_biolleyi,43,34,9,Alphahull-PointsKO-Adjacents,293
Piper_bisasperatum,74,61,13,Alphahull-PointsKO-Adjacents,225
Piper_biseriatum,144,112,32,Alphahull-PointsKO-Adjacents,976
Piper_blattarum,17,14,3,Points-PointsKO-Adjacents,59
Piper_bogotense,80,46,34,Alphahull-PointsKO-Adjacents,669
Piper_bolivianum,24,0,24,Points-PointsKO-Adjacents,69
Piper_bredemeyeri,138,82,56,Alphahull-PointsKO-Adjacents,2938
Piper_cachimboense,24,6,18,Points-PointsKO-Adjacents,206
Piper_calvibaccum,0,0,0,NA,0
Piper_capense,409,289,120,Alphahull-PointsKO-Adjacents,14027
Piper_carpinteranum,54,41,13,Alphahull-PointsKO-Adjacents,282
Piper_carpunya,135,102,33,Alphahull-PointsKO-Adjacents,1845
Piper_carrapanum,0,0,0,NA,0
Piper_carrilloanum,96,83,13,Alphahull-PointsKO-Adjacents,415
Piper_celsum,1,1,0,Points-PointsKO-Adjacents,9
Piper_cernuum,911,720,191,Alphahull-PointsKO-Adjacents,37982
Piper_chrysostachyum,80,67,13,Alphahull-PointsKO-Adjacents,475
Piper_colonense,67,47,20,Alphahull-PointsKO-Adjacents,1235
Piper_cordulatum,53,31,22,Alphahull-PointsKO-Adjacents,168
Piper_corintoananum,0,0,0,NA,0
Piper_corrugatum,138,122,16,Alphahull-PointsKO-Adjacents,614
Piper_costatum,25,10,15,Points-PointsKO-Adjacents,219
Piper_crassinervium,1214,1024,190,Alphahull-PointsKO-Adjacents,36866
Piper_crenulatum,0,0,0,NA,0
Piper_cumanense,59,32,27,Alphahull-PointsKO-Adjacents,3638
Piper_cupreatum,3,3,0,Points-PointsKO-Adjacents,27
Piper_curtispicum,132,112,20,Alphahull-PointsKO-Adjacents,488
Piper_curvatipes,8,3,5,Points-PointsKO-Adjacents,69
Piper_curvipilum,29,23,6,Alphahull-PointsKO-Adjacents,108
Piper_daniel-gonzalezii,48,36,12,Alphahull-PointsKO-Adjacents,672
Piper_dasyoura,17,7,10,Points-PointsKO-Adjacents,91
Piper_desultorium,1,1,0,Points-PointsKO-Adjacents,9
Piper_dichotomum,30,12,18,Points-PointsKO-Adjacents,228
Piper_dilatatum,370,202,168,Alphahull-PointsKO-Adjacents,17896
Piper_distigmatum,4,4,0,Points-PointsKO-Adjacents,19
Piper_divaricatum,340,207,133,Alphahull-PointsKO-Adjacents,12499
Piper_dotanum,46,33,13,Alphahull-PointsKO-Adjacents,160
Piper_epigynium,98,0,98,Points-PointsKO-Adjacents,453
Piper_eriopodon,91,63,28,Alphahull-PointsKO-Adjacents,2088
Piper_fagifolium,1,1,0,Points-PointsKO-Adjacents,9
Piper_fimbriulatum,92,71,21,Alphahull-PointsKO-Adjacents,805
Piper_formosum,3,3,0,Points-PointsKO-Adjacents,27
Piper_fortunaense,40,0,40,Points-PointsKO-Adjacents,170
Piper_fresnoense,3,3,0,Points-PointsKO-Adjacents,27
Piper_friedrichsthalii,236,201,35,Alphahull-PointsKO-Adjacents,1313
Piper_fundacionense,4,4,0,Points-PointsKO-Adjacents,12
Piper_gaudichaudianum,605,486,119,Alphahull-PointsKO-Adjacents,16998
Piper_gibbosum,27,23,4,Alphahull-PointsKO-Adjacents,55
Piper_glabrescens,355,273,82,Alphahull-PointsKO-Adjacents,5606
Piper_grande,148,101,47,Alphahull-PointsKO-Adjacents,5935
Piper_guanacostense,45,31,14,Alphahull-PointsKO-Adjacents,230
Piper_guineense,403,313,90,Alphahull-PointsKO-Adjacents,22935
Piper_gutierrezii,3,3,0,Points-PointsKO-Adjacents,27
Piper_hartwegianum,8,3,5,Points-PointsKO-Adjacents,58
Piper_haughtii,32,19,13,Points-PointsKO-Adjacents,238
Piper_hispidum,3105,2777,328,Alphahull-PointsKO-Adjacents,141125
Piper_holdridgeianum,16,11,5,Points-PointsKO-Adjacents,75
Piper_hostmannianum,353,258,95,Alphahull-PointsKO-Adjacents,23116
Piper_huantanum,3,3,0,Points-PointsKO-Adjacents,27
Piper_hylophilum,7,2,5,Points-PointsKO-Adjacents,63
Piper_imperiale,268,233,35,Alphahull-PointsKO-Adjacents,4925
Piper_inaequale,9,0,9,Points-PointsKO-Adjacents,64
Piper_incomptum,2,2,0,Points-PointsKO-Adjacents,18
Piper_indiciflexum,1,1,0,Points-PointsKO-Adjacents,9
Piper_insignilaminum,6,1,5,Points-PointsKO-Adjacents,38
Piper_interitum,1,1,0,Points-PointsKO-Adjacents,9
Piper_itayanum,10,3,7,Points-PointsKO-Adjacents,46
Piper_jacquemontianum,587,518,69,Alphahull-PointsKO-Adjacents,7216
Piper_jauaense,4,4,0,Points-PointsKO-Adjacents,24
Piper_lacunosum,106,72,34,Alphahull-PointsKO-Adjacents,1873
Piper_laevigatum,114,77,37,Alphahull-PointsKO-Adjacents,8344
Piper_laguna-cochanum,17,4,13,Points-PointsKO-Adjacents,113
Piper_lanceifolium,253,199,54,Alphahull-PointsKO-Adjacents,3718
Piper_lhotzkyanum,81,52,29,Alphahull-PointsKO-Adjacents,3165
Piper_lineatum,35,22,13,Alphahull-PointsKO-Adjacents,949
Piper_longepetiolatum,26,13,13,Points-PointsKO-Adjacents,65
Piper_longestamineum,2,2,0,Points-PointsKO-Adjacents,18
Piper_longicaudatum,9,5,4,Points-PointsKO-Adjacents,63
Piper_longispicum,130,93,37,Alphahull-PointsKO-Adjacents,3514
Piper_lucigaudens,13,4,9,Points-PointsKO-Adjacents,83
Piper_malifolium,4,4,0,Points-PointsKO-Adjacents,36
Piper_marginatum,923,727,196,Alphahull-PointsKO-Adjacents,41934
Piper_marturetense,4,4,0,Points-PointsKO-Adjacents,32
Piper_maxonii,27,16,11,Points-PointsKO-Adjacents,111
Piper_mazamariense,1,1,0,Points-PointsKO-Adjacents,9
Piper_melanocladum,117,85,32,Alphahull-PointsKO-Adjacents,1272
Piper_minute-scabiosum,6,3,3,Points-PointsKO-Adjacents,27
Piper_mollicomum,770,599,171,Alphahull-PointsKO-Adjacents,19815
Piper_montanum,14,7,7,Points-PointsKO-Adjacents,104
Piper_nanegalense,5,5,0,Points-PointsKO-Adjacents,45
Piper_neesianum,182,158,24,Alphahull-PointsKO-Adjacents,2553
Piper_nudilimbum,63,31,32,Alphahull-PointsKO-Adjacents,3960
Piper_obliquum,1193,1027,166,Alphahull-PointsKO-Adjacents,66269
Piper_obovatifolium,0,0,0,NA,0
Piper_obtusilimbum,87,57,30,Alphahull-PointsKO-Adjacents,5454
Piper_ollantaitambanum,0,0,0,NA,0
Piper_ottoniifolium,88,54,34,Alphahull-PointsKO-Adjacents,1683
Piper_parianum,0,0,0,NA,0
Piper_pellitum,49,18,31,Points-PointsKO-Adjacents,299
Piper_peltilimbum,19,13,6,Points-PointsKO-Adjacents,75
Piper_peracuminatum,36,23,13,Alphahull-PointsKO-Adjacents,382
Piper_perareolatum,31,16,15,Points-PointsKO-Adjacents,216
Piper_percostatum,46,34,12,Alphahull-PointsKO-Adjacents,268
Piper_perenense,1,1,0,Points-PointsKO-Adjacents,9
Piper_perscabrifolium,4,4,0,Points-PointsKO-Adjacents,26
Piper_persubulatum,2,2,0,Points-PointsKO-Adjacents,18
Piper_perverrucosum,7,0,7,Points-PointsKO-Adjacents,59
Piper_phytolaccifolium,211,149,62,Alphahull-PointsKO-Adjacents,5966
Piper_pilirameum,52,36,16,Alphahull-PointsKO-Adjacents,562
Piper_pinoganense,11,6,5,Points-PointsKO-Adjacents,56
Piper_pittieri,58,48,10,Alphahull-PointsKO-Adjacents,137
Piper_planipes,1,1,0,Points-PointsKO-Adjacents,9
Piper_platylobum,NA,NA,NA,NA,NA
Piper_poasanum,20,12,8,Points-PointsKO-Adjacents,104
Piper_prismaticum,85,70,15,Alphahull-PointsKO-Adjacents,317
Piper_procerum,2,2,0,Points-PointsKO-Adjacents,18
Piper_productispicum,2,2,0,Points-PointsKO-Adjacents,18
Piper_propinquum,74,32,42,Alphahull-PointsKO-Adjacents,1166
Piper_pseudoarboreum,115,86,29,Alphahull-PointsKO-Adjacents,2603
Piper_pseudodivulgatum,1,1,0,Points-PointsKO-Adjacents,9
Piper_pseudofuligineum,417,343,74,Alphahull-PointsKO-Adjacents,6597
Piper_psilophyllum,16,11,5,Points-PointsKO-Adjacents,84
Piper_psilorhachis,166,121,45,Alphahull-PointsKO-Adjacents,2863
Piper_puberulinerve,5,5,0,Points-PointsKO-Adjacents,45
Piper_pulchrum,20,13,7,Points-PointsKO-Adjacents,127
Piper_puraceanum,13,2,11,Points-PointsKO-Adjacents,96
Piper_regale,3,3,0,Points-PointsKO-Adjacents,27
Piper_resalutatum,0,0,0,NA,0
Piper_restio,2,2,0,Points-PointsKO-Adjacents,18
Piper_reticulatum,802,651,151,Alphahull-PointsKO-Adjacents,33910
Piper_ronaldii,6,0,6,Points-PointsKO-Adjacents,41
Piper_rugulosum,8,0,8,Points-PointsKO-Adjacents,72
Piper_sabaletasanum,0,0,0,NA,0
Piper_sanctum,156,108,48,Alphahull-PointsKO-Adjacents,4123
Piper_sanroqueanum,1,1,0,Points-PointsKO-Adjacents,9
Piper_san-vicentense,1,1,0,Points-PointsKO-Adjacents,9
Piper_schiedeanum,311,248,63,Alphahull-PointsKO-Adjacents,5135
Piper_secundum,21,8,13,Points-PointsKO-Adjacents,144
Piper_semimetrale,11,2,9,Points-PointsKO-Adjacents,91
Piper_sempervirens,155,138,17,Alphahull-PointsKO-Adjacents,2167
Piper_standleyi,6,2,4,Points-PointsKO-Adjacents,36
Piper_strigosum,9,4,5,Points-PointsKO-Adjacents,81
Piper_subtomentosum,0,0,0,NA,0
Piper_swartzianum,2,0,2,Points-PointsKO-Adjacents,18
Piper_tenue,19,0,19,Points-PointsKO-Adjacents,156
Piper_terrabanum,88,71,17,Alphahull-PointsKO-Adjacents,657
Piper_tovarense,0,0,0,NA,0
Piper_tuberculatum,1585,1305,280,Alphahull-PointsKO-Adjacents,120609
Piper_tucumanum,118,81,37,Alphahull-PointsKO-Adjacents,1124
Piper_umbellatum,266,218,48,Alphahull-PointsKO-Adjacents,5485
Piper_umbriense,5,5,0,Points-PointsKO-Adjacents,42
Piper_villiramulum,255,187,68,Alphahull-PointsKO-Adjacents,3235
Piper_villosispicum,5,5,0,Points-PointsKO-Adjacents,45
Piper_viridistachyum,12,4,8,Points-PointsKO-Adjacents,79
Piper_yzabalanum,44,25,19,Alphahull-PointsKO-Adjacents,1233
Piper_zacatense,49,34,15,Alphahull-PointsKO-Adjacents,708
Piptadenia_adiantoides,163,116,47,Alphahull-PointsKO-Adjacents,4765
Piptadenia_boliviana,7,3,4,Points-PointsKO-Adjacents,57
Piptadenia_buchtienii,54,40,14,Alphahull-PointsKO-Adjacents,567
Piptadenia_flava,347,232,115,Alphahull-PointsKO-Adjacents,8102
Piptadenia_gonoacantha,997,856,141,Alphahull-PointsKO-Adjacents,32088
Piptadenia_latifolia,1,1,0,Points-PointsKO-Adjacents,9
Piptadenia_leucoxylon,3,0,3,Points-PointsKO-Adjacents,27
Piptadenia_macradenia,41,0,41,Points-PointsKO-Adjacents,311
Piptadenia_minutiflora,20,1,19,Points-PointsKO-Adjacents,162
Piptadenia_obliqua,189,124,65,Alphahull-PointsKO-Adjacents,5059
Piptadenia_paniculata,324,265,59,Alphahull-PointsKO-Adjacents,5108
Piptadenia_peruviana,27,12,15,Points-PointsKO-Adjacents,164
Piptadenia_pteroclada,71,0,71,Points-PointsKO-Adjacents,562
Piptadenia_robusta,39,0,39,Points-PointsKO-Adjacents,290
Piptadenia_uliginosa,4,4,0,Points-PointsKO-Adjacents,35
Piptadenia_viridiflora,620,512,108,Alphahull-PointsKO-Adjacents,14486
Piptadenia_weberbaueri,2,2,0,Points-PointsKO-Adjacents,18
Piptadeniastrum_africanum,299,232,67,Alphahull-PointsKO-Adjacents,12437
Piptadeniopsis_lomentifera,21,11,10,Points-PointsKO-Adjacents,164
Piptocarpha_angustifolia,272,247,25,Alphahull-PointsKO-Adjacents,3867
Piptocarpha_axillaris,609,541,68,Alphahull-PointsKO-Adjacents,7725
Piptocarpha_boyacensis,4,4,0,Points-PointsKO-Adjacents,34
Piptocarpha_densifolia,112,84,28,Alphahull-PointsKO-Adjacents,1475
Piptocarpha_lechleri,55,23,32,Alphahull-PointsKO-Adjacents,634
Piptocarpha_macropoda,617,545,72,Alphahull-PointsKO-Adjacents,11954
Piptocarpha_opaca,112,43,69,Alphahull-PointsKO-Adjacents,6716
Piptocarpha_organensis,27,13,14,Points-PointsKO-Adjacents,197
Piptocarpha_poeppigiana,275,186,89,Alphahull-PointsKO-Adjacents,9480
Piptocarpha_polycephala,18,1,17,Points-PointsKO-Adjacents,126
Piptocarpha_regnellii,253,213,40,Alphahull-PointsKO-Adjacents,2894
Piptocarpha_robusta,7,0,7,Points-PointsKO-Adjacents,63
Piptocarpha_rotundifolia,710,633,77,Alphahull-PointsKO-Adjacents,23162
Piptocoma_acuminata,13,3,10,Points-PointsKO-Adjacents,73
Piptocoma_discolor,375,326,49,Alphahull-PointsKO-Adjacents,8988
Piptocoma_macrophylla,15,4,11,Points-PointsKO-Adjacents,108
Piptocoma_milleri,3,3,0,Points-PointsKO-Adjacents,26
Piptocoma_niceforoi,47,28,19,Alphahull-PointsKO-Adjacents,1201
Piptocoma_samanensis,2,2,0,Points-PointsKO-Adjacents,17
Piptocoma_schomburgkii,128,101,27,Alphahull-PointsKO-Adjacents,9733
Piptolepis_buxoides,8,2,6,Points-PointsKO-Adjacents,56
Piptolepis_monticola,11,8,3,Points-PointsKO-Adjacents,60
Piptomeris_sternbergiana,112,90,22,Alphahull-PointsKO-Adjacents,740
Piptostigma_calophyllum,17,5,12,Points-PointsKO-Adjacents,128
Piptostigma_fasciculatum,69,28,41,Alphahull-PointsKO-Adjacents,1505
Piptostigma_fugax,53,36,17,Alphahull-PointsKO-Adjacents,1016
Piptostigma_giganteum,0,0,0,NA,0
Piptostigma_glabrescens,31,18,13,Points-PointsKO-Adjacents,206
Piptostigma_mortehanii,31,10,21,Points-PointsKO-Adjacents,234
Piptostigma_multinervium,51,39,12,Alphahull-PointsKO-Adjacents,906
Piptostigma_oyemense,9,2,7,Points-PointsKO-Adjacents,69
Piptostigma_pilosum,27,13,14,Points-PointsKO-Adjacents,183
Pipturus_albidus,84,61,23,Alphahull-PointsKO-Adjacents,251
Pipturus_arborescens,30,12,18,Points-PointsKO-Adjacents,140
Pipturus_argenteus,881,672,209,Alphahull-PointsKO-Adjacents,15085
Pipturus_velutinus,0,0,0,NA,0
Piranhea_longepedunculata,9,1,8,Points-PointsKO-Adjacents,66
Piranhea_longipedunculata,19,7,12,Points-PointsKO-Adjacents,155
Piranhea_mexicana,68,49,19,Alphahull-PointsKO-Adjacents,149
Piranhea_securinega,40,29,11,Alphahull-PointsKO-Adjacents,692
Piranhea_trifoliata,280,222,58,Alphahull-PointsKO-Adjacents,23298
Piscidia_carthagenensis,262,174,88,Alphahull-PointsKO-Adjacents,5574
Piscidia_ekmanii,8,6,2,Points-PointsKO-Adjacents,62
Piscidia_grandifolia,190,156,34,Alphahull-PointsKO-Adjacents,1215
Piscidia_havanensis,4,3,1,Points-PointsKO-Adjacents,31
Piscidia_mollis,32,24,8,Alphahull-PointsKO-Adjacents,307
Piscidia_piscipula,635,0,635,Points-PointsKO-Adjacents,2496
Pisonia_aculeata,1487,1132,355,Alphahull-PointsKO-Adjacents,29084
Pisonia_albida,10,2,8,Points-PointsKO-Adjacents,49
Pisonia_ambigua,78,38,40,Alphahull-PointsKO-Adjacents,3963
Pisonia_brunoniana,19,6,13,Points-PointsKO-Adjacents,65
Pisonia_capitata,95,67,28,Alphahull-PointsKO-Adjacents,1205
Pisonia_costata,0,0,0,NA,0
Pisonia_donnellsmithii,7,2,5,Points-PointsKO-Adjacents,48
Pisonia_floribunda,8,0,8,Points-PointsKO-Adjacents,50
Pisonia_floridana,0,0,0,NA,0
Pisonia_grandis,33,2,31,Points-PointsKO-Adjacents,151
Pisonia_indecora,0,0,0,NA,0
Pisonia_lanceolata,0,0,0,NA,0
Pisonia_macranthocarpa,295,0,295,Points-PointsKO-Adjacents,1176
Pisonia_rotundata,5,2,3,Points-PointsKO-Adjacents,33
Pisonia_sandwicensis,5,3,2,Points-PointsKO-Adjacents,34
Pisonia_tahitensis,7,1,6,Points-PointsKO-Adjacents,28
Pisonia_subcordata,17,6,11,Points-PointsKO-Adjacents,101
Pisonia_taina,3,2,1,Points-PointsKO-Adjacents,18
Pisonia_umbellifera,338,194,144,Alphahull-PointsKO-Adjacents,2416
Pisonia_wagneriana,1,1,0,Points-PointsKO-Adjacents,9
Pisonia_zapallo,299,235,64,Alphahull-PointsKO-Adjacents,24336
Pistacia_aethiopica,6,0,6,Points-PointsKO-Adjacents,54
Pistacia_atlantica,199,126,73,Alphahull-PointsKO-Adjacents,2618
Pistacia_chinensis,233,170,63,Alphahull-PointsKO-Adjacents,25293
Pistacia_khinjuk,69,36,33,Alphahull-PointsKO-Adjacents,2012
Pistacia_lentiscus,21623,19308,2315,Alphahull-PointsKO-Adjacents,16669
Pistacia_mexicana,457,399,58,Alphahull-PointsKO-Adjacents,7967
Pistacia_terebinthus,4826,4462,364,Alphahull-PointsKO-Adjacents,18595
Pistacia_vera,31,9,22,Points-PointsKO-Adjacents,251
Pistacia_weinmanniifolia,88,68,20,Alphahull-PointsKO-Adjacents,5123
Pitardella_poilanei,NA,NA,NA,NA,NA
Pitardella_sikkimensis,0,0,0,NA,0
Pitavia_punctata,4,0,4,Points-PointsKO-Adjacents,35
Pithecellobium_bipinnatum,13,9,4,Points-PointsKO-Adjacents,42
Pithecellobium_circinale,21,14,7,Points-PointsKO-Adjacents,117
Pithecellobium_diversifolium,269,240,29,Alphahull-PointsKO-Adjacents,6746
Pithecellobium_domingense,3,3,0,Points-PointsKO-Adjacents,21
Pithecellobium_dulce,1237,1018,219,Alphahull-PointsKO-Adjacents,25029
Pithecellobium_excelsum,132,115,17,Alphahull-PointsKO-Adjacents,1085
Pithecellobium_furcatum,36,19,17,Points-PointsKO-Adjacents,172
Pithecellobium_histrix,14,2,12,Points-PointsKO-Adjacents,99
Pithecellobium_hymenaeifolium,76,45,31,Alphahull-PointsKO-Adjacents,678
Pithecellobium_johansenii,5,5,0,Points-PointsKO-Adjacents,41
Pithecellobium_keyense,25,11,14,Points-PointsKO-Adjacents,146
Pithecellobium_lanceolatum,397,324,73,Alphahull-PointsKO-Adjacents,8991
Pithecellobium_macrandrium,26,14,12,Points-PointsKO-Adjacents,136
Pithecellobium_nicoyanum,0,0,0,NA,0
Pithecellobium_oblongum,167,92,75,Alphahull-PointsKO-Adjacents,4866
Pithecellobium_peckii,7,4,3,Points-PointsKO-Adjacents,53
Pithecellobium_pistaciifolium,4,3,1,Points-PointsKO-Adjacents,30
Pithecellobium_platycarpum,NA,NA,NA,NA,NA
Pithecellobium_roseum,30,15,15,Points-PointsKO-Adjacents,242
Pithecellobium_striolatum,0,0,0,NA,0
Pithecellobium_subglobosum,5,5,0,Points-PointsKO-Adjacents,39
Pithecellobium_tenue,9,2,7,Points-PointsKO-Adjacents,81
Pithecellobium_unguis-cati,321,196,125,Alphahull-PointsKO-Adjacents,7710
Pittoniotis_protracta,245,204,41,Alphahull-PointsKO-Adjacents,3763
Pittoniotis_rotata,4,4,0,Points-PointsKO-Adjacents,18
Pittoniotis_trichantha,102,54,48,Alphahull-PointsKO-Adjacents,1863
Pittosporopsis_kerrii,12,3,9,Points-PointsKO-Adjacents,98
Pittosporum_abyssinicum,14,5,9,Points-PointsKO-Adjacents,108
Pittosporum_argentifolium,6,2,4,Points-PointsKO-Adjacents,22
Pittosporum_balansae,26,8,18,Points-PointsKO-Adjacents,210
Pittosporum_balfourii,0,0,0,NA,0
Pittosporum_bicolor,3364,3322,42,Alphahull-PointsKO-Adjacents,2892
Pittosporum_bracteolatum,7,2,5,Points-PointsKO-Adjacents,3
Pittosporum_brevicalyx,32,11,21,Points-PointsKO-Adjacents,288
Pittosporum_cacondense,1,1,0,Points-PointsKO-Adjacents,9
Pittosporum_coccineum,24,14,10,Points-PointsKO-Adjacents,93
Pittosporum_confertiflorum,10,3,7,Points-PointsKO-Adjacents,44
Pittosporum_coriaceum,4,4,0,Points-PointsKO-Adjacents,13
Pittosporum_cornifolium,323,276,47,Alphahull-PointsKO-Adjacents,1718
Pittosporum_crassifolium,211,150,61,Alphahull-PointsKO-Adjacents,1856
Pittosporum_dallii,14,7,7,Points-PointsKO-Adjacents,74
Pittosporum_daphniphylloides,85,62,23,Alphahull-PointsKO-Adjacents,521
Pittosporum_ellipticum,92,69,23,Alphahull-PointsKO-Adjacents,614
Pittosporum_erioloma,11,7,4,Points-PointsKO-Adjacents,5
Pittosporum_eugenioides,1605,1491,114,Alphahull-PointsKO-Adjacents,4389
Pittosporum_fairchildii,7,0,7,Points-PointsKO-Adjacents,34
Pittosporum_flocculosum,1,1,0,Points-PointsKO-Adjacents,8
Pittosporum_fulvipilosum,3,3,0,Points-PointsKO-Adjacents,27
Pittosporum_gayanum,5,2,3,Points-PointsKO-Adjacents,19
Pittosporum_glabrum,28,16,12,Points-PointsKO-Adjacents,80
Pittosporum_goetzei,5,5,0,Points-PointsKO-Adjacents,23
Pittosporum_halophylum,7,1,6,Points-PointsKO-Adjacents,36
Pittosporum_hawaiiense,4,4,0,Points-PointsKO-Adjacents,31
Pittosporum_hosmeri,9,3,6,Points-PointsKO-Adjacents,63
Pittosporum_humbertii,9,2,7,Points-PointsKO-Adjacents,51
Pittosporum_huttonianum,60,44,16,Alphahull-PointsKO-Adjacents,201
Pittosporum_johnstonianum,12,8,4,Points-PointsKO-Adjacents,35
Pittosporum_kauaiense,9,4,5,Points-PointsKO-Adjacents,18
Pittosporum_kerrii,10,4,6,Points-PointsKO-Adjacents,90
Pittosporum_kunmingense,3,3,0,Points-PointsKO-Adjacents,27
Pittosporum_kwangsiense,4,4,0,Points-PointsKO-Adjacents,36
Pittosporum_leptosepalum,4,4,0,Points-PointsKO-Adjacents,36
Pittosporum_napaliense,4,1,3,Points-PointsKO-Adjacents,10
Pittosporum_obcordatum,54,26,28,Alphahull-PointsKO-Adjacents,692
Pittosporum_ochrosiifolium,142,119,23,Alphahull-PointsKO-Adjacents,1319
Pittosporum_paniculiferum,2,2,0,Points-PointsKO-Adjacents,18
Pittosporum_patulum,81,66,15,Alphahull-PointsKO-Adjacents,315
Pittosporum_pentandrum,62,0,62,Points-PointsKO-Adjacents,264
Pittosporum_perglabratum,NA,NA,NA,NA,NA
Pittosporum_phillyraeoides,7679,7465,214,Alphahull-PointsKO-Adjacents,59901
Pittosporum_planilobum,3,3,0,Points-PointsKO-Adjacents,27
Pittosporum_polyspermum,71,46,25,Alphahull-PointsKO-Adjacents,590
Pittosporum_resiniferum,2,2,0,Points-PointsKO-Adjacents,18
Pittosporum_senacia,55,40,15,Alphahull-PointsKO-Adjacents,303
Citriobatus_spinescens,109,84,25,Alphahull-PointsKO-Adjacents,3590
Pittosporum_tanianum,2,2,0,Points-PointsKO-Adjacents,11
Pittosporum_tenuifolium,1823,1666,157,Alphahull-PointsKO-Adjacents,4802
Pittosporum_tenuivalvatum,3,3,0,Points-PointsKO-Adjacents,27
Pittosporum_terminalioides,17,9,8,Points-PointsKO-Adjacents,75
Pittosporum_umbellatum,141,120,21,Alphahull-PointsKO-Adjacents,976
Pittosporum_undulatifolium,0,0,0,NA,0
Pittosporum_undulatum,7613,6447,1166,Alphahull-PointsKO-Adjacents,9553
Pittosporum_verticillatum,122,96,26,Alphahull-PointsKO-Adjacents,1757
Pittosporum_virgatum,76,65,11,Alphahull-PointsKO-Adjacents,135
Pittosporum_viridiflorum,477,318,159,Alphahull-PointsKO-Adjacents,19343
Pityrocarpa_moniliformis,905,849,56,Alphahull-PointsKO-Adjacents,13781
Placodiscus_amaniensis,5,0,5,Points-PointsKO-Adjacents,39
Placodiscus_angustifolius,7,0,7,Points-PointsKO-Adjacents,63
Placodiscus_attenuatus,30,21,9,Alphahull-PointsKO-Adjacents,372
Placodiscus_bancoensis,16,13,3,Points-PointsKO-Adjacents,106
Placodiscus_boya,22,11,11,Points-PointsKO-Adjacents,183
Placodiscus_caudatus,5,1,4,Points-PointsKO-Adjacents,36
Placodiscus_glandulosus,16,6,10,Points-PointsKO-Adjacents,118
Placodiscus_leptostachys,13,3,10,Points-PointsKO-Adjacents,71
Placodiscus_opacus,39,26,13,Alphahull-PointsKO-Adjacents,1789
Placodiscus_pedicellatus,3,3,0,Points-PointsKO-Adjacents,18
Placodiscus_pseudostipularis,32,16,16,Points-PointsKO-Adjacents,226
Placodiscus_pynaertii,2,2,0,Points-PointsKO-Adjacents,9
Placodiscus_riparius,4,3,1,Points-PointsKO-Adjacents,36
Placodiscus_splendidus,3,3,0,Points-PointsKO-Adjacents,24
Placodiscus_turbinatus,2,1,1,Points-PointsKO-Adjacents,18
Placolobium_ellipticum,NA,NA,NA,NA,NA
Placolobium_vietnamense,NA,NA,NA,NA,NA
Placolobium_watsonii,0,0,0,NA,0
Plagianthus_regius,277,221,56,Alphahull-PointsKO-Adjacents,2991
Plagiocladus_diandrus,104,92,12,Alphahull-PointsKO-Adjacents,1318
Plagioscyphus_calciphilus,13,10,3,Points-PointsKO-Adjacents,52
Plagioscyphus_cauliflorus,4,3,1,Points-PointsKO-Adjacents,33
Plagioscyphus_danguyanus,2,2,0,Points-PointsKO-Adjacents,16
Plagioscyphus_humbertii,9,0,9,Points-PointsKO-Adjacents,81
Plagioscyphus_jumellei,39,19,20,Points-PointsKO-Adjacents,214
Plagioscyphus_louvelii,49,26,23,Alphahull-PointsKO-Adjacents,690
Plagioscyphus_meridionalis,9,0,9,Points-PointsKO-Adjacents,27
Plagioscyphus_unijugatus,6,1,5,Points-PointsKO-Adjacents,37
Plagiosiphon_emarginatus,126,103,23,Alphahull-PointsKO-Adjacents,2595
Plagiosiphon_gabonensis,51,40,11,Alphahull-PointsKO-Adjacents,755
Plagiosiphon_longitubus,26,0,26,Points-PointsKO-Adjacents,176
Plagiosiphon_multijugus,39,25,14,Alphahull-PointsKO-Adjacents,952
Plagiostyles_africana,218,183,35,Alphahull-PointsKO-Adjacents,5659
Planchonella_amieuana,11,4,7,Points-PointsKO-Adjacents,49
Planchonella_aneityensis,3,3,0,Points-PointsKO-Adjacents,18
Planchonella_annamensis,11,1,10,Points-PointsKO-Adjacents,90
Planchonella_anteridifera,28,10,18,Points-PointsKO-Adjacents,143
Planchonella_arnhemica,174,161,13,Alphahull-PointsKO-Adjacents,3668
Planchonella_australis,824,773,51,Alphahull-PointsKO-Adjacents,1459
Planchonella_boninensis,NA,NA,NA,NA,NA
Planchonella_brevipes,0,0,0,NA,0
Planchonella_calcarea,1,1,0,Points-PointsKO-Adjacents,8
Planchonella_cauliflora,3,3,0,Points-PointsKO-Adjacents,21
Planchonella_chartacea,273,0,273,Points-PointsKO-Adjacents,1120
Planchonella_chrysophylloides,1,1,0,Points-PointsKO-Adjacents,9
Planchonella_cinerea,15,8,7,Points-PointsKO-Adjacents,71
Planchonella_clemensii,1,1,0,Points-PointsKO-Adjacents,9
Planchonella_contermina,15,8,7,Points-PointsKO-Adjacents,42
Planchonella_costata,64,44,20,Alphahull-PointsKO-Adjacents,449
Planchonella_cotinifolia,217,178,39,Alphahull-PointsKO-Adjacents,5585
Planchonella_cyclopensis,2,2,0,Points-PointsKO-Adjacents,16
Planchonella_duclitan,21,0,21,Points-PointsKO-Adjacents,133
Planchonella_eerwah,34,18,16,Points-PointsKO-Adjacents,92
Planchonella_endlicheri,19,12,7,Points-PointsKO-Adjacents,55
Planchonella_erringtonii,NA,NA,NA,NA,NA
Planchonella_euphlebia,80,66,14,Alphahull-PointsKO-Adjacents,210
Planchonella_forbesii,3,3,0,Points-PointsKO-Adjacents,21
Planchonella_garberi,11,0,11,Points-PointsKO-Adjacents,48
Planchonella_glauca,10,5,5,Points-PointsKO-Adjacents,47
Planchonella_grandifolia,6,0,6,Points-PointsKO-Adjacents,54
Planchonella_guillauminii,1,1,0,Points-PointsKO-Adjacents,9
Planchonella_howeana,11,8,3,Points-PointsKO-Adjacents,5
Planchonella_kaalaensis,20,12,8,Points-PointsKO-Adjacents,49
Planchonella_kaernbachiana,3,2,1,Points-PointsKO-Adjacents,25
Planchonella_kaniensis,0,0,0,NA,0
Planchonella_keyensis,8,0,8,Points-PointsKO-Adjacents,43
Planchonella_kuebiniensis,29,18,11,Points-PointsKO-Adjacents,98
Planchonella_laetevirens,21,15,6,Points-PointsKO-Adjacents,58
Planchonella_lamii,4,4,0,Points-PointsKO-Adjacents,10
Planchonella_latihila,1,1,0,Points-PointsKO-Adjacents,9
Planchonella_lauracea,55,39,16,Alphahull-PointsKO-Adjacents,147
Planchonella_lifuana,3,3,0,Points-PointsKO-Adjacents,22
Planchonella_longipetiolata,1,0,1,Points-PointsKO-Adjacents,9
Planchonella_luteocostata,7,0,7,Points-PointsKO-Adjacents,31
Planchonella_maingayi,3,0,3,Points-PointsKO-Adjacents,27
Planchonella_mandjeliana,6,1,5,Points-PointsKO-Adjacents,19
Planchonella_membranacea,0,0,0,NA,0
Planchonella_micronesica,1,1,0,Points-PointsKO-Adjacents,5
Planchonella_microphylla,8,3,5,Points-PointsKO-Adjacents,28
Planchonella_mindanaensis,1,1,0,Points-PointsKO-Adjacents,9
Planchonella_myrsinifolia,163,122,41,Alphahull-PointsKO-Adjacents,924
Planchonella_myrsinodendron,176,115,61,Alphahull-PointsKO-Adjacents,1803
Planchonella_myrsinoides,214,177,37,Alphahull-PointsKO-Adjacents,4882
Planchonella_nebulicola,2,2,0,Points-PointsKO-Adjacents,12
Planchonella_obovata,209,106,103,Alphahull-PointsKO-Adjacents,1202
Planchonella_peekelii,0,0,0,NA,0
Planchonella_petaloides,2,2,0,Points-PointsKO-Adjacents,12
Planchonella_pinifolia,6,0,6,Points-PointsKO-Adjacents,33
Planchonella_pohlmaniana,349,282,67,Alphahull-PointsKO-Adjacents,5537
Planchonella_povilana,4,4,0,Points-PointsKO-Adjacents,21
Planchonella_pyrulifera,1,1,0,Points-PointsKO-Adjacents,9
Planchonella_reticulata,19,0,19,Points-PointsKO-Adjacents,53
Planchonella_rheophytopsis,3,3,0,Points-PointsKO-Adjacents,9
Planchonella_roseoloba,11,6,5,Points-PointsKO-Adjacents,35
Planchonella_rufocostata,8,3,5,Points-PointsKO-Adjacents,37
Planchonella_saligna,8,3,5,Points-PointsKO-Adjacents,33
Planchonella_sandwicensis,27,16,11,Points-PointsKO-Adjacents,99
Planchonella_sarcospermoides,7,3,4,Points-PointsKO-Adjacents,19
Planchonella_schlechteri,0,0,0,NA,0
Planchonella_sessilis,0,0,0,NA,0
Planchonella_smithii,2,2,0,Points-PointsKO-Adjacents,3
Planchonella_sphaerocarpa,11,6,5,Points-PointsKO-Adjacents,52
Planchonella_suboppositifolia,1,1,0,Points-PointsKO-Adjacents,9
Planchonella_sussu,1,1,0,Points-PointsKO-Adjacents,9
Planchonella_tahitensis,15,1,14,Points-PointsKO-Adjacents,52
Planchonella_tenuipes,0,0,0,NA,0
Planchonella_thiensis,12,8,4,Points-PointsKO-Adjacents,36
Planchonella_thyrsoidea,18,6,12,Points-PointsKO-Adjacents,104
Planchonella_torricellensis,52,30,22,Alphahull-PointsKO-Adjacents,183
Planchonella_umbonata,0,0,0,NA,0
Planchonella_velutina,3,3,0,Points-PointsKO-Adjacents,27
Planchonella_vitiensis,0,0,0,NA,0
Planchonella_vrieseana,4,4,0,Points-PointsKO-Adjacents,34
Planchonella_wakere,28,15,13,Points-PointsKO-Adjacents,96
Planchonella_xylocarpa,21,11,10,Points-PointsKO-Adjacents,65
Planchonella_yunnanensis,NA,NA,NA,NA,NA
Planchonia_brevistipitata,6,1,5,Points-PointsKO-Adjacents,50
Planchonia_careya,3817,3720,97,Alphahull-PointsKO-Adjacents,11138
Planchonia_grandis,2,2,0,Points-PointsKO-Adjacents,18
Planchonia_papuana,31,10,21,Points-PointsKO-Adjacents,220
Planchonia_rupestris,30,21,9,Alphahull-PointsKO-Adjacents,343
Planchonia_spectabilis,2,2,0,Points-PointsKO-Adjacents,18
Planchonia_timorensis,1,1,0,Points-PointsKO-Adjacents,9
Planchonia_valida,23,7,16,Points-PointsKO-Adjacents,191
Planera_aquatica,726,636,90,Alphahull-PointsKO-Adjacents,9980
Platanus_gentryi,9,1,8,Points-PointsKO-Adjacents,54
Platanus_kerrii,8,2,6,Points-PointsKO-Adjacents,72
Platanus_mexicana,406,344,62,Alphahull-PointsKO-Adjacents,3138
Platanus_occidentalis,7467,6436,1031,Alphahull-PointsKO-Adjacents,42204
Platanus_orientalis,280,209,71,Alphahull-PointsKO-Adjacents,4087
Platanus_racemosa,1268,0,1268,Points-PointsKO-Adjacents,1796
Platanus_rzedowskii,69,60,9,Alphahull-PointsKO-Adjacents,413
Platanus_wrightii,351,322,29,Alphahull-PointsKO-Adjacents,3125
Platea_bullata,1,1,0,Points-PointsKO-Adjacents,9
Platea_excelsa,84,34,50,Alphahull-PointsKO-Adjacents,1284
Platea_latifolia,22,1,21,Points-PointsKO-Adjacents,177
Platea_parvifolia,3,0,3,Points-PointsKO-Adjacents,27
Platea_sclerophylla,1,1,0,Points-PointsKO-Adjacents,9
Plathymenia_foliolosa,47,16,31,Points-PointsKO-Adjacents,320
Plathymenia_reticulata,1913,1794,119,Alphahull-PointsKO-Adjacents,60582
Platonia_insignis,315,248,67,Alphahull-PointsKO-Adjacents,24653
Platycarpum_acreanum,6,2,4,Points-PointsKO-Adjacents,45
Platycarpum_decipiens,20,10,10,Points-PointsKO-Adjacents,138
Platycarpum_duckei,9,0,9,Points-PointsKO-Adjacents,81
Platycarpum_eglandulosum,0,0,0,NA,0
Platycarpum_egleri,36,26,10,Alphahull-PointsKO-Adjacents,174
Platycarpum_froesii,27,21,6,Alphahull-PointsKO-Adjacents,396
Platycarpum_maguirei,5,5,0,Points-PointsKO-Adjacents,41
Platycarpum_negrense,9,2,7,Points-PointsKO-Adjacents,79
Platycarpum_orinocense,85,66,19,Alphahull-PointsKO-Adjacents,1370
Platycarpum_rhododactylum,26,22,4,Alphahull-PointsKO-Adjacents,93
Platycarpum_rugosum,9,2,7,Points-PointsKO-Adjacents,56
Platycarpum_schultesii,19,10,9,Points-PointsKO-Adjacents,152
Platycarya_strobilacea,285,210,75,Alphahull-PointsKO-Adjacents,17430
Platycladus_orientalis,208,134,74,Alphahull-PointsKO-Adjacents,31187
Platycyamus_regnellii,296,247,49,Alphahull-PointsKO-Adjacents,6696
Platycyamus_ulei,9,2,7,Points-PointsKO-Adjacents,81
Platydesma_remyi,1,1,0,Points-PointsKO-Adjacents,8
Platydesma_rostrata,1,1,0,Points-PointsKO-Adjacents,8
Melicope_spathulata,7,0,7,Points-PointsKO-Adjacents,40
Platylophus_trifoliatus,31,9,22,Points-PointsKO-Adjacents,166
Platymiscium_albertinae,3,3,0,Points-PointsKO-Adjacents,21
Platymiscium_calyptratum,1,1,0,Points-PointsKO-Adjacents,9
Platymiscium_curuense,36,29,7,Alphahull-PointsKO-Adjacents,85
Platymiscium_darienense,34,23,11,Alphahull-PointsKO-Adjacents,798
Platymiscium_diadelphum,43,30,13,Alphahull-PointsKO-Adjacents,1622
Platymiscium_dimorphandrum,100,68,32,Alphahull-PointsKO-Adjacents,2157
Platymiscium_filipes,51,24,27,Alphahull-PointsKO-Adjacents,928
Platymiscium_floribundum,863,760,103,Alphahull-PointsKO-Adjacents,40183
Platymiscium_gracile,10,4,6,Points-PointsKO-Adjacents,70
Platymiscium_hebestachyum,30,18,12,Points-PointsKO-Adjacents,221
Platymiscium_jejunum,7,0,7,Points-PointsKO-Adjacents,57
Platymiscium_lasiocarpum,55,33,22,Alphahull-PointsKO-Adjacents,577
Platymiscium_parviflorum,69,53,16,Alphahull-PointsKO-Adjacents,775
Platymiscium_pinnatum,536,377,159,Alphahull-PointsKO-Adjacents,22238
Platymiscium_pleiostachyum,4,4,0,Points-PointsKO-Adjacents,33
Platymiscium_pubescens,224,179,45,Alphahull-PointsKO-Adjacents,12487
Platymiscium_speciosum,17,4,13,Points-PointsKO-Adjacents,120
Platymiscium_stipulare,100,68,32,Alphahull-PointsKO-Adjacents,8855
Platymiscium_trifoliolatum,24,13,11,Points-PointsKO-Adjacents,130
Platymiscium_trinitatis,198,111,87,Alphahull-PointsKO-Adjacents,21783
Platymiscium_yucatanum,121,97,24,Alphahull-PointsKO-Adjacents,3358
Platypodium_elegans,1941,1778,163,Alphahull-PointsKO-Adjacents,53118
Platypterocarpus_tanganyikensis,5,5,0,Points-PointsKO-Adjacents,29
Platysepalum_chevalieri,19,8,11,Points-PointsKO-Adjacents,107
Platysepalum_cuspidatum,NA,NA,NA,NA,NA
Platysepalum_ferrugineum,0,0,0,NA,0
Platysepalum_hypoleucum,4,4,0,Points-PointsKO-Adjacents,32
Platysepalum_inopinatum,15,7,8,Points-PointsKO-Adjacents,87
Platysepalum_vanderystii,14,10,4,Points-PointsKO-Adjacents,100
Platysepalum_violaceum,46,19,27,Points-PointsKO-Adjacents,304
Plectocomia_microstachys,5,5,0,Points-PointsKO-Adjacents,44
Plectroniella_armata,68,56,12,Alphahull-PointsKO-Adjacents,893
Pleiocarpa_bicarpellata,56,0,56,Points-PointsKO-Adjacents,310
Pleiocarpa_mutica,130,82,48,Alphahull-PointsKO-Adjacents,2072
Pleiocarpa_pycnantha,213,148,65,Alphahull-PointsKO-Adjacents,7343
Pleiocarpa_rostrata,67,53,14,Alphahull-PointsKO-Adjacents,659
Pleioceras_afzelii,5,5,0,Points-PointsKO-Adjacents,43
Pleioceras_orientale,1,1,0,Points-PointsKO-Adjacents,9
Pleiogynium_timoriense,214,163,51,Alphahull-PointsKO-Adjacents,2389
Pleiomeris_canariensis,34,24,10,Alphahull-PointsKO-Adjacents,80
Pleiospermium_alatum,2,0,2,Points-PointsKO-Adjacents,18
Plenckia_microcarpa,2,2,0,Points-PointsKO-Adjacents,18
Plenckia_populnea,755,681,74,Alphahull-PointsKO-Adjacents,28432
Pleodendron_costaricense,9,5,4,Points-PointsKO-Adjacents,46
Pleodendron_ekmanii,1,1,0,Points-PointsKO-Adjacents,9
Pleodendron_macranthum,1,1,0,Points-PointsKO-Adjacents,9
Pleradenophora_bilocularis,96,71,25,Alphahull-PointsKO-Adjacents,1761
Pleradenophora_lottiae,10,1,9,Points-PointsKO-Adjacents,48
Pleradenophora_membranifolia,177,124,53,Alphahull-PointsKO-Adjacents,15594
Pleradenophora_tikalana,30,6,24,Points-PointsKO-Adjacents,169
Pleradenophora_tuerckheimiana,73,0,73,Points-PointsKO-Adjacents,427
Plerandra_actinostigma,2,2,0,Points-PointsKO-Adjacents,16
Plerandra_baillonii,1,1,0,Points-PointsKO-Adjacents,7
Plerandra_bakeriana,0,0,0,NA,0
Plerandra_brassii,0,0,0,NA,0
Plerandra_cabalionii,2,2,0,Points-PointsKO-Adjacents,15
Plerandra_costata,NA,NA,NA,NA,NA
Plerandra_crassipes,54,42,12,Alphahull-PointsKO-Adjacents,97
Plerandra_elegantissima,18,11,7,Points-PointsKO-Adjacents,59
Plerandra_elongata,25,18,7,Points-PointsKO-Adjacents,60
Plerandra_emiliana,5,5,0,Points-PointsKO-Adjacents,33
Plerandra_gabriellae,99,85,14,Alphahull-PointsKO-Adjacents,254
Plerandra_grayi,6,4,2,Points-PointsKO-Adjacents,43
Plerandra_insolita,3,3,0,Points-PointsKO-Adjacents,18
Plerandra_leptophylla,20,15,5,Points-PointsKO-Adjacents,89
Plerandra_micrantha,0,0,0,NA,0
Plerandra_nono,14,7,7,Points-PointsKO-Adjacents,61
Plerandra_osyana,61,50,11,Alphahull-PointsKO-Adjacents,204
Plerandra_pachyphylla,7,2,5,Points-PointsKO-Adjacents,27
Plerandra_pancheri,46,34,12,Alphahull-PointsKO-Adjacents,108
Plerandra_pickeringii,4,4,0,Points-PointsKO-Adjacents,27
Plerandra_plerandroides,32,22,10,Alphahull-PointsKO-Adjacents,84
Plerandra_polydactylis,27,16,11,Points-PointsKO-Adjacents,69
Plerandra_reginae,46,39,7,Alphahull-PointsKO-Adjacents,72
Plerandra_seemanniana,1,1,0,Points-PointsKO-Adjacents,9
Plerandra_solomonensis,0,0,0,NA,0
Plerandra_stahliana,50,26,24,Alphahull-PointsKO-Adjacents,964
Plerandra_tannae,2,2,0,Points-PointsKO-Adjacents,11
Plerandra_vanuatua,NA,NA,NA,NA,NA
Plerandra_victoriae,NA,NA,NA,NA,NA
Plerandra_vitiensis,0,0,0,NA,0
Pleuranthodendron_lindenii,202,0,202,Points-PointsKO-Adjacents,1315
Pleurisanthes_flava,22,4,18,Points-PointsKO-Adjacents,159
Pleurocalyptus_austrocaledonicus,29,19,10,Points-PointsKO-Adjacents,101
Pleurocalyptus_pancheri,14,10,4,Points-PointsKO-Adjacents,64
Pleuropetalum_pleiogynum,145,104,41,Alphahull-PointsKO-Adjacents,1234
Pleuropetalum_sprucei,246,179,67,Alphahull-PointsKO-Adjacents,1265
Pleurostylia_africana,7,0,7,Points-PointsKO-Adjacents,63
Pleurostylia_capensis,47,26,21,Alphahull-PointsKO-Adjacents,654
Pleurostylia_leucocarpa,1,1,0,Points-PointsKO-Adjacents,9
Pleurostylia_opposita,148,100,48,Alphahull-PointsKO-Adjacents,1921
Pleurostylia_pachyphlaea,1,1,0,Points-PointsKO-Adjacents,6
Pleurothyrium_acuminatum,10,0,10,Points-PointsKO-Adjacents,86
Pleurothyrium_amapaense,9,1,8,Points-PointsKO-Adjacents,81
Pleurothyrium_amplifolium,9,0,9,Points-PointsKO-Adjacents,64
Pleurothyrium_arcuatum,3,3,0,Points-PointsKO-Adjacents,23
Pleurothyrium_bifidum,38,19,19,Points-PointsKO-Adjacents,240
Pleurothyrium_bracteatum,2,2,0,Points-PointsKO-Adjacents,18
Pleurothyrium_brochidodromum,6,3,3,Points-PointsKO-Adjacents,48
Pleurothyrium_chrysothyrsus,NA,NA,NA,NA,NA
Pleurothyrium_cinereum,51,31,20,Alphahull-PointsKO-Adjacents,1511
Pleurothyrium_costanense,19,6,13,Points-PointsKO-Adjacents,141
Pleurothyrium_crassitepalum,4,4,0,Points-PointsKO-Adjacents,34
Pleurothyrium_cuneifolium,178,131,47,Alphahull-PointsKO-Adjacents,12820
Pleurothyrium_giganthum,8,2,6,Points-PointsKO-Adjacents,57
Pleurothyrium_glabrifolium,15,7,8,Points-PointsKO-Adjacents,128
Pleurothyrium_glabritepalum,15,6,9,Points-PointsKO-Adjacents,112
Pleurothyrium_golfodulcense,39,32,7,Alphahull-PointsKO-Adjacents,90
Pleurothyrium_grandiflorum,2,2,0,Points-PointsKO-Adjacents,17
Pleurothyrium_guindonii,12,6,6,Points-PointsKO-Adjacents,50
Pleurothyrium_hexaglandulosum,9,3,6,Points-PointsKO-Adjacents,59
Pleurothyrium_immersum,6,1,5,Points-PointsKO-Adjacents,34
Pleurothyrium_insigne,76,52,24,Alphahull-PointsKO-Adjacents,2771
Pleurothyrium_intermedium,58,39,19,Alphahull-PointsKO-Adjacents,1565
Pleurothyrium_marginale,3,3,0,Points-PointsKO-Adjacents,27
Pleurothyrium_maximum,12,1,11,Points-PointsKO-Adjacents,104
Pleurothyrium_nobile,11,0,11,Points-PointsKO-Adjacents,99
Pleurothyrium_oblongum,6,2,4,Points-PointsKO-Adjacents,36
Pleurothyrium_obovatum,3,3,0,Points-PointsKO-Adjacents,27
Pleurothyrium_palmanum,34,25,9,Alphahull-PointsKO-Adjacents,112
Pleurothyrium_panurense,24,9,15,Points-PointsKO-Adjacents,188
Pleurothyrium_parviflorum,121,83,38,Alphahull-PointsKO-Adjacents,8877
Pleurothyrium_pauciflorum,14,10,4,Points-PointsKO-Adjacents,33
Pleurothyrium_pilosum,2,2,0,Points-PointsKO-Adjacents,17
Pleurothyrium_poeppigii,131,93,38,Alphahull-PointsKO-Adjacents,4755
Pleurothyrium_prancei,9,0,9,Points-PointsKO-Adjacents,66
Pleurothyrium_racemosum,3,3,0,Points-PointsKO-Adjacents,15
Pleurothyrium_steyermarkianum,3,3,0,Points-PointsKO-Adjacents,27
Pleurothyrium_synandrum,9,3,6,Points-PointsKO-Adjacents,72
Pleurothyrium_tomentellum,9,3,6,Points-PointsKO-Adjacents,69
Pleurothyrium_tomiwahlii,9,6,3,Points-PointsKO-Adjacents,68
Pleurothyrium_trianae,148,104,44,Alphahull-PointsKO-Adjacents,7434
Pleurothyrium_triflorum,9,3,6,Points-PointsKO-Adjacents,27
Pleurothyrium_undulatum,5,5,0,Points-PointsKO-Adjacents,39
Pleurothyrium_vasquezii,94,52,42,Alphahull-PointsKO-Adjacents,2594
Pleurothyrium_westphalii,2,2,0,Points-PointsKO-Adjacents,18
Pleurothyrium_williamsii,18,3,15,Points-PointsKO-Adjacents,134
Plinia_abeggii,23,15,8,Points-PointsKO-Adjacents,149
Plinia_anonyma,6,0,6,Points-PointsKO-Adjacents,50
Plinia_arenicola,NA,NA,NA,NA,NA
Plinia_baileyi,NA,NA,NA,NA,NA
Plinia_baracoensis,NA,NA,NA,NA,NA
Plinia_callosa,24,11,13,Points-PointsKO-Adjacents,100
Plinia_caricensis,0,0,0,NA,0
Plinia_cauliflora,161,106,55,Alphahull-PointsKO-Adjacents,9074
Plinia_cerrocampanensis,5,5,0,Points-PointsKO-Adjacents,21
Plinia_cidrensis,0,0,0,NA,0
Plinia_clausa,1,1,0,Points-PointsKO-Adjacents,9
Plinia_coclensis,8,6,2,Points-PointsKO-Adjacents,43
Plinia_complanata,35,0,35,Points-PointsKO-Adjacents,184
Plinia_cordifolia,64,54,10,Alphahull-PointsKO-Adjacents,703
Plinia_coronata,3,1,2,Points-PointsKO-Adjacents,27
Plinia_costata,16,10,6,Points-PointsKO-Adjacents,121
Plinia_cubensis,0,0,0,NA,0
Plinia_cuspidata,11,8,3,Points-PointsKO-Adjacents,82
Plinia_darienensis,6,2,4,Points-PointsKO-Adjacents,28
Plinia_dermatodes,2,2,0,Points-PointsKO-Adjacents,17
Plinia_duplipilosa,6,0,6,Points-PointsKO-Adjacents,52
Plinia_edulis,99,54,45,Alphahull-PointsKO-Adjacents,884
Plinia_ekmaniana,0,0,0,NA,0
Plinia_espinhacensis,7,3,4,Points-PointsKO-Adjacents,51
Plinia_gentryi,4,3,1,Points-PointsKO-Adjacents,19
Plinia_grandifolia,31,15,16,Points-PointsKO-Adjacents,233
Plinia_guanacastensis,11,8,3,Points-PointsKO-Adjacents,33
Plinia_hatschbachii,13,1,12,Points-PointsKO-Adjacents,94
Plinia_ilhensis,5,5,0,Points-PointsKO-Adjacents,37
Plinia_inflata,5,5,0,Points-PointsKO-Adjacents,39
Plinia_involucrata,43,21,22,Alphahull-PointsKO-Adjacents,990
Plinia_longiacuminata,5,5,0,Points-PointsKO-Adjacents,18
Plinia_marqueteana,4,3,1,Points-PointsKO-Adjacents,32
Plinia_martinellii,9,0,9,Points-PointsKO-Adjacents,62
Plinia_microcycla,0,0,0,NA,0
Plinia_moaensis,NA,NA,NA,NA,NA
Plinia_moralesii,12,7,5,Points-PointsKO-Adjacents,49
Plinia_muricata,7,4,3,Points-PointsKO-Adjacents,44
Plinia_nicaraguensis,5,5,0,Points-PointsKO-Adjacents,45
Plinia_oblongata,1,0,1,Points-PointsKO-Adjacents,9
Plinia_panamensis,24,15,9,Points-PointsKO-Adjacents,77
Plinia_pauciflora,3,3,0,Points-PointsKO-Adjacents,18
Plinia_peroblata,6,2,4,Points-PointsKO-Adjacents,36
Plinia_peruviana,148,105,43,Alphahull-PointsKO-Adjacents,7545
Plinia_phitrantha,12,1,11,Points-PointsKO-Adjacents,103
Plinia_pinnata,8,4,4,Points-PointsKO-Adjacents,24
Plinia_punctata,4,4,0,Points-PointsKO-Adjacents,20
Plinia_puriscalensis,12,9,3,Points-PointsKO-Adjacents,25
Plinia_rara,8,2,6,Points-PointsKO-Adjacents,49
Plinia_renatiana,5,0,5,Points-PointsKO-Adjacents,36
Plinia_rivularis,473,377,96,Alphahull-PointsKO-Adjacents,13809
Plinia_rogersiana,NA,NA,NA,NA,NA
Plinia_rupestris,0,0,0,NA,0
Plinia_salamancana,9,4,5,Points-PointsKO-Adjacents,42
Plinia_salticola,30,23,7,Alphahull-PointsKO-Adjacents,202
Plinia_sebastianopolitana,2,1,1,Points-PointsKO-Adjacents,12
Plinia_spiciflora,11,3,8,Points-PointsKO-Adjacents,50
Plinia_spirito-santensis,6,0,6,Points-PointsKO-Adjacents,45
Plinia_subavenia,5,5,0,Points-PointsKO-Adjacents,35
Plocama_pendula,83,0,83,Points-PointsKO-Adjacents,139
Plocosperma_buxifolium,55,43,12,Alphahull-PointsKO-Adjacents,298
Ploiarium_alternifolium,29,6,23,Points-PointsKO-Adjacents,218
Pluchea_carolinensis,376,236,140,Alphahull-PointsKO-Adjacents,10819
Plukenetia_brachybotrya,67,30,37,Alphahull-PointsKO-Adjacents,1975
Plumeria_alba,48,27,21,Alphahull-PointsKO-Adjacents,264
Plumeria_filifolia,10,2,8,Points-PointsKO-Adjacents,71
Plumeria_inodora,38,13,25,Points-PointsKO-Adjacents,279
Plumeria_magna,4,4,0,Points-PointsKO-Adjacents,33
Plumeria_obtusa,236,0,236,Points-PointsKO-Adjacents,1189
Plumeria_pudica,46,16,30,Points-PointsKO-Adjacents,303
Plumeria_rubra,1040,895,145,Alphahull-PointsKO-Adjacents,16271
Plumeria_subsessilis,9,4,5,Points-PointsKO-Adjacents,67
Podachaenium_chiapanum,14,8,6,Points-PointsKO-Adjacents,42
Podachaenium_eminens,429,366,63,Alphahull-PointsKO-Adjacents,6862
Podachaenium_standleyi,10,0,10,Points-PointsKO-Adjacents,54
Podadenia_sapida,1,1,0,Points-PointsKO-Adjacents,9
Podalyria_calyptrata,68,47,21,Alphahull-PointsKO-Adjacents,354
Podocalyx_loranthoides,264,221,43,Alphahull-PointsKO-Adjacents,14179
Podocarpus_acuminatus,6,0,6,Points-PointsKO-Adjacents,42
Podocarpus_affinis,4,4,0,Points-PointsKO-Adjacents,30
Podocarpus_aracensis,12,3,9,Points-PointsKO-Adjacents,54
Podocarpus_archboldii,82,64,18,Alphahull-PointsKO-Adjacents,802
Podocarpus_atjehensis,2,2,0,Points-PointsKO-Adjacents,18
Podocarpus_borneensis,2,2,0,Points-PointsKO-Adjacents,18
Podocarpus_bracteatus,3,3,0,Points-PointsKO-Adjacents,18
Podocarpus_brasiliensis,40,0,40,Points-PointsKO-Adjacents,257
Podocarpus_brassii,96,70,26,Alphahull-PointsKO-Adjacents,411
Podocarpus_capuronii,29,16,13,Points-PointsKO-Adjacents,107
Podocarpus_celatus,96,38,58,Alphahull-PointsKO-Adjacents,4481
Podocarpus_chingianus,0,0,0,NA,0
Podocarpus_confertus,2,2,0,Points-PointsKO-Adjacents,17
Podocarpus_coriaceus,37,16,21,Points-PointsKO-Adjacents,119
Podocarpus_costalis,12,4,8,Points-PointsKO-Adjacents,73
Podocarpus_costaricensis,6,2,4,Points-PointsKO-Adjacents,18
Podocarpus_crassigemmis,36,22,14,Alphahull-PointsKO-Adjacents,508
Podocarpus_deflexus,1,1,0,Points-PointsKO-Adjacents,9
Podocarpus_degeneri,1,0,1,Points-PointsKO-Adjacents,9
Podocarpus_dispermus,45,37,8,Alphahull-PointsKO-Adjacents,78
Podocarpus_elatus,472,377,95,Alphahull-PointsKO-Adjacents,2529
Podocarpus_elongatus,46,31,15,Alphahull-PointsKO-Adjacents,411
Podocarpus_fasciculus,26,0,26,Points-PointsKO-Adjacents,105
Podocarpus_gibbsii,0,0,0,NA,0
Podocarpus_glaucus,12,0,12,Points-PointsKO-Adjacents,87
Podocarpus_globulus,4,4,0,Points-PointsKO-Adjacents,35
Podocarpus_glomeratus,45,18,27,Points-PointsKO-Adjacents,296
Podocarpus_grayae,191,152,39,Alphahull-PointsKO-Adjacents,547
Podocarpus_guatemalensis,213,159,54,Alphahull-PointsKO-Adjacents,4927
Podocarpus_henkelii,37,17,20,Points-PointsKO-Adjacents,263
Podocarpus_hispaniolensis,11,8,3,Points-PointsKO-Adjacents,47
Podocarpus_humbertii,9,0,9,Points-PointsKO-Adjacents,54
Podocarpus_insularis,17,1,16,Points-PointsKO-Adjacents,133
Podocarpus_lambertii,377,325,52,Alphahull-PointsKO-Adjacents,5373
Podocarpus_latifolius,183,137,46,Alphahull-PointsKO-Adjacents,4014
Podocarpus_laubenfelsii,3,3,0,Points-PointsKO-Adjacents,18
Podocarpus_ledermannii,19,2,17,Points-PointsKO-Adjacents,123
Podocarpus_levis,1,1,0,Points-PointsKO-Adjacents,9
Podocarpus_longifoliolatus,3,1,2,Points-PointsKO-Adjacents,26
Podocarpus_lophatus,2,2,0,Points-PointsKO-Adjacents,18
Podocarpus_lucienii,28,18,10,Points-PointsKO-Adjacents,92
Podocarpus_macrocarpus,2,1,1,Points-PointsKO-Adjacents,18
Podocarpus_macrophyllus,178,83,95,Alphahull-PointsKO-Adjacents,10859
Podocarpus_madagascariensis,147,126,21,Alphahull-PointsKO-Adjacents,1986
Podocarpus_magnifolius,47,11,36,Points-PointsKO-Adjacents,326
Podocarpus_matudae,312,274,38,Alphahull-PointsKO-Adjacents,4854
Podocarpus_micropedunculatus,3,3,0,Points-PointsKO-Adjacents,27
Podocarpus_milanjianus,145,81,64,Alphahull-PointsKO-Adjacents,10106
Podocarpus_nakaii,39,26,13,Alphahull-PointsKO-Adjacents,109
Podocarpus_neriifolius,323,185,138,Alphahull-PointsKO-Adjacents,9878
Podocarpus_nubigenus,57,35,22,Alphahull-PointsKO-Adjacents,1090
Podocarpus_oleifolius,624,510,114,Alphahull-PointsKO-Adjacents,7749
Podocarpus_palawanensis,0,0,0,NA,0
Podocarpus_parlatorei,120,0,120,Points-PointsKO-Adjacents,543
Podocarpus_pendulifolius,6,0,6,Points-PointsKO-Adjacents,42
Podocarpus_perrieri,2,2,0,Points-PointsKO-Adjacents,18
Podocarpus_pilgeri,142,82,60,Alphahull-PointsKO-Adjacents,1849
Podocarpus_polyspermus,9,6,3,Points-PointsKO-Adjacents,37
Podocarpus_polystachyus,28,3,25,Points-PointsKO-Adjacents,192
Podocarpus_pseudobracteatus,24,17,7,Points-PointsKO-Adjacents,160
Podocarpus_purdieanus,6,3,3,Points-PointsKO-Adjacents,21
Podocarpus_ramosii,3,3,0,Points-PointsKO-Adjacents,27
Podocarpus_ridleyi,5,5,0,Points-PointsKO-Adjacents,39
Podocarpus_roraimae,36,22,14,Alphahull-PointsKO-Adjacents,391
Podocarpus_rostratus,1,0,1,Points-PointsKO-Adjacents,9
Podocarpus_rubens,19,2,17,Points-PointsKO-Adjacents,143
Podocarpus_rumphii,35,0,35,Points-PointsKO-Adjacents,218
Podocarpus_rusbyi,44,26,18,Alphahull-PointsKO-Adjacents,225
Podocarpus_salicifolius,18,9,9,Points-PointsKO-Adjacents,94
Podocarpus_salignus,50,37,13,Alphahull-PointsKO-Adjacents,615
Podocarpus_salomoniensis,7,1,6,Points-PointsKO-Adjacents,39
Podocarpus_sellowii,173,126,47,Alphahull-PointsKO-Adjacents,11846
Podocarpus_smithii,57,50,7,Alphahull-PointsKO-Adjacents,82
Podocarpus_spathoides,2,2,0,Points-PointsKO-Adjacents,18
Podocarpus_sprucei,28,21,7,Alphahull-PointsKO-Adjacents,246
Podocarpus_steyermarkii,25,9,16,Points-PointsKO-Adjacents,128
Podocarpus_subtropicalis,2,2,0,Points-PointsKO-Adjacents,18
Podocarpus_sylvestris,78,61,17,Alphahull-PointsKO-Adjacents,159
Podocarpus_tepuiensis,50,32,18,Alphahull-PointsKO-Adjacents,878
Podocarpus_teysmannii,8,1,7,Points-PointsKO-Adjacents,72
Podocarpus_totara,7134,6969,165,Alphahull-PointsKO-Adjacents,4662
Podocarpus_transiens,15,0,15,Points-PointsKO-Adjacents,108
Podocarpus_urbanii,8,3,5,Points-PointsKO-Adjacents,21
Podonephelium_gongrocarpum,25,17,8,Points-PointsKO-Adjacents,69
Podonephelium_homei,51,39,12,Alphahull-PointsKO-Adjacents,254
Podopterus_guatemalensis,4,4,0,Points-PointsKO-Adjacents,33
Podopterus_mexicanus,245,187,58,Alphahull-PointsKO-Adjacents,6650
Poecilandra_retusa,131,114,17,Alphahull-PointsKO-Adjacents,3966
Poecilanthe_falcata,151,114,37,Alphahull-PointsKO-Adjacents,7111
Poecilanthe_hostmannii,36,0,36,Points-PointsKO-Adjacents,268
Poecilanthe_itapuana,27,9,18,Points-PointsKO-Adjacents,98
Poecilanthe_ovalifolia,2,2,0,Points-PointsKO-Adjacents,18
Poecilanthe_parviflora,144,108,36,Alphahull-PointsKO-Adjacents,5450
Poecilanthe_subcordata,38,24,14,Alphahull-PointsKO-Adjacents,510
Poecilanthe_ulei,277,249,28,Alphahull-PointsKO-Adjacents,5357
Poeppigia_procera,42,18,24,Points-PointsKO-Adjacents,314
Poga_oleosa,44,24,20,Alphahull-PointsKO-Adjacents,633
Pogonophora_letouzeyi,30,21,9,Alphahull-PointsKO-Adjacents,385
Pogonophora_schomburgkiana,801,678,123,Alphahull-PointsKO-Adjacents,44423
Pogonopus_exsertus,123,83,40,Alphahull-PointsKO-Adjacents,1323
Pogonopus_speciosus,58,34,24,Alphahull-PointsKO-Adjacents,1100
Pogonopus_tubulosus,266,204,62,Alphahull-PointsKO-Adjacents,11476
Poincianella_bracteosa,243,206,37,Alphahull-PointsKO-Adjacents,10308
Poincianella_eriostachys,69,32,37,Alphahull-PointsKO-Adjacents,435
Poincianella_exostemma,19,9,10,Points-PointsKO-Adjacents,68
Poincianella_melanadenia,57,53,4,Alphahull-PointsKO-Adjacents,48
Poincianella_microphylla,177,160,17,Alphahull-PointsKO-Adjacents,2919
Poincianella_pluviosa,288,216,72,Alphahull-PointsKO-Adjacents,16620
Poincianella_pyramidalis,601,571,30,Alphahull-PointsKO-Adjacents,8098
Poissonia_hypoleuca,24,8,16,Points-PointsKO-Adjacents,196
Poissonia_orbicularis,4,4,0,Points-PointsKO-Adjacents,30
Poitea_carinalis,3,3,0,Points-PointsKO-Adjacents,12
Poitea_florida,32,21,11,Alphahull-PointsKO-Adjacents,114
Poitea_galegoides,22,15,7,Points-PointsKO-Adjacents,107
Poitea_glyciphylla,4,3,1,Points-PointsKO-Adjacents,36
Poitea_multiflora,6,2,4,Points-PointsKO-Adjacents,48
Poitea_punicea,29,21,8,Alphahull-PointsKO-Adjacents,61
Polaskia_chende,52,41,11,Alphahull-PointsKO-Adjacents,149
Polaskia_chichipe,74,64,10,Alphahull-PointsKO-Adjacents,93
Polemannia_montana,13,6,7,Points-PointsKO-Adjacents,117
Polemanniopsis_marlothii,8,2,6,Points-PointsKO-Adjacents,54
Poliothyrsis_sinensis,19,4,15,Points-PointsKO-Adjacents,171
Polyalthia_amischocarpa,2,2,0,Points-PointsKO-Adjacents,18
Uvaria_amygdalina,0,0,0,NA,0
Polyalthia_angustifolia,0,0,0,NA,0
Polyalthia_australis,402,363,39,Alphahull-PointsKO-Adjacents,1686
Polyalthia_beamaniorum,1,1,0,Points-PointsKO-Adjacents,9
Polyalthia_borneensis,3,3,0,Points-PointsKO-Adjacents,27
Polyalthia_bromantha,0,0,0,NA,0
Polyalthia_bullata,3,3,0,Points-PointsKO-Adjacents,18
Polyalthia_cauliflora,69,43,26,Alphahull-PointsKO-Adjacents,5068
Polyalthia_charitopoda,1,1,0,Points-PointsKO-Adjacents,9
Polyalthia_chinensis,2,2,0,Points-PointsKO-Adjacents,18
Polyalthia_chrysotricha,3,3,0,Points-PointsKO-Adjacents,21
Polyalthia_cinnamomea,8,1,7,Points-PointsKO-Adjacents,64
Polyalthia_congesta,1,1,0,Points-PointsKO-Adjacents,9
Unona_corticosa,0,0,0,NA,0
Polyalthia_dictyoneura,4,4,0,Points-PointsKO-Adjacents,30
Polyalthia_dolichopoda,7,0,7,Points-PointsKO-Adjacents,46
Polyalthia_elliptica,3,3,0,Points-PointsKO-Adjacents,21
Polyalthia_endertii,0,0,0,NA,0
Unona_evecta,9,1,8,Points-PointsKO-Adjacents,81
Polyalthia_flagellaris,12,4,8,Points-PointsKO-Adjacents,75
Polyalthia_fragrans,1,0,1,Points-PointsKO-Adjacents,9
Polyalthia_glabra,0,0,0,NA,0
Polyalthia_ichthyosma,2,2,0,Points-PointsKO-Adjacents,18
Polyalthia_igniflora,1,1,0,Points-PointsKO-Adjacents,9
Polyalthia_insignis,13,3,10,Points-PointsKO-Adjacents,109
Polyalthia_kinabaluensis,0,0,0,NA,0
Polyalthia_lancilimba,1,1,0,Points-PointsKO-Adjacents,9
Polyalthia_lasioclada,1,1,0,Points-PointsKO-Adjacents,9
Polyalthia_lateriflora,28,3,25,Points-PointsKO-Adjacents,219
Polyalthia_litseifolia,1,1,0,Points-PointsKO-Adjacents,9
Polyalthia_liukiuensis,2,2,0,Points-PointsKO-Adjacents,15
Polyalthia_longifolia,1,0,1,Points-PointsKO-Adjacents,9
Unona_luensis,2,2,0,Points-PointsKO-Adjacents,18
Polyalthia_microsepala,NA,NA,NA,NA,NA
Polyalthia_microtus,24,11,13,Points-PointsKO-Adjacents,122
Polyalthia_miliusoides,1,1,0,Points-PointsKO-Adjacents,9
Polyalthia_monocarpioides,1,1,0,Points-PointsKO-Adjacents,9
Polyalthia_montis-silam,0,0,0,NA,0
Polyalthia_motleyana,14,9,5,Points-PointsKO-Adjacents,116
Polyalthia_myristica,6,0,6,Points-PointsKO-Adjacents,50
Polyalthia_obliqua,7,1,6,Points-PointsKO-Adjacents,54
Polyalthia_oblonga,1,1,0,Points-PointsKO-Adjacents,9
Polyalthia_pingpienensis,11,3,8,Points-PointsKO-Adjacents,90
Polyalthia_polyphlebia,0,0,0,NA,0
Polyalthia_saprosma,2,2,0,Points-PointsKO-Adjacents,18
Polyalthia_stenopetala,4,4,0,Points-PointsKO-Adjacents,36
Polyalthia_stenophylla,4,4,0,Points-PointsKO-Adjacents,24
Polyalthia_subcordata,3,3,0,Points-PointsKO-Adjacents,27
Polyalthia_suberosa,34,7,27,Points-PointsKO-Adjacents,280
Polyalthia_tipuliflora,0,0,0,NA,0
Polyalthia_trochilia,3,3,0,Points-PointsKO-Adjacents,25
Polyalthia_verrucipes,2,2,0,Points-PointsKO-Adjacents,18
Polycardia_aquifolium,21,8,13,Points-PointsKO-Adjacents,126
Polycardia_libera,39,14,25,Points-PointsKO-Adjacents,223
Polycardia_phyllanthoides,50,33,17,Alphahull-PointsKO-Adjacents,239
Polyceratocarpus_angustifolius,0,0,0,NA,0
Polyceratocarpus_gossweileri,5,0,5,Points-PointsKO-Adjacents,45
Polyceratocarpus_laurifolius,0,0,0,NA,0
Polyceratocarpus_microtrichus,13,5,8,Points-PointsKO-Adjacents,81
Polyceratocarpus_parviflorus,71,46,25,Alphahull-PointsKO-Adjacents,956
Polyceratocarpus_pellegrinii,11,5,6,Points-PointsKO-Adjacents,91
Polyceratocarpus_scheffleri,22,8,14,Points-PointsKO-Adjacents,87
Polygala_arillata,195,152,43,Alphahull-PointsKO-Adjacents,9853
Polygala_cowellii,12,8,4,Points-PointsKO-Adjacents,63
Polygala_cuneata,9,0,9,Points-PointsKO-Adjacents,50
Polygala_didyma,7,3,4,Points-PointsKO-Adjacents,38
Polygala_dukei,2,1,1,Points-PointsKO-Adjacents,16
Polygala_fallax,65,41,24,Alphahull-PointsKO-Adjacents,2575
Polygala_gazensis,9,3,6,Points-PointsKO-Adjacents,65
Polygala_jamaicensis,52,32,20,Alphahull-PointsKO-Adjacents,893
Polygala_teretifolia,35,23,12,Alphahull-PointsKO-Adjacents,245
Polygala_wattersii,53,27,26,Alphahull-PointsKO-Adjacents,5446
Polygala_balansae,23,14,9,Points-PointsKO-Adjacents,125
Polygonanthus_amazonicus,19,10,9,Points-PointsKO-Adjacents,137
Polylepis_australis,19,6,13,Points-PointsKO-Adjacents,156
Polylepis_besseri,76,48,28,Alphahull-PointsKO-Adjacents,2465
Polylepis_canoi,3,3,0,Points-PointsKO-Adjacents,27
Polylepis_flavipila,5,5,0,Points-PointsKO-Adjacents,35
Polylepis_incana,61,45,16,Alphahull-PointsKO-Adjacents,283
Polylepis_incarum,3,3,0,Points-PointsKO-Adjacents,27
Polylepis_lanata,21,9,12,Points-PointsKO-Adjacents,125
Polylepis_lanuginosa,22,17,5,Points-PointsKO-Adjacents,114
Polylepis_multijuga,14,7,7,Points-PointsKO-Adjacents,77
Polylepis_neglecta,9,3,6,Points-PointsKO-Adjacents,60
Polylepis_pacensis,4,4,0,Points-PointsKO-Adjacents,36
Polylepis_pauta,69,43,26,Alphahull-PointsKO-Adjacents,589
Polylepis_pepei,30,18,12,Points-PointsKO-Adjacents,129
Polylepis_racemosa,44,28,16,Alphahull-PointsKO-Adjacents,438
Polylepis_reticulata,51,40,11,Alphahull-PointsKO-Adjacents,212
Polylepis_sericea,129,90,39,Alphahull-PointsKO-Adjacents,976
Polylepis_subsericans,11,4,7,Points-PointsKO-Adjacents,69
Polylepis_subtusalbida,6,1,5,Points-PointsKO-Adjacents,33
Polylepis_tomentella,48,31,17,Alphahull-PointsKO-Adjacents,879
Polylepis_weberbaueri,63,45,18,Alphahull-PointsKO-Adjacents,354
Polymnia_cocuyensis,2,2,0,Points-PointsKO-Adjacents,18
Polyosma_cambodiana,8,4,4,Points-PointsKO-Adjacents,63
Polyosma_integrifolia,46,16,30,Points-PointsKO-Adjacents,308
Polyscias_aculeata,89,58,31,Alphahull-PointsKO-Adjacents,309
Polyscias_acuminata,1,0,1,Points-PointsKO-Adjacents,9
Polyscias_aemiliguineae,0,0,0,NA,0
Polyscias_aequatoguineensis,7,5,2,Points-PointsKO-Adjacents,33
Polyscias_aherniana,8,0,8,Points-PointsKO-Adjacents,62
Polyscias_albersiana,9,2,7,Points-PointsKO-Adjacents,48
Polyscias_amplifolia,49,31,18,Alphahull-PointsKO-Adjacents,795
Polyscias_anacardium,17,8,9,Points-PointsKO-Adjacents,83
Polyscias_andraerum,NA,NA,NA,NA,NA
Polyscias_angustifolia,0,0,0,NA,0
Polyscias_ariadnes,45,35,10,Alphahull-PointsKO-Adjacents,255
Polyscias_ashtonii,0,0,0,NA,0
Polyscias_australiana,224,187,37,Alphahull-PointsKO-Adjacents,1260
Polyscias_baehniana,15,8,7,Points-PointsKO-Adjacents,87
Polyscias_balfouriana,0,0,0,NA,0
Polyscias_baretiana,20,0,20,Points-PointsKO-Adjacents,84
Polyscias_belensis,10,3,7,Points-PointsKO-Adjacents,63
Polyscias_bernieri,0,0,0,NA,0
Polyscias_biformis,4,4,0,Points-PointsKO-Adjacents,34
Polyscias_bipinnata,1,1,0,Points-PointsKO-Adjacents,9
Polyscias_bisattenuata,3,3,0,Points-PointsKO-Adjacents,11
Polyscias_boivinii,92,67,25,Alphahull-PointsKO-Adjacents,1302
Polyscias_borbonica,0,0,0,NA,0
Polyscias_borneensis,4,3,1,Points-PointsKO-Adjacents,26
Polyscias_bracteata,78,63,15,Alphahull-PointsKO-Adjacents,285
Polyscias_briquetiana,65,45,20,Alphahull-PointsKO-Adjacents,470
Polyscias_carolorum,44,26,18,Alphahull-PointsKO-Adjacents,603
Polyscias_cenabrei,1,1,0,Points-PointsKO-Adjacents,8
Polyscias_chapelieri,41,31,10,Alphahull-PointsKO-Adjacents,101
Polyscias_cissiflora,10,5,5,Points-PointsKO-Adjacents,70
Polyscias_cissodendron,38,9,29,Points-PointsKO-Adjacents,142
Polyscias_collina,4,4,0,Points-PointsKO-Adjacents,24
Polyscias_compacta,14,6,8,Points-PointsKO-Adjacents,56
Polyscias_confertifolia,9,2,7,Points-PointsKO-Adjacents,78
Polyscias_coriacea,1,1,0,Points-PointsKO-Adjacents,9
Polyscias_corticata,1,1,0,Points-PointsKO-Adjacents,9
Polyscias_crassa,1,1,0,Points-PointsKO-Adjacents,6
Polyscias_crenata,4,4,0,Points-PointsKO-Adjacents,34
Polyscias_culminicola,0,0,0,NA,0
Polyscias_cumingiana,14,0,14,Points-PointsKO-Adjacents,92
Polyscias_cussonioides,3,3,0,Points-PointsKO-Adjacents,14
Polyscias_cutispongia,3,2,1,Points-PointsKO-Adjacents,14
Polyscias_dichrostachya,1,0,1,Points-PointsKO-Adjacents,9
Polyscias_dioica,62,47,15,Alphahull-PointsKO-Adjacents,193
Polyscias_diversifolia,13,0,13,Points-PointsKO-Adjacents,104
Polyscias_duplicata,35,14,21,Points-PointsKO-Adjacents,199
Polyscias_elegans,1396,1301,95,Alphahull-PointsKO-Adjacents,4458
Polyscias_elliptica,2,2,0,Points-PointsKO-Adjacents,18
Polyscias_engganoense,0,0,0,NA,0
Polyscias_farinosa,6,1,5,Points-PointsKO-Adjacents,54
Polyscias_felicis,4,4,0,Points-PointsKO-Adjacents,14
Polyscias_filicifolia,0,0,0,NA,0
Polyscias_floccosa,17,11,6,Points-PointsKO-Adjacents,44
Polyscias_florosa,1,1,0,Points-PointsKO-Adjacents,9
Polyscias_flynnii,3,3,0,Points-PointsKO-Adjacents,9
Polyscias_fraxinifolia,71,52,19,Alphahull-PointsKO-Adjacents,1258
Polyscias_fruticosa,58,3,55,Points-PointsKO-Adjacents,402
Polyscias_fulva,121,68,53,Alphahull-PointsKO-Adjacents,4823
Polyscias_gracilis,3,2,1,Points-PointsKO-Adjacents,17
Polyscias_guilfoylei,4,4,0,Points-PointsKO-Adjacents,36
Polyscias_gymnocarpa,2,2,0,Points-PointsKO-Adjacents,13
Polyscias_havilandii,NA,NA,NA,NA,NA
Polyscias_hawaiensis,8,2,6,Points-PointsKO-Adjacents,45
Polyscias_heineana,13,11,2,Points-PointsKO-Adjacents,46
Polyscias_humbertiana,6,4,2,Points-PointsKO-Adjacents,38
Polyscias_jackiana,5,5,0,Points-PointsKO-Adjacents,32
Polyscias_javanica,2,2,0,Points-PointsKO-Adjacents,18
Polyscias_joskei,7,4,3,Points-PointsKO-Adjacents,46
Polyscias_kalabenonensis,3,3,0,Points-PointsKO-Adjacents,18
Polyscias_kavaiensis,5,1,4,Points-PointsKO-Adjacents,40
Polyscias_kikuyuensis,16,9,7,Points-PointsKO-Adjacents,108
Polyscias_kivuensis,4,4,0,Points-PointsKO-Adjacents,36
Polyscias_kjellbergii,1,1,0,Points-PointsKO-Adjacents,9
Polyscias_lancifolia,14,0,14,Points-PointsKO-Adjacents,44
Polyscias_lantzii,6,1,5,Points-PointsKO-Adjacents,44
Polyscias_leandriana,3,3,0,Points-PointsKO-Adjacents,23
Polyscias_lecardii,9,0,9,Points-PointsKO-Adjacents,32
Polyscias_ledermannii,40,28,12,Alphahull-PointsKO-Adjacents,344
Polyscias_le-testui,4,4,0,Points-PointsKO-Adjacents,36
Polyscias_lionnetii,NA,NA,NA,NA,NA
Polyscias_lucens,0,0,0,NA,0
Polyscias_lydgatei,2,1,1,Points-PointsKO-Adjacents,6
Polyscias_mackeei,4,4,0,Points-PointsKO-Adjacents,18
Polyscias_macranthum,63,43,20,Alphahull-PointsKO-Adjacents,681
Polyscias_macrocarpa,0,0,0,NA,0
Polyscias_madagascariensis,56,47,9,Alphahull-PointsKO-Adjacents,165
Polyscias_maraisiana,2,1,1,Points-PointsKO-Adjacents,12
Polyscias_maralia,40,23,17,Alphahull-PointsKO-Adjacents,255
Polyscias_marchionensis,2,2,0,Points-PointsKO-Adjacents,11
Polyscias_mauritiana,0,0,0,NA,0
Polyscias_mayottensis,3,3,0,Points-PointsKO-Adjacents,13
Polyscias_meliifolia,0,0,0,NA,0
Polyscias_mollis,51,38,13,Alphahull-PointsKO-Adjacents,142
Polyscias_montana,1,1,0,Points-PointsKO-Adjacents,9
Polyscias_multibracteata,59,41,18,Alphahull-PointsKO-Adjacents,395
Polyscias_multijuga,9,1,8,Points-PointsKO-Adjacents,47
Polyscias_muraltana,NA,NA,NA,NA,NA
Polyscias_murrayi,591,526,65,Alphahull-PointsKO-Adjacents,1608
Polyscias_myrsine,54,30,24,Alphahull-PointsKO-Adjacents,424
Polyscias_neraudiana,2,2,0,Points-PointsKO-Adjacents,12
Polyscias_nodosa,42,8,34,Points-PointsKO-Adjacents,250
Polyscias_nossibiensis,1,1,0,Points-PointsKO-Adjacents,8
Polyscias_oahuensis,19,13,6,Points-PointsKO-Adjacents,80
Polyscias_ornifolia,192,168,24,Alphahull-PointsKO-Adjacents,2174
Polyscias_otopyrena,16,11,5,Points-PointsKO-Adjacents,53
Polyscias_pachypedicellata,6,1,5,Points-PointsKO-Adjacents,30
Polyscias_pacifica,9,0,9,Points-PointsKO-Adjacents,53
Polyscias_palmervandenbroekii,0,0,0,NA,0
Polyscias_paniculata,2,2,0,Points-PointsKO-Adjacents,14
Polyscias_pentamera,56,47,9,Alphahull-PointsKO-Adjacents,171
Polyscias_pinnata,0,0,0,NA,0
Polyscias_pleiosperma,12,8,4,Points-PointsKO-Adjacents,30
Polyscias_prolifera,7,0,7,Points-PointsKO-Adjacents,45
Polyscias_pulgarensis,0,0,0,NA,0
Polyscias_purpurea,66,53,13,Alphahull-PointsKO-Adjacents,150
Polyscias_quintasii,5,2,3,Points-PointsKO-Adjacents,16
Polyscias_racemosa,4,4,0,Points-PointsKO-Adjacents,16
Polyscias_rainaliorum,7,0,7,Points-PointsKO-Adjacents,48
Polyscias_reineckei,2,2,0,Points-PointsKO-Adjacents,14
Polyscias_repanda,4,0,4,Points-PointsKO-Adjacents,18
Polyscias_revoluta,1,1,0,Points-PointsKO-Adjacents,9
Polyscias_richardsiae,1,1,0,Points-PointsKO-Adjacents,9
Polyscias_rivalsii,0,0,0,NA,0
Polyscias_rodriguesiana,0,0,0,NA,0
Polyscias_roemeriana,1,1,0,Points-PointsKO-Adjacents,9
Polyscias_royenii,13,6,7,Points-PointsKO-Adjacents,87
Polyscias_rubiginosa,NA,NA,NA,NA,NA
Polyscias_rufosepala,0,0,0,NA,0
Polyscias_sambucifolia,7710,7300,410,Alphahull-PointsKO-Adjacents,5271
Polyscias_samoensis,13,3,10,Points-PointsKO-Adjacents,68
Polyscias_sandwicensis,6,1,5,Points-PointsKO-Adjacents,49
Polyscias_schmidii,3,3,0,Points-PointsKO-Adjacents,24
Polyscias_schultzei,40,22,18,Alphahull-PointsKO-Adjacents,391
Polyscias_scopoliae,6,1,5,Points-PointsKO-Adjacents,22
Polyscias_scutellaria,23,0,23,Points-PointsKO-Adjacents,141
Polyscias_sechellarum,2,2,0,Points-PointsKO-Adjacents,14
Polyscias_serratifolia,20,5,15,Points-PointsKO-Adjacents,113
Polyscias_sessiliflora,1,1,0,Points-PointsKO-Adjacents,9
Polyscias_sorongensis,NA,NA,NA,NA,NA
Polyscias_spectabilis,53,35,18,Alphahull-PointsKO-Adjacents,966
Polyscias_stonei,0,0,0,NA,0
Polyscias_stuhlmannii,24,17,7,Points-PointsKO-Adjacents,86
Polyscias_subcapitata,2,2,0,Points-PointsKO-Adjacents,5
Polyscias_tafondroensis,16,12,4,Points-PointsKO-Adjacents,74
Polyscias_tahitensis,4,4,0,Points-PointsKO-Adjacents,24
Polyscias_terminalia,7,1,6,Points-PointsKO-Adjacents,15
Polyscias_thailandica,NA,NA,NA,NA,NA
Polyscias_verrucosa,3,3,0,Points-PointsKO-Adjacents,16
Polyscias_verticillata,12,1,11,Points-PointsKO-Adjacents,74
Polyscias_vieillardii,28,15,13,Points-PointsKO-Adjacents,103
Polyscias_waialealae,5,1,4,Points-PointsKO-Adjacents,17
Polyscias_waimeae,5,2,3,Points-PointsKO-Adjacents,31
Polyscias_weinmanniae,6,2,4,Points-PointsKO-Adjacents,27
Polyscias_wohlhauseri,5,5,0,Points-PointsKO-Adjacents,27
Polyscias_zanthoxyloides,42,31,11,Alphahull-PointsKO-Adjacents,288
Polysphaeria_acuminata,32,17,15,Points-PointsKO-Adjacents,146
Polysphaeria_aethiopica,2,2,0,Points-PointsKO-Adjacents,9
Polysphaeria_arbuscula,178,153,25,Alphahull-PointsKO-Adjacents,2982
Polysphaeria_braunii,30,19,11,Points-PointsKO-Adjacents,176
Polysphaeria_capuronii,9,3,6,Points-PointsKO-Adjacents,75
Polysphaeria_cleistocalyx,20,8,12,Points-PointsKO-Adjacents,146
Polysphaeria_dischistocalyx,12,5,7,Points-PointsKO-Adjacents,85
Polysphaeria_grandiflora,27,16,11,Points-PointsKO-Adjacents,139
Polysphaeria_lanceolata,46,22,24,Alphahull-PointsKO-Adjacents,644
Polysphaeria_lepidocarpa,24,16,8,Points-PointsKO-Adjacents,60
Polysphaeria_macrantha,17,10,7,Points-PointsKO-Adjacents,68
Polysphaeria_maxima,7,0,7,Points-PointsKO-Adjacents,35
Polysphaeria_multiflora,102,79,23,Alphahull-PointsKO-Adjacents,2574
Polysphaeria_ntemii,7,5,2,Points-PointsKO-Adjacents,22
Polysphaeria_parvifolia,49,32,17,Alphahull-PointsKO-Adjacents,458
Polysphaeria_pedunculata,5,5,0,Points-PointsKO-Adjacents,45
Polysphaeria_tubulosa,16,0,16,Points-PointsKO-Adjacents,116
Polyspora_axillaris,364,299,65,Alphahull-PointsKO-Adjacents,2285
Polyspora_balansae,2,2,0,Points-PointsKO-Adjacents,18
Polyspora_hainanensis,4,4,0,Points-PointsKO-Adjacents,36
Polyspora_longicarpa,28,17,11,Points-PointsKO-Adjacents,136
Polyspora_speciosa,4,4,0,Points-PointsKO-Adjacents,36
Polyspora_tiantangensis,0,0,0,NA,0
Polystemonanthus_dinklagei,17,10,7,Points-PointsKO-Adjacents,97
Pombalia_prunifolia,73,48,25,Alphahull-PointsKO-Adjacents,3614
Pometia_pinnata,249,128,121,Alphahull-PointsKO-Adjacents,4958
Ponapea_hosinoi,0,0,0,NA,0
Ponapea_ledermanniana,0,0,0,NA,0
Ponapea_palauensis,0,0,0,NA,0
Pongamia_pinnata,407,248,159,Alphahull-PointsKO-Adjacents,7131
Pongamiopsis_amygdalina,43,0,43,Points-PointsKO-Adjacents,112
Pongamiopsis_pervilleana,148,118,30,Alphahull-PointsKO-Adjacents,1987
Pongamiopsis_viguieri,9,5,4,Points-PointsKO-Adjacents,48
Popowia_alata,3,3,0,Points-PointsKO-Adjacents,9
Popowia_hirta,17,6,11,Points-PointsKO-Adjacents,110
Popowia_odoardi,14,5,9,Points-PointsKO-Adjacents,114
Popowia_pisocarpa,97,57,40,Alphahull-PointsKO-Adjacents,3900
Populus_adenopoda,53,0,53,Points-PointsKO-Adjacents,464
Populus_afghanica,3,3,0,Points-PointsKO-Adjacents,27
Populus_alaschanica,0,0,0,NA,0
Populus_alba,15447,11508,3939,Alphahull-PointsKO-Adjacents,118933
Populus_amurensis,0,0,0,NA,0
Populus_angustifolia,1162,1089,73,Alphahull-PointsKO-Adjacents,27811
Populus_balsamifera,5565,5002,563,Alphahull-PointsKO-Adjacents,152834
Populus_cathayana,18,3,15,Points-PointsKO-Adjacents,162
Populus_charbinensis,1,1,0,Points-PointsKO-Adjacents,9
Populus_ciliata,32,16,16,Points-PointsKO-Adjacents,215
Populus_deltoides,5342,4205,1137,Alphahull-PointsKO-Adjacents,88854
Populus_euphratica,129,52,77,Alphahull-PointsKO-Adjacents,1716
Populus_fremontii,1952,1671,281,Alphahull-PointsKO-Adjacents,30987
Populus_girinensis,NA,NA,NA,NA,NA
Populus_glauca,0,0,0,NA,0
Populus_grandidentata,6977,6497,480,Alphahull-PointsKO-Adjacents,32298
Populus_guzmanantlensis,20,11,9,Points-PointsKO-Adjacents,54
Populus_haoana,8,2,6,Points-PointsKO-Adjacents,72
Populus_heterophylla,449,0,449,Points-PointsKO-Adjacents,2945
Populus_hsinganica,1,1,0,Points-PointsKO-Adjacents,9
Populus_ilicifolia,23,16,7,Points-PointsKO-Adjacents,161
Populus_iliensis,0,0,0,NA,0
Populus_intramongolica,NA,NA,NA,NA,NA
Populus_kangdingensis,1,1,0,Points-PointsKO-Adjacents,9
Populus_keerqinensis,NA,NA,NA,NA,NA
Populus_koreana,29,9,20,Points-PointsKO-Adjacents,213
Populus_lancifolia,NA,NA,NA,NA,NA
Populus_lasiocarpa,21,8,13,Points-PointsKO-Adjacents,189
Populus_laurifolia,9,0,9,Points-PointsKO-Adjacents,80
Populus_mainlingensis,3,3,0,Points-PointsKO-Adjacents,27
Populus_manshurica,NA,NA,NA,NA,NA
Populus_mexicana,71,39,32,Alphahull-PointsKO-Adjacents,1256
Populus_minhoensis,NA,NA,NA,NA,NA
Populus_nakaii,NA,NA,NA,NA,NA
Populus_nigra,19520,15587,3933,Alphahull-PointsKO-Adjacents,52651
Populus_ningshanica,NA,NA,NA,NA,NA
Populus_pamirica,4,4,0,Points-PointsKO-Adjacents,27
Populus_pilosa,1,1,0,Points-PointsKO-Adjacents,9
Populus_platyphylla,NA,NA,NA,NA,NA
Populus_pruinosa,17,3,14,Points-PointsKO-Adjacents,150
Populus_pseudoglauca,1,1,0,Points-PointsKO-Adjacents,9
Populus_pseudomaximowiczii,NA,NA,NA,NA,NA
Populus_pseudosimonii,6,0,6,Points-PointsKO-Adjacents,54
Populus_purdomii,6,2,4,Points-PointsKO-Adjacents,54
Populus_qamdoensis,1,1,0,Points-PointsKO-Adjacents,9
Populus_qiongdaoensis,NA,NA,NA,NA,NA
Populus_schneideri,2,2,0,Points-PointsKO-Adjacents,18
Populus_shanxiensis,NA,NA,NA,NA,NA
Populus_simaroa,39,29,10,Alphahull-PointsKO-Adjacents,491
Populus_simonii,49,16,33,Points-PointsKO-Adjacents,435
Populus_suaveolens,41,11,30,Points-PointsKO-Adjacents,314
Populus_szechuanica,26,12,14,Points-PointsKO-Adjacents,234
Populus_talassica,2,2,0,Points-PointsKO-Adjacents,18
Populus_tomentosa,23,2,21,Points-PointsKO-Adjacents,206
Populus_tremula,76755,67353,9402,Alphahull-PointsKO-Adjacents,95943
Populus_tremuloides,23545,22678,867,Alphahull-PointsKO-Adjacents,131206
Populus_trichocarpa,1278,954,324,Alphahull-PointsKO-Adjacents,32682
Populus_trinervis,4,4,0,Points-PointsKO-Adjacents,36
Populus_violascens,0,0,0,NA,0
Populus_wenxianica,NA,NA,NA,NA,NA
Populus_wilsonii,6,1,5,Points-PointsKO-Adjacents,54
Populus_wuana,NA,NA,NA,NA,NA
Populus_wulianensis,NA,NA,NA,NA,NA
Populus_xiangchengensis,3,3,0,Points-PointsKO-Adjacents,27
Populus_yatungensis,3,3,0,Points-PointsKO-Adjacents,27
Populus_yuana,1,1,0,Points-PointsKO-Adjacents,9
Populus_yunnanensis,9,2,7,Points-PointsKO-Adjacents,81
Poraqueiba_guianensis,252,191,61,Alphahull-PointsKO-Adjacents,19214
Poraqueiba_paraensis,49,14,35,Points-PointsKO-Adjacents,390
Poraqueiba_sericea,214,160,54,Alphahull-PointsKO-Adjacents,11521
Porcelia_macrocarpa,82,42,40,Alphahull-PointsKO-Adjacents,4814
Porcelia_magnifructa,13,4,9,Points-PointsKO-Adjacents,93
Porcelia_mediocris,30,17,13,Points-PointsKO-Adjacents,189
Porcelia_nitidifolia,43,26,17,Alphahull-PointsKO-Adjacents,945
Porcelia_ponderosa,85,0,85,Points-PointsKO-Adjacents,591
Porcelia_steinbachii,13,8,5,Points-PointsKO-Adjacents,77
Porcelia_venezuelensis,23,4,19,Points-PointsKO-Adjacents,190
Porlieria_angustifolia,229,198,31,Alphahull-PointsKO-Adjacents,4026
Porlieria_chilensis,35,17,18,Points-PointsKO-Adjacents,224
Porlieria_microphylla,114,85,29,Alphahull-PointsKO-Adjacents,7713
Porocystis_acuminata,8,1,7,Points-PointsKO-Adjacents,69
Porocystis_toulicioides,73,44,29,Alphahull-PointsKO-Adjacents,3084
Porterandia_anisophylla,34,21,13,Alphahull-PointsKO-Adjacents,1546
Porterandia_beamanii,8,2,6,Points-PointsKO-Adjacents,36
Porterandia_bruneiensis,NA,NA,NA,NA,NA
Porterandia_catappifolia,3,3,0,Points-PointsKO-Adjacents,27
Porterandia_celebica,2,2,0,Points-PointsKO-Adjacents,18
Porterandia_chanii,1,1,0,Points-PointsKO-Adjacents,9
Porterandia_congestiflora,2,2,0,Points-PointsKO-Adjacents,18
Porterandia_dinghoui,NA,NA,NA,NA,NA
Porterandia_glabrifolia,0,0,0,NA,0
Porterandia_grandifolia,6,0,6,Points-PointsKO-Adjacents,54
Porterandia_hosei,NA,NA,NA,NA,NA
Porterandia_kalimantanensis,1,1,0,Points-PointsKO-Adjacents,9
Porterandia_lambirensis,0,0,0,NA,0
Porterandia_laxiflora,0,0,0,NA,0
Porterandia_macroptera,1,1,0,Points-PointsKO-Adjacents,9
Porterandia_minor,0,0,0,NA,0
Porterandia_pauciflora,1,1,0,Points-PointsKO-Adjacents,9
Porterandia_postarii,1,1,0,Points-PointsKO-Adjacents,8
Porterandia_puffii,1,1,0,Points-PointsKO-Adjacents,9
Porterandia_rarissima,NA,NA,NA,NA,NA
Porterandia_scortechinii,3,3,0,Points-PointsKO-Adjacents,19
Porterandia_subsessilis,1,1,0,Points-PointsKO-Adjacents,9
Portlandia_grandiflora,3,3,0,Points-PointsKO-Adjacents,23
Portlandia_harrisii,0,0,0,NA,0
Portlandia_microsepala,0,0,0,NA,0
Portlandia_platantha,5,1,4,Points-PointsKO-Adjacents,23
Portulacaria_afra,80,53,27,Alphahull-PointsKO-Adjacents,1018
Posoqueria_acutifolia,138,0,138,Points-PointsKO-Adjacents,697
Posoqueria_bahiensis,15,10,5,Points-PointsKO-Adjacents,72
Posoqueria_calantha,NA,NA,NA,NA,NA
Posoqueria_coriacea,297,219,78,Alphahull-PointsKO-Adjacents,5972
Posoqueria_correana,15,7,8,Points-PointsKO-Adjacents,55
Posoqueria_costaricensis,25,14,11,Points-PointsKO-Adjacents,105
Posoqueria_fragrantissima,NA,NA,NA,NA,NA
Posoqueria_grandiflora,63,53,10,Alphahull-PointsKO-Adjacents,370
Posoqueria_grandifructa,57,48,9,Alphahull-PointsKO-Adjacents,328
Posoqueria_laevis,18,14,4,Points-PointsKO-Adjacents,55
Posoqueria_latifolia,2970,2680,290,Alphahull-PointsKO-Adjacents,128693
Posoqueria_laurifolia,1,1,0,Points-PointsKO-Adjacents,9
Posoqueria_longiflora,613,500,113,Alphahull-PointsKO-Adjacents,45947
Posoqueria_palustris,25,7,18,Points-PointsKO-Adjacents,174
Posoqueria_platysiphonia,9,0,9,Points-PointsKO-Adjacents,72
Posoqueria_robusta,32,27,5,Alphahull-PointsKO-Adjacents,79
Posoqueria_trinitatis,20,4,16,Points-PointsKO-Adjacents,154
Posoqueria_velutina,16,5,11,Points-PointsKO-Adjacents,134
Posoqueria_williamsii,21,13,8,Points-PointsKO-Adjacents,121
Potalia_amara,318,230,88,Alphahull-PointsKO-Adjacents,37336
Potalia_coronata,66,46,20,Alphahull-PointsKO-Adjacents,3092
Potalia_elegans,62,33,29,Alphahull-PointsKO-Adjacents,1103
Potalia_maguireorum,9,2,7,Points-PointsKO-Adjacents,81
Potalia_resinifera,285,213,72,Alphahull-PointsKO-Adjacents,42684
Potalia_turbinata,34,23,11,Alphahull-PointsKO-Adjacents,142
Potameia_chartacea,9,3,6,Points-PointsKO-Adjacents,58
Potameia_confluens,4,4,0,Points-PointsKO-Adjacents,34
Potameia_crassifolia,12,2,10,Points-PointsKO-Adjacents,104
Potameia_lotungensis,1,1,0,Points-PointsKO-Adjacents,9
Potameia_micrantha,6,2,4,Points-PointsKO-Adjacents,25
Potameia_obtusifolia,8,0,8,Points-PointsKO-Adjacents,63
Potameia_tirunelvelica,NA,NA,NA,NA,NA
Potameia_tomentella,4,4,0,Points-PointsKO-Adjacents,26
Potoxylon_melagangai,1,1,0,Points-PointsKO-Adjacents,9
Pouchetia_africana,225,172,53,Alphahull-PointsKO-Adjacents,6940
Pouchetia_parviflora,13,3,10,Points-PointsKO-Adjacents,102
Poulsenia_armata,615,517,98,Alphahull-PointsKO-Adjacents,20052
Poupartia_borbonica,0,0,0,NA,0
Poupartia_castanea,0,0,0,NA,0
Poupartia_chapelieri,110,86,24,Alphahull-PointsKO-Adjacents,943
Poupartia_minor,47,27,20,Alphahull-PointsKO-Adjacents,855
Poupartia_orientalis,13,3,10,Points-PointsKO-Adjacents,98
Poupartia_pubescens,0,0,0,NA,0
Pourouma_acuminata,36,19,17,Points-PointsKO-Adjacents,277
Pourouma_bicolor,1063,941,122,Alphahull-PointsKO-Adjacents,62128
Pourouma_bolivarensis,3,3,0,Points-PointsKO-Adjacents,25
Pourouma_cecropiifolia,672,0,672,Points-PointsKO-Adjacents,4023
Pourouma_cordata,8,1,7,Points-PointsKO-Adjacents,72
Pourouma_cucura,168,111,57,Alphahull-PointsKO-Adjacents,10555
Pourouma_cuspidata,9,1,8,Points-PointsKO-Adjacents,73
Pourouma_elliptica,7,1,6,Points-PointsKO-Adjacents,54
Pourouma_ferruginea,52,28,24,Alphahull-PointsKO-Adjacents,2209
Pourouma_floccosa,18,6,12,Points-PointsKO-Adjacents,136
Pourouma_formicarum,15,0,15,Points-PointsKO-Adjacents,102
Pourouma_guianensis,1255,1117,138,Alphahull-PointsKO-Adjacents,80286
Pourouma_herrerensis,35,24,11,Alphahull-PointsKO-Adjacents,479
Pourouma_hirsutipetiolata,51,35,16,Alphahull-PointsKO-Adjacents,788
Pourouma_melinonii,180,108,72,Alphahull-PointsKO-Adjacents,23101
Pourouma_minor,869,787,82,Alphahull-PointsKO-Adjacents,61758
Pourouma_mollis,302,210,92,Alphahull-PointsKO-Adjacents,16830
Pourouma_montana,6,1,5,Points-PointsKO-Adjacents,45
Pourouma_myrmecophila,86,53,33,Alphahull-PointsKO-Adjacents,7084
Pourouma_napoensis,25,17,8,Points-PointsKO-Adjacents,153
Pourouma_oraria,6,0,6,Points-PointsKO-Adjacents,54
Pourouma_ovata,85,51,34,Alphahull-PointsKO-Adjacents,3562
Pourouma_petiolulata,19,11,8,Points-PointsKO-Adjacents,93
Pourouma_phaeotricha,21,1,20,Points-PointsKO-Adjacents,168
Pourouma_saulensis,5,2,3,Points-PointsKO-Adjacents,24
Pourouma_stipulacea,5,5,0,Points-PointsKO-Adjacents,44
Pourouma_tomentosa,492,413,79,Alphahull-PointsKO-Adjacents,48488
Pourouma_velutina,206,112,94,Alphahull-PointsKO-Adjacents,13820
Pourouma_villosa,107,54,53,Alphahull-PointsKO-Adjacents,8317
Pouteria_adolfi-friedericii,54,21,33,Alphahull-PointsKO-Adjacents,1680
Pouteria_alnifolia,448,394,54,Alphahull-PointsKO-Adjacents,5217
Pouteria_altissima,94,50,44,Alphahull-PointsKO-Adjacents,1657
Pouteria_amapaensis,1,1,0,Points-PointsKO-Adjacents,9
Pouteria_amazonica,2,1,1,Points-PointsKO-Adjacents,18
Pouteria_ambelaniifolia,35,13,22,Points-PointsKO-Adjacents,241
Pouteria_amygdalicarpa,46,19,27,Points-PointsKO-Adjacents,246
Pouteria_amygdalina,25,17,8,Points-PointsKO-Adjacents,155
Pouteria_andarahiensis,85,1,84,Points-PointsKO-Adjacents,257
Pouteria_anomala,26,11,15,Points-PointsKO-Adjacents,189
Pouteria_anteridata,1,1,0,Points-PointsKO-Adjacents,9
Pouteria_arcuata,5,5,0,Points-PointsKO-Adjacents,45
Pouteria_areolatifolia,2,2,0,Points-PointsKO-Adjacents,18
Pouteria_arguacoensium,2,2,0,Points-PointsKO-Adjacents,18
Pouteria_aristata,3,3,0,Points-PointsKO-Adjacents,26
Pouteria_atabapoensis,8,1,7,Points-PointsKO-Adjacents,57
Pouteria_aubrevillei,9,0,9,Points-PointsKO-Adjacents,81
Pouteria_aurea,3,3,0,Points-PointsKO-Adjacents,27
Pouteria_austin-smithii,17,11,6,Points-PointsKO-Adjacents,94
Pouteria_baehniana,103,60,43,Alphahull-PointsKO-Adjacents,1365
Pouteria_bangii,210,115,95,Alphahull-PointsKO-Adjacents,4729
Pouteria_bapeba,15,0,15,Points-PointsKO-Adjacents,105
Pouteria_beaurepairei,44,19,25,Points-PointsKO-Adjacents,339
Pouteria_belizensis,15,0,15,Points-PointsKO-Adjacents,96
Pouteria_benai,6,5,1,Points-PointsKO-Adjacents,30
Pouteria_bilocularis,205,135,70,Alphahull-PointsKO-Adjacents,11394
Pouteria_bonneriana,2,2,0,Points-PointsKO-Adjacents,18
Pouteria_brachyandra,19,5,14,Points-PointsKO-Adjacents,139
Pouteria_bracteata,2,2,0,Points-PointsKO-Adjacents,12
Pouteria_brevensis,0,0,0,NA,0
Pouteria_brevipetiolata,0,0,0,NA,0
Pouteria_briocheoides,2,2,0,Points-PointsKO-Adjacents,18
Pouteria_buenaventurensis,49,33,16,Alphahull-PointsKO-Adjacents,126
Pouteria_bullata,21,6,15,Points-PointsKO-Adjacents,150
Pouteria_bulliformis,26,17,9,Points-PointsKO-Adjacents,91
Pouteria_butyrocarpa,31,15,16,Points-PointsKO-Adjacents,225
Pouteria_caimito,619,490,129,Alphahull-PointsKO-Adjacents,61897
Pouteria_campanulata,31,0,31,Points-PointsKO-Adjacents,199
Pouteria_campechiana,604,531,73,Alphahull-PointsKO-Adjacents,12263
Pouteria_canaimaensis,8,0,8,Points-PointsKO-Adjacents,51
Pouteria_capacifolia,13,8,5,Points-PointsKO-Adjacents,81
Pouteria_cayennensis,12,2,10,Points-PointsKO-Adjacents,87
Pouteria_celebica,3,2,1,Points-PointsKO-Adjacents,23
Pouteria_chiricana,4,3,1,Points-PointsKO-Adjacents,31
Pouteria_chocoensis,2,2,0,Points-PointsKO-Adjacents,18
Pouteria_cicatricata,4,4,0,Points-PointsKO-Adjacents,36
Pouteria_cinnamomea,2,2,0,Points-PointsKO-Adjacents,18
Pouteria_cladantha,119,61,58,Alphahull-PointsKO-Adjacents,5679
Pouteria_coelomatica,8,5,3,Points-PointsKO-Adjacents,70
Pouteria_collina,27,17,10,Points-PointsKO-Adjacents,144
Pouteria_condorensis,4,4,0,Points-PointsKO-Adjacents,25
Pouteria_congestifolia,43,30,13,Alphahull-PointsKO-Adjacents,169
Pouteria_cordiformis,4,3,1,Points-PointsKO-Adjacents,36
Pouteria_coriacea,54,19,35,Points-PointsKO-Adjacents,403
Pouteria_crassiflora,3,3,0,Points-PointsKO-Adjacents,27
Pouteria_cubensis,0,0,0,NA,0
Pouteria_cuspidata,391,269,122,Alphahull-PointsKO-Adjacents,31506
Pouteria_decorticans,15,4,11,Points-PointsKO-Adjacents,120
Pouteria_decussata,3,3,0,Points-PointsKO-Adjacents,27
Pouteria_deliciosa,2,0,2,Points-PointsKO-Adjacents,18
Pouteria_dictyoneura,19,4,15,Points-PointsKO-Adjacents,116
Pouteria_dominigensis,20,3,17,Points-PointsKO-Adjacents,135
Pouteria_doonsaf,3,3,0,Points-PointsKO-Adjacents,24
Pouteria_durlandii,304,182,122,Alphahull-PointsKO-Adjacents,4280
Pouteria_egregia,37,5,32,Points-PointsKO-Adjacents,260
Pouteria_elegans,185,132,53,Alphahull-PointsKO-Adjacents,12008
Pouteria_engleri,26,6,20,Points-PointsKO-Adjacents,219
Pouteria_ephedrantha,42,21,21,Alphahull-PointsKO-Adjacents,386
Pouteria_ericoides,3,3,0,Points-PointsKO-Adjacents,21
Pouteria_erythrochrysa,8,3,5,Points-PointsKO-Adjacents,57
Pouteria_espinae,4,4,0,Points-PointsKO-Adjacents,36
Pouteria_eugeniifolia,71,24,47,Alphahull-PointsKO-Adjacents,555
Pouteria_euryphylla,1,0,1,Points-PointsKO-Adjacents,7
Pouteria_exfoliata,31,25,6,Alphahull-PointsKO-Adjacents,98
Pouteria_exstaminodia,0,0,0,NA,0
Pouteria_filiformis,15,10,5,Points-PointsKO-Adjacents,47
Pouteria_filipes,76,37,39,Alphahull-PointsKO-Adjacents,593
Pouteria_fimbriata,18,3,15,Points-PointsKO-Adjacents,153
Pouteria_flavilatex,6,3,3,Points-PointsKO-Adjacents,39
Pouteria_fossicola,45,30,15,Alphahull-PointsKO-Adjacents,447
Pouteria_foveolata,24,15,9,Points-PointsKO-Adjacents,115
Pouteria_fragrans,10,4,6,Points-PointsKO-Adjacents,78
Pouteria_franciscana,6,0,6,Points-PointsKO-Adjacents,54
Pouteria_freitasii,7,0,7,Points-PointsKO-Adjacents,33
Pouteria_fulva,5,0,5,Points-PointsKO-Adjacents,39
Pouteria_furcata,20,7,13,Points-PointsKO-Adjacents,164
Pouteria_gabrielensis,18,8,10,Points-PointsKO-Adjacents,139
Pouteria_gardneri,433,361,72,Alphahull-PointsKO-Adjacents,29446
Pouteria_gardneriana,237,166,71,Alphahull-PointsKO-Adjacents,24228
Pouteria_gigantea,2,2,0,Points-PointsKO-Adjacents,18
Pouteria_glauca,7,0,7,Points-PointsKO-Adjacents,59
Pouteria_glomerata,443,257,186,Alphahull-PointsKO-Adjacents,25205
Pouteria_gongrijpii,34,14,20,Points-PointsKO-Adjacents,264
Pouteria_gracilis,6,0,6,Points-PointsKO-Adjacents,35
Pouteria_grandiflora,179,133,46,Alphahull-PointsKO-Adjacents,3220
Pouteria_grandis,2,0,2,Points-PointsKO-Adjacents,18
Pouteria_guianensis,545,398,147,Alphahull-PointsKO-Adjacents,62111
Pouteria_hexastemon,2,1,1,Points-PointsKO-Adjacents,18
Pouteria_hotteana,3,0,3,Points-PointsKO-Adjacents,21
Pouteria_izabalensis,37,23,14,Alphahull-PointsKO-Adjacents,205
Pouteria_jariensis,26,11,15,Points-PointsKO-Adjacents,213
Pouteria_juruana,4,4,0,Points-PointsKO-Adjacents,36
Pouteria_kaieteurensis,7,4,3,Points-PointsKO-Adjacents,42
Pouteria_krukovii,17,0,17,Points-PointsKO-Adjacents,138
Pouteria_laevigata,82,47,35,Alphahull-PointsKO-Adjacents,4749
Pouteria_latianthera,3,3,0,Points-PointsKO-Adjacents,27
Pouteria_lecythidicarpa,19,14,5,Points-PointsKO-Adjacents,71
Pouteria_leptopedicellata,24,13,11,Points-PointsKO-Adjacents,113
Pouteria_longifolia,5,2,3,Points-PointsKO-Adjacents,45
Pouteria_lucens,6,0,6,Points-PointsKO-Adjacents,54
Pouteria_lucida,NA,NA,NA,NA,NA
Pouteria_lucuma,66,40,26,Alphahull-PointsKO-Adjacents,1628
Pouteria_lucumifolia,36,11,25,Points-PointsKO-Adjacents,262
Pouteria_macahensis,50,0,50,Points-PointsKO-Adjacents,291
Pouteria_macrocarpa,40,9,31,Points-PointsKO-Adjacents,289
Pouteria_macrophylla,186,94,92,Alphahull-PointsKO-Adjacents,8342
Pouteria_maguirei,12,2,10,Points-PointsKO-Adjacents,87
Pouteria_manaosensis,29,13,16,Points-PointsKO-Adjacents,189
Pouteria_mattogrossensis,1,1,0,Points-PointsKO-Adjacents,9
Pouteria_maxima,8,3,5,Points-PointsKO-Adjacents,57
Pouteria_megaphylla,4,4,0,Points-PointsKO-Adjacents,27
Pouteria_melanopoda,0,0,0,NA,0
Pouteria_micrantha,1,1,0,Points-PointsKO-Adjacents,9
Pouteria_microstrigosa,48,31,17,Alphahull-PointsKO-Adjacents,1056
Pouteria_minima,13,6,7,Points-PointsKO-Adjacents,71
Pouteria_mongaguensis,NA,NA,NA,NA,NA
Pouteria_multiflora,6,0,6,Points-PointsKO-Adjacents,54
Pouteria_nemorosa,40,29,11,Alphahull-PointsKO-Adjacents,872
Pouteria_nudipetala,8,2,6,Points-PointsKO-Adjacents,72
Pouteria_oblanceolata,53,22,31,Alphahull-PointsKO-Adjacents,312
Pouteria_obscura,1,1,0,Points-PointsKO-Adjacents,9
Pouteria_opposita,22,8,14,Points-PointsKO-Adjacents,144
Pouteria_oppositifolia,11,2,9,Points-PointsKO-Adjacents,76
Pouteria_orinocoensis,9,2,7,Points-PointsKO-Adjacents,81
Pouteria_oxyedra,0,0,0,NA,0
Pouteria_oxypetala,10,1,9,Points-PointsKO-Adjacents,77
Pouteria_pachycalyx,18,8,10,Points-PointsKO-Adjacents,148
Pouteria_pachyphylla,14,0,14,Points-PointsKO-Adjacents,111
Pouteria_pallens,6,1,5,Points-PointsKO-Adjacents,48
Pouteria_pallida,8,2,6,Points-PointsKO-Adjacents,24
Pouteria_pariry,6,0,6,Points-PointsKO-Adjacents,54
Pouteria_penicillata,1,1,0,Points-PointsKO-Adjacents,9
Pouteria_pentamera,3,3,0,Points-PointsKO-Adjacents,24
Pouteria_peruviensis,2,2,0,Points-PointsKO-Adjacents,18
Pouteria_petiolata,10,2,8,Points-PointsKO-Adjacents,82
Pouteria_pierrei,32,18,14,Points-PointsKO-Adjacents,242
Pouteria_pimichinensis,9,0,9,Points-PointsKO-Adjacents,64
Pouteria_pisquiensis,2,2,0,Points-PointsKO-Adjacents,18
Pouteria_platyphylla,15,3,12,Points-PointsKO-Adjacents,120
Pouteria_plicata,42,6,36,Points-PointsKO-Adjacents,358
Pouteria_polycarpa,2,2,0,Points-PointsKO-Adjacents,18
Pouteria_polysepala,7,1,6,Points-PointsKO-Adjacents,57
Pouteria_procera,70,23,47,Alphahull-PointsKO-Adjacents,2392
Pouteria_psammophila,30,9,21,Points-PointsKO-Adjacents,208
Pouteria_pseudoracemosa,12,6,6,Points-PointsKO-Adjacents,82
Pouteria_puberula,1,1,0,Points-PointsKO-Adjacents,9
Pouteria_pubescens,9,0,9,Points-PointsKO-Adjacents,76
Pouteria_pullei,1,1,0,Points-PointsKO-Adjacents,9
Pouteria_putamen-ovi,9,0,9,Points-PointsKO-Adjacents,54
Pouteria_quicheana,2,2,0,Points-PointsKO-Adjacents,18
Pouteria_ramiflora,740,664,76,Alphahull-PointsKO-Adjacents,46761
Pouteria_resinosa,2,2,0,Points-PointsKO-Adjacents,14
Pouteria_reticulata,693,531,162,Alphahull-PointsKO-Adjacents,36436
Pouteria_retinervis,9,3,6,Points-PointsKO-Adjacents,81
Pouteria_rhynchocarpa,9,0,9,Points-PointsKO-Adjacents,22
Pouteria_rigida,45,0,45,Points-PointsKO-Adjacents,281
Pouteria_rigidopsis,3,3,0,Points-PointsKO-Adjacents,27
Pouteria_rodriguesiana,11,5,6,Points-PointsKO-Adjacents,80
Pouteria_rostrata,65,31,34,Alphahull-PointsKO-Adjacents,1746
Pouteria_rufotomentosa,4,4,0,Points-PointsKO-Adjacents,18
Pouteria_sagotiana,27,18,9,Points-PointsKO-Adjacents,219
Pouteria_salicifolia,93,66,27,Alphahull-PointsKO-Adjacents,5550
Pouteria_sambuensis,0,0,0,NA,0
Pouteria_sapota,234,176,58,Alphahull-PointsKO-Adjacents,7851
Pouteria_scabritesta,2,2,0,Points-PointsKO-Adjacents,12
Pouteria_sclerocarpa,6,1,5,Points-PointsKO-Adjacents,42
Pouteria_scrobiculata,4,4,0,Points-PointsKO-Adjacents,36
Pouteria_semecarpifolia,1,1,0,Points-PointsKO-Adjacents,8
Pouteria_sessiliflora,6,0,6,Points-PointsKO-Adjacents,53
Pouteria_sessilis,3,3,0,Points-PointsKO-Adjacents,17
Pouteria_silvestris,12,8,4,Points-PointsKO-Adjacents,50
Pouteria_simulans,22,4,18,Points-PointsKO-Adjacents,194
Pouteria_singularis,6,4,2,Points-PointsKO-Adjacents,45
Pouteria_sipapoensis,1,1,0,Points-PointsKO-Adjacents,9
Pouteria_speciosa,19,5,14,Points-PointsKO-Adjacents,132
Pouteria_spicata,8,2,6,Points-PointsKO-Adjacents,51
Pouteria_squamosa,3,3,0,Points-PointsKO-Adjacents,26
Pouteria_stenophylla,6,0,6,Points-PointsKO-Adjacents,47
Pouteria_stipitata,21,0,21,Points-PointsKO-Adjacents,126
Pouteria_stipulifera,2,2,0,Points-PointsKO-Adjacents,18
Pouteria_stylifera,2,2,0,Points-PointsKO-Adjacents,18
Pouteria_subcaerulea,29,8,21,Points-PointsKO-Adjacents,236
Pouteria_subrotata,80,52,28,Alphahull-PointsKO-Adjacents,1724
Pouteria_subsessilifolia,21,16,5,Points-PointsKO-Adjacents,54
Pouteria_superba,3,3,0,Points-PointsKO-Adjacents,24
Pouteria_surumuensis,58,39,19,Alphahull-PointsKO-Adjacents,1025
Pouteria_tannaense,0,0,0,NA,0
Pouteria_tarapotensis,11,3,8,Points-PointsKO-Adjacents,90
Pouteria_tarumanensis,3,3,0,Points-PointsKO-Adjacents,27
Pouteria_tenuisepala,5,1,4,Points-PointsKO-Adjacents,34
Pouteria_torta,791,648,143,Alphahull-PointsKO-Adjacents,56366
Pouteria_trigonosperma,5,0,5,Points-PointsKO-Adjacents,45
Pouteria_trilocularis,109,55,54,Alphahull-PointsKO-Adjacents,3697
Pouteria_triplarifolia,7,0,7,Points-PointsKO-Adjacents,54
Pouteria_ucuqui,23,12,11,Points-PointsKO-Adjacents,162
Pouteria_undulatifolia,0,0,0,NA,0
Pouteria_unmackiana,61,44,17,Alphahull-PointsKO-Adjacents,958
Pouteria_validinervis,0,0,0,NA,0
Pouteria_venosa,285,176,109,Alphahull-PointsKO-Adjacents,19195
Pouteria_vernicosa,27,11,16,Points-PointsKO-Adjacents,163
Pouteria_virescens,21,8,13,Points-PointsKO-Adjacents,150
Pouteria_viridis,82,63,19,Alphahull-PointsKO-Adjacents,783
Pouteria_williamii,8,0,8,Points-PointsKO-Adjacents,57
Boehmeria_australis,33,16,17,Points-PointsKO-Adjacents,46
Pouzolzia_formicaria,47,28,19,Alphahull-PointsKO-Adjacents,1713
Pouzolzia_mandrarensis,2,2,0,Points-PointsKO-Adjacents,12
Pouzolzia_mixta,140,16,124,Points-PointsKO-Adjacents,1135
Pouzolzia_obliqua,93,44,49,Alphahull-PointsKO-Adjacents,3289
Pouzolzia_occidentalis,174,109,65,Alphahull-PointsKO-Adjacents,4910
Pouzolzia_poeppigiana,55,29,26,Alphahull-PointsKO-Adjacents,359
Boehmeria_rugulosa,9,0,9,Points-PointsKO-Adjacents,79
Povedadaphne_quadriporata,21,15,6,Points-PointsKO-Adjacents,60
Pradosia_argentea,4,4,0,Points-PointsKO-Adjacents,36
Pradosia_atroviolacea,23,3,20,Points-PointsKO-Adjacents,192
Pradosia_beardii,52,34,18,Alphahull-PointsKO-Adjacents,1006
Pradosia_caracasana,71,54,17,Alphahull-PointsKO-Adjacents,3269
Pradosia_cochlearia,39,13,26,Points-PointsKO-Adjacents,256
Pradosia_colombiana,67,52,15,Alphahull-PointsKO-Adjacents,1317
Pradosia_cuatrecasasii,6,0,6,Points-PointsKO-Adjacents,53
Pradosia_decipiens,7,0,7,Points-PointsKO-Adjacents,49
Pradosia_glaziovii,7,0,7,Points-PointsKO-Adjacents,63
Pradosia_granulosa,31,16,15,Points-PointsKO-Adjacents,264
Pradosia_grisebachii,9,2,7,Points-PointsKO-Adjacents,76
Pradosia_huberi,10,1,9,Points-PointsKO-Adjacents,90
Pradosia_kuhlmannii,8,1,7,Points-PointsKO-Adjacents,66
Pradosia_lactescens,369,295,74,Alphahull-PointsKO-Adjacents,3743
Pradosia_montana,15,8,7,Points-PointsKO-Adjacents,102
Pradosia_mutisii,5,5,0,Points-PointsKO-Adjacents,45
Pradosia_ptychandra,18,11,7,Points-PointsKO-Adjacents,117
Pradosia_schomburgkiana,245,194,51,Alphahull-PointsKO-Adjacents,14329
Pradosia_spinosa,6,2,4,Points-PointsKO-Adjacents,38
Pradosia_subverticillata,15,0,15,Points-PointsKO-Adjacents,121
Pradosia_surinamensis,87,54,33,Alphahull-PointsKO-Adjacents,7741
Pradosia_verrucosa,7,0,7,Points-PointsKO-Adjacents,60
Pradosia_verticillata,7,1,6,Points-PointsKO-Adjacents,51
Prainea_limpato,17,4,13,Points-PointsKO-Adjacents,141
Praravinia_bullata,3,3,0,Points-PointsKO-Adjacents,21
Praravinia_cauliflora,NA,NA,NA,NA,NA
Praravinia_celebica,1,1,0,Points-PointsKO-Adjacents,9
Praravinia_chalcotricha,4,4,0,Points-PointsKO-Adjacents,36
Praravinia_coriacea,2,2,0,Points-PointsKO-Adjacents,18
Praravinia_creaghii,4,3,1,Points-PointsKO-Adjacents,30
Praravinia_densiflora,0,0,0,NA,0
Praravinia_hallieri,2,2,0,Points-PointsKO-Adjacents,18
Praravinia_havilandii,3,3,0,Points-PointsKO-Adjacents,27
Praravinia_hexamera,4,4,0,Points-PointsKO-Adjacents,32
Praravinia_loconensis,2,2,0,Points-PointsKO-Adjacents,18
Praravinia_megistocalyx,2,2,0,Points-PointsKO-Adjacents,9
Praravinia_minahassae,2,2,0,Points-PointsKO-Adjacents,18
Praravinia_mollis,4,4,0,Points-PointsKO-Adjacents,36
Praravinia_montana,NA,NA,NA,NA,NA
Praravinia_neriifolia,0,0,0,NA,0
Praravinia_oresitropha,3,3,0,Points-PointsKO-Adjacents,21
Praravinia_parviflora,1,1,0,Points-PointsKO-Adjacents,9
Praravinia_polymera,2,2,0,Points-PointsKO-Adjacents,18
Praravinia_robusta,NA,NA,NA,NA,NA
Praravinia_sablanensis,2,2,0,Points-PointsKO-Adjacents,12
Praravinia_sarawacensis,NA,NA,NA,NA,NA
Praravinia_sericotricha,5,5,0,Points-PointsKO-Adjacents,30
Praravinia_suberosa,9,5,4,Points-PointsKO-Adjacents,76
Praravinia_subtomentosa,3,3,0,Points-PointsKO-Adjacents,24
Praravinia_teysmannii,0,0,0,NA,0
Praravinia_urophylloides,0,0,0,NA,0
Praravinia_verruculosa,4,4,0,Points-PointsKO-Adjacents,36
Premna_acuminata,1002,952,50,Alphahull-PointsKO-Adjacents,13562
Premna_amplectens,0,0,0,NA,0
Premna_angolensis,155,104,51,Alphahull-PointsKO-Adjacents,2027
Premna_aureolepidota,0,0,0,NA,0
Premna_barbata,3,3,0,Points-PointsKO-Adjacents,26
Premna_bengalensis,1,1,0,Points-PointsKO-Adjacents,9
Premna_bracteata,2,1,1,Points-PointsKO-Adjacents,18
Premna_cavaleriei,16,6,10,Points-PointsKO-Adjacents,144
Premna_chevalieri,3,3,0,Points-PointsKO-Adjacents,27
Premna_chrysoclada,47,32,15,Alphahull-PointsKO-Adjacents,328
Premna_confinis,0,0,0,NA,0
Premna_debiana,NA,NA,NA,NA,NA
Premna_decaryi,4,4,0,Points-PointsKO-Adjacents,27
Premna_discolor,7,2,5,Points-PointsKO-Adjacents,41
Premna_fohaiensis,1,1,0,Points-PointsKO-Adjacents,9
Premna_fulva,12,5,7,Points-PointsKO-Adjacents,108
Premna_guillauminii,0,0,0,NA,0
Premna_hans-joachimii,5,5,0,Points-PointsKO-Adjacents,41
Premna_hildebrandtii,26,14,12,Points-PointsKO-Adjacents,200
Premna_hispida,59,37,22,Alphahull-PointsKO-Adjacents,2631
Premna_humbertii,14,11,3,Points-PointsKO-Adjacents,70
Premna_hutchinsonii,6,1,5,Points-PointsKO-Adjacents,46
Premna_interrupta,16,4,12,Points-PointsKO-Adjacents,112
Premna_khasiana,NA,NA,NA,NA,NA
Premna_lepidella,8,0,8,Points-PointsKO-Adjacents,66
Premna_longiacuminata,4,4,0,Points-PointsKO-Adjacents,30
Premna_maclurei,0,0,0,NA,0
Premna_madagascariensis,5,5,0,Points-PointsKO-Adjacents,36
Premna_maxima,2,2,0,Points-PointsKO-Adjacents,18
Premna_microphylla,233,150,83,Alphahull-PointsKO-Adjacents,9470
Premna_milleflora,0,0,0,NA,0
Premna_mollissima,7,0,7,Points-PointsKO-Adjacents,60
Premna_mooiensis,42,29,13,Alphahull-PointsKO-Adjacents,1130
Premna_oblongata,18,1,17,Points-PointsKO-Adjacents,146
Premna_odorata,59,29,30,Alphahull-PointsKO-Adjacents,1087
Premna_paisehensis,1,1,0,Points-PointsKO-Adjacents,9
Premna_pallescens,2,2,0,Points-PointsKO-Adjacents,17
Premna_parasitica,4,4,0,Points-PointsKO-Adjacents,36
Premna_perplexans,20,7,13,Points-PointsKO-Adjacents,149
Premna_protrusa,0,0,0,NA,0
Premna_puberula,58,35,23,Alphahull-PointsKO-Adjacents,3881
Premna_pubescens,4,3,1,Points-PointsKO-Adjacents,32
Premna_quadrifolia,63,0,63,Points-PointsKO-Adjacents,248
Premna_rabakensis,0,0,0,NA,0
Premna_regularis,7,0,7,Points-PointsKO-Adjacents,59
Premna_resinosa,84,35,49,Alphahull-PointsKO-Adjacents,3467
Premna_richardsiae,6,1,5,Points-PointsKO-Adjacents,31
Premna_schimperi,31,18,13,Points-PointsKO-Adjacents,139
Premna_schliebenii,9,2,7,Points-PointsKO-Adjacents,70
Premna_scoriarum,1,1,0,Points-PointsKO-Adjacents,9
Premna_senensis,41,0,41,Points-PointsKO-Adjacents,307
Premna_serratifolia,1021,689,332,Alphahull-PointsKO-Adjacents,26315
Premna_sterculiifolia,2,2,0,Points-PointsKO-Adjacents,18
Premna_sulphurea,1,1,0,Points-PointsKO-Adjacents,9
Premna_szemaoensis,8,4,4,Points-PointsKO-Adjacents,63
Premna_tahitensis,4,4,0,Points-PointsKO-Adjacents,21
Premna_tanganyikensis,4,4,0,Points-PointsKO-Adjacents,18
Premna_tomentosa,87,22,65,Alphahull-PointsKO-Adjacents,599
Premna_trichostoma,71,18,53,Points-PointsKO-Adjacents,568
Premna_velutina,0,0,0,NA,0
Premna_wightiana,NA,NA,NA,NA,NA
Prepusa_montana,40,30,10,Alphahull-PointsKO-Adjacents,109
Preslianthus_panamensis,10,7,3,Points-PointsKO-Adjacents,41
Prestoea_acuminata,615,506,109,Alphahull-PointsKO-Adjacents,10238
Prestoea_decurrens,227,191,36,Alphahull-PointsKO-Adjacents,3245
Prestoea_ensiformis,135,94,41,Alphahull-PointsKO-Adjacents,3289
Prestoea_longepetiolata,84,61,23,Alphahull-PointsKO-Adjacents,283
Prestoea_pubens,24,11,13,Points-PointsKO-Adjacents,115
Prestoea_pubigera,6,0,6,Points-PointsKO-Adjacents,20
Prestoea_schultzeana,191,153,38,Alphahull-PointsKO-Adjacents,3815
Prestoea_simplicifolia,7,4,3,Points-PointsKO-Adjacents,42
Prestoea_tenuiramosa,16,6,10,Points-PointsKO-Adjacents,105
Priogymnanthus_apertus,2,2,0,Points-PointsKO-Adjacents,18
Priogymnanthus_hasslerianus,166,128,38,Alphahull-PointsKO-Adjacents,10479
Prionostemma_aspera,224,125,99,Alphahull-PointsKO-Adjacents,16791
Prioria_balsamifera,64,35,29,Alphahull-PointsKO-Adjacents,3691
Prioria_buchholzii,69,40,29,Alphahull-PointsKO-Adjacents,2321
Prioria_copaifera,137,115,22,Alphahull-PointsKO-Adjacents,2151
Prioria_gilbertii,9,3,6,Points-PointsKO-Adjacents,59
Prioria_joveri,21,14,7,Points-PointsKO-Adjacents,125
Prioria_mannii,14,8,6,Points-PointsKO-Adjacents,106
Prioria_msoo,7,1,6,Points-PointsKO-Adjacents,45
Prioria_oxyphylla,84,51,33,Alphahull-PointsKO-Adjacents,3967
Prioria_platycarpa,0,0,0,NA,0
Prismatomeris_beccariana,33,19,14,Points-PointsKO-Adjacents,271
Prismatomeris_brachypus,2,2,0,Points-PointsKO-Adjacents,9
Prismatomeris_filamentosa,6,2,4,Points-PointsKO-Adjacents,53
Prismatomeris_fragrans,4,4,0,Points-PointsKO-Adjacents,30
Prismatomeris_glabra,3,0,3,Points-PointsKO-Adjacents,27
Prismatomeris_griffithii,3,3,0,Points-PointsKO-Adjacents,27
Prismatomeris_kinabaluensis,2,2,0,Points-PointsKO-Adjacents,12
Prismatomeris_robusta,3,3,0,Points-PointsKO-Adjacents,27
Prismatomeris_tetrandra,34,5,29,Points-PointsKO-Adjacents,290
Pristimera_andongensis,30,0,30,Points-PointsKO-Adjacents,219
Pristimera_nervosa,82,0,82,Points-PointsKO-Adjacents,612
Pritchardia_arecina,1,1,0,Points-PointsKO-Adjacents,8
Pritchardia_bakeri,2,2,0,Points-PointsKO-Adjacents,8
Pritchardia_beccariana,3,3,0,Points-PointsKO-Adjacents,24
Pritchardia_flynnii,0,0,0,NA,0
Pritchardia_forbesiana,2,2,0,Points-PointsKO-Adjacents,9
Pritchardia_glabrata,1,1,0,Points-PointsKO-Adjacents,8
Pritchardia_gordonii,NA,NA,NA,NA,NA
Pritchardia_hardyi,0,0,0,NA,0
Pritchardia_hillebrandii,3,2,1,Points-PointsKO-Adjacents,20
Pritchardia_kaalae,0,0,0,NA,0
Pritchardia_kahukuensis,1,1,0,Points-PointsKO-Adjacents,8
Pritchardia_lanigera,0,0,0,NA,0
Pritchardia_lowreyana,0,0,0,NA,0
Pritchardia_maideniana,6,0,6,Points-PointsKO-Adjacents,36
Pritchardia_martii,5,0,5,Points-PointsKO-Adjacents,20
Pritchardia_minor,1,1,0,Points-PointsKO-Adjacents,8
Pritchardia_mitiaroana,0,0,0,NA,0
Pritchardia_munroi,1,1,0,Points-PointsKO-Adjacents,9
Pritchardia_napaliensis,1,1,0,Points-PointsKO-Adjacents,6
Pritchardia_pacifica,0,0,0,NA,0
Pritchardia_perlmanii,0,0,0,NA,0
Pritchardia_remota,0,0,0,NA,0
Pritchardia_schattaueri,0,0,0,NA,0
Pritchardia_thurstonii,0,0,0,NA,0
Pritchardia_viscosa,0,0,0,NA,0
Pritchardia_vuylstekeana,1,1,0,Points-PointsKO-Adjacents,4
Pritchardia_waialealeana,2,2,0,Points-PointsKO-Adjacents,18
Pritchardia_woodii,NA,NA,NA,NA,NA
Prockia_costaricensis,19,11,8,Points-PointsKO-Adjacents,56
Prockia_crucis,1569,1302,267,Alphahull-PointsKO-Adjacents,68196
Prockia_flava,11,7,4,Points-PointsKO-Adjacents,48
Prockia_pentamera,10,3,7,Points-PointsKO-Adjacents,81
Prockiopsis_grandis,3,3,0,Points-PointsKO-Adjacents,11
Prockiopsis_hildebrandtii,25,14,11,Points-PointsKO-Adjacents,125
Prockiopsis_orientalis,2,2,0,Points-PointsKO-Adjacents,18
Prockiopsis_razakamalalae,3,3,0,Points-PointsKO-Adjacents,26
Prosopis_abbreviata,12,6,6,Points-PointsKO-Adjacents,107
Prosopis_affinis,153,124,29,Alphahull-PointsKO-Adjacents,10178
Prosopis_africana,888,830,58,Alphahull-PointsKO-Adjacents,9696
Prosopis_alba,210,174,36,Alphahull-PointsKO-Adjacents,12892
Prosopis_alpataco,27,10,17,Points-PointsKO-Adjacents,234
Prosopis_articulata,108,79,29,Alphahull-PointsKO-Adjacents,974
Prosopis_caldenia,26,13,13,Points-PointsKO-Adjacents,234
Prosopis_chilensis,359,274,85,Alphahull-PointsKO-Adjacents,16332
Prosopis_cineraria,11,2,9,Points-PointsKO-Adjacents,83
Prosopis_elata,56,37,19,Alphahull-PointsKO-Adjacents,3083
Prosopis_farcta,563,475,88,Alphahull-PointsKO-Adjacents,515
Prosopis_ferox,36,0,36,Points-PointsKO-Adjacents,254
Prosopis_fiebrigii,9,3,6,Points-PointsKO-Adjacents,72
Prosopis_flexuosa,118,60,58,Alphahull-PointsKO-Adjacents,5214
Prosopis_glandulosa,6797,6506,291,Alphahull-PointsKO-Adjacents,34297
Prosopis_globosa,2,2,0,Points-PointsKO-Adjacents,18
Prosopis_hassleri,39,24,15,Alphahull-PointsKO-Adjacents,2317
Prosopis_juliflora,781,568,213,Alphahull-PointsKO-Adjacents,28078
Prosopis_koelziana,1,1,0,Points-PointsKO-Adjacents,9
Prosopis_kuntzei,116,95,21,Alphahull-PointsKO-Adjacents,7620
Prosopis_laevigata,726,653,73,Alphahull-PointsKO-Adjacents,9225
Prosopis_nigra,198,166,32,Alphahull-PointsKO-Adjacents,13635
Prosopis_nuda,18,8,10,Points-PointsKO-Adjacents,133
Prosopis_pallida,98,72,26,Alphahull-PointsKO-Adjacents,1656
Prosopis_palmeri,78,0,78,Points-PointsKO-Adjacents,296
Prosopis_pubescens,271,217,54,Alphahull-PointsKO-Adjacents,4996
Prosopis_rojasiana,9,5,4,Points-PointsKO-Adjacents,63
Prosopis_rubriflora,31,23,8,Alphahull-PointsKO-Adjacents,514
Prosopis_ruscifolia,157,122,35,Alphahull-PointsKO-Adjacents,8879
Prosopis_sericantha,61,42,19,Alphahull-PointsKO-Adjacents,3655
Prosopis_tamarugo,29,19,10,Points-PointsKO-Adjacents,139
Prosopis_tamaulipana,34,19,15,Points-PointsKO-Adjacents,208
Prosopis_torquata,57,43,14,Alphahull-PointsKO-Adjacents,3683
Prosopis_velutina,745,694,51,Alphahull-PointsKO-Adjacents,5896
Prosopis_vinalillo,66,45,21,Alphahull-PointsKO-Adjacents,4533
Protea_angolensis,38,11,27,Points-PointsKO-Adjacents,295
Protea_aurea,74,0,74,Points-PointsKO-Adjacents,304
Protea_caffra,17,5,12,Points-PointsKO-Adjacents,79
Protea_comptonii,7,2,5,Points-PointsKO-Adjacents,51
Protea_curvata,5,5,0,Points-PointsKO-Adjacents,37
Protea_eximia,130,0,130,Points-PointsKO-Adjacents,525
Protea_flavopilosa,2,2,0,Points-PointsKO-Adjacents,14
Protea_gaguedi,136,76,60,Alphahull-PointsKO-Adjacents,2963
Protea_glabra,44,36,8,Alphahull-PointsKO-Adjacents,317
Protea_lacticolor,21,12,9,Points-PointsKO-Adjacents,114
Protea_laetans,34,21,13,Alphahull-PointsKO-Adjacents,386
Protea_lanceolata,37,25,12,Alphahull-PointsKO-Adjacents,149
Protea_laurifolia,135,120,15,Alphahull-PointsKO-Adjacents,810
Protea_lorifolia,131,115,16,Alphahull-PointsKO-Adjacents,632
Protea_madiensis,250,149,101,Alphahull-PointsKO-Adjacents,9323
Protea_mundii,79,57,22,Alphahull-PointsKO-Adjacents,480
Protea_nitida,205,173,32,Alphahull-PointsKO-Adjacents,922
Protea_obtusifolia,56,1,55,Points-PointsKO-Adjacents,198
Protea_petiolaris,18,0,18,Points-PointsKO-Adjacents,156
Protea_punctata,96,82,14,Alphahull-PointsKO-Adjacents,516
Protea_repens,277,227,50,Alphahull-PointsKO-Adjacents,1414
Protea_roupelliae,161,137,24,Alphahull-PointsKO-Adjacents,3470
Protea_rubrobracteata,8,3,5,Points-PointsKO-Adjacents,66
Protea_rubropilosa,15,8,7,Points-PointsKO-Adjacents,103
Protea_rupestris,4,4,0,Points-PointsKO-Adjacents,36
Protea_welwitschii,122,64,58,Alphahull-PointsKO-Adjacents,3130
Protium_aidanianum,17,14,3,Points-PointsKO-Adjacents,113
Protium_altsonii,331,249,82,Alphahull-PointsKO-Adjacents,40203
Protium_amazonicum,417,342,75,Alphahull-PointsKO-Adjacents,36134
Protium_amplum,50,32,18,Alphahull-PointsKO-Adjacents,736
Protium_apiculatum,399,342,57,Alphahull-PointsKO-Adjacents,33967
Protium_aracouchini,1220,1092,128,Alphahull-PointsKO-Adjacents,74425
Protium_araguense,3,3,0,Points-PointsKO-Adjacents,27
Icica_attenuata,9,3,6,Points-PointsKO-Adjacents,23
Protium_bahianum,132,83,49,Alphahull-PointsKO-Adjacents,956
Protium_beandou,26,12,14,Points-PointsKO-Adjacents,102
Protium_boomii,8,3,5,Points-PointsKO-Adjacents,54
Protium_brasiliense,224,180,44,Alphahull-PointsKO-Adjacents,7036
Protium_calanense,136,102,34,Alphahull-PointsKO-Adjacents,6332
Protium_calendulinum,89,43,46,Alphahull-PointsKO-Adjacents,6774
Protium_carana,1,1,0,Points-PointsKO-Adjacents,9
Protium_carnosum,86,45,41,Alphahull-PointsKO-Adjacents,3114
Protium_carolense,38,28,10,Alphahull-PointsKO-Adjacents,744
Protium_colombianum,57,41,16,Alphahull-PointsKO-Adjacents,1002
Protium_confusum,307,273,34,Alphahull-PointsKO-Adjacents,3984
Protium_copal,89,81,8,Alphahull-PointsKO-Adjacents,992
Protium_costaricense,149,131,18,Alphahull-PointsKO-Adjacents,836
Protium_cranipyrenum,28,16,12,Points-PointsKO-Adjacents,171
Protium_crassipetalum,211,156,55,Alphahull-PointsKO-Adjacents,18172
Protium_crenatum,71,35,36,Alphahull-PointsKO-Adjacents,4351
Protium_cubense,15,4,11,Points-PointsKO-Adjacents,87
Protium_cuneatum,67,37,30,Alphahull-PointsKO-Adjacents,1911
Protium_dawsonii,17,4,13,Points-PointsKO-Adjacents,64
Protium_decandrum,388,312,76,Alphahull-PointsKO-Adjacents,43810
Protium_demerarense,50,26,24,Alphahull-PointsKO-Adjacents,1597
Protium_divaricatum,304,235,69,Alphahull-PointsKO-Adjacents,26227
Protium_ecuadorense,67,46,21,Alphahull-PointsKO-Adjacents,740
Protium_elegans,38,17,21,Points-PointsKO-Adjacents,266
Protium_ferrugineum,195,154,41,Alphahull-PointsKO-Adjacents,18872
Protium_fragrans,2,2,0,Points-PointsKO-Adjacents,17
Protium_gallicum,11,8,3,Points-PointsKO-Adjacents,82
Protium_gallosum,156,115,41,Alphahull-PointsKO-Adjacents,9388
Protium_giganteum,203,146,57,Alphahull-PointsKO-Adjacents,18103
Protium_glabrescens,242,187,55,Alphahull-PointsKO-Adjacents,19635
Protium_glabrum,324,294,30,Alphahull-PointsKO-Adjacents,2100
Protium_glaucum,6,0,6,Points-PointsKO-Adjacents,54
Protium_grandifolium,221,150,71,Alphahull-PointsKO-Adjacents,13567
Protium_guacayanum,11,0,11,Points-PointsKO-Adjacents,75
Protium_guianense,391,301,90,Alphahull-PointsKO-Adjacents,36869
Protium_hebetatum,283,226,57,Alphahull-PointsKO-Adjacents,16203
Protium_heptaphyllum,3822,3591,231,Alphahull-PointsKO-Adjacents,129025
Protium_icicariba,165,121,44,Alphahull-PointsKO-Adjacents,1397
Protium_inodorum,5,5,0,Points-PointsKO-Adjacents,27
Protium_kleinii,141,109,32,Alphahull-PointsKO-Adjacents,961
Protium_laxiflorum,78,33,45,Alphahull-PointsKO-Adjacents,2649
Protium_leptostachyum,91,0,91,Points-PointsKO-Adjacents,686
Protium_llanorum,196,165,31,Alphahull-PointsKO-Adjacents,14316
Protium_macrocarpum,38,8,30,Points-PointsKO-Adjacents,281
Protium_macrophyllum,28,18,10,Points-PointsKO-Adjacents,181
Protium_macrosepalum,8,4,4,Points-PointsKO-Adjacents,41
Protium_madagascariense,80,57,23,Alphahull-PointsKO-Adjacents,818
Protium_melinonis,0,0,0,NA,0
Protium_meridionale,60,0,60,Points-PointsKO-Adjacents,374
Protium_minutiflorum,3,3,0,Points-PointsKO-Adjacents,25
Protium_montanum,87,71,16,Alphahull-PointsKO-Adjacents,492
Protium_morii,39,21,18,Alphahull-PointsKO-Adjacents,619
Protium_multiramiflorum,88,77,11,Alphahull-PointsKO-Adjacents,825
Protium_nitidifolium,122,78,44,Alphahull-PointsKO-Adjacents,7836
Protium_nodulosum,358,287,71,Alphahull-PointsKO-Adjacents,12452
Protium_obtusifolium,1,1,0,Points-PointsKO-Adjacents,9
Protium_occultum,25,9,16,Points-PointsKO-Adjacents,136
Protium_opacum,400,313,87,Alphahull-PointsKO-Adjacents,40458
Protium_ovatum,321,278,43,Alphahull-PointsKO-Adjacents,16507
Protium_pallidum,97,51,46,Alphahull-PointsKO-Adjacents,2065
Protium_panamense,219,192,27,Alphahull-PointsKO-Adjacents,956
Protium_paniculatum,421,370,51,Alphahull-PointsKO-Adjacents,32824
Protium_pecuniosum,46,37,9,Alphahull-PointsKO-Adjacents,86
Protium_pedicellatum,21,2,19,Points-PointsKO-Adjacents,156
Protium_pilosellum,4,4,0,Points-PointsKO-Adjacents,36
Protium_pilosissimum,226,179,47,Alphahull-PointsKO-Adjacents,26902
Protium_pilosum,70,44,26,Alphahull-PointsKO-Adjacents,2557
Protium_pittieri,96,86,10,Alphahull-PointsKO-Adjacents,535
Protium_plagiocarpium,9,6,3,Points-PointsKO-Adjacents,54
Protium_polybotryum,283,212,71,Alphahull-PointsKO-Adjacents,29008
Protium_ptarianum,5,5,0,Points-PointsKO-Adjacents,36
Protium_pullei,4,4,0,Points-PointsKO-Adjacents,34
Protium_puncticulatum,202,0,202,Points-PointsKO-Adjacents,1135
Protium_ravenii,132,0,132,Points-PointsKO-Adjacents,357
Protium_reticulatum,28,18,10,Points-PointsKO-Adjacents,209
Protium_rhynchophyllum,129,108,21,Alphahull-PointsKO-Adjacents,4541
Protium_robustum,270,207,63,Alphahull-PointsKO-Adjacents,27106
Protium_rubrum,79,41,38,Alphahull-PointsKO-Adjacents,5699
Protium_sagotianum,885,796,89,Alphahull-PointsKO-Adjacents,76328
Protium_serratum,20,0,20,Points-PointsKO-Adjacents,154
Protium_spruceanum,1080,953,127,Alphahull-PointsKO-Adjacents,84189
Protium_strumosum,93,60,33,Alphahull-PointsKO-Adjacents,2439
Protium_subserratum,383,310,73,Alphahull-PointsKO-Adjacents,34760
Protium_tenuifolium,163,131,32,Alphahull-PointsKO-Adjacents,1268
Protium_tovarense,84,61,23,Alphahull-PointsKO-Adjacents,2405
Protium_trifoliolatum,511,435,76,Alphahull-PointsKO-Adjacents,43697
Protium_unifoliolatum,764,699,65,Alphahull-PointsKO-Adjacents,61385
Protium_urophyllidium,36,11,25,Points-PointsKO-Adjacents,260
Protium_veneralense,16,9,7,Points-PointsKO-Adjacents,122
Protium_vestitum,9,4,5,Points-PointsKO-Adjacents,72
Protium_widgrenii,191,146,45,Alphahull-PointsKO-Adjacents,4181
Protium_yunnanense,1,1,0,Points-PointsKO-Adjacents,9
Protomegabaria_meiocarpa,6,0,6,Points-PointsKO-Adjacents,54
Protomegabaria_stapfiana,163,120,43,Alphahull-PointsKO-Adjacents,2078
Protorhus_longifolia,57,53,4,Alphahull-PointsKO-Adjacents,83551
Prumnopitys_andina,123,90,33,Alphahull-PointsKO-Adjacents,1446
Prumnopitys_exigua,69,0,69,Points-PointsKO-Adjacents,225
Prumnopitys_ferruginea,11680,11580,100,Alphahull-PointsKO-Adjacents,4669
Prumnopitys_ferruginoides,34,22,12,Alphahull-PointsKO-Adjacents,95
Prumnopitys_harmsiana,68,27,41,Alphahull-PointsKO-Adjacents,581
Prumnopitys_ladei,37,31,6,Alphahull-PointsKO-Adjacents,37
Prumnopitys_montana,153,108,45,Alphahull-PointsKO-Adjacents,2509
Prumnopitys_standleyi,30,26,4,Alphahull-PointsKO-Adjacents,29
Prumnopitys_taxifolia,2753,2656,97,Alphahull-PointsKO-Adjacents,4393
Prunus_accumulans,21,9,12,Points-PointsKO-Adjacents,180
Prunus_adenopoda,0,0,0,NA,0
Prunus_africana,287,188,99,Alphahull-PointsKO-Adjacents,16056
Prunus_alabamensis,58,0,58,Points-PointsKO-Adjacents,397
Prunus_alleghaniensis,37,24,13,Alphahull-PointsKO-Adjacents,411
Prunus_americana,2146,1730,416,Alphahull-PointsKO-Adjacents,64328
Prunus_amplifolia,74,41,33,Alphahull-PointsKO-Adjacents,875
Prunus_angustifolia,976,787,189,Alphahull-PointsKO-Adjacents,30335
Prunus_annularis,85,71,14,Alphahull-PointsKO-Adjacents,248
Prunus_arabica,22,0,22,Points-PointsKO-Adjacents,139
Prunus_arborea,52,22,30,Alphahull-PointsKO-Adjacents,1383
Prunus_armeniaca,761,363,398,Alphahull-PointsKO-Adjacents,23909
Prunus_avium,61592,50812,10780,Alphahull-PointsKO-Adjacents,73738
Prunus_axitliana,16,5,11,Points-PointsKO-Adjacents,90
Prunus_beccarii,4,0,4,Points-PointsKO-Adjacents,36
Prunus_bokhariensis,0,0,0,NA,0
Prunus_brachybotrya,507,450,57,Alphahull-PointsKO-Adjacents,7929
Prunus_brachypoda,30,10,20,Points-PointsKO-Adjacents,237
Prunus_bracteopadus,0,0,0,NA,0
Prunus_brasiliensis,137,100,37,Alphahull-PointsKO-Adjacents,8969
Prunus_brigantina,84,78,6,Alphahull-PointsKO-Adjacents,250
Prunus_brittoniana,42,27,15,Alphahull-PointsKO-Adjacents,156
Prunus_buergeriana,359,200,159,Alphahull-PointsKO-Adjacents,13010
Prunus_buxifolia,9,4,5,Points-PointsKO-Adjacents,60
Prunus_campanulata,198,0,198,Points-PointsKO-Adjacents,756
Prunus_caroliniana,519,333,186,Alphahull-PointsKO-Adjacents,10788
Prunus_caudata,2,1,1,Points-PointsKO-Adjacents,18
Prunus_cerasifera,187,101,86,Alphahull-PointsKO-Adjacents,6096
Prunus_cerasoides,96,61,35,Alphahull-PointsKO-Adjacents,3548
Prunus_cerasus,15320,11689,3631,Alphahull-PointsKO-Adjacents,65190
Prunus_ceylanica,0,0,0,NA,0
Prunus_chamissoana,18,4,14,Points-PointsKO-Adjacents,132
Prunus_chiapensis,3,3,0,Points-PointsKO-Adjacents,27
Prunus_choreiana,NA,NA,NA,NA,NA
Prunus_clarofolia,57,31,26,Alphahull-PointsKO-Adjacents,3099
Prunus_clementis,5,5,0,Points-PointsKO-Adjacents,41
Prunus_cocomilia,30,0,30,Points-PointsKO-Adjacents,198
Prunus_compacta,3,3,0,Points-PointsKO-Adjacents,25
Prunus_conadenia,35,24,11,Alphahull-PointsKO-Adjacents,774
Prunus_conradinae,64,38,26,Alphahull-PointsKO-Adjacents,4632
Prunus_consociiflora,8,1,7,Points-PointsKO-Adjacents,68
Prunus_cornuta,31,5,26,Points-PointsKO-Adjacents,249
Prunus_cortapico,55,29,26,Alphahull-PointsKO-Adjacents,467
Prunus_costata,24,6,18,Points-PointsKO-Adjacents,196
Prunus_crassifolia,2,2,0,Points-PointsKO-Adjacents,18
Prunus_cyclamina,10,2,8,Points-PointsKO-Adjacents,90
Prunus_davidiana,33,0,33,Points-PointsKO-Adjacents,297
Prunus_dawyckensis,0,0,0,NA,0
Prunus_debilis,238,183,55,Alphahull-PointsKO-Adjacents,5106
Prunus_detrita,17,5,12,Points-PointsKO-Adjacents,110
Prunus_dielsiana,14,1,13,Points-PointsKO-Adjacents,120
Prunus_discadenia,17,0,17,Points-PointsKO-Adjacents,135
Prunus_discoidea,2,2,0,Points-PointsKO-Adjacents,18
Prunus_dolichobotrys,57,34,23,Alphahull-PointsKO-Adjacents,1725
Prunus_domestica,18535,14966,3569,Alphahull-PointsKO-Adjacents,64817
Prunus_douglasii,2,2,0,Points-PointsKO-Adjacents,18
Prunus_emarginata,1929,1784,145,Alphahull-PointsKO-Adjacents,26999
Cerasus_x_eminens,39,0,39,Points-PointsKO-Adjacents,195
Prunus_eremophila,8,6,2,Points-PointsKO-Adjacents,15
Prunus_espinozana,2,2,0,Points-PointsKO-Adjacents,9
Prunus_fenzliana,16,11,5,Points-PointsKO-Adjacents,65
Prunus_fordiana,18,3,15,Points-PointsKO-Adjacents,128
Prunus_fortunensis,83,72,11,Alphahull-PointsKO-Adjacents,201
Prunus_fragrans,1,1,0,Points-PointsKO-Adjacents,9
Prunus_fremontii,316,295,21,Alphahull-PointsKO-Adjacents,582
Prunus_fruticosa,195,119,76,Alphahull-PointsKO-Adjacents,3283
Prunus_gazelle-peninsulae,47,31,16,Alphahull-PointsKO-Adjacents,652
Prunus_glabrifolia,1,1,0,Points-PointsKO-Adjacents,9
Prunus_grayana,669,420,249,Alphahull-PointsKO-Adjacents,5368
Prunus_grisea,98,42,56,Alphahull-PointsKO-Adjacents,1352
Prunus_guanaiensis,33,11,22,Points-PointsKO-Adjacents,279
Prunus_guatemalensis,9,4,5,Points-PointsKO-Adjacents,54
Prunus_henryi,46,30,16,Alphahull-PointsKO-Adjacents,995
Prunus_herthae,13,7,6,Points-PointsKO-Adjacents,65
Prunus_hortulana,256,169,87,Alphahull-PointsKO-Adjacents,7647
Prunus_huantensis,72,47,25,Alphahull-PointsKO-Adjacents,528
Prunus_hypotricha,17,0,17,Points-PointsKO-Adjacents,153
Prunus_ilicifolia,882,698,184,Alphahull-PointsKO-Adjacents,2091
Prunus_integrifolia,192,136,56,Alphahull-PointsKO-Adjacents,2973
Prunus_javanica,14,1,13,Points-PointsKO-Adjacents,102
Prunus_jenkinsii,6,0,6,Points-PointsKO-Adjacents,45
Prunus_kinabaluensis,0,0,0,NA,0
Prunus_lamponga,1,1,0,Points-PointsKO-Adjacents,9
Prunus_lancilimba,1,1,0,Points-PointsKO-Adjacents,9
Prunus_laurocerasus,21,13,8,Points-PointsKO-Adjacents,131
Prunus_laxinervis,2,2,0,Points-PointsKO-Adjacents,18
Prunus_ledebouriana,0,0,0,NA,0
Prunus_ligustrina,5,5,0,Points-PointsKO-Adjacents,45
Prunus_litigiosa,42,15,27,Points-PointsKO-Adjacents,338
Prunus_littlei,24,11,13,Points-PointsKO-Adjacents,195
Prunus_lundelliana,33,19,14,Points-PointsKO-Adjacents,202
Prunus_lusitanica,337,279,58,Alphahull-PointsKO-Adjacents,6476
Prunus_lyonii,148,111,37,Alphahull-PointsKO-Adjacents,256
Prunus_maackii,6,0,6,Points-PointsKO-Adjacents,54
Prunus_mahaleb,9355,7875,1480,Alphahull-PointsKO-Adjacents,45099
Prunus_malayana,0,0,0,NA,0
Prunus_mandshurica,6,1,5,Points-PointsKO-Adjacents,54
Prunus_marsupialis,6,0,6,Points-PointsKO-Adjacents,52
Prunus_maximowiczii,162,0,162,Points-PointsKO-Adjacents,616
Prunus_megacarpa,3,3,0,Points-PointsKO-Adjacents,27
Prunus_mexicana,856,652,204,Alphahull-PointsKO-Adjacents,21826
Prunus_microcarpa,31,6,25,Points-PointsKO-Adjacents,201
Prunus_mira,20,10,10,Points-PointsKO-Adjacents,162
Prunus_mirabilis,3,3,0,Points-PointsKO-Adjacents,12
Prunus_moritziana,25,11,14,Points-PointsKO-Adjacents,169
Prunus_mugus,22,16,6,Points-PointsKO-Adjacents,122
Prunus_mume,96,36,60,Alphahull-PointsKO-Adjacents,2245
Prunus_munsoniana,261,0,261,Points-PointsKO-Adjacents,1874
Prunus_muris,20,8,12,Points-PointsKO-Adjacents,153
Prunus_myrtifolia,1824,1608,216,Alphahull-PointsKO-Adjacents,28657
Prunus_napaulensis,50,21,29,Alphahull-PointsKO-Adjacents,2417
Prunus_nigra,267,0,267,Points-PointsKO-Adjacents,2057
Prunus_oblonga,8,3,5,Points-PointsKO-Adjacents,41
Prunus_obtusata,132,86,46,Alphahull-PointsKO-Adjacents,5421
Prunus_occidentalis,155,0,155,Points-PointsKO-Adjacents,866
Prunus_oleifolia,53,34,19,Alphahull-PointsKO-Adjacents,379
Prunus_oligantha,25,13,12,Points-PointsKO-Adjacents,136
Prunus_omissa,1,1,0,Points-PointsKO-Adjacents,9
Prunus_oocarpa,7,2,5,Points-PointsKO-Adjacents,44
Prunus_opaca,101,72,29,Alphahull-PointsKO-Adjacents,1981
Prunus_padus,63288,54773,8515,Alphahull-PointsKO-Adjacents,75946
Prunus_patentipila,6,1,5,Points-PointsKO-Adjacents,54
Prunus_pearcei,22,12,10,Points-PointsKO-Adjacents,100
Prunus_pensylvanica,3245,2885,360,Alphahull-PointsKO-Adjacents,63560
Prunus_persica,18,11,7,Points-PointsKO-Adjacents,151
Prunus_perulata,23,11,12,Points-PointsKO-Adjacents,183
Prunus_petunnikowii,2,2,0,Points-PointsKO-Adjacents,18
Prunus_phaeosticta,524,446,78,Alphahull-PointsKO-Adjacents,10528
Prunus_pilosiuscula,44,19,25,Points-PointsKO-Adjacents,350
Prunus_pleiantha,31,16,15,Points-PointsKO-Adjacents,150
Prunus_pleiocerasus,8,2,6,Points-PointsKO-Adjacents,72
Prunus_pleuradenia,2,2,0,Points-PointsKO-Adjacents,14
Prunus_pogonostyla,30,21,9,Alphahull-PointsKO-Adjacents,439
Prunus_polystachya,7,0,7,Points-PointsKO-Adjacents,39
Prunus_polytricha,21,6,15,Points-PointsKO-Adjacents,189
Prunus_prostrata,409,349,60,Alphahull-PointsKO-Adjacents,3106
Prunus_pseudocerasus,21,1,20,Points-PointsKO-Adjacents,189
Prunus_pulgarensis,0,0,0,NA,0
Prunus_pusilliflora,8,0,8,Points-PointsKO-Adjacents,63
Prunus_pygeoides,2,2,0,Points-PointsKO-Adjacents,18
Prunus_ramburii,257,245,12,Alphahull-PointsKO-Adjacents,148
Prunus_ravenii,4,4,0,Points-PointsKO-Adjacents,36
Prunus_rhamnoides,192,153,39,Alphahull-PointsKO-Adjacents,3340
Prunus_rigida,29,18,11,Points-PointsKO-Adjacents,247
Prunus_rotunda,25,7,18,Points-PointsKO-Adjacents,197
Prunus_rubiginosa,2,2,0,Points-PointsKO-Adjacents,17
Prunus_rufa,7,0,7,Points-PointsKO-Adjacents,57
Prunus_ruiziana,6,0,6,Points-PointsKO-Adjacents,54
Prunus_salasii,24,12,12,Points-PointsKO-Adjacents,173
Prunus_salicina,202,156,46,Alphahull-PointsKO-Adjacents,21650
Prunus_samydoides,79,62,17,Alphahull-PointsKO-Adjacents,323
Prunus_sargentii,193,146,47,Alphahull-PointsKO-Adjacents,2540
Prunus_schlechteri,68,40,28,Alphahull-PointsKO-Adjacents,1250
Prunus_schneideriana,6,0,6,Points-PointsKO-Adjacents,54
Prunus_serotina,39306,36224,3082,Alphahull-PointsKO-Adjacents,141890
Prunus_serrula,59,42,17,Alphahull-PointsKO-Adjacents,1310
Prunus_serrulata,551,321,230,Alphahull-PointsKO-Adjacents,3239
Prunus_setulosa,8,1,7,Points-PointsKO-Adjacents,72
Prunus_sibirica,10,0,10,Points-PointsKO-Adjacents,86
Prunus_simonii,0,0,0,NA,0
Prunus_sogdiana,88,30,58,Alphahull-PointsKO-Adjacents,925
Prunus_spinosa,7472,6413,1059,Alphahull-PointsKO-Adjacents,32386
Prunus_spinosissima,7,0,7,Points-PointsKO-Adjacents,54
Prunus_spinulosa,193,119,74,Alphahull-PointsKO-Adjacents,6356
Prunus_ssiori,51,28,23,Alphahull-PointsKO-Adjacents,564
Prunus_stellipila,9,0,9,Points-PointsKO-Adjacents,80
Prunus_stipulacea,7,0,7,Points-PointsKO-Adjacents,63
Prunus_stipulata,54,30,24,Alphahull-PointsKO-Adjacents,444
Prunus_subcordata,384,341,43,Alphahull-PointsKO-Adjacents,3294
Prunus_subcoriacea,93,64,29,Alphahull-PointsKO-Adjacents,5294
Prunus_subcorymbosa,67,35,32,Alphahull-PointsKO-Adjacents,984
Prunus_subglabra,2,2,0,Points-PointsKO-Adjacents,12
Prunus_subhirtella,66,8,58,Points-PointsKO-Adjacents,478
Prunus_szechuanica,7,2,5,Points-PointsKO-Adjacents,63
Prunus_tadzhikistanica,NA,NA,NA,NA,NA
Prunus_takesimensis,14,9,5,Points-PointsKO-Adjacents,6
Prunus_tartarea,4,4,0,Points-PointsKO-Adjacents,36
Prunus_tatsienensis,8,1,7,Points-PointsKO-Adjacents,62
Prunus_tenella,127,0,127,Points-PointsKO-Adjacents,822
Prunus_tetradenia,90,57,33,Alphahull-PointsKO-Adjacents,2005
Prunus_tomentosa,85,25,60,Alphahull-PointsKO-Adjacents,1349
Prunus_trichamygdalus,1,1,0,Points-PointsKO-Adjacents,9
Prunus_trichantha,1,1,0,Points-PointsKO-Adjacents,9
Prunus_trichostoma,45,33,12,Alphahull-PointsKO-Adjacents,1833
Prunus_triloba,11,0,11,Points-PointsKO-Adjacents,98
Prunus_tuberculata,12,8,4,Points-PointsKO-Adjacents,37
Prunus_tucumanensis,71,42,29,Alphahull-PointsKO-Adjacents,602
Prunus_turfosa,0,0,0,NA,0
Prunus_turneriana,153,130,23,Alphahull-PointsKO-Adjacents,492
Prunus_ulei,7,1,6,Points-PointsKO-Adjacents,61
Prunus_ulmifolia,0,0,0,NA,0
Prunus_umbellata,426,340,86,Alphahull-PointsKO-Adjacents,10740
Prunus_undulata,121,86,35,Alphahull-PointsKO-Adjacents,5708
Prunus_urotaenia,30,15,15,Points-PointsKO-Adjacents,214
Prunus_ussuriensis,3,3,0,Points-PointsKO-Adjacents,27
Prunus_velutina,9,1,8,Points-PointsKO-Adjacents,81
Prunus_venosa,100,42,58,Alphahull-PointsKO-Adjacents,1157
Prunus_virginiana,6509,5534,975,Alphahull-PointsKO-Adjacents,133828
Prunus_walkeri,0,0,0,NA,0
Prunus_wallichii,67,31,36,Alphahull-PointsKO-Adjacents,1057
Prunus_webbii,18,4,14,Points-PointsKO-Adjacents,129
Prunus_wilsonii,64,35,29,Alphahull-PointsKO-Adjacents,5234
Prunus_wurdackii,7,4,3,Points-PointsKO-Adjacents,53
Prunus_yunnanensis,37,24,13,Alphahull-PointsKO-Adjacents,1306
Prunus_zippeliana,171,90,81,Alphahull-PointsKO-Adjacents,3301
Psammisia_macrophylla,113,85,28,Alphahull-PointsKO-Adjacents,3376
Psammisia_pauciflora,36,16,20,Points-PointsKO-Adjacents,231
Psathura_batopedina,6,1,5,Points-PointsKO-Adjacents,51
Psathura_borbonica,0,0,0,NA,0
Psathura_lutescens,3,3,0,Points-PointsKO-Adjacents,12
Psathura_myriantha,4,4,0,Points-PointsKO-Adjacents,30
Psathura_sechellarum,1,1,0,Points-PointsKO-Adjacents,6
Pseudagrostistachys_africana,33,19,14,Points-PointsKO-Adjacents,161
Pseudagrostistachys_ugandensis,9,2,7,Points-PointsKO-Adjacents,75
Pseudanamomis_umbellulifera,60,37,23,Alphahull-PointsKO-Adjacents,2544
Pseudannona_grandiflora,1,1,0,Points-PointsKO-Adjacents,9
Pseudephedranthus_fragrans,8,0,8,Points-PointsKO-Adjacents,63
Pseudima_frutescens,393,302,91,Alphahull-PointsKO-Adjacents,29165
Pseudobersama_mossambicensis,47,1,46,Points-PointsKO-Adjacents,288
Pseudobombax_andicola,7,2,5,Points-PointsKO-Adjacents,63
Pseudobombax_argentinum,42,25,17,Alphahull-PointsKO-Adjacents,3333
Pseudobombax_cajamarcanus,6,2,4,Points-PointsKO-Adjacents,44
Pseudobombax_campestre,84,63,21,Alphahull-PointsKO-Adjacents,1292
Pseudobombax_crassipes,4,4,0,Points-PointsKO-Adjacents,32
Pseudobombax_croizatii,32,21,11,Alphahull-PointsKO-Adjacents,329
Pseudobombax_ellipticum,592,484,108,Alphahull-PointsKO-Adjacents,12165
Pseudobombax_grandiflorum,669,571,98,Alphahull-PointsKO-Adjacents,13699
Pseudobombax_guayasense,9,5,4,Points-PointsKO-Adjacents,34
Pseudobombax_heteromorphum,89,41,48,Alphahull-PointsKO-Adjacents,6019
Pseudobombax_longiflorum,592,531,61,Alphahull-PointsKO-Adjacents,38224
Pseudobombax_marginatum,696,625,71,Alphahull-PointsKO-Adjacents,39139
Pseudobombax_maximum,11,3,8,Points-PointsKO-Adjacents,74
Pseudobombax_millei,24,16,8,Points-PointsKO-Adjacents,149
Pseudobombax_munguba,183,135,48,Alphahull-PointsKO-Adjacents,22540
Pseudobombax_palmeri,67,35,32,Alphahull-PointsKO-Adjacents,428
Pseudobombax_pulchellum,9,4,5,Points-PointsKO-Adjacents,75
Pseudobombax_riopretensis,4,4,0,Points-PointsKO-Adjacents,30
Pseudobombax_septenatum,446,344,102,Alphahull-PointsKO-Adjacents,11583
Pseudobombax_simplicifolium,248,0,248,Points-PointsKO-Adjacents,1664
Pseudobombax_tomentosum,396,357,39,Alphahull-PointsKO-Adjacents,21710
Pseudobotrys_cauliflora,20,5,15,Points-PointsKO-Adjacents,137
Pseudobotrys_dorae,9,6,3,Points-PointsKO-Adjacents,72
Pseudocarpidium_avicennioides,4,4,0,Points-PointsKO-Adjacents,35
Pseudocarpidium_domingense,2,2,0,Points-PointsKO-Adjacents,18
Pseudocarpidium_ilicifolium,1,1,0,Points-PointsKO-Adjacents,9
Pseudocarpidium_multidens,1,1,0,Points-PointsKO-Adjacents,8
Pseudocarpidium_neglecta,NA,NA,NA,NA,NA
Pseudocarpidium_pungens,NA,NA,NA,NA,NA
Pseudocarpidium_rigens,2,2,0,Points-PointsKO-Adjacents,17
Pseudocarpidium_shaferi,0,0,0,NA,0
Pseudocarpidium_wrightii,8,1,7,Points-PointsKO-Adjacents,60
Pseudocedrela_kotschyi,673,621,52,Alphahull-PointsKO-Adjacents,4879
Pseudoclausena_chrysogyne,13,0,13,Points-PointsKO-Adjacents,113
Pseudoconnarus_rhynchosioides,18,5,13,Points-PointsKO-Adjacents,116
Pseudogynoxys_chenopodioides,685,573,112,Alphahull-PointsKO-Adjacents,11993
Pseudolachnostylis_maprouneifolia,239,164,75,Alphahull-PointsKO-Adjacents,13034
Pseudolarix_amabilis,22,5,17,Points-PointsKO-Adjacents,186
Pseudolmedia_boliviana,3,3,0,Points-PointsKO-Adjacents,27
Pseudolmedia_gentryi,10,0,10,Points-PointsKO-Adjacents,82
Pseudolmedia_glabrata,339,302,37,Alphahull-PointsKO-Adjacents,5278
Pseudolmedia_hirtula,7,0,7,Points-PointsKO-Adjacents,52
Pseudolmedia_laevigata,1268,1154,114,Alphahull-PointsKO-Adjacents,103258
Pseudolmedia_laevis,909,817,92,Alphahull-PointsKO-Adjacents,59934
Pseudolmedia_macrophylla,514,428,86,Alphahull-PointsKO-Adjacents,39909
Pseudolmedia_manabiensis,1,1,0,Points-PointsKO-Adjacents,9
Pseudolmedia_rigida,406,0,406,Points-PointsKO-Adjacents,2512
Pseudolmedia_spuria,232,176,56,Alphahull-PointsKO-Adjacents,4676
Pseudomacrolobium_mengei,2,2,0,Points-PointsKO-Adjacents,18
Pseudomalmea_boyacana,8,4,4,Points-PointsKO-Adjacents,54
Pseudomalmea_diclina,40,19,21,Points-PointsKO-Adjacents,340
Pseudomalmea_wingfieldii,4,4,0,Points-PointsKO-Adjacents,25
Pseudomantalania_macrophylla,7,3,4,Points-PointsKO-Adjacents,35
Pseudomiltemia_davidsonii,5,5,0,Points-PointsKO-Adjacents,24
Pseudomorus_brunoniana,172,137,35,Alphahull-PointsKO-Adjacents,1534
Pseudomussaenda_mozambicensis,1,1,0,Points-PointsKO-Adjacents,9
Pseudopachystela_oyemensis,2,2,0,Points-PointsKO-Adjacents,18
Pseudopanax_chathamicus,25,19,6,Points-PointsKO-Adjacents,43
Pseudopanax_crassifolius,9961,9843,118,Alphahull-PointsKO-Adjacents,4664
Pseudopanax_discolor,193,0,193,Points-PointsKO-Adjacents,133
Pseudopanax_ferox,328,292,36,Alphahull-PointsKO-Adjacents,3161
Pseudopanax_gilliesii,20,17,3,Points-PointsKO-Adjacents,29
Pseudopanax_lessonii,213,162,51,Alphahull-PointsKO-Adjacents,1486
Pseudophoenix_ekmanii,1,1,0,Points-PointsKO-Adjacents,9
Pseudophoenix_lediniana,1,1,0,Points-PointsKO-Adjacents,9
Pseudophoenix_sargentii,50,16,34,Points-PointsKO-Adjacents,312
Pseudophoenix_vinifera,7,5,2,Points-PointsKO-Adjacents,38
Pseudophyllanthus_ovalis,64,36,28,Alphahull-PointsKO-Adjacents,1039
Pseudopilocereus_tuberculatus,45,33,12,Alphahull-PointsKO-Adjacents,830
Pseudopiptadenia_bahiana,85,71,14,Alphahull-PointsKO-Adjacents,1662
Pseudopiptadenia_brenanii,180,164,16,Alphahull-PointsKO-Adjacents,2214
Pseudopiptadenia_colombiana,0,0,0,NA,0
Pseudopiptadenia_contorta,537,467,70,Alphahull-PointsKO-Adjacents,9692
Pseudopiptadenia_inaequalis,54,37,17,Alphahull-PointsKO-Adjacents,546
Pseudopiptadenia_leptostachya,128,0,128,Points-PointsKO-Adjacents,753
Pseudopiptadenia_pittieri,23,8,15,Points-PointsKO-Adjacents,178
Pseudopiptadenia_psilostachya,220,137,83,Alphahull-PointsKO-Adjacents,17904
Pseudopiptadenia_schumanniana,44,0,44,Points-PointsKO-Adjacents,214
Pseudopiptadenia_suaveolens,295,198,97,Alphahull-PointsKO-Adjacents,24263
Pseudopiptadenia_warmingii,164,133,31,Alphahull-PointsKO-Adjacents,5097
Pseudoprosopis_bampsiana,5,5,0,Points-PointsKO-Adjacents,45
Pseudoprosopis_euryphylla,21,12,9,Points-PointsKO-Adjacents,104
Pseudoprosopis_fischeri,11,2,9,Points-PointsKO-Adjacents,69
Pseudopteris_ankaranensis,17,12,5,Points-PointsKO-Adjacents,58
Pseudopteris_arborea,6,1,5,Points-PointsKO-Adjacents,42
Pseudosalacia_streyi,6,3,3,Points-PointsKO-Adjacents,33
Pseudosamanea_cubana,1,1,0,Points-PointsKO-Adjacents,9
Pseudosamanea_guachapele,348,272,76,Alphahull-PointsKO-Adjacents,11687
Pseudoscolopia_polyantha,12,5,7,Points-PointsKO-Adjacents,73
Pseudosenefeldera_inclinata,31,6,25,Points-PointsKO-Adjacents,250
Pseudosindora_palustris,0,0,0,NA,0
Pseudosmodingium_multifolium,210,184,26,Alphahull-PointsKO-Adjacents,1257
Pseudosmodingium_perniciosum,118,96,22,Alphahull-PointsKO-Adjacents,1589
Pseudospondias_longifolia,40,19,21,Points-PointsKO-Adjacents,244
Pseudospondias_microcarpa,373,283,90,Alphahull-PointsKO-Adjacents,14150
Pseudotsuga_japonica,9,2,7,Points-PointsKO-Adjacents,60
Pseudotsuga_macrocarpa,329,306,23,Alphahull-PointsKO-Adjacents,689
Pseudotsuga_menziesii,26340,25939,401,Alphahull-PointsKO-Adjacents,52287
Pseudotsuga_sinensis,98,71,27,Alphahull-PointsKO-Adjacents,1794
Pseudoweinmannia_apetala,54,43,11,Alphahull-PointsKO-Adjacents,152
Pseudoweinmannia_lachnocarpa,170,143,27,Alphahull-PointsKO-Adjacents,454
Pseudowintera_axillaris,2469,2424,45,Alphahull-PointsKO-Adjacents,2441
Pseudoxandra_acreana,9,3,6,Points-PointsKO-Adjacents,77
Pseudoxandra_bahiensis,60,47,13,Alphahull-PointsKO-Adjacents,294
Pseudoxandra_borbensis,3,3,0,Points-PointsKO-Adjacents,27
Pseudoxandra_cauliflora,11,4,7,Points-PointsKO-Adjacents,96
Pseudoxandra_cuspidata,59,30,29,Alphahull-PointsKO-Adjacents,2358
Pseudoxandra_duckei,6,0,6,Points-PointsKO-Adjacents,48
Pseudoxandra_leiophylla,72,0,72,Points-PointsKO-Adjacents,505
Pseudoxandra_lucida,148,86,62,Alphahull-PointsKO-Adjacents,11749
Pseudoxandra_obscurinervis,30,22,8,Alphahull-PointsKO-Adjacents,601
Pseudoxandra_pacifica,22,11,11,Points-PointsKO-Adjacents,120
Pseudoxandra_papillosa,8,3,5,Points-PointsKO-Adjacents,50
Pseudoxandra_parvifolia,3,3,0,Points-PointsKO-Adjacents,15
Pseudoxandra_pilosa,2,2,0,Points-PointsKO-Adjacents,18
Pseudoxandra_polyphleba,251,183,68,Alphahull-PointsKO-Adjacents,34491
Pseudoxandra_rionegrensis,13,5,8,Points-PointsKO-Adjacents,117
Pseudoxandra_sclerocarpa,22,16,6,Points-PointsKO-Adjacents,67
Pseudoxandra_spiritus-sancti,14,0,14,Points-PointsKO-Adjacents,16
Pseudoxandra_williamsii,0,0,0,NA,0
Pseuduvaria_borneensis,1,1,0,Points-PointsKO-Adjacents,9
Pseuduvaria_bruneiensis,2,2,0,Points-PointsKO-Adjacents,12
Pseuduvaria_calliura,0,0,0,NA,0
Pseuduvaria_froggattii,43,36,7,Alphahull-PointsKO-Adjacents,82
Pseuduvaria_hyadena,NA,NA,NA,NA,NA
Pseuduvaria_macrophylla,8,2,6,Points-PointsKO-Adjacents,59
Mitrephora_multiovulata,3,3,0,Points-PointsKO-Adjacents,27
Pseuduvaria_obliqua,1,1,0,Points-PointsKO-Adjacents,9
Pseuduvaria_pamattonis,3,3,0,Points-PointsKO-Adjacents,26
Pseuduvaria_parvipetala,4,4,0,Points-PointsKO-Adjacents,33
Craibella_phuyensis,3,3,0,Points-PointsKO-Adjacents,15
Pseuduvaria_prainii,0,0,0,NA,0
Pseuduvaria_reticulata,15,2,13,Points-PointsKO-Adjacents,119
Pseuduvaria_rugosa,21,0,21,Points-PointsKO-Adjacents,166
Pseuduvaria_setosa,12,4,8,Points-PointsKO-Adjacents,105
Pseuduvaria_trimera,6,2,4,Points-PointsKO-Adjacents,53
Psiadia_altissima,57,37,20,Alphahull-PointsKO-Adjacents,2402
Psiadia_dentata,4,3,1,Points-PointsKO-Adjacents,21
Psiadia_laurifolia,2,2,0,Points-PointsKO-Adjacents,12
Psidium_acranthum,3,2,1,Points-PointsKO-Adjacents,25
Psidium_acunae,1,1,0,Points-PointsKO-Adjacents,9
Psidium_acutangulum,659,560,99,Alphahull-PointsKO-Adjacents,81846
Psidium_albescens,3,2,1,Points-PointsKO-Adjacents,25
Psidium_amplexicaule,15,11,4,Points-PointsKO-Adjacents,70
Psidium_apiculatum,NA,NA,NA,NA,NA
Psidium_appendiculatum,173,151,22,Alphahull-PointsKO-Adjacents,7793
Psidium_araucanum,10,5,5,Points-PointsKO-Adjacents,63
Psidium_arboreum,2,2,0,Points-PointsKO-Adjacents,18
Psidium_australe,207,136,71,Alphahull-PointsKO-Adjacents,13392
Psidium_bahianum,37,17,20,Points-PointsKO-Adjacents,184
Psidium_brownianum,314,277,37,Alphahull-PointsKO-Adjacents,5690
Psidium_calyptranthoides,3,3,0,Points-PointsKO-Adjacents,18
Psidium_canum,10,2,8,Points-PointsKO-Adjacents,78
Psidium_cattleianum,1022,779,243,Alphahull-PointsKO-Adjacents,15240
Psidium_cauliflorum,12,6,6,Points-PointsKO-Adjacents,48
Psidium_claraense,2,2,0,Points-PointsKO-Adjacents,17
Psidium_densicomum,215,158,57,Alphahull-PointsKO-Adjacents,20881
Psidium_dictyophyllum,5,5,0,Points-PointsKO-Adjacents,31
Psidium_donianum,4,4,0,Points-PointsKO-Adjacents,36
Psidium_dumetorum,NA,NA,NA,NA,NA
Psidium_friedrichsthalianum,106,56,50,Alphahull-PointsKO-Adjacents,2822
Psidium_fulvum,4,4,0,Points-PointsKO-Adjacents,36
Psidium_galapagaeum,0,0,0,NA,0
Psidium_giganteum,4,4,0,Points-PointsKO-Adjacents,36
Psidium_grandifolium,278,216,62,Alphahull-PointsKO-Adjacents,14841
Psidium_guajava,4432,3550,882,Alphahull-PointsKO-Adjacents,137686
Psidium_guineense,2499,2179,320,Alphahull-PointsKO-Adjacents,105228
Psidium_guyanense,161,77,84,Alphahull-PointsKO-Adjacents,2571
Psidium_harrisianum,1,1,0,Points-PointsKO-Adjacents,9
Psidium_hians,19,1,18,Points-PointsKO-Adjacents,165
Psidium_hotteanum,1,1,0,Points-PointsKO-Adjacents,7
Psidium_huanucoense,5,5,0,Points-PointsKO-Adjacents,45
Psidium_inaequilaterum,NA,NA,NA,NA,NA
Psidium_itanareense,0,0,0,NA,0
Psidium_kennedyanum,33,1,32,Points-PointsKO-Adjacents,251
Psidium_langsdorffii,NA,NA,NA,NA,NA
Psidium_longipetiolatum,77,47,30,Alphahull-PointsKO-Adjacents,1534
Psidium_maribense,35,0,35,Points-PointsKO-Adjacents,275
Psidium_minutifolium,1,1,0,Points-PointsKO-Adjacents,8
Psidium_montanum,2,1,1,Points-PointsKO-Adjacents,14
Psidium_myrsinites,531,469,62,Alphahull-PointsKO-Adjacents,19793
Psidium_myrtoides,366,313,53,Alphahull-PointsKO-Adjacents,19301
Psidium_oblongatum,47,39,8,Alphahull-PointsKO-Adjacents,911
Psidium_oligospermum,473,376,97,Alphahull-PointsKO-Adjacents,17288
Psidium_orbifolium,2,2,0,Points-PointsKO-Adjacents,17
Psidium_ovale,101,67,34,Alphahull-PointsKO-Adjacents,1540
Psidium_parvifolium,7,3,4,Points-PointsKO-Adjacents,49
Psidium_pedicellatum,1,1,0,Points-PointsKO-Adjacents,9
Psidium_reversum,1,1,0,Points-PointsKO-Adjacents,8
Psidium_robustum,24,0,24,Points-PointsKO-Adjacents,189
Psidium_rostratum,4,4,0,Points-PointsKO-Adjacents,30
Psidium_rufum,430,376,54,Alphahull-PointsKO-Adjacents,11531
Psidium_rutidocarpum,5,5,0,Points-PointsKO-Adjacents,45
Psidium_salutare,522,367,155,Alphahull-PointsKO-Adjacents,27325
Psidium_sartorianum,994,774,220,Alphahull-PointsKO-Adjacents,52785
Psidium_schenckianum,280,246,34,Alphahull-PointsKO-Adjacents,3874
Psidium_scopulorum,4,4,0,Points-PointsKO-Adjacents,29
Psidium_sessilifolium,2,2,0,Points-PointsKO-Adjacents,17
Psidium_sintenisii,3,1,2,Points-PointsKO-Adjacents,16
Psidium_striatulum,170,77,93,Alphahull-PointsKO-Adjacents,7571
Psidium_subrostrifolium,NA,NA,NA,NA,NA
Psidium_tenuirame,1,1,0,Points-PointsKO-Adjacents,9
Psidium_trilobum,0,0,0,NA,0
Psidium_ubatubense,NA,NA,NA,NA,NA
Psiloxylon_mauritianum,3,2,1,Points-PointsKO-Adjacents,18
Psoralea_affinis,84,58,26,Alphahull-PointsKO-Adjacents,529
Psoralea_angustifolia,18,4,14,Points-PointsKO-Adjacents,161
Psoralea_arborea,58,28,30,Alphahull-PointsKO-Adjacents,340
Psoralea_odoratissima,24,18,6,Points-PointsKO-Adjacents,84
Psoralea_pinnata,346,190,156,Alphahull-PointsKO-Adjacents,4372
Psoralea_tenuifolia,17,12,5,Points-PointsKO-Adjacents,133
Psorospermum_alternifolium,45,30,15,Alphahull-PointsKO-Adjacents,1410
Psorospermum_atrorufum,3,3,0,Points-PointsKO-Adjacents,27
Psorospermum_aurantiacum,14,8,6,Points-PointsKO-Adjacents,68
Psorospermum_baumii,17,1,16,Points-PointsKO-Adjacents,135
Psorospermum_brachypodum,13,0,13,Points-PointsKO-Adjacents,82
Psorospermum_bullatum,0,0,0,NA,0
Psorospermum_cerasifolium,55,39,16,Alphahull-PointsKO-Adjacents,1557
Psorospermum_cornifolium,1,1,0,Points-PointsKO-Adjacents,9
Psorospermum_corymbiferum,108,0,108,Points-PointsKO-Adjacents,646
Psorospermum_densipunctatum,9,3,6,Points-PointsKO-Adjacents,61
Psorospermum_febrifugum,361,245,116,Alphahull-PointsKO-Adjacents,27843
Psorospermum_sexlineatum,0,0,0,NA,0
Psorospermum_staudtii,39,24,15,Alphahull-PointsKO-Adjacents,689
Psorospermum_tenuifolium,102,68,34,Alphahull-PointsKO-Adjacents,2762
Psorothamnus_spinosus,433,0,433,Points-PointsKO-Adjacents,881
Psychotria_abdita,4,4,0,Points-PointsKO-Adjacents,36
Psychotria_acreana,40,0,40,Points-PointsKO-Adjacents,320
Psychotria_adamsonii,NA,NA,NA,NA,NA
Psychotria_adenophylla,16,3,13,Points-PointsKO-Adjacents,138
Psychotria_aguilarii,7,1,6,Points-PointsKO-Adjacents,60
Psychotria_alabatensis,1,1,0,Points-PointsKO-Adjacents,9
Psychotria_alaotrensis,3,2,1,Points-PointsKO-Adjacents,18
Psychotria_alba,51,16,35,Points-PointsKO-Adjacents,390
Psychotria_allenii,163,127,36,Alphahull-PointsKO-Adjacents,3026
Psychotria_alpestris,0,0,0,NA,0
Psychotria_alsophila,20,13,7,Points-PointsKO-Adjacents,76
Psychotria_altiplanensis,2,2,0,Points-PointsKO-Adjacents,18
Psychotria_amoena,1,1,0,Points-PointsKO-Adjacents,3
Psychotria_ampullacea,0,0,0,NA,0
Psychotria_anamallayana,0,0,0,NA,0
Psychotria_anceps,84,35,49,Alphahull-PointsKO-Adjacents,4584
Psychotria_andapae,5,1,4,Points-PointsKO-Adjacents,15
Psychotria_aneityensis,21,11,10,Points-PointsKO-Adjacents,101
Psychotria_angulata,1,1,0,Points-PointsKO-Adjacents,8
Psychotria_angustiflora,99,76,23,Alphahull-PointsKO-Adjacents,518
Psychotria_araiosantha,NA,NA,NA,NA,NA
Psychotria_ararum,5,4,1,Points-PointsKO-Adjacents,33
Psychotria_arborea,1,1,0,Points-PointsKO-Adjacents,8
Psychotria_arborescens,2,2,0,Points-PointsKO-Adjacents,14
Psychotria_arbuscula,0,0,0,NA,0
Psychotria_archboldiana,0,0,0,NA,0
Psychotria_archboldii,5,5,0,Points-PointsKO-Adjacents,43
Psychotria_areolata,7,2,5,Points-PointsKO-Adjacents,50
Psychotria_argantha,0,0,0,NA,0
Psychotria_articulata,80,60,20,Alphahull-PointsKO-Adjacents,2185
Psychotria_aschersoniana,48,31,17,Alphahull-PointsKO-Adjacents,1544
Psychotria_asiatica,447,358,89,Alphahull-PointsKO-Adjacents,689
Psychotria_atricaulis,2,2,0,Points-PointsKO-Adjacents,4
Psychotria_aurantibractea,23,17,6,Points-PointsKO-Adjacents,79
Psychotria_aurantiocarpa,0,0,0,NA,0
Psychotria_aurea,1,1,0,Points-PointsKO-Adjacents,9
Psychotria_aviculoides,48,0,48,Points-PointsKO-Adjacents,169
Psychotria_axilliflora,0,0,0,NA,0
Psychotria_azuensis,0,0,0,NA,0
Psychotria_bagshawei,8,0,8,Points-PointsKO-Adjacents,68
Psychotria_bakeri,3,3,0,Points-PointsKO-Adjacents,27
Psychotria_baltenweckii,6,2,4,Points-PointsKO-Adjacents,32
Psychotria_banahaensis,1,1,0,Points-PointsKO-Adjacents,7
Psychotria_bangueyensis,0,0,0,NA,0
Psychotria_bayombongensis,0,0,0,NA,0
Psychotria_beddomei,1,1,0,Points-PointsKO-Adjacents,9
Psychotria_bernardii,0,0,0,NA,0
Psychotria_bertieroides,124,94,30,Alphahull-PointsKO-Adjacents,7003
Psychotria_biaristata,382,327,55,Alphahull-PointsKO-Adjacents,5822
Psychotria_bidentata,41,32,9,Alphahull-PointsKO-Adjacents,1175
Psychotria_bimbiensis,11,4,7,Points-PointsKO-Adjacents,42
Psychotria_blepharophora,9,1,8,Points-PointsKO-Adjacents,81
Psychotria_boholensis,1,1,0,Points-PointsKO-Adjacents,9
Psychotria_bolivarensis,24,0,24,Points-PointsKO-Adjacents,162
Psychotria_bontocensis,0,0,0,NA,0
Psychotria_borjensis,25,0,25,Points-PointsKO-Adjacents,195
Psychotria_botryocephala,7,1,6,Points-PointsKO-Adjacents,45
Psychotria_boyanii,1,1,0,Points-PointsKO-Adjacents,9
Psychotria_brachythrix,0,0,0,NA,0
Psychotria_brackenridgei,1,1,0,Points-PointsKO-Adjacents,9
Psychotria_brassii,6,5,1,Points-PointsKO-Adjacents,43
Psychotria_brazaoi,2,2,0,Points-PointsKO-Adjacents,18
Psychotria_brevicalyx,0,0,0,NA,0
Psychotria_broweri,1,1,0,Points-PointsKO-Adjacents,9
Psychotria_bryonicola,0,0,0,NA,0
Psychotria_buchii,0,0,0,NA,0
Psychotria_buchtienii,414,330,84,Alphahull-PointsKO-Adjacents,9987
Psychotria_bugoyensis,17,12,5,Points-PointsKO-Adjacents,94
Psychotria_burkillii,NA,NA,NA,NA,NA
Psychotria_butibumensis,2,0,2,Points-PointsKO-Adjacents,15
Psychotria_caerulea,352,289,63,Alphahull-PointsKO-Adjacents,8114
Psychotria_calophylla,52,33,19,Alphahull-PointsKO-Adjacents,263
Psychotria_calycosa,0,0,0,NA,0
Psychotria_campyloneura,72,26,46,Alphahull-PointsKO-Adjacents,6588
Psychotria_canescens,2,2,0,Points-PointsKO-Adjacents,18
Psychotria_capensis,227,148,79,Alphahull-PointsKO-Adjacents,6586
Psychotria_capitata,930,752,178,Alphahull-PointsKO-Adjacents,47934
Psychotria_carnosocarpa,2,2,0,Points-PointsKO-Adjacents,18
Psychotria_carthagenensis,1789,1572,217,Alphahull-PointsKO-Adjacents,71517
Psychotria_cascajalensis,5,4,1,Points-PointsKO-Adjacents,36
Psychotria_castroi,0,0,0,NA,0
Psychotria_catanduaniensis,NA,NA,NA,NA,NA
Psychotria_catetensis,2,2,0,Points-PointsKO-Adjacents,18
Psychotria_cathetoneura,0,0,0,NA,0
Psychotria_celebica,14,8,6,Points-PointsKO-Adjacents,54
Psychotria_cephalophora,15,12,3,Points-PointsKO-Adjacents,6
Psychotria_cernua,NA,NA,NA,NA,NA
Psychotria_ceronii,8,0,8,Points-PointsKO-Adjacents,64
Psychotria_chagrensis,195,154,41,Alphahull-PointsKO-Adjacents,1997
Psychotria_chalconeura,33,10,23,Points-PointsKO-Adjacents,233
Psychotria_cheathamiana,0,0,0,NA,0
Psychotria_chimboracensis,10,5,5,Points-PointsKO-Adjacents,81
Psychotria_chlorobotrya,16,12,4,Points-PointsKO-Adjacents,78
Psychotria_chlorocalyx,0,0,0,NA,0
Psychotria_chocoana,3,3,0,Points-PointsKO-Adjacents,24
Psychotria_chonantha,6,1,5,Points-PointsKO-Adjacents,24
Psychotria_chrysantha,18,6,12,Points-PointsKO-Adjacents,138
Psychotria_chrysanthoides,1,1,0,Points-PointsKO-Adjacents,9
Psychotria_chrysocarpa,1,1,0,Points-PointsKO-Adjacents,9
Psychotria_clarendonensis,1,1,0,Points-PointsKO-Adjacents,9
Psychotria_clivorum,46,24,22,Alphahull-PointsKO-Adjacents,443
Psychotria_closterocarpa,3,3,0,Points-PointsKO-Adjacents,18
Psychotria_clusioides,1,1,0,Points-PointsKO-Adjacents,9
Psychotria_cocosensis,6,2,4,Points-PointsKO-Adjacents,2
Psychotria_coelocalyx,1,1,0,Points-PointsKO-Adjacents,7
Psychotria_collina,46,33,13,Alphahull-PointsKO-Adjacents,223
Psychotria_confertiloba,1,1,0,Points-PointsKO-Adjacents,9
Psychotria_congesta,4,4,0,Points-PointsKO-Adjacents,27
Psychotria_conglobata,0,0,0,NA,0
Psychotria_conjugens,1,0,1,Points-PointsKO-Adjacents,9
Psychotria_connata,0,0,0,NA,0
Psychotria_convergens,33,16,17,Points-PointsKO-Adjacents,192
Psychotria_cookei,0,0,0,NA,0
Psychotria_cooperi,165,139,26,Alphahull-PointsKO-Adjacents,3029
Psychotria_cordata,0,0,0,NA,0
Psychotria_cordatula,0,0,0,NA,0
Psychotria_cornejoi,16,6,10,Points-PointsKO-Adjacents,116
Psychotria_correae,70,51,19,Alphahull-PointsKO-Adjacents,621
Psychotria_costivenia,557,504,53,Alphahull-PointsKO-Adjacents,5502
Psychotria_costularia,7,0,7,Points-PointsKO-Adjacents,63
Psychotria_crassiflora,1,1,0,Points-PointsKO-Adjacents,9
Psychotria_crassifolia,1,1,0,Points-PointsKO-Adjacents,9
Psychotria_crassipedunculata,5,5,0,Points-PointsKO-Adjacents,44
Psychotria_crassipetala,8,4,4,Points-PointsKO-Adjacents,31
Psychotria_crispipila,3,3,0,Points-PointsKO-Adjacents,21
Psychotria_croceovenosa,11,5,6,Points-PointsKO-Adjacents,55
Psychotria_cuatrecasasii,8,4,4,Points-PointsKO-Adjacents,55
Psychotria_cupularis,128,81,47,Alphahull-PointsKO-Adjacents,2215
Psychotria_cyanopharynx,145,101,44,Alphahull-PointsKO-Adjacents,17678
Psychotria_cyathicalyx,34,25,9,Alphahull-PointsKO-Adjacents,166
Psychotria_cyclophylla,0,0,0,NA,0
Psychotria_dalzellii,0,0,0,NA,0
Psychotria_damasiana,5,5,0,Points-PointsKO-Adjacents,36
Psychotria_dasyophthalma,0,0,0,NA,0
Psychotria_defretesiana,1,1,0,Points-PointsKO-Adjacents,9
Psychotria_deneversii,2,2,0,Points-PointsKO-Adjacents,12
Psychotria_densinervia,35,29,6,Alphahull-PointsKO-Adjacents,408
Psychotria_dermatophylla,66,49,17,Alphahull-PointsKO-Adjacents,1903
Psychotria_deverdiana,1,1,0,Points-PointsKO-Adjacents,8
Psychotria_diegoae,NA,NA,NA,NA,NA
Psychotria_diffusiflora,0,0,0,NA,0
Psychotria_dingalanensis,1,1,0,Points-PointsKO-Adjacents,7
Psychotria_diplococca,9,3,6,Points-PointsKO-Adjacents,64
Psychotria_dipteropodioides,5,4,1,Points-PointsKO-Adjacents,19
Psychotria_direpta,2,2,0,Points-PointsKO-Adjacents,12
Psychotria_dives,25,6,19,Points-PointsKO-Adjacents,145
Psychotria_djumaensis,82,39,43,Alphahull-PointsKO-Adjacents,6983
Psychotria_dolichocalyx,6,1,5,Points-PointsKO-Adjacents,46
Psychotria_dolichosepala,7,0,7,Points-PointsKO-Adjacents,63
Psychotria_domatiata,NA,NA,NA,NA,NA
Psychotria_dubia,0,0,0,NA,0
Psychotria_dura,3,3,0,Points-PointsKO-Adjacents,22
Psychotria_durilancifolia,11,6,5,Points-PointsKO-Adjacents,58
Psychotria_dwyeri,6,0,6,Points-PointsKO-Adjacents,39
Psychotria_egensis,76,48,28,Alphahull-PointsKO-Adjacents,3335
Psychotria_elachistantha,14,10,4,Points-PointsKO-Adjacents,53
Psychotria_embirensis,5,5,0,Points-PointsKO-Adjacents,45
Psychotria_eminiana,122,0,122,Points-PointsKO-Adjacents,801
Psychotria_ernestii,136,80,56,Alphahull-PointsKO-Adjacents,11479
Psychotria_erythrocephala,25,12,13,Points-PointsKO-Adjacents,131
Psychotria_eumorphanthus,0,0,0,NA,0
Psychotria_evansensis,0,0,0,NA,0
Psychotria_everardii,53,37,16,Alphahull-PointsKO-Adjacents,730
Psychotria_exellii,0,0,0,NA,0
Psychotria_expansa,0,0,0,NA,0
Psychotria_fanshawei,21,13,8,Points-PointsKO-Adjacents,103
Psychotria_fauriei,1,1,0,Points-PointsKO-Adjacents,8
Psychotria_fenicis,0,0,0,NA,0
Psychotria_filipes,1,1,0,Points-PointsKO-Adjacents,9
Psychotria_flava,135,105,30,Alphahull-PointsKO-Adjacents,1017
Psychotria_flavida,NA,NA,NA,NA,NA
Psychotria_flaviflora,69,45,24,Alphahull-PointsKO-Adjacents,1930
Psychotria_florencei,1,1,0,Points-PointsKO-Adjacents,9
Psychotria_fluminensis,3,3,0,Points-PointsKO-Adjacents,27
Psychotria_foetens,0,0,0,NA,0
Psychotria_foremanii,2,2,0,Points-PointsKO-Adjacents,9
Psychotria_formosa,3,3,0,Points-PointsKO-Adjacents,27
Psychotria_forsteriana,6,0,6,Points-PointsKO-Adjacents,28
Psychotria_fortuita,78,42,36,Alphahull-PointsKO-Adjacents,815
Psychotria_foxworthyi,0,0,0,NA,0
Psychotria_fractinervata,16,8,8,Points-PointsKO-Adjacents,100
Psychotria_fragrans,0,0,0,NA,0
Psychotria_frakei,0,0,0,NA,0
Psychotria_franchetiana,2,2,0,Points-PointsKO-Adjacents,12
Psychotria_frodinii,2,2,0,Points-PointsKO-Adjacents,18
Psychotria_fuertesii,NA,NA,NA,NA,NA
Psychotria_furcans,0,0,0,NA,0
Psychotria_fusiformis,28,19,9,Points-PointsKO-Adjacents,146
Psychotria_gabonica,78,53,25,Alphahull-PointsKO-Adjacents,915
Psychotria_gaitalensis,2,2,0,Points-PointsKO-Adjacents,14
Psychotria_gallerana,10,0,10,Points-PointsKO-Adjacents,64
Psychotria_galorei,3,3,0,Points-PointsKO-Adjacents,20
Psychotria_garberiana,0,0,0,NA,0
Psychotria_gardneri,3,2,1,Points-PointsKO-Adjacents,27
Psychotria_gawadacephaelis,1,1,0,Points-PointsKO-Adjacents,9
Psychotria_gentryi,54,39,15,Alphahull-PointsKO-Adjacents,989
Psychotria_gibbsiae,1,1,0,Points-PointsKO-Adjacents,9
Psychotria_gigantopus,1,1,0,Points-PointsKO-Adjacents,9
Psychotria_gillespieana,0,0,0,NA,0
Psychotria_gilletii,88,58,30,Alphahull-PointsKO-Adjacents,10642
Psychotria_giluwensis,2,2,0,Points-PointsKO-Adjacents,14
Psychotria_gitingensis,4,4,0,Points-PointsKO-Adjacents,26
Psychotria_glabra,0,0,0,NA,0
Psychotria_glabrata,11,1,10,Points-PointsKO-Adjacents,85
Psychotria_glandulicalyx,34,17,17,Points-PointsKO-Adjacents,188
Psychotria_glandulifera,0,0,0,NA,0
Psychotria_glandulosa,0,0,0,NA,0
Psychotria_glaucifolia,35,18,17,Points-PointsKO-Adjacents,179
Psychotria_glaziovii,6,1,5,Points-PointsKO-Adjacents,45
Psychotria_globicephala,0,0,0,NA,0
Psychotria_glomerulata,258,217,41,Alphahull-PointsKO-Adjacents,2644
Psychotria_goetzei,116,0,116,Points-PointsKO-Adjacents,406
Psychotria_goldmanii,49,38,11,Alphahull-PointsKO-Adjacents,191
Psychotria_goodenoughiensis,2,2,0,Points-PointsKO-Adjacents,9
Psychotria_gracilenta,509,350,159,Alphahull-PointsKO-Adjacents,35303
Psychotria_gracilior,0,0,0,NA,0
Psychotria_gracilipes,1,1,0,Points-PointsKO-Adjacents,9
Psychotria_grandiflora,0,0,0,NA,0
Psychotria_grandis,324,247,77,Alphahull-PointsKO-Adjacents,5092
Psychotria_grandistipulata,3,3,0,Points-PointsKO-Adjacents,17
Psychotria_grantii,0,0,0,NA,0
Psychotria_greenwelliae,7,2,5,Points-PointsKO-Adjacents,12
Psychotria_griffithii,0,0,0,NA,0
Psychotria_griseifolia,1,1,0,Points-PointsKO-Adjacents,9
Psychotria_grumilia,6,2,4,Points-PointsKO-Adjacents,14
Psychotria_guaremalensis,2,2,0,Points-PointsKO-Adjacents,18
Psychotria_guerkeana,7,4,3,Points-PointsKO-Adjacents,11
Psychotria_guineensis,39,16,23,Points-PointsKO-Adjacents,201
Psychotria_gyrulosa,16,10,6,Points-PointsKO-Adjacents,69
Psychotria_haitiensis,0,0,0,NA,0
Psychotria_hamiltoniana,17,10,7,Points-PointsKO-Adjacents,55
Psychotria_hanoverensis,0,0,0,NA,0
Psychotria_hathewayi,3,2,1,Points-PointsKO-Adjacents,16
Psychotria_haumugaensis,1,1,0,Points-PointsKO-Adjacents,9
Psychotria_hawaiiensis,17,11,6,Points-PointsKO-Adjacents,72
Psychotria_hazenii,103,76,27,Alphahull-PointsKO-Adjacents,1394
Psychotria_hentyi,6,1,5,Points-PointsKO-Adjacents,20
Psychotria_herrerana,3,3,0,Points-PointsKO-Adjacents,21
Psychotria_heterochroa,8,3,5,Points-PointsKO-Adjacents,57
Psychotria_heterophylla,1,1,0,Points-PointsKO-Adjacents,6
Psychotria_heterosticta,48,23,25,Alphahull-PointsKO-Adjacents,1184
Psychotria_hexandra,7,0,7,Points-PointsKO-Adjacents,31
Psychotria_hidalgensis,18,11,7,Points-PointsKO-Adjacents,51
Psychotria_hierniana,0,0,0,NA,0
Psychotria_hilonghilongensis,0,0,0,NA,0
Psychotria_hivaoana,2,2,0,Points-PointsKO-Adjacents,8
Psychotria_hobdyi,2,2,0,Points-PointsKO-Adjacents,8
Psychotria_hoffmannseggiana,1382,1143,239,Alphahull-PointsKO-Adjacents,101179
Psychotria_hollandiae,15,4,11,Points-PointsKO-Adjacents,124
Psychotria_holoxantha,2,2,0,Points-PointsKO-Adjacents,16
Psychotria_homalosperma,1,1,0,Points-PointsKO-Adjacents,6
Psychotria_hombroniana,19,8,11,Points-PointsKO-Adjacents,32
Psychotria_hosokawae,0,0,0,NA,0
Psychotria_humblotii,8,3,5,Points-PointsKO-Adjacents,35
Psychotria_hunteri,0,0,0,NA,0
Psychotria_hyalina,4,4,0,Points-PointsKO-Adjacents,30
Psychotria_hypargyraea,0,0,0,NA,0
Psychotria_hypochlorina,26,19,7,Points-PointsKO-Adjacents,164
Psychotria_impercepta,0,0,0,NA,0
Psychotria_imthurnii,1,1,0,Points-PointsKO-Adjacents,9
Psychotria_incompta,0,0,0,NA,0
Psychotria_ingentifolia,18,12,6,Points-PointsKO-Adjacents,137
Psychotria_insignis,1,0,1,Points-PointsKO-Adjacents,7
Psychotria_insularum,8,7,1,Points-PointsKO-Adjacents,21
Psychotria_iridensis,1,1,0,Points-PointsKO-Adjacents,9
Psychotria_irwinii,22,8,14,Points-PointsKO-Adjacents,183
Psychotria_jambosioides,106,76,30,Alphahull-PointsKO-Adjacents,1199
Psychotria_jamesoniana,5,5,0,Points-PointsKO-Adjacents,30
Psychotria_jefensis,6,0,6,Points-PointsKO-Adjacents,27
Psychotria_jervisei,34,27,7,Alphahull-PointsKO-Adjacents,104
Psychotria_jimenezii,55,45,10,Alphahull-PointsKO-Adjacents,139
Psychotria_johnsii,3,3,0,Points-PointsKO-Adjacents,12
Psychotria_juarezana,5,5,0,Points-PointsKO-Adjacents,35
Psychotria_juddii,0,0,0,NA,0
Psychotria_jugalis,0,0,0,NA,0
Psychotria_kaduana,8,1,7,Points-PointsKO-Adjacents,29
Psychotria_kahuziensis,2,2,0,Points-PointsKO-Adjacents,9
Psychotria_kaieteurensis,8,2,6,Points-PointsKO-Adjacents,30
Psychotria_kairoana,2,2,0,Points-PointsKO-Adjacents,11
Psychotria_kajewskii,1,1,0,Points-PointsKO-Adjacents,9
Psychotria_kaoensis,1,1,0,Points-PointsKO-Adjacents,8
Psychotria_karemaensis,0,0,0,NA,0
Psychotria_katikii,6,2,4,Points-PointsKO-Adjacents,33
Psychotria_kelelensis,2,2,0,Points-PointsKO-Adjacents,18
Psychotria_koroiveibaui,0,0,0,NA,0
Psychotria_kosraensis,NA,NA,NA,NA,NA
Psychotria_krukovii,3,3,0,Points-PointsKO-Adjacents,27
Psychotria_kuruvolii,0,0,0,NA,0
Psychotria_kurzii,0,0,0,NA,0
Psychotria_laciniata,40,21,19,Alphahull-PointsKO-Adjacents,289
Psychotria_lamarinensis,28,17,11,Points-PointsKO-Adjacents,134
Psychotria_lanceifolia,46,35,11,Alphahull-PointsKO-Adjacents,554
Psychotria_lancilimba,0,0,0,NA,0
Psychotria_laselvensis,14,7,7,Points-PointsKO-Adjacents,60
Psychotria_lasianthoides,3,3,0,Points-PointsKO-Adjacents,9
Psychotria_lasiophthalma,9,2,7,Points-PointsKO-Adjacents,48
Psychotria_lauracea,72,0,72,Points-PointsKO-Adjacents,398
Psychotria_laurentii,49,27,22,Alphahull-PointsKO-Adjacents,3834
Psychotria_leiocarpa,496,0,496,Points-PointsKO-Adjacents,2681
Psychotria_leiophloea,7,1,6,Points-PointsKO-Adjacents,61
Psychotria_leiophylla,1,1,0,Points-PointsKO-Adjacents,9
Psychotria_leitana,12,10,2,Points-PointsKO-Adjacents,85
Psychotria_leleana,6,2,4,Points-PointsKO-Adjacents,51
Psychotria_leleanoides,3,3,0,Points-PointsKO-Adjacents,18
Psychotria_leonardiana,6,1,5,Points-PointsKO-Adjacents,43
Psychotria_leptantha,0,0,0,NA,0
Psychotria_leptothyrsa,79,45,34,Alphahull-PointsKO-Adjacents,949
Psychotria_leucocalyx,0,0,0,NA,0
Psychotria_levis,20,4,16,Points-PointsKO-Adjacents,140
Psychotria_levuensis,0,0,0,NA,0
Psychotria_ligustrifolia,12,2,10,Points-PointsKO-Adjacents,62
Psychotria_limba,12,7,5,Points-PointsKO-Adjacents,72
Psychotria_limonensis,304,243,61,Alphahull-PointsKO-Adjacents,3580
Psychotria_linearisepala,26,9,17,Points-PointsKO-Adjacents,188
Psychotria_liogieri,15,11,4,Points-PointsKO-Adjacents,59
Psychotria_loheri,1,1,0,Points-PointsKO-Adjacents,6
Psychotria_lolokiensis,1,1,0,Points-PointsKO-Adjacents,9
Psychotria_longicuspis,353,273,80,Alphahull-PointsKO-Adjacents,16134
Psychotria_longipaniculata,1,1,0,Points-PointsKO-Adjacents,9
Psychotria_longipetiolata,1,1,0,Points-PointsKO-Adjacents,9
Psychotria_longirostris,89,60,29,Alphahull-PointsKO-Adjacents,3743
Psychotria_lorenciana,12,7,5,Points-PointsKO-Adjacents,57
Psychotria_lundellii,32,24,8,Alphahull-PointsKO-Adjacents,441
Psychotria_luteola,1,1,0,Points-PointsKO-Adjacents,9
Psychotria_luzoniensis,1,1,0,Points-PointsKO-Adjacents,9
Psychotria_macgregorii,0,0,0,NA,0
Psychotria_macrocalyx,1,1,0,Points-PointsKO-Adjacents,9
Psychotria_macrocarpa,0,0,0,NA,0
Psychotria_mafuluensis,1,1,0,Points-PointsKO-Adjacents,9
Psychotria_magnasepala,0,0,0,NA,0
Psychotria_magnifica,0,0,0,NA,0
Psychotria_magnifolia,0,0,0,NA,0
Psychotria_mahonii,126,1,125,Points-PointsKO-Adjacents,701
Psychotria_malacorrhax,NA,NA,NA,NA,NA
Psychotria_malaspinae,0,0,0,NA,0
Psychotria_malayana,1,1,0,Points-PointsKO-Adjacents,9
Psychotria_maleolens,7,4,3,Points-PointsKO-Adjacents,15
Psychotria_manillensis,22,12,10,Points-PointsKO-Adjacents,62
Psychotria_mapourioides,523,394,129,Alphahull-PointsKO-Adjacents,23470
Psychotria_marafungaensis,4,4,0,Points-PointsKO-Adjacents,30
Psychotria_marchionica,10,5,5,Points-PointsKO-Adjacents,13
Psychotria_marginata,9,0,9,Points-PointsKO-Adjacents,63
Psychotria_mariana,0,0,0,NA,0
Psychotria_maricaensis,3,2,1,Points-PointsKO-Adjacents,18
Psychotria_mariguidonensis,0,0,0,NA,0
Psychotria_mariniana,7,5,2,Points-PointsKO-Adjacents,26
Psychotria_marmeladensis,0,0,0,NA,0
Psychotria_matagalpensis,25,22,3,Alphahull-PointsKO-Adjacents,105
Psychotria_matambuaii,1,1,0,Points-PointsKO-Adjacents,9
Psychotria_mathewsii,8,0,8,Points-PointsKO-Adjacents,72
Psychotria_mauiensis,5,2,3,Points-PointsKO-Adjacents,24
Psychotria_mazaruniensis,33,22,11,Alphahull-PointsKO-Adjacents,110
Psychotria_megalocarpa,14,7,7,Points-PointsKO-Adjacents,81
Psychotria_megalopus,32,25,7,Alphahull-PointsKO-Adjacents,222
Psychotria_megistantha,17,13,4,Points-PointsKO-Adjacents,60
Psychotria_melanocarpa,2,2,0,Points-PointsKO-Adjacents,18
Psychotria_membranifolia,11,0,11,Points-PointsKO-Adjacents,96
Psychotria_mendozii,0,0,0,NA,0
Psychotria_merrilliana,0,0,0,NA,0
Psychotria_merrillii,1,0,1,Points-PointsKO-Adjacents,7
Psychotria_merrittii,0,0,0,NA,0
Psychotria_mexiae,157,121,36,Alphahull-PointsKO-Adjacents,2058
Psychotria_micralabastra,19,11,8,Points-PointsKO-Adjacents,117
Psychotria_micrantha,251,192,59,Alphahull-PointsKO-Adjacents,10309
Psychotria_microbotrys,302,216,86,Alphahull-PointsKO-Adjacents,14932
Psychotria_micrococca,19,5,14,Points-PointsKO-Adjacents,129
Psychotria_milnei,27,15,12,Points-PointsKO-Adjacents,131
Psychotria_mindanaensis,1,1,0,Points-PointsKO-Adjacents,9
Psychotria_misolensis,0,0,0,NA,0
Psychotria_molinae,10,6,4,Points-PointsKO-Adjacents,76
Psychotria_monensis,4,4,0,Points-PointsKO-Adjacents,36
Psychotria_monocarpa,0,0,0,NA,0
Psychotria_monsalveae,50,41,9,Alphahull-PointsKO-Adjacents,399
Psychotria_montana,16,0,16,Points-PointsKO-Adjacents,116
Psychotria_monteverdensis,23,17,6,Points-PointsKO-Adjacents,83
Psychotria_montivaga,45,27,18,Alphahull-PointsKO-Adjacents,585
Psychotria_mornicola,0,0,0,NA,0
Psychotria_mortoniana,49,0,49,Points-PointsKO-Adjacents,200
Psychotria_moseskemei,9,5,4,Points-PointsKO-Adjacents,56
Psychotria_mumfordiana,0,0,0,NA,0
Psychotria_muscosa,92,52,40,Alphahull-PointsKO-Adjacents,1586
Psychotria_myrmecophila,0,0,0,NA,0
Psychotria_myrsinoides,2,2,0,Points-PointsKO-Adjacents,16
Psychotria_nandarivatensis,0,0,0,NA,0
Psychotria_nanifrutex,4,1,3,Points-PointsKO-Adjacents,18
Psychotria_nautensis,29,14,15,Points-PointsKO-Adjacents,225
Psychotria_neillii,48,39,9,Alphahull-PointsKO-Adjacents,162
Psychotria_nemorosa,245,179,66,Alphahull-PointsKO-Adjacents,9269
Psychotria_nervosa,602,0,602,Points-PointsKO-Adjacents,2836
Psychotria_nesophila,374,343,31,Alphahull-PointsKO-Adjacents,2177
Psychotria_nigra,2,2,0,Points-PointsKO-Adjacents,18
Psychotria_nilgiriensis,0,0,0,NA,0
Psychotria_nossibensis,15,8,7,Points-PointsKO-Adjacents,73
Psychotria_novohiberiensis,3,3,0,Points-PointsKO-Adjacents,24
Psychotria_nubicola,7,3,4,Points-PointsKO-Adjacents,14
Psychotria_nubiphila,104,91,13,Alphahull-PointsKO-Adjacents,221
Psychotria_nuda,324,270,54,Alphahull-PointsKO-Adjacents,3652
Psychotria_nudiflora,0,0,0,NA,0
Psychotria_oblonga,41,28,13,Alphahull-PointsKO-Adjacents,533
Psychotria_octosulcata,0,0,0,NA,0
Psychotria_officinalis,275,151,124,Alphahull-PointsKO-Adjacents,10145
Psychotria_olgae,8,5,3,Points-PointsKO-Adjacents,31
Psychotria_oliveri,2,2,0,Points-PointsKO-Adjacents,5
Psychotria_oncocarpa,1,1,0,Points-PointsKO-Adjacents,9
Psychotria_oresbia,2,2,0,Points-PointsKO-Adjacents,18
Psychotria_orophila,25,16,9,Points-PointsKO-Adjacents,150
Psychotria_orosiana,84,65,19,Alphahull-PointsKO-Adjacents,247
Psychotria_orosioides,13,7,6,Points-PointsKO-Adjacents,38
Psychotria_osaensis,5,0,5,Points-PointsKO-Adjacents,9
Psychotria_ottonis,29,13,16,Points-PointsKO-Adjacents,170
Psychotria_ovatistipula,18,13,5,Points-PointsKO-Adjacents,69
Psychotria_pachyantha,0,0,0,NA,0
Psychotria_pacifica,5,5,0,Points-PointsKO-Adjacents,24
Psychotria_pakaraimensis,4,4,0,Points-PointsKO-Adjacents,18
Psychotria_pallidifolia,0,0,0,NA,0
Psychotria_paloensis,1,1,0,Points-PointsKO-Adjacents,9
Psychotria_paludicola,1,1,0,Points-PointsKO-Adjacents,9
Psychotria_panamensis,436,385,51,Alphahull-PointsKO-Adjacents,4728
Psychotria_panayensis,0,0,0,NA,0
Psychotria_pandensis,5,5,0,Points-PointsKO-Adjacents,36
Psychotria_papantlensis,60,37,23,Alphahull-PointsKO-Adjacents,929
Psychotria_paradichroa,41,33,8,Alphahull-PointsKO-Adjacents,128
Psychotria_paravillosa,23,12,11,Points-PointsKO-Adjacents,137
Psychotria_parkeri,103,92,11,Alphahull-PointsKO-Adjacents,1094
Psychotria_parvibractea,8,1,7,Points-PointsKO-Adjacents,72
Psychotria_parvistipulata,9,1,8,Points-PointsKO-Adjacents,57
Psychotria_parvula,0,0,0,NA,0
Psychotria_patentinervia,24,0,24,Points-PointsKO-Adjacents,120
Psychotria_patulinervia,0,0,0,NA,0
Psychotria_pavairiensis,0,0,0,NA,0
Psychotria_pebasensis,38,21,17,Alphahull-PointsKO-Adjacents,674
Psychotria_peduncularis,569,455,114,Alphahull-PointsKO-Adjacents,26751
Psychotria_peekeliana,NA,NA,NA,NA,NA
Psychotria_pernitida,0,0,0,NA,0
Psychotria_pervillei,1,1,0,Points-PointsKO-Adjacents,7
Psychotria_peteri,9,4,5,Points-PointsKO-Adjacents,41
Psychotria_petiolosa,0,0,0,NA,0
Psychotria_petitii,7,4,3,Points-PointsKO-Adjacents,21
Psychotria_phaeochlamys,8,4,4,Points-PointsKO-Adjacents,61
Psychotria_phaeochlamysioides,2,2,0,Points-PointsKO-Adjacents,17
Psychotria_phanerophlebia,0,0,0,NA,0
Psychotria_pichisensis,104,73,31,Alphahull-PointsKO-Adjacents,4582
Psychotria_pickeringii,4,4,0,Points-PointsKO-Adjacents,36
Psychotria_pilosa,547,0,547,Points-PointsKO-Adjacents,2020
Psychotria_pilosella,2,2,0,Points-PointsKO-Adjacents,16
Psychotria_pilulifera,0,0,0,NA,0
Psychotria_pinnatinervia,0,0,0,NA,0
Psychotria_pisonioides,14,8,6,Points-PointsKO-Adjacents,62
Psychotria_pittosporifolia,1,1,0,Points-PointsKO-Adjacents,9
Psychotria_platycocca,1,1,0,Points-PointsKO-Adjacents,9
Psychotria_platyneura,0,0,0,NA,0
Psychotria_pleeana,0,0,0,NA,0
Psychotria_pleuropoda,29,19,10,Points-PointsKO-Adjacents,153
Psychotria_plicata,1,1,0,Points-PointsKO-Adjacents,9
Psychotria_plumeriifolia,1,1,0,Points-PointsKO-Adjacents,9
Psychotria_plumieri,16,7,9,Points-PointsKO-Adjacents,111
Psychotria_plurivenia,0,0,0,NA,0
Psychotria_podantha,0,0,0,NA,0
Psychotria_potaroensis,41,36,5,Alphahull-PointsKO-Adjacents,138
Psychotria_praecox,NA,NA,NA,NA,NA
Psychotria_principensis,0,0,0,NA,0
Psychotria_prismoclavata,0,0,0,NA,0
Psychotria_pritchardii,2,2,0,Points-PointsKO-Adjacents,18
Psychotria_pseudoplatyphylla,29,16,13,Points-PointsKO-Adjacents,116
Psychotria_psychotriifolia,147,106,41,Alphahull-PointsKO-Adjacents,3026
Psychotria_psychotrioides,236,168,68,Alphahull-PointsKO-Adjacents,12787
Psychotria_pubiflora,0,0,0,NA,0
Psychotria_punctata,275,196,79,Alphahull-PointsKO-Adjacents,11015
Psychotria_pyramidata,2,2,0,Points-PointsKO-Adjacents,18
Psychotria_quadrangulata,6,3,3,Points-PointsKO-Adjacents,31
Psychotria_quisumbingiana,0,0,0,NA,0
Psychotria_racemosa,1030,861,169,Alphahull-PointsKO-Adjacents,69145
Psychotria_raivavaensis,2,2,0,Points-PointsKO-Adjacents,3
Psychotria_ramuensis,8,0,8,Points-PointsKO-Adjacents,47
Psychotria_ramulosa,3,3,0,Points-PointsKO-Adjacents,27
Psychotria_reducta,21,13,8,Points-PointsKO-Adjacents,155
Psychotria_reineckei,3,3,0,Points-PointsKO-Adjacents,12
Psychotria_remota,393,0,393,Points-PointsKO-Adjacents,2217
Psychotria_retiphlebia,27,14,13,Points-PointsKO-Adjacents,187
Psychotria_revoluta,31,6,25,Points-PointsKO-Adjacents,217
Psychotria_reynosoi,0,0,0,NA,0
Psychotria_rhinocerotis,8,0,8,Points-PointsKO-Adjacents,71
Psychotria_rhodothamna,92,65,27,Alphahull-PointsKO-Adjacents,7895
Psychotria_rhombibracteata,0,0,0,NA,0
Psychotria_rhombocarpa,3,3,0,Points-PointsKO-Adjacents,5
Psychotria_robusta,3,3,0,Points-PointsKO-Adjacents,27
Psychotria_rosella,9,4,5,Points-PointsKO-Adjacents,46
Psychotria_rosseliensis,3,3,0,Points-PointsKO-Adjacents,26
Psychotria_rostrata,4,3,1,Points-PointsKO-Adjacents,36
Psychotria_rotensis,0,0,0,NA,0
Psychotria_rubiginosa,1,1,0,Points-PointsKO-Adjacents,7
Psychotria_rufocalyx,0,0,0,NA,0
Psychotria_rufovillosa,6,1,5,Points-PointsKO-Adjacents,53
Psychotria_saidoriensis,2,2,0,Points-PointsKO-Adjacents,13
Psychotria_sanblasensis,37,29,8,Alphahull-PointsKO-Adjacents,137
Psychotria_sanchezii,6,3,3,Points-PointsKO-Adjacents,24
Psychotria_sanluisensis,0,0,0,NA,0
Psychotria_santaritensis,8,4,4,Points-PointsKO-Adjacents,47
Psychotria_sarapiquensis,73,50,23,Alphahull-PointsKO-Adjacents,452
Psychotria_sarmiensis,0,0,0,NA,0
Psychotria_scaberula,0,0,0,NA,0
Psychotria_schaeferi,2,2,0,Points-PointsKO-Adjacents,8
Psychotria_schlimii,4,4,0,Points-PointsKO-Adjacents,36
Psychotria_schmielei,0,0,0,NA,0
Psychotria_schomburgkii,13,0,13,Points-PointsKO-Adjacents,66
Psychotria_schunkei,88,51,37,Alphahull-PointsKO-Adjacents,3510
Psychotria_scitula,0,0,0,NA,0
Psychotria_sentanensis,0,0,0,NA,0
Psychotria_silhouettae,NA,NA,NA,NA,NA
Psychotria_siphonophora,1,1,0,Points-PointsKO-Adjacents,9
Psychotria_sixaolensis,20,14,6,Points-PointsKO-Adjacents,70
Psychotria_sloanei,3,3,0,Points-PointsKO-Adjacents,25
Psychotria_soejartoi,4,4,0,Points-PointsKO-Adjacents,26
Psychotria_sohmeri,0,0,0,NA,0
Psychotria_solanoides,0,0,0,NA,0
Psychotria_solitudinum,206,173,33,Alphahull-PointsKO-Adjacents,1650
Psychotria_solomonensis,0,0,0,NA,0
Psychotria_sordida,2,1,1,Points-PointsKO-Adjacents,18
Psychotria_sorsogonensis,1,1,0,Points-PointsKO-Adjacents,9
Psychotria_speciosa,0,0,0,NA,0
Psychotria_sphaerothyrsa,2,2,0,Points-PointsKO-Adjacents,18
Psychotria_srilankensis,2,1,1,Points-PointsKO-Adjacents,18
Psychotria_stellaris,51,31,20,Alphahull-PointsKO-Adjacents,228
Psychotria_stenantha,0,0,0,NA,0
Psychotria_stenocalyx,16,2,14,Points-PointsKO-Adjacents,110
Psychotria_stenostachya,247,202,45,Alphahull-PointsKO-Adjacents,9765
Psychotria_stevensiana,5,5,0,Points-PointsKO-Adjacents,34
Psychotria_stipulosa,61,18,43,Points-PointsKO-Adjacents,482
Psychotria_st-johnii,NA,NA,NA,NA,NA
Psychotria_storckii,1,1,0,Points-PointsKO-Adjacents,9
Psychotria_streimannii,1,1,0,Points-PointsKO-Adjacents,8
Psychotria_subalpina,0,0,0,NA,0
Psychotria_subsessiliflora,1,1,0,Points-PointsKO-Adjacents,9
Psychotria_subspathulata,31,0,31,Points-PointsKO-Adjacents,239
Psychotria_subundulata,68,25,43,Alphahull-PointsKO-Adjacents,2989
Psychotria_succulenta,100,19,81,Points-PointsKO-Adjacents,658
Psychotria_suerrensis,371,326,45,Alphahull-PointsKO-Adjacents,2812
Psychotria_sulitii,0,0,0,NA,0
Psychotria_surianii,NA,NA,NA,NA,NA
Psychotria_surigaoensis,1,1,0,Points-PointsKO-Adjacents,9
Psychotria_suterella,448,390,58,Alphahull-PointsKO-Adjacents,7407
Psychotria_sylvivaga,116,96,20,Alphahull-PointsKO-Adjacents,231
Psychotria_symplocifolia,2,1,1,Points-PointsKO-Adjacents,18
Psychotria_tahitensis,4,4,0,Points-PointsKO-Adjacents,18
Psychotria_taitensis,3,3,0,Points-PointsKO-Adjacents,14
Psychotria_talasensis,9,1,8,Points-PointsKO-Adjacents,70
Psychotria_tapantiensis,7,3,4,Points-PointsKO-Adjacents,34
Psychotria_tapirapecoana,1,1,0,Points-PointsKO-Adjacents,9
Psychotria_tatei,4,4,0,Points-PointsKO-Adjacents,34
Psychotria_taupotinii,2,2,0,Points-PointsKO-Adjacents,11
Psychotria_taviunensis,1,1,0,Points-PointsKO-Adjacents,9
Psychotria_tayabensis,1,1,0,Points-PointsKO-Adjacents,9
Psychotria_tenerior,164,88,76,Alphahull-PointsKO-Adjacents,2952
Psychotria_tenuicaulis,56,26,30,Alphahull-PointsKO-Adjacents,649
Psychotria_tenuifolia,479,345,134,Alphahull-PointsKO-Adjacents,9158
Psychotria_tenuipetiolata,7,1,6,Points-PointsKO-Adjacents,30
Psychotria_tenuis,0,0,0,NA,0
Psychotria_tepuiensis,50,27,23,Alphahull-PointsKO-Adjacents,1004
Psychotria_tetragonoides,0,0,0,NA,0
Psychotria_thomensis,2,2,0,Points-PointsKO-Adjacents,12
Psychotria_timonioides,0,0,0,NA,0
Psychotria_tomaniviensis,0,0,0,NA,0
Psychotria_torresiana,35,26,9,Alphahull-PointsKO-Adjacents,100
Psychotria_toviana,5,5,0,Points-PointsKO-Adjacents,11
Psychotria_transiens,44,24,20,Alphahull-PointsKO-Adjacents,405
Psychotria_trichocephala,95,58,37,Alphahull-PointsKO-Adjacents,7851
Psychotria_trichostoma,0,0,0,NA,0
Psychotria_trichotoma,419,321,98,Alphahull-PointsKO-Adjacents,13150
Psychotria_tripedunculata,0,0,0,NA,0
Psychotria_trivialis,172,129,43,Alphahull-PointsKO-Adjacents,11562
Psychotria_trujilloi,3,3,0,Points-PointsKO-Adjacents,21
Psychotria_truncata,0,0,0,NA,0
Psychotria_tsakiana,35,25,10,Alphahull-PointsKO-Adjacents,191
Psychotria_tubuaiensis,1,1,0,Points-PointsKO-Adjacents,3
Psychotria_turbinata,0,0,0,NA,0
Psychotria_turrubarensis,21,21,0,Alphahull,7851
Psychotria_uahukensis,0,0,0,NA,0
Psychotria_uapoensis,5,5,0,Points-PointsKO-Adjacents,5
Psychotria_umbellata,341,280,61,Alphahull-PointsKO-Adjacents,6686
Psychotria_uncumariana,0,0,0,NA,0
Psychotria_unicarinata,0,0,0,NA,0
Psychotria_utakwensis,1,1,0,Points-PointsKO-Adjacents,9
Psychotria_valerioana,60,45,15,Alphahull-PointsKO-Adjacents,160
Psychotria_valleculata,0,0,0,NA,0
Psychotria_vanimoensis,1,1,0,Points-PointsKO-Adjacents,8
Psychotria_vellosiana,1051,931,120,Alphahull-PointsKO-Adjacents,16414
Psychotria_venosa,79,60,19,Alphahull-PointsKO-Adjacents,1832
Psychotria_venulosa,82,47,35,Alphahull-PointsKO-Adjacents,3280
Psychotria_versteegii,0,0,0,NA,0
Psychotria_victoriae,5,2,3,Points-PointsKO-Adjacents,45
Psychotria_viridialba,1,0,1,Points-PointsKO-Adjacents,9
Psychotria_viridiflora,12,1,11,Points-PointsKO-Adjacents,99
Psychotria_viridis,274,198,76,Alphahull-PointsKO-Adjacents,11910
Psychotria_vitiensis,0,0,0,NA,0
Psychotria_vogeliana,508,429,79,Alphahull-PointsKO-Adjacents,20768
Psychotria_vomensis,0,0,0,NA,0
Psychotria_waasii,0,0,0,NA,0
Psychotria_wawrae,3,3,0,Points-PointsKO-Adjacents,12
Psychotria_weberbaueri,1,1,0,Points-PointsKO-Adjacents,9
Psychotria_weberi,0,0,0,NA,0
Psychotria_wichmannii,5,5,0,Points-PointsKO-Adjacents,36
Psychotria_woytkowskii,NA,NA,NA,NA,NA
Psychotria_xanthochlora,3,3,0,Points-PointsKO-Adjacents,18
Psychotria_yapasensis,3,3,0,Points-PointsKO-Adjacents,27
Psychotria_yaracuyensis,1,1,0,Points-PointsKO-Adjacents,9
Psychotria_yatesii,0,0,0,NA,0
Psychotria_yavitensis,2,2,0,Points-PointsKO-Adjacents,12
Psychotria_yenii,NA,NA,NA,NA,NA
Psychotria_zevallosii,3,3,0,Points-PointsKO-Adjacents,27
Psychotria_zombamontana,53,33,20,Alphahull-PointsKO-Adjacents,328
Psydrax_ammophila,95,75,20,Alphahull-PointsKO-Adjacents,7216
Psydrax_arnoldiana,39,10,29,Points-PointsKO-Adjacents,328
Psydrax_attenuata,303,241,62,Alphahull-PointsKO-Adjacents,15865
Psydrax_banksii,83,62,21,Alphahull-PointsKO-Adjacents,516
Psydrax_bridsoniana,7,0,7,Points-PointsKO-Adjacents,27
Psydrax_calcicola,0,0,0,NA,0
Psydrax_cymigera,31,11,20,Points-PointsKO-Adjacents,169
Psydrax_dicoccos,61,19,42,Points-PointsKO-Adjacents,500
Psydrax_dunlapii,28,17,11,Points-PointsKO-Adjacents,113
Psydrax_esirensis,7,1,6,Points-PointsKO-Adjacents,53
Psydrax_faulknerae,45,29,16,Alphahull-PointsKO-Adjacents,311
Psydrax_ficiformis,0,0,0,NA,0
Psydrax_forsteri,58,45,13,Alphahull-PointsKO-Adjacents,1623
Psydrax_fragrantissima,4,3,1,Points-PointsKO-Adjacents,31
Psydrax_gilletii,8,1,7,Points-PointsKO-Adjacents,63
Psydrax_graciliflora,63,41,22,Alphahull-PointsKO-Adjacents,248
Psydrax_grandifolia,0,0,0,NA,0
Psydrax_johnsonii,72,53,19,Alphahull-PointsKO-Adjacents,1442
Psydrax_kibuwae,2,2,0,Points-PointsKO-Adjacents,9
Psydrax_kingii,0,0,0,NA,0
Psydrax_lamprophylla,198,154,44,Alphahull-PointsKO-Adjacents,1341
Psydrax_latifolia,687,631,56,Alphahull-PointsKO-Adjacents,23837
Psydrax_laxiflorens,44,38,6,Alphahull-PointsKO-Adjacents,123
Psydrax_lepida,16,7,9,Points-PointsKO-Adjacents,89
Psydrax_livida,155,83,72,Alphahull-PointsKO-Adjacents,5492
Psydrax_locuples,30,16,14,Points-PointsKO-Adjacents,237
Psydrax_longipes,51,35,16,Alphahull-PointsKO-Adjacents,1104
Psydrax_lynesii,3,3,0,Points-PointsKO-Adjacents,22
Psydrax_maingayi,0,0,0,NA,0
Psydrax_manensis,7,2,5,Points-PointsKO-Adjacents,63
Psydrax_martini,1,1,0,Points-PointsKO-Adjacents,9
Psydrax_micans,16,5,11,Points-PointsKO-Adjacents,112
Psydrax_moggii,6,0,6,Points-PointsKO-Adjacents,41
Psydrax_montana,1,1,0,Points-PointsKO-Adjacents,9
Psydrax_montigena,53,44,9,Alphahull-PointsKO-Adjacents,91
Psydrax_mutimushii,8,0,8,Points-PointsKO-Adjacents,72
Psydrax_nitida,3,0,3,Points-PointsKO-Adjacents,26
Psydrax_obovata,81,45,36,Alphahull-PointsKO-Adjacents,1942
Psydrax_odorata,1675,1563,112,Alphahull-PointsKO-Adjacents,13189
Psydrax_oleifolia,488,459,29,Alphahull-PointsKO-Adjacents,8789
Psydrax_pallida,5,4,1,Points-PointsKO-Adjacents,30
Psydrax_palma,36,18,18,Points-PointsKO-Adjacents,316
Psydrax_paludosa,41,22,19,Alphahull-PointsKO-Adjacents,581
Psydrax_paradoxa,0,0,0,NA,0
Psydrax_parviflora,216,147,69,Alphahull-PointsKO-Adjacents,6253
Psydrax_pendulina,174,158,16,Alphahull-PointsKO-Adjacents,1666
Psydrax_pergracilis,0,0,0,NA,0
Psydrax_polhillii,20,13,7,Points-PointsKO-Adjacents,103
Psydrax_reticulata,29,21,8,Alphahull-PointsKO-Adjacents,78
Psydrax_richardsiae,5,5,0,Points-PointsKO-Adjacents,27
Psydrax_rigidula,81,66,15,Alphahull-PointsKO-Adjacents,3498
Psydrax_saligna,103,70,33,Alphahull-PointsKO-Adjacents,2801
Psydrax_sambiranensis,0,0,0,NA,0
Psydrax_schimperiana,97,53,44,Alphahull-PointsKO-Adjacents,3168
Psydrax_splendens,9,2,7,Points-PointsKO-Adjacents,70
Psydrax_subcordata,138,78,60,Alphahull-PointsKO-Adjacents,10490
Psydrax_suborbicularis,8,3,5,Points-PointsKO-Adjacents,35
Psydrax_tropica,40,28,12,Alphahull-PointsKO-Adjacents,149
Psydrax_umbellata,2,2,0,Points-PointsKO-Adjacents,18
Psydrax_whitei,5,5,0,Points-PointsKO-Adjacents,45
Ptaeroxylon_obliquum,131,86,45,Alphahull-PointsKO-Adjacents,3501
Ptelea_crenulata,221,194,27,Alphahull-PointsKO-Adjacents,1114
Ptelea_trifoliata,2335,1894,441,Alphahull-PointsKO-Adjacents,60327
Pteleopsis_anisoptera,25,6,19,Points-PointsKO-Adjacents,204
Pteleopsis_apetala,6,2,4,Points-PointsKO-Adjacents,47
Pteleopsis_diptera,17,4,13,Points-PointsKO-Adjacents,132
Pteleopsis_habeensis,12,4,8,Points-PointsKO-Adjacents,73
Pteleopsis_hylodendron,65,32,33,Alphahull-PointsKO-Adjacents,1827
Pteleopsis_kerstingii,5,5,0,Points-PointsKO-Adjacents,41
Pteleopsis_myrtifolia,111,71,40,Alphahull-PointsKO-Adjacents,4236
Pteleopsis_suberosa,687,658,29,Alphahull-PointsKO-Adjacents,5345
Pteleopsis_tetraptera,24,12,12,Points-PointsKO-Adjacents,152
Pteralyxia_kauaiensis,4,4,0,Points-PointsKO-Adjacents,14
Pteralyxia_laurifolia,3,3,0,Points-PointsKO-Adjacents,13
Pterandra_arborea,47,28,19,Alphahull-PointsKO-Adjacents,250
Pterandra_colombiana,10,4,6,Points-PointsKO-Adjacents,64
Pterandra_egleri,2,2,0,Points-PointsKO-Adjacents,18
Pterandra_evansii,8,1,7,Points-PointsKO-Adjacents,66
Pterandra_flavescens,4,4,0,Points-PointsKO-Adjacents,24
Pterandra_guianensis,5,4,1,Points-PointsKO-Adjacents,32
Pterandra_hirsuta,8,4,4,Points-PointsKO-Adjacents,66
Pterandra_isthmica,2,2,0,Points-PointsKO-Adjacents,18
Pterandra_mcphersonii,2,2,0,Points-PointsKO-Adjacents,16
Pterandra_sericea,14,5,9,Points-PointsKO-Adjacents,120
Pternandra_azurea,39,22,17,Alphahull-PointsKO-Adjacents,2987
Pternandra_caerulescens,18,6,12,Points-PointsKO-Adjacents,135
Pterocarpus_acapulcensis,170,114,56,Alphahull-PointsKO-Adjacents,5371
Pterocarpus_albopubescens,0,0,0,NA,0
Pterocarpus_amazonum,714,645,69,Alphahull-PointsKO-Adjacents,64108
Pterocarpus_angolensis,260,88,172,Alphahull-PointsKO-Adjacents,10462
Pterocarpus_antunesii,53,23,30,Alphahull-PointsKO-Adjacents,555
Pterocarpus_brenanii,23,6,17,Points-PointsKO-Adjacents,149
Pterocarpus_claessensii,NA,NA,NA,NA,NA
Pterocarpus_dalbergioides,0,0,0,NA,0
Ecastaphyllum_dubium,NA,NA,NA,NA,NA
Pterocarpus_echinatus,72,9,63,Points-PointsKO-Adjacents,538
Pterocarpus_erinaceus,1622,1570,52,Alphahull-PointsKO-Adjacents,10981
Pterocarpus_gilletii,NA,NA,NA,NA,NA
Pterocarpus_hockii,0,0,0,NA,0
Pterocarpus_homblei,NA,NA,NA,NA,NA
Pterocarpus_indicus,35,0,35,Points-PointsKO-Adjacents,271
Pterocarpus_lucens,142,75,67,Alphahull-PointsKO-Adjacents,3104
Pterocarpus_macrocarpus,19,6,13,Points-PointsKO-Adjacents,156
Pterocarpus_marsupium,0,0,0,NA,0
Pterocarpus_michelianus,35,23,12,Alphahull-PointsKO-Adjacents,164
Pterocarpus_mildbraedii,53,19,34,Points-PointsKO-Adjacents,334
Pterocarpus_mutondo,0,0,0,NA,0
Pterocarpus_officinalis,595,432,163,Alphahull-PointsKO-Adjacents,28297
Pterocarpus_orbiculatus,83,60,23,Alphahull-PointsKO-Adjacents,2123
Pterocarpus_osun,9,0,9,Points-PointsKO-Adjacents,79
Pterocarpus_rohrii,1162,904,258,Alphahull-PointsKO-Adjacents,64636
Pterocarpus_rotundifolius,168,126,42,Alphahull-PointsKO-Adjacents,4442
Pterocarpus_santalinoides,1110,946,164,Alphahull-PointsKO-Adjacents,90700
Pterocarpus_santalinus,0,0,0,NA,0
Pterocarpus_soyauxii,517,473,44,Alphahull-PointsKO-Adjacents,7918
Pterocarpus_ternatus,13,8,5,Points-PointsKO-Adjacents,86
Pterocarpus_tessmannii,8,0,8,Points-PointsKO-Adjacents,71
Pterocarpus_tinctorius,75,34,41,Alphahull-PointsKO-Adjacents,4408
Pterocarpus_velutinus,NA,NA,NA,NA,NA
Pterocarpus_villosus,107,84,23,Alphahull-PointsKO-Adjacents,4563
Pterocarpus_zehntneri,56,33,23,Alphahull-PointsKO-Adjacents,2885
Pterocarpus_zenkeri,0,0,0,NA,0
Pterocarya_hupehensis,19,6,13,Points-PointsKO-Adjacents,171
Pterocarya_pterocarpa,338,108,230,Alphahull-PointsKO-Adjacents,11529
Pterocarya_rhoifolia,203,156,47,Alphahull-PointsKO-Adjacents,2214
Pterocarya_stenoptera,156,94,62,Alphahull-PointsKO-Adjacents,15414
Pterocarya_tonkinensis,8,3,5,Points-PointsKO-Adjacents,72
Pterocelastrus_echinatus,112,82,30,Alphahull-PointsKO-Adjacents,2657
Pterocelastrus_galpinii,52,34,18,Alphahull-PointsKO-Adjacents,1637
Pterocelastrus_rostratus,66,1,65,Points-PointsKO-Adjacents,458
Pterocelastrus_tricuspidatus,158,134,24,Alphahull-PointsKO-Adjacents,2159
Pteroceltis_tatarinowii,58,23,35,Alphahull-PointsKO-Adjacents,4824
Pterodon_abruptus,147,120,27,Alphahull-PointsKO-Adjacents,7307
Pterodon_emarginatus,999,921,78,Alphahull-PointsKO-Adjacents,31343
Pterogyne_nitens,1050,928,122,Alphahull-PointsKO-Adjacents,37730
Pterolobium_integrum,6,0,6,Points-PointsKO-Adjacents,54
Pterospermum_acerifolium,10,1,9,Points-PointsKO-Adjacents,90
Pterospermum_heterophyllum,45,25,20,Alphahull-PointsKO-Adjacents,2785
Pterospermum_kingtungense,2,2,0,Points-PointsKO-Adjacents,18
Pterospermum_lanceifolium,2,0,2,Points-PointsKO-Adjacents,9
Pterospermum_menglunense,1,1,0,Points-PointsKO-Adjacents,9
Pterospermum_niveum,14,6,8,Points-PointsKO-Adjacents,53
Pterospermum_proteus,2,2,0,Points-PointsKO-Adjacents,18
Pterospermum_suberifolium,5,1,4,Points-PointsKO-Adjacents,45
Pterospermum_truncatolobatum,7,0,7,Points-PointsKO-Adjacents,57
Velaga_xylocarpa,3,3,0,Points-PointsKO-Adjacents,27
Pterospermum_yunnanense,1,1,0,Points-PointsKO-Adjacents,9
Pterostyrax_corymbosus,92,62,30,Alphahull-PointsKO-Adjacents,2246
Pterostyrax_psilophyllus,33,13,20,Points-PointsKO-Adjacents,296
Pterygota_alata,8,0,8,Points-PointsKO-Adjacents,63
Pterygota_amazonica,76,48,28,Alphahull-PointsKO-Adjacents,982
Pterygota_augouardii,2,2,0,Points-PointsKO-Adjacents,18
Pterygota_bequaertii,56,27,29,Alphahull-PointsKO-Adjacents,2280
Pterygota_colombiana,25,13,12,Points-PointsKO-Adjacents,179
Tetradia_horsfieldii,24,1,23,Points-PointsKO-Adjacents,159
Pterygota_macrocarpa,35,18,17,Points-PointsKO-Adjacents,286
Pterygota_madagascariensis,2,2,0,Points-PointsKO-Adjacents,18
Pterygota_mildbraedii,14,4,10,Points-PointsKO-Adjacents,110
Pterygota_perrieri,7,1,6,Points-PointsKO-Adjacents,63
Ptilochaeta_bahiensis,251,218,33,Alphahull-PointsKO-Adjacents,9692
Ptilochaeta_densiflora,32,13,19,Points-PointsKO-Adjacents,211
Ptilochaeta_glabra,72,48,24,Alphahull-PointsKO-Adjacents,4086
Ptilochaeta_nudipes,15,5,10,Points-PointsKO-Adjacents,126
Ptychococcus_lepidotus,4,4,0,Points-PointsKO-Adjacents,32
Ptychococcus_paradoxus,19,4,15,Points-PointsKO-Adjacents,141
Ptychopetalum_anceps,157,133,24,Alphahull-PointsKO-Adjacents,2127
Ptychopetalum_olacoides,107,71,36,Alphahull-PointsKO-Adjacents,5480
Ptychopetalum_petiolatum,97,81,16,Alphahull-PointsKO-Adjacents,1387
Ptychopetalum_uncinatum,7,0,7,Points-PointsKO-Adjacents,63
Ptychopyxis_arborea,4,0,4,Points-PointsKO-Adjacents,36
Ptychopyxis_bacciformis,6,3,3,Points-PointsKO-Adjacents,54
Ptychopyxis_caput-medusae,2,2,0,Points-PointsKO-Adjacents,9
Ptychopyxis_chrysantha,5,5,0,Points-PointsKO-Adjacents,38
Ptychopyxis_costata,3,1,2,Points-PointsKO-Adjacents,12
Ptychopyxis_glochidiifolia,3,0,3,Points-PointsKO-Adjacents,27
Ptychopyxis_grandis,8,2,6,Points-PointsKO-Adjacents,66
Ptychopyxis_javanica,3,3,0,Points-PointsKO-Adjacents,27
Ptychopyxis_kingii,2,2,0,Points-PointsKO-Adjacents,18
Ptychopyxis_plagiocarpa,1,1,0,Points-PointsKO-Adjacents,9
Ptychopyxis_triradiata,0,0,0,NA,0
Ptychosperma_ambiguum,1,1,0,Points-PointsKO-Adjacents,9
Ptychosperma_buabe,1,1,0,Points-PointsKO-Adjacents,9
Ptychosperma_burretianum,2,2,0,Points-PointsKO-Adjacents,11
Ptychosperma_caryotoides,7,2,5,Points-PointsKO-Adjacents,59
Ptychosperma_cuneatum,2,2,0,Points-PointsKO-Adjacents,12
Ptychosperma_elegans,90,61,29,Alphahull-PointsKO-Adjacents,513
Ptychosperma_furcatum,1,1,0,Points-PointsKO-Adjacents,8
Ptychosperma_gracile,1,1,0,Points-PointsKO-Adjacents,9
Ptychosperma_hartmannii,NA,NA,NA,NA,NA
Ptychosperma_lauterbachii,3,3,0,Points-PointsKO-Adjacents,23
Ptychosperma_lineare,3,3,0,Points-PointsKO-Adjacents,18
Ptychosperma_macarthurii,58,43,15,Alphahull-PointsKO-Adjacents,346
Ptychosperma_macrocerum,NA,NA,NA,NA,NA
Ptychosperma_mambare,1,1,0,Points-PointsKO-Adjacents,7
Ptychosperma_microcarpum,7,1,6,Points-PointsKO-Adjacents,35
Ptychosperma_mooreanum,2,2,0,Points-PointsKO-Adjacents,16
Ptychosperma_nicolai,0,0,0,NA,0
Ptychosperma_praemorsum,0,0,0,NA,0
Ptychosperma_propinquum,0,0,0,NA,0
Ptychosperma_pullenii,0,0,0,NA,0
Ptychosperma_ramosissimum,1,1,0,Points-PointsKO-Adjacents,6
Ptychosperma_rosselense,4,4,0,Points-PointsKO-Adjacents,11
Ptychosperma_salomonense,6,0,6,Points-PointsKO-Adjacents,41
Ptychosperma_sanderianum,0,0,0,NA,0
Ptychosperma_schefferi,0,0,0,NA,0
Ptychosperma_streimannii,NA,NA,NA,NA,NA
Ptychosperma_tagulense,0,0,0,NA,0
Ptychosperma_vestitum,NA,NA,NA,NA,NA
Ptychosperma_waitianum,3,3,0,Points-PointsKO-Adjacents,24
Pubistylus_andamanensis,0,0,0,NA,0
Punica_granatum,32,17,15,Points-PointsKO-Adjacents,227
Punica_protopunica,10,8,2,Points-PointsKO-Adjacents,37
Purdiaea_nutans,55,37,18,Alphahull-PointsKO-Adjacents,563
Purshia_mexicana,444,407,37,Alphahull-PointsKO-Adjacents,5628
Purshia_stansburiana,1103,1075,28,Alphahull-PointsKO-Adjacents,11016
Putranjiva_formosana,20,8,12,Points-PointsKO-Adjacents,107
Putranjiva_matsumurae,3,3,0,Points-PointsKO-Adjacents,18
Putranjiva_roxburghii,8,0,8,Points-PointsKO-Adjacents,72
Putranjiva_zeylanica,3,3,0,Points-PointsKO-Adjacents,27
Putterlickia_pyracantha,123,86,37,Alphahull-PointsKO-Adjacents,3822
Putterlickia_verrucosa,50,28,22,Alphahull-PointsKO-Adjacents,644
Pycnandra_acuminata,9,2,7,Points-PointsKO-Adjacents,54
Pycnandra_atrofusca,5,5,0,Points-PointsKO-Adjacents,28
Pycnandra_balansae,29,18,11,Points-PointsKO-Adjacents,103
Pycnandra_belepensis,5,1,4,Points-PointsKO-Adjacents,14
Pycnandra_benthamii,19,13,6,Points-PointsKO-Adjacents,81
Pycnandra_blaffartii,2,2,0,Points-PointsKO-Adjacents,13
Pycnandra_blanchonii,15,9,6,Points-PointsKO-Adjacents,57
Pycnandra_bourailensis,0,0,0,NA,0
Pycnandra_bracteolata,3,3,0,Points-PointsKO-Adjacents,10
Pycnandra_caeruleilatex,2,2,0,Points-PointsKO-Adjacents,15
Pycnandra_canaliculata,15,11,4,Points-PointsKO-Adjacents,33
Pycnandra_carinocostata,14,6,8,Points-PointsKO-Adjacents,82
Pycnandra_chartacea,5,0,5,Points-PointsKO-Adjacents,37
Pycnandra_comptonii,24,16,8,Points-PointsKO-Adjacents,70
Pycnandra_confusa,1,1,0,Points-PointsKO-Adjacents,9
Pycnandra_controversa,14,6,8,Points-PointsKO-Adjacents,54
Pycnandra_cylindricarpa,11,5,6,Points-PointsKO-Adjacents,45
Pycnandra_decandra,15,6,9,Points-PointsKO-Adjacents,75
Pycnandra_deplanchei,12,6,6,Points-PointsKO-Adjacents,55
Pycnandra_elliptica,3,3,0,Points-PointsKO-Adjacents,10
Pycnandra_fastuosa,20,10,10,Points-PointsKO-Adjacents,98
Pycnandra_francii,18,10,8,Points-PointsKO-Adjacents,75
Pycnandra_glabella,3,3,0,Points-PointsKO-Adjacents,24
Pycnandra_glaberrima,9,5,4,Points-PointsKO-Adjacents,45
Pycnandra_gordoniifolia,18,11,7,Points-PointsKO-Adjacents,70
Pycnandra_griseosepala,9,2,7,Points-PointsKO-Adjacents,56
Pycnandra_heteromera,8,5,3,Points-PointsKO-Adjacents,47
Pycnandra_kaalaensis,34,21,13,Alphahull-PointsKO-Adjacents,75
Pycnandra_longipetiolata,3,3,0,Points-PointsKO-Adjacents,14
Pycnandra_neocaledonica,8,4,4,Points-PointsKO-Adjacents,24
Pycnandra_paucinervia,3,3,0,Points-PointsKO-Adjacents,14
Pycnandra_pubiflora,6,1,5,Points-PointsKO-Adjacents,41
Pycnandra_sarlinii,6,1,5,Points-PointsKO-Adjacents,27
Pycnandra_schmidii,9,4,5,Points-PointsKO-Adjacents,40
Pycnandra_sessiliflora,7,0,7,Points-PointsKO-Adjacents,42
Pycnandra_sessilifolia,13,6,7,Points-PointsKO-Adjacents,61
Pycnandra_vieillardii,9,2,7,Points-PointsKO-Adjacents,51
Pycnandra_viridifolia,NA,NA,NA,NA,NA
Pycnanthus_angolensis,471,394,77,Alphahull-PointsKO-Adjacents,13494
Pycnanthus_marchalianus,10,3,7,Points-PointsKO-Adjacents,57
Pycnocoma_dentata,1,1,0,Points-PointsKO-Adjacents,9
Pycnocoma_littoralis,30,16,14,Points-PointsKO-Adjacents,160
Pycnocoma_macrantha,7,2,5,Points-PointsKO-Adjacents,27
Pycnocoma_macrophylla,118,86,32,Alphahull-PointsKO-Adjacents,2009
Pycnocoma_reygaertii,3,3,0,Points-PointsKO-Adjacents,27
Pycnocoma_subflava,1,1,0,Points-PointsKO-Adjacents,9
Pycnocoma_thonneri,34,21,13,Alphahull-PointsKO-Adjacents,2312
Pygeum_macrocarpum,2,2,0,Points-PointsKO-Adjacents,18
Pygeum_oblongum,2,2,0,Points-PointsKO-Adjacents,18
Pyracantha_angustifolia,67,52,15,Alphahull-PointsKO-Adjacents,1743
Pyracantha_atalantioides,59,37,22,Alphahull-PointsKO-Adjacents,2987
Pyracantha_crenulata,75,32,43,Alphahull-PointsKO-Adjacents,2609
Pyracantha_koidzumii,24,14,10,Points-PointsKO-Adjacents,142
Pyramidanthe_prismatica,14,1,13,Points-PointsKO-Adjacents,118
Pyranthus_alasoa,23,19,4,Points-PointsKO-Adjacents,111
Pyranthus_tullearensis,45,1,44,Points-PointsKO-Adjacents,166
Pyrenaria_diospyricarpa,6,0,6,Points-PointsKO-Adjacents,54
Pyrenaria_hirta,46,29,17,Alphahull-PointsKO-Adjacents,1799
Pyrenaria_jonquieriana,2,2,0,Points-PointsKO-Adjacents,18
Pyrenaria_khasiana,0,0,0,NA,0
Pyrenaria_kwangsiensis,1,1,0,Points-PointsKO-Adjacents,9
Pyrenaria_maculatoclada,NA,NA,NA,NA,NA
Pyrenaria_menglaensis,NA,NA,NA,NA,NA
Pyrenaria_microcarpa,128,101,27,Alphahull-PointsKO-Adjacents,2158
Pyrenaria_oblongicarpa,1,1,0,Points-PointsKO-Adjacents,9
Tutcheria_pahangensis,1,1,0,Points-PointsKO-Adjacents,9
Pyrenaria_pingpienensis,1,1,0,Points-PointsKO-Adjacents,9
Pyrenaria_sophiae,2,2,0,Points-PointsKO-Adjacents,18
Tutcheria_tawauensis,7,0,7,Points-PointsKO-Adjacents,57
Pyrenaria_wuana,NA,NA,NA,NA,NA
Pyrostegia_venusta,1047,703,344,Alphahull-PointsKO-Adjacents,41250
Pyrostria_affinis,27,9,18,Points-PointsKO-Adjacents,202
Pyrostria_alaotrensis,3,3,0,Points-PointsKO-Adjacents,27
Pyrostria_analamazaotrensis,14,8,6,Points-PointsKO-Adjacents,40
Pyrostria_andilanensis,20,13,7,Points-PointsKO-Adjacents,94
Pyrostria_bibracteata,33,14,19,Points-PointsKO-Adjacents,218
Pyrostria_bispathacea,0,0,0,NA,0
Pyrostria_brunnescens,NA,NA,NA,NA,NA
Pyrostria_chapmanii,5,5,0,Points-PointsKO-Adjacents,32
Pyrostria_cochinchinensis,1,1,0,Points-PointsKO-Adjacents,9
Pyrostria_commersonii,1,1,0,Points-PointsKO-Adjacents,8
Pyrostria_cordifolia,2,2,0,Points-PointsKO-Adjacents,15
Pyrostria_fasciculata,0,0,0,NA,0
Pyrostria_ferruginea,0,0,0,NA,0
Pyrostria_heliconioides,0,0,0,NA,0
Pyrostria_hystrix,24,14,10,Points-PointsKO-Adjacents,203
Pyrostria_isomonensis,4,4,0,Points-PointsKO-Adjacents,36
Pyrostria_ixorifolia,16,8,8,Points-PointsKO-Adjacents,57
Pyrostria_lobulata,5,5,0,Points-PointsKO-Adjacents,27
Pyrostria_macrophylla,0,0,0,NA,0
Pyrostria_madagascariensis,17,1,16,Points-PointsKO-Adjacents,81
Pyrostria_major,8,1,7,Points-PointsKO-Adjacents,50
Pyrostria_media,83,57,26,Alphahull-PointsKO-Adjacents,524
Pyrostria_orbicularis,1,1,0,Points-PointsKO-Adjacents,8
Pyrostria_perrieri,39,26,13,Alphahull-PointsKO-Adjacents,199
Pyrostria_phyllanthoidea,9,1,8,Points-PointsKO-Adjacents,70
Pyrostria_pseudocommersonii,2,2,0,Points-PointsKO-Adjacents,18
Pyrostria_revoluta,0,0,0,NA,0
Pyrostria_sambavensis,9,5,4,Points-PointsKO-Adjacents,47
Pyrostria_sarodranensis,7,2,5,Points-PointsKO-Adjacents,51
Pyrostria_urschii,3,3,0,Points-PointsKO-Adjacents,27
Pyrostria_variistipula,3,3,0,Points-PointsKO-Adjacents,22
Pyrostria_verdcourtii,4,4,0,Points-PointsKO-Adjacents,27
Pyrularia_edulis,41,17,24,Points-PointsKO-Adjacents,329
Pyrus_acutiserrata,NA,NA,NA,NA,NA
Pyrus_amygdaliformis,198,1,197,Points-PointsKO-Adjacents,928
Pyrus_armeniacifolia,NA,NA,NA,NA,NA
Pyrus_betulifolia,14,2,12,Points-PointsKO-Adjacents,121
Pyrus_boissieriana,4,4,0,Points-PointsKO-Adjacents,36
Pyrus_bourgaeana,909,842,67,Alphahull-PointsKO-Adjacents,4089
Pyrus_bretschneideri,12,0,12,Points-PointsKO-Adjacents,108
Pyrus_browiczii,NA,NA,NA,NA,NA
Pyrus_calleryana,741,395,346,Alphahull-PointsKO-Adjacents,37632
Pyrus_caucasica,11,7,4,Points-PointsKO-Adjacents,60
Pyrus_chosrovica,2,2,0,Points-PointsKO-Adjacents,9
Pyrus_communis,18187,15407,2780,Alphahull-PointsKO-Adjacents,53093
Pyrus_complexa,1,1,0,Points-PointsKO-Adjacents,9
Pyrus_cordata,1143,1027,116,Alphahull-PointsKO-Adjacents,7262
Pyrus_demetrii,NA,NA,NA,NA,NA
Pyrus_elaeagnifolia,18,2,16,Points-PointsKO-Adjacents,147
Pyrus_elata,0,0,0,NA,0
Pyrus_fedorovii,1,1,0,Points-PointsKO-Adjacents,9
Pyrus_georgica,0,0,0,NA,0
Pyrus_gergerana,NA,NA,NA,NA,NA
Pyrus_grossheimii,2,2,0,Points-PointsKO-Adjacents,12
Pyrus_hajastana,0,0,0,NA,0
Pyrus_hopeiensis,NA,NA,NA,NA,NA
Pyrus_hyrcana,1,1,0,Points-PointsKO-Adjacents,9
Sorbus_kachinensis,0,0,0,NA,0
Pyrus_ketzkhovelii,0,0,0,NA,0
Pyrus_korshinskyi,18,7,11,Points-PointsKO-Adjacents,57
Pyrus_medvedevii,2,2,0,Points-PointsKO-Adjacents,18
Pyrus_megrica,NA,NA,NA,NA,NA
Pyrus_nivalis,51,31,20,Alphahull-PointsKO-Adjacents,2666
Pyrus_nutans,2,2,0,Points-PointsKO-Adjacents,18
Pyrus_oxyprion,1,1,0,Points-PointsKO-Adjacents,9
Pyrus_pashia,206,163,43,Alphahull-PointsKO-Adjacents,5694
Pyrus_phaeocarpa,4,3,1,Points-PointsKO-Adjacents,36
Pyrus_pseudopashia,6,1,5,Points-PointsKO-Adjacents,51
Pyrus_pseudosyriaca,2,2,0,Points-PointsKO-Adjacents,18
Pyrus_pyrifolia,121,75,46,Alphahull-PointsKO-Adjacents,17784
Pyrus_regelii,14,3,11,Points-PointsKO-Adjacents,91
Pyrus_sachokiana,1,1,0,Points-PointsKO-Adjacents,9
Pyrus_salicifolia,42,32,10,Alphahull-PointsKO-Adjacents,1125
Pyrus_serrulata,46,23,23,Alphahull-PointsKO-Adjacents,3866
Pyrus_sinkiangensis,5,5,0,Points-PointsKO-Adjacents,45
Pyrus_sosnovskyi,0,0,0,NA,0
Pyrus_syriaca,196,170,26,Alphahull-PointsKO-Adjacents,417
Pyrus_tadshikistanica,NA,NA,NA,NA,NA
Pyrus_taiwanensis,4,3,1,Points-PointsKO-Adjacents,29
Pyrus_takhtadzhianii,2,2,0,Points-PointsKO-Adjacents,9
Pyrus_tamamschiannae,NA,NA,NA,NA,NA
Pyrus_theodorovii,NA,NA,NA,NA,NA
Pyrus_turcomanica,30,16,14,Points-PointsKO-Adjacents,88
Pyrus_ussuriensis,30,0,30,Points-PointsKO-Adjacents,262
Pyrus_voronovii,1,1,0,Points-PointsKO-Adjacents,9
Pyrus_vsevolodii,0,0,0,NA,0
Pyrus_xerophila,11,4,7,Points-PointsKO-Adjacents,99
Pyrus_zangezura,3,2,1,Points-PointsKO-Adjacents,27
Quadrella_cynophallophora,150,92,58,Alphahull-PointsKO-Adjacents,2059
Quadrella_dressleri,4,4,0,Points-PointsKO-Adjacents,30
Quadrella_ferruginea,29,14,15,Points-PointsKO-Adjacents,179
Quadrella_incana,16,6,10,Points-PointsKO-Adjacents,92
Quadrella_indica,535,379,156,Alphahull-PointsKO-Adjacents,7469
Quadrella_isthmensis,44,27,17,Alphahull-PointsKO-Adjacents,202
Quadrella_lindeniana,22,9,13,Points-PointsKO-Adjacents,127
Quadrella_morenoi,21,9,12,Points-PointsKO-Adjacents,112
Quadrella_odoratissima,345,255,90,Alphahull-PointsKO-Adjacents,7873
Quadrella_quintanarooensis,9,0,9,Points-PointsKO-Adjacents,43
Quadrella_singularis,1,1,0,Points-PointsKO-Adjacents,9
Qualea_acuminata,240,157,83,Alphahull-PointsKO-Adjacents,11873
Qualea_amapaensis,7,2,5,Points-PointsKO-Adjacents,36
Qualea_amoena,19,2,17,Points-PointsKO-Adjacents,160
Qualea_brasiliana,5,5,0,Points-PointsKO-Adjacents,41
Qualea_brevipedicellata,39,0,39,Points-PointsKO-Adjacents,248
Qualea_calantha,6,0,6,Points-PointsKO-Adjacents,54
Qualea_calophylla,11,4,7,Points-PointsKO-Adjacents,89
Qualea_coerulea,68,40,28,Alphahull-PointsKO-Adjacents,2704
Qualea_cordata,777,704,73,Alphahull-PointsKO-Adjacents,21159
Qualea_cryptantha,245,178,67,Alphahull-PointsKO-Adjacents,5791
Qualea_cyanea,6,0,6,Points-PointsKO-Adjacents,54
Qualea_cymulosa,9,2,7,Points-PointsKO-Adjacents,74
Qualea_decorticans,1,1,0,Points-PointsKO-Adjacents,9
Qualea_dichotoma,485,433,52,Alphahull-PointsKO-Adjacents,20168
Qualea_dinizii,124,66,58,Alphahull-PointsKO-Adjacents,10832
Qualea_gestasiana,59,40,19,Alphahull-PointsKO-Adjacents,985
Qualea_glaziovii,25,9,16,Points-PointsKO-Adjacents,179
Qualea_gracilior,16,2,14,Points-PointsKO-Adjacents,142
Qualea_grandiflora,1514,1399,115,Alphahull-PointsKO-Adjacents,47789
Qualea_homosepala,49,16,33,Points-PointsKO-Adjacents,376
Qualea_impexa,6,0,6,Points-PointsKO-Adjacents,54
Qualea_ingens,79,0,79,Points-PointsKO-Adjacents,628
Qualea_labouriauana,8,4,4,Points-PointsKO-Adjacents,45
Qualea_lineata,46,33,13,Alphahull-PointsKO-Adjacents,545
Qualea_lundii,5,1,4,Points-PointsKO-Adjacents,37
Qualea_macropetala,6,0,6,Points-PointsKO-Adjacents,46
Qualea_magna,13,2,11,Points-PointsKO-Adjacents,94
Qualea_megalocarpa,18,0,18,Points-PointsKO-Adjacents,133
Qualea_moriboomii,1,1,0,Points-PointsKO-Adjacents,9
Qualea_multiflora,1508,1383,125,Alphahull-PointsKO-Adjacents,40439
Qualea_nitida,1,1,0,Points-PointsKO-Adjacents,9
Qualea_panamensis,20,13,7,Points-PointsKO-Adjacents,104
Qualea_paraensis,434,322,112,Alphahull-PointsKO-Adjacents,37178
Qualea_parviflora,1563,1475,88,Alphahull-PointsKO-Adjacents,43979
Qualea_polychroma,48,30,18,Alphahull-PointsKO-Adjacents,317
Qualea_psidiifolia,27,10,17,Points-PointsKO-Adjacents,219
Qualea_pulcherrima,14,2,12,Points-PointsKO-Adjacents,126
Qualea_rosea,35,21,14,Alphahull-PointsKO-Adjacents,823
Qualea_rupicola,9,0,9,Points-PointsKO-Adjacents,75
Qualea_schomburgkiana,50,34,16,Alphahull-PointsKO-Adjacents,685
Qualea_selloi,66,32,34,Alphahull-PointsKO-Adjacents,2477
Qualea_sprucei,6,0,6,Points-PointsKO-Adjacents,41
Qualea_suprema,7,1,6,Points-PointsKO-Adjacents,63
Qualea_tessmannii,79,52,27,Alphahull-PointsKO-Adjacents,5097
Qualea_themistoclesii,2,2,0,Points-PointsKO-Adjacents,18
Qualea_tricolor,1,1,0,Points-PointsKO-Adjacents,9
Qualea_tuberculata,7,1,6,Points-PointsKO-Adjacents,50
Qualea_wurdackii,9,2,7,Points-PointsKO-Adjacents,71
Quararibea_amazonica,96,63,33,Alphahull-PointsKO-Adjacents,6990
Quararibea_aristeguietae,3,3,0,Points-PointsKO-Adjacents,27
Quararibea_asterolepis,109,90,19,Alphahull-PointsKO-Adjacents,1030
Quararibea_aurantiocalyx,4,4,0,Points-PointsKO-Adjacents,18
Quararibea_bilobata,3,3,0,Points-PointsKO-Adjacents,27
Quararibea_cacao,4,4,0,Points-PointsKO-Adjacents,36
Quararibea_caldasiana,42,19,23,Points-PointsKO-Adjacents,275
Quararibea_casasecae,6,0,6,Points-PointsKO-Adjacents,32
Quararibea_chodatii,19,11,8,Points-PointsKO-Adjacents,103
Quararibea_ciroana,11,0,11,Points-PointsKO-Adjacents,84
Quararibea_cogolloi,11,1,10,Points-PointsKO-Adjacents,88
Quararibea_costaricensis,63,51,12,Alphahull-PointsKO-Adjacents,141
Quararibea_duckei,42,0,42,Points-PointsKO-Adjacents,315
Quararibea_foenigraeca,13,8,5,Points-PointsKO-Adjacents,80
Quararibea_funebris,113,97,16,Alphahull-PointsKO-Adjacents,2149
Quararibea_gentlei,3,2,1,Points-PointsKO-Adjacents,27
Quararibea_gigantiflora,0,0,0,NA,0
Quararibea_gomeziana,18,12,6,Points-PointsKO-Adjacents,45
Quararibea_guianensis,288,218,70,Alphahull-PointsKO-Adjacents,30538
Quararibea_huallagensis,9,1,8,Points-PointsKO-Adjacents,73
Quararibea_magnifica,9,3,6,Points-PointsKO-Adjacents,74
Quararibea_martini,12,9,3,Points-PointsKO-Adjacents,82
Quararibea_obovalifolia,4,4,0,Points-PointsKO-Adjacents,36
Quararibea_parviflora,4,4,0,Points-PointsKO-Adjacents,36
Quararibea_parvifolia,52,43,9,Alphahull-PointsKO-Adjacents,225
Quararibea_pendula,9,3,6,Points-PointsKO-Adjacents,49
Quararibea_penduliflora,35,18,17,Points-PointsKO-Adjacents,221
Quararibea_platyphylla,34,14,20,Points-PointsKO-Adjacents,168
Quararibea_pterocalyx,63,40,23,Alphahull-PointsKO-Adjacents,423
Quararibea_pumila,7,1,6,Points-PointsKO-Adjacents,28
Quararibea_putumayensis,6,0,6,Points-PointsKO-Adjacents,54
Quararibea_santaritensis,4,3,1,Points-PointsKO-Adjacents,19
Quararibea_spatulata,25,7,18,Points-PointsKO-Adjacents,192
Quararibea_stenophylla,74,56,18,Alphahull-PointsKO-Adjacents,663
Quararibea_steyermarkii,2,2,0,Points-PointsKO-Adjacents,18
Quararibea_tulekunae,14,11,3,Points-PointsKO-Adjacents,104
Quararibea_turbinata,307,206,101,Alphahull-PointsKO-Adjacents,3303
Quararibea_velutina,2,2,0,Points-PointsKO-Adjacents,18
Quararibea_verticillaris,38,22,16,Alphahull-PointsKO-Adjacents,553
Quararibea_wittii,249,222,27,Alphahull-PointsKO-Adjacents,10076
Quararibea_yunckeri,8,2,6,Points-PointsKO-Adjacents,56
Quassia_amara,462,332,130,Alphahull-PointsKO-Adjacents,8926
Quassia_baileyana,45,38,7,Alphahull-PointsKO-Adjacents,64
Quassia_bidwillii,99,71,28,Alphahull-PointsKO-Adjacents,539
Quassia_borneensis,0,0,0,NA,0
Quassia_gabonensis,141,89,52,Alphahull-PointsKO-Adjacents,5375
Quassia_harmandiana,0,0,0,NA,0
Quassia_indica,73,18,55,Points-PointsKO-Adjacents,403
Quassia_sanguinea,18,12,6,Points-PointsKO-Adjacents,52
Quassia_schweinfurthii,0,0,0,NA,0
Quassia_undulata,316,257,59,Alphahull-PointsKO-Adjacents,6256
Quassia_versicolor,83,44,39,Alphahull-PointsKO-Adjacents,5831
Quelchia_cardonae,8,0,8,Points-PointsKO-Adjacents,43
Quercus_acerifolia,3,3,0,Points-PointsKO-Adjacents,18
Quercus_acrodonta,15,2,13,Points-PointsKO-Adjacents,127
Quercus_acuta,342,209,133,Alphahull-PointsKO-Adjacents,2510
Quercus_acutangula,2,2,0,Points-PointsKO-Adjacents,18
Quercus_acutifolia,567,519,48,Alphahull-PointsKO-Adjacents,8594
Quercus_acutissima,379,160,219,Alphahull-PointsKO-Adjacents,3785
Quercus_aerea,1,1,0,Points-PointsKO-Adjacents,9
Quercus_afares,18,8,10,Points-PointsKO-Adjacents,98
Quercus_affinis,390,365,25,Alphahull-PointsKO-Adjacents,3274
Quercus_agrifolia,2547,2081,466,Alphahull-PointsKO-Adjacents,2767
Quercus_ajoensis,34,16,18,Points-PointsKO-Adjacents,190
Quercus_alba,42049,39944,2105,Alphahull-PointsKO-Adjacents,45270
Quercus_albicaulis,1,1,0,Points-PointsKO-Adjacents,9
Quercus_albocincta,84,67,17,Alphahull-PointsKO-Adjacents,1225
Quercus_aliena,225,137,88,Alphahull-PointsKO-Adjacents,19550
Quercus_alnifolia,8,8,0,Points-PointsKO-Adjacents,30
Quercus_annulata,8,1,7,Points-PointsKO-Adjacents,69
Quercus_aquifolioides,65,45,20,Alphahull-PointsKO-Adjacents,2641
Quercus_arbutifolia,1,1,0,Points-PointsKO-Adjacents,9
Quercus_argentata,11,3,8,Points-PointsKO-Adjacents,87
Quercus_argyrotricha,0,0,0,NA,0
Quercus_aristata,111,96,15,Alphahull-PointsKO-Adjacents,2246
Quercus_arizonica,1707,1677,30,Alphahull-PointsKO-Adjacents,11590
Quercus_arkansana,65,46,19,Alphahull-PointsKO-Adjacents,952
Quercus_asymmetrica,6,2,4,Points-PointsKO-Adjacents,45
Quercus_aucheri,10,6,4,Points-PointsKO-Adjacents,58
Quercus_augustini,41,22,19,Alphahull-PointsKO-Adjacents,1011
Quercus_auricoma,30,0,30,Points-PointsKO-Adjacents,270
Quercus_austrina,43,23,20,Alphahull-PointsKO-Adjacents,1306
Quercus_austrocochinchinensis,3,3,0,Points-PointsKO-Adjacents,27
Quercus_baloot,53,42,11,Alphahull-PointsKO-Adjacents,799
Quercus_baronii,16,4,12,Points-PointsKO-Adjacents,144
Quercus_bawanglingensis,NA,NA,NA,NA,NA
Quercus_bella,18,5,13,Points-PointsKO-Adjacents,162
Quercus_benthamii,81,68,13,Alphahull-PointsKO-Adjacents,655
Quercus_berberidifolia,997,900,97,Alphahull-PointsKO-Adjacents,2427
Quercus_bicolor,1943,0,1943,Points-PointsKO-Adjacents,10952
Quercus_blakei,27,16,11,Points-PointsKO-Adjacents,234
Quercus_boyacensis,1,1,0,Points-PointsKO-Adjacents,9
Quercus_boyntonii,5,4,1,Points-PointsKO-Adjacents,45
Quercus_braianensis,6,0,6,Points-PointsKO-Adjacents,36
Quercus_brandegeei,50,42,8,Alphahull-PointsKO-Adjacents,105
Quercus_brandisiana,3,3,0,Points-PointsKO-Adjacents,27
Quercus_brantii,19,5,14,Points-PointsKO-Adjacents,166
Quercus_brenesii,8,3,5,Points-PointsKO-Adjacents,54
Quercus_brevicalyx,0,0,0,NA,0
Quercus_breviradiata,6,1,5,Points-PointsKO-Adjacents,54
Quercus_buckleyi,281,248,33,Alphahull-PointsKO-Adjacents,1769
Quercus_canariensis,564,501,63,Alphahull-PointsKO-Adjacents,959
Quercus_canbyi,173,156,17,Alphahull-PointsKO-Adjacents,1742
Quercus_candicans,741,662,79,Alphahull-PointsKO-Adjacents,8115
Quercus_carmenensis,3,3,0,Points-PointsKO-Adjacents,12
Quercus_castanea,1615,1479,136,Alphahull-PointsKO-Adjacents,8319
Quercus_castaneifolia,4,0,4,Points-PointsKO-Adjacents,36
Quercus_cedrosensis,75,0,75,Points-PointsKO-Adjacents,223
Quercus_cerris,371,276,95,Alphahull-PointsKO-Adjacents,18731
Quercus_championii,71,48,23,Alphahull-PointsKO-Adjacents,174
Quercus_chapmanii,151,119,32,Alphahull-PointsKO-Adjacents,1614
Quercus_chartacea,8,4,4,Points-PointsKO-Adjacents,44
Quercus_chenii,31,19,12,Points-PointsKO-Adjacents,275
Quercus_chevalieri,3,3,0,Points-PointsKO-Adjacents,27
Quercus_chihuahuensis,292,265,27,Alphahull-PointsKO-Adjacents,5349
Quercus_chimaltenangana,0,0,0,NA,0
Quercus_chinantlensis,3,2,1,Points-PointsKO-Adjacents,27
Quercus_chrysocalyx,2,2,0,Points-PointsKO-Adjacents,18
Quercus_chrysolepis,3171,0,3171,Points-PointsKO-Adjacents,3985
Quercus_chrysotricha,1,1,0,Points-PointsKO-Adjacents,9
Quercus_chungii,14,8,6,Points-PointsKO-Adjacents,122
Quercus_ciliaris,47,19,28,Points-PointsKO-Adjacents,417
Quercus_coahuilensis,6,1,5,Points-PointsKO-Adjacents,39
Quercus_coccifera,27087,24974,2113,Alphahull-PointsKO-Adjacents,20204
Quercus_cocciferoides,28,14,14,Points-PointsKO-Adjacents,252
Quercus_coccinea,14173,13474,699,Alphahull-PointsKO-Adjacents,30948
Quercus_coffeicolor,3,3,0,Points-PointsKO-Adjacents,21
Quercus_colombiana,2,2,0,Points-PointsKO-Adjacents,18
Quercus_conduplicans,NA,NA,NA,NA,NA
Quercus_congesta,13,9,4,Points-PointsKO-Adjacents,61
Quercus_convallata,41,31,10,Alphahull-PointsKO-Adjacents,1269
Quercus_conzattii,98,87,11,Alphahull-PointsKO-Adjacents,571
Quercus_copeyensis,57,45,12,Alphahull-PointsKO-Adjacents,177
Quercus_cornelius-mulleri,298,287,11,Alphahull-PointsKO-Adjacents,433
Quercus_cortesii,121,82,39,Alphahull-PointsKO-Adjacents,2551
Quercus_costaricensis,99,91,8,Alphahull-PointsKO-Adjacents,112
Quercus_crassifolia,1095,1048,47,Alphahull-PointsKO-Adjacents,8706
Quercus_crassipes,756,680,76,Alphahull-PointsKO-Adjacents,4034
Quercus_crenata,99,79,20,Alphahull-PointsKO-Adjacents,884
Quercus_crispifolia,31,0,31,Points-PointsKO-Adjacents,223
Quercus_crispipilis,147,137,10,Alphahull-PointsKO-Adjacents,550
Quercus_cualensis,5,4,1,Points-PointsKO-Adjacents,34
Quercus_cubana,8,5,3,Points-PointsKO-Adjacents,30
Quercus_daimingshanensis,3,3,0,Points-PointsKO-Adjacents,27
Quercus_dalechampii,37,24,13,Alphahull-PointsKO-Adjacents,461
Quercus_dankiaensis,0,0,0,NA,0
Quercus_delavayi,34,22,12,Alphahull-PointsKO-Adjacents,1025
Quercus_delgadoana,11,7,4,Points-PointsKO-Adjacents,47
Quercus_delicatula,6,0,6,Points-PointsKO-Adjacents,54
Quercus_deliquescens,8,4,4,Points-PointsKO-Adjacents,37
Quercus_dentata,222,128,94,Alphahull-PointsKO-Adjacents,5699
Quercus_depressipes,92,78,14,Alphahull-PointsKO-Adjacents,1718
Quercus_deserticola,338,297,41,Alphahull-PointsKO-Adjacents,4592
Quercus_devia,37,25,12,Alphahull-PointsKO-Adjacents,132
Quercus_dinghuensis,1,1,0,Points-PointsKO-Adjacents,9
Quercus_disciformis,8,1,7,Points-PointsKO-Adjacents,72
Quercus_dolicholepis,35,16,19,Points-PointsKO-Adjacents,314
Quercus_dongfangensis,NA,NA,NA,NA,NA
Quercus_douglasii,2300,2148,152,Alphahull-PointsKO-Adjacents,6465
Quercus_dumosa,476,378,98,Alphahull-PointsKO-Adjacents,2771
Quercus_durata,674,612,62,Alphahull-PointsKO-Adjacents,1751
Quercus_durifolia,197,178,19,Alphahull-PointsKO-Adjacents,3385
Quercus_edithiae,5,5,0,Points-PointsKO-Adjacents,45
Quercus_eduardi,561,521,40,Alphahull-PointsKO-Adjacents,5833
Quercus_edwardsiae,2,2,0,Points-PointsKO-Adjacents,9
Quercus_elevaticostata,NA,NA,NA,NA,NA
Quercus_ellipsoidalis,1948,1789,159,Alphahull-PointsKO-Adjacents,14769
Quercus_elliptica,454,406,48,Alphahull-PointsKO-Adjacents,7020
Quercus_elmeri,6,2,4,Points-PointsKO-Adjacents,54
Quercus_emoryi,1368,1338,30,Alphahull-PointsKO-Adjacents,9519
Quercus_engelmannii,409,0,409,Points-PointsKO-Adjacents,446
Quercus_engleriana,50,18,32,Points-PointsKO-Adjacents,446
Quercus_eumorpha,0,0,0,NA,0
Quercus_fabrei,174,136,38,Alphahull-PointsKO-Adjacents,10941
Quercus_faginea,11398,11079,319,Alphahull-PointsKO-Adjacents,9806
Quercus_falcata,23998,22842,1156,Alphahull-PointsKO-Adjacents,23852
Quercus_fimbriata,2,2,0,Points-PointsKO-Adjacents,18
Quercus_floccosa,3,3,0,Points-PointsKO-Adjacents,27
Quercus_flocculenta,7,3,4,Points-PointsKO-Adjacents,30
Quercus_floribunda,38,18,20,Points-PointsKO-Adjacents,261
Quercus_frainetto,150,141,9,Alphahull-PointsKO-Adjacents,4939
Quercus_franchetii,23,16,7,Points-PointsKO-Adjacents,198
Quercus_fuliginosa,NA,NA,NA,NA,NA
Quercus_fulva,121,107,14,Alphahull-PointsKO-Adjacents,3748
Quercus_furfuracea,16,7,9,Points-PointsKO-Adjacents,109
Quercus_fusiformis,398,0,398,Points-PointsKO-Adjacents,1554
Quercus_gaharuensis,3,3,0,Points-PointsKO-Adjacents,27
Quercus_gambelii,6654,6571,83,Alphahull-PointsKO-Adjacents,14358
Quercus_gambleana,17,4,13,Points-PointsKO-Adjacents,123
Quercus_garryana,1832,0,1832,Points-PointsKO-Adjacents,3316
Quercus_gemelliflora,5,0,5,Points-PointsKO-Adjacents,45
Quercus_geminata,343,279,64,Alphahull-PointsKO-Adjacents,2832
Quercus_gentryi,219,0,219,Points-PointsKO-Adjacents,921
Quercus_georgiana,4,2,2,Points-PointsKO-Adjacents,24
Quercus_germana,217,0,217,Points-PointsKO-Adjacents,513
Quercus_ghiesbreghtii,8,4,4,Points-PointsKO-Adjacents,41
Quercus_gilliana,24,12,12,Points-PointsKO-Adjacents,216
Quercus_gilva,147,86,61,Alphahull-PointsKO-Adjacents,598
Quercus_glauca,1056,795,261,Alphahull-PointsKO-Adjacents,24104
Quercus_glaucescens,196,165,31,Alphahull-PointsKO-Adjacents,4894
Quercus_glaucoides,390,360,30,Alphahull-PointsKO-Adjacents,5805
Quercus_gomeziana,0,0,0,NA,0
Quercus_gracilenta,NA,NA,NA,NA,NA
Quercus_gracilior,4,4,0,Points-PointsKO-Adjacents,24
Quercus_gravesii,112,89,23,Alphahull-PointsKO-Adjacents,1343
Quercus_griffithii,62,36,26,Alphahull-PointsKO-Adjacents,2306
Quercus_grisea,953,918,35,Alphahull-PointsKO-Adjacents,14252
Quercus_gulielmitreleasei,11,1,10,Points-PointsKO-Adjacents,66
Quercus_guyavifolia,20,10,10,Points-PointsKO-Adjacents,126
Quercus_handeliana,2,2,0,Points-PointsKO-Adjacents,18
Quercus_hartwissiana,4,2,2,Points-PointsKO-Adjacents,36
Quercus_havardii,120,112,8,Alphahull-PointsKO-Adjacents,2652
Quercus_helferiana,18,0,18,Points-PointsKO-Adjacents,104
Quercus_hemisphaerica,414,335,79,Alphahull-PointsKO-Adjacents,6434
Quercus_hintonii,49,43,6,Alphahull-PointsKO-Adjacents,88
Quercus_hintoniorum,38,0,38,Points-PointsKO-Adjacents,143
Quercus_hirtifolia,15,0,15,Points-PointsKO-Adjacents,75
Quercus_hondae,1,0,1,Points-PointsKO-Adjacents,9
Quercus_humboldtii,432,395,37,Alphahull-PointsKO-Adjacents,2922
Quercus_hypoleucoides,476,456,20,Alphahull-PointsKO-Adjacents,5405
Quercus_hypophaea,19,12,7,Points-PointsKO-Adjacents,82
Quercus_hypoxantha,55,43,12,Alphahull-PointsKO-Adjacents,724
Quercus_ichnusae,20,14,6,Points-PointsKO-Adjacents,84
Quercus_ignaciensis,2,2,0,Points-PointsKO-Adjacents,18
Quercus_ilex,11353,10372,981,Alphahull-PointsKO-Adjacents,24896
Quercus_ilicifolia,570,462,108,Alphahull-PointsKO-Adjacents,5711
Quercus_iltisii,4,3,1,Points-PointsKO-Adjacents,34
Quercus_imbricaria,2043,1717,326,Alphahull-PointsKO-Adjacents,18889
Quercus_incana,1112,0,1112,Points-PointsKO-Adjacents,4548
Quercus_infectoria,69,48,21,Alphahull-PointsKO-Adjacents,5086
Quercus_inopina,27,13,14,Points-PointsKO-Adjacents,169
Quercus_insignis,130,89,41,Alphahull-PointsKO-Adjacents,2572
Quercus_invaginata,74,62,12,Alphahull-PointsKO-Adjacents,858
Quercus_ithaburensis,530,445,85,Alphahull-PointsKO-Adjacents,2337
Quercus_jenseniana,28,11,17,Points-PointsKO-Adjacents,246
Quercus_jinpinensis,NA,NA,NA,NA,NA
Quercus_john-tuckeri,283,268,15,Alphahull-PointsKO-Adjacents,1006
Quercus_jonesii,299,264,35,Alphahull-PointsKO-Adjacents,4360
Quercus_juergensenii,0,0,0,NA,0
Quercus_kelloggii,2869,2748,121,Alphahull-PointsKO-Adjacents,4671
Quercus_kerangasensis,1,0,1,Points-PointsKO-Adjacents,9
Quercus_kerrii,35,14,21,Points-PointsKO-Adjacents,288
Quercus_kinabaluensis,1,1,0,Points-PointsKO-Adjacents,9
Quercus_kingiana,6,0,6,Points-PointsKO-Adjacents,54
Quercus_kiukiangensis,4,4,0,Points-PointsKO-Adjacents,34
Quercus_kongshanensis,2,2,0,Points-PointsKO-Adjacents,18
Quercus_kotschyana,0,0,0,NA,0
Quercus_kouangsiensis,6,1,5,Points-PointsKO-Adjacents,54
Quercus_laceyi,159,137,22,Alphahull-PointsKO-Adjacents,2527
Quercus_laeta,1089,1017,72,Alphahull-PointsKO-Adjacents,9807
Quercus_laevis,2811,2606,205,Alphahull-PointsKO-Adjacents,7022
Quercus_lamellosa,33,23,10,Alphahull-PointsKO-Adjacents,408
Quercus_lanata,15,1,14,Points-PointsKO-Adjacents,112
Quercus_lancifolia,359,293,66,Alphahull-PointsKO-Adjacents,4739
Quercus_langbianensis,8,0,8,Points-PointsKO-Adjacents,59
Quercus_laurifolia,11471,10775,696,Alphahull-PointsKO-Adjacents,14993
Quercus_laurina,1219,1148,71,Alphahull-PointsKO-Adjacents,7858
Quercus_laxa,35,22,13,Alphahull-PointsKO-Adjacents,1172
Quercus_leiophylla,71,55,16,Alphahull-PointsKO-Adjacents,1063
Quercus_lenticellata,1,1,0,Points-PointsKO-Adjacents,9
Quercus_libani,20,10,10,Points-PointsKO-Adjacents,130
Quercus_liboensis,1,1,0,Points-PointsKO-Adjacents,9
Quercus_liebmannii,19,14,5,Points-PointsKO-Adjacents,134
Quercus_lineata,5,0,5,Points-PointsKO-Adjacents,30
Quercus_litseoides,1,1,0,Points-PointsKO-Adjacents,9
Quercus_lobata,1327,1116,211,Alphahull-PointsKO-Adjacents,2804
Quercus_lobbii,2,2,0,Points-PointsKO-Adjacents,18
Quercus_lodicosa,2,2,0,Points-PointsKO-Adjacents,15
Quercus_longinux,272,252,20,Alphahull-PointsKO-Adjacents,300
Quercus_longispica,18,7,11,Points-PointsKO-Adjacents,156
Quercus_look,1,1,0,Points-PointsKO-Adjacents,9
Quercus_lowii,2,2,0,Points-PointsKO-Adjacents,12
Quercus_lungmaiensis,3,3,0,Points-PointsKO-Adjacents,27
Quercus_lusitanica,403,341,62,Alphahull-PointsKO-Adjacents,6693
Quercus_lyrata,2745,2518,227,Alphahull-PointsKO-Adjacents,20903
Quercus_macdougallii,14,9,5,Points-PointsKO-Adjacents,63
Quercus_macranthera,54,40,14,Alphahull-PointsKO-Adjacents,603
Quercus_macrocalyx,48,25,23,Alphahull-PointsKO-Adjacents,1941
Quercus_macrocarpa,5601,4936,665,Alphahull-PointsKO-Adjacents,51602
Quercus_magnoliifolia,917,850,67,Alphahull-PointsKO-Adjacents,5713
Quercus_margarettae,1596,1501,95,Alphahull-PointsKO-Adjacents,12149
Quercus_marilandica,8547,0,8547,Points-PointsKO-Adjacents,18217
Quercus_marlipoensis,1,1,0,Points-PointsKO-Adjacents,9
Quercus_martinezii,162,147,15,Alphahull-PointsKO-Adjacents,2439
Quercus_meihuashanensis,NA,NA,NA,NA,NA
Quercus_merrillii,0,0,0,NA,0
Quercus_mespilifolia,8,0,8,Points-PointsKO-Adjacents,66
Quercus_mexicana,653,603,50,Alphahull-PointsKO-Adjacents,4653
Quercus_michauxii,3523,3187,336,Alphahull-PointsKO-Adjacents,25019
Quercus_minima,646,581,65,Alphahull-PointsKO-Adjacents,2973
Quercus_miquihuanensis,8,4,4,Points-PointsKO-Adjacents,47
Quercus_miyagii,16,5,11,Points-PointsKO-Adjacents,42
Quercus_mohriana,101,79,22,Alphahull-PointsKO-Adjacents,3953
Quercus_mongolica,593,0,593,Points-PointsKO-Adjacents,2146
Quercus_monimotricha,38,27,11,Alphahull-PointsKO-Adjacents,1273
Quercus_montana,1547,1372,175,Alphahull-PointsKO-Adjacents,13437
Quercus_morii,132,122,10,Alphahull-PointsKO-Adjacents,224
Quercus_motuoensis,NA,NA,NA,NA,NA
Quercus_muehlenbergii,4679,4180,499,Alphahull-PointsKO-Adjacents,40582
Quercus_mulleri,5,4,1,Points-PointsKO-Adjacents,39
Quercus_multinervis,11,0,11,Points-PointsKO-Adjacents,93
Quercus_myrsinifolia,245,114,131,Alphahull-PointsKO-Adjacents,1713
Quercus_myrtifolia,177,0,177,Points-PointsKO-Adjacents,924
Quercus_nigra,27526,26038,1488,Alphahull-PointsKO-Adjacents,18713
Quercus_ningangensis,1,1,0,Points-PointsKO-Adjacents,9
Quercus_ningqiangensis,NA,NA,NA,NA,NA
Quercus_nivea,1,1,0,Points-PointsKO-Adjacents,9
Quercus_nixoniana,3,3,0,Points-PointsKO-Adjacents,27
Quercus_oblongata,21,6,15,Points-PointsKO-Adjacents,169
Quercus_oblongifolia,296,271,25,Alphahull-PointsKO-Adjacents,5052
Quercus_obtusanthera,1,1,0,Points-PointsKO-Adjacents,9
Quercus_obtusata,1405,1324,81,Alphahull-PointsKO-Adjacents,7495
Quercus_ocoteifolia,130,100,30,Alphahull-PointsKO-Adjacents,2467
Quercus_oglethorpensis,6,4,2,Points-PointsKO-Adjacents,51
Quercus_oidocarpa,4,4,0,Points-PointsKO-Adjacents,36
Quercus_oleoides,672,566,106,Alphahull-PointsKO-Adjacents,4498
Quercus_oocarpa,106,79,27,Alphahull-PointsKO-Adjacents,953
Quercus_oxyodon,71,30,41,Alphahull-PointsKO-Adjacents,3811
Quercus_oxyphylla,12,2,10,Points-PointsKO-Adjacents,108
Quercus_pachucana,2,2,0,Points-PointsKO-Adjacents,18
Quercus_pachyloma,82,55,27,Alphahull-PointsKO-Adjacents,913
Quercus_pacifica,128,119,9,Alphahull-PointsKO-Adjacents,70
Quercus_pagoda,6253,5889,364,Alphahull-PointsKO-Adjacents,17668
Quercus_palmeri,211,181,30,Alphahull-PointsKO-Adjacents,4512
Quercus_palustris,2238,1749,489,Alphahull-PointsKO-Adjacents,27119
Quercus_panamandinaea,1,1,0,Points-PointsKO-Adjacents,9
Quercus_parvula,248,216,32,Alphahull-PointsKO-Adjacents,637
Quercus_pauciradiata,10,7,3,Points-PointsKO-Adjacents,63
Quercus_peduncularis,626,0,626,Points-PointsKO-Adjacents,2027
Quercus_peninsularis,82,70,12,Alphahull-PointsKO-Adjacents,206
Quercus_pentacycla,1,1,0,Points-PointsKO-Adjacents,9
Quercus_percoriacea,0,0,0,NA,0
Quercus_perpallida,21,14,7,Points-PointsKO-Adjacents,89
Quercus_petelotii,1,1,0,Points-PointsKO-Adjacents,9
Quercus_petraea,34948,30652,4296,Alphahull-PointsKO-Adjacents,65878
Quercus_phanera,9,0,9,Points-PointsKO-Adjacents,72
Quercus_phellos,8711,0,8711,Points-PointsKO-Adjacents,14291
Quercus_phillyreoides,47,25,22,Alphahull-PointsKO-Adjacents,481
Quercus_pinbianensis,1,1,0,Points-PointsKO-Adjacents,9
Quercus_pinnativenulosa,31,11,20,Points-PointsKO-Adjacents,150
Quercus_planipocula,71,53,18,Alphahull-PointsKO-Adjacents,1325
Quercus_platycalyx,0,0,0,NA,0
Quercus_poilanei,5,0,5,Points-PointsKO-Adjacents,45
Quercus_polymorpha,490,0,490,Points-PointsKO-Adjacents,1447
Quercus_pontica,7,3,4,Points-PointsKO-Adjacents,49
Quercus_praeco,42,32,10,Alphahull-PointsKO-Adjacents,365
Quercus_prinoides,505,0,505,Points-PointsKO-Adjacents,3216
Quercus_pseudoverticillata,0,0,0,NA,0
Quercus_pubescens,7935,6978,957,Alphahull-PointsKO-Adjacents,43023
Quercus_pungens,183,153,30,Alphahull-PointsKO-Adjacents,7089
Quercus_purulhana,79,56,23,Alphahull-PointsKO-Adjacents,999
Quercus_pyrenaica,9475,9207,268,Alphahull-PointsKO-Adjacents,13856
Quercus_quangtriensis,2,2,0,Points-PointsKO-Adjacents,18
Quercus_radiata,20,14,6,Points-PointsKO-Adjacents,131
Quercus_ramsbottomii,0,0,0,NA,0
Quercus_rehderiana,38,22,16,Alphahull-PointsKO-Adjacents,1603
Quercus_rekonis,8,1,7,Points-PointsKO-Adjacents,40
Quercus_resinosa,336,310,26,Alphahull-PointsKO-Adjacents,3952
Quercus_rex,1,1,0,Points-PointsKO-Adjacents,9
Quercus_robur,18484,0,18484,Points-PointsKO-Adjacents,9087
Quercus_rotundifolia,42085,40759,1326,Alphahull-PointsKO-Adjacents,10398
Quercus_rubra,30186,28512,1674,Alphahull-PointsKO-Adjacents,50598
Quercus_rugosa,1771,1666,105,Alphahull-PointsKO-Adjacents,19318
Quercus_runcinatifolia,3,3,0,Points-PointsKO-Adjacents,23
Quercus_rupestris,1,1,0,Points-PointsKO-Adjacents,9
Quercus_rysophylla,131,117,14,Alphahull-PointsKO-Adjacents,730
Quercus_salicifolia,293,263,30,Alphahull-PointsKO-Adjacents,5264
Quercus_salicina,464,339,125,Alphahull-PointsKO-Adjacents,2623
Quercus_saltillensis,74,60,14,Alphahull-PointsKO-Adjacents,445
Quercus_sanchezcolinii,4,4,0,Points-PointsKO-Adjacents,23
Quercus_sapotifolia,497,434,63,Alphahull-PointsKO-Adjacents,3918
Quercus_saravanensis,1,1,0,Points-PointsKO-Adjacents,9
Quercus_schottkyana,100,1,99,Points-PointsKO-Adjacents,809
Quercus_schultzei,2,2,0,Points-PointsKO-Adjacents,18
Quercus_scytophylla,410,377,33,Alphahull-PointsKO-Adjacents,4509
Quercus_sebifera,189,169,20,Alphahull-PointsKO-Adjacents,1934
Quercus_seemannii,170,134,36,Alphahull-PointsKO-Adjacents,634
Quercus_segoviensis,277,255,22,Alphahull-PointsKO-Adjacents,1470
Quercus_semecarpifolia,75,0,75,Points-PointsKO-Adjacents,567
Quercus_semiserrata,1,0,1,Points-PointsKO-Adjacents,9
Quercus_semiserratoides,2,2,0,Points-PointsKO-Adjacents,18
Quercus_senescens,32,22,10,Alphahull-PointsKO-Adjacents,1798
Quercus_serrata,649,429,220,Alphahull-PointsKO-Adjacents,15826
Quercus_sessilifolia,352,256,96,Alphahull-PointsKO-Adjacents,5458
Quercus_setulosa,17,3,14,Points-PointsKO-Adjacents,147
Quercus_shanxiensis,0,0,0,NA,0
Quercus_shumardii,2805,2473,332,Alphahull-PointsKO-Adjacents,28600
Quercus_sichourensis,2,2,0,Points-PointsKO-Adjacents,18
Quercus_sideroxyla,539,512,27,Alphahull-PointsKO-Adjacents,9008
Quercus_similis,155,122,33,Alphahull-PointsKO-Adjacents,6870
Quercus_sinuata,265,209,56,Alphahull-PointsKO-Adjacents,6923
Quercus_skinneri,168,136,32,Alphahull-PointsKO-Adjacents,2357
Quercus_spinosa,78,43,35,Alphahull-PointsKO-Adjacents,897
Quercus_splendens,129,104,25,Alphahull-PointsKO-Adjacents,2831
Quercus_steenisii,0,0,0,NA,0
Quercus_stellata,25487,24315,1172,Alphahull-PointsKO-Adjacents,32001
Quercus_stenophylloides,237,225,12,Alphahull-PointsKO-Adjacents,271
Quercus_stewardiana,23,8,15,Points-PointsKO-Adjacents,207
Quercus_suber,7684,7188,496,Alphahull-PointsKO-Adjacents,14486
Quercus_subsericea,3,0,3,Points-PointsKO-Adjacents,27
Quercus_subspathulata,98,72,26,Alphahull-PointsKO-Adjacents,1694
Quercus_sumatrana,1,1,0,Points-PointsKO-Adjacents,9
Quercus_tarahumara,37,29,8,Alphahull-PointsKO-Adjacents,310
Quercus_tarokoensis,37,32,5,Alphahull-PointsKO-Adjacents,82
Quercus_texana,830,766,64,Alphahull-PointsKO-Adjacents,8652
Quercus_thomsoniana,0,0,0,NA,0
Quercus_thorelii,3,3,0,Points-PointsKO-Adjacents,27
Quercus_tiaoloshanica,2,2,0,Points-PointsKO-Adjacents,18
Quercus_tinkhamii,46,37,9,Alphahull-PointsKO-Adjacents,220
Quercus_tomentella,133,1,132,Points-PointsKO-Adjacents,120
Quercus_tomentosinervis,1,1,0,Points-PointsKO-Adjacents,9
Quercus_tonduzii,2,1,1,Points-PointsKO-Adjacents,18
Quercus_toumeyi,144,128,16,Alphahull-PointsKO-Adjacents,1505
Quercus_treubiana,0,0,0,NA,0
Quercus_trojana,60,46,14,Alphahull-PointsKO-Adjacents,696
Quercus_tuberculata,178,150,28,Alphahull-PointsKO-Adjacents,5052
Quercus_tuitensis,7,1,6,Points-PointsKO-Adjacents,27
Quercus_tungmaiensis,NA,NA,NA,NA,NA
Quercus_turbinella,1582,0,1582,Points-PointsKO-Adjacents,3494
Quercus_undata,11,0,11,Points-PointsKO-Adjacents,56
Quercus_urbanii,172,155,17,Alphahull-PointsKO-Adjacents,1670
Quercus_utilis,5,5,0,Points-PointsKO-Adjacents,45
Quercus_uxoris,110,93,17,Alphahull-PointsKO-Adjacents,1606
Quercus_valdinervosa,7,1,6,Points-PointsKO-Adjacents,52
Quercus_vallicola,1,1,0,Points-PointsKO-Adjacents,9
Quercus_variabilis,421,290,131,Alphahull-PointsKO-Adjacents,23583
Quercus_vaseyana,83,0,83,Points-PointsKO-Adjacents,577
Quercus_velutina,27080,25717,1363,Alphahull-PointsKO-Adjacents,41700
Quercus_verde,3,3,0,Points-PointsKO-Adjacents,24
Quercus_vestita,0,0,0,NA,0
Quercus_vicentensis,62,33,29,Alphahull-PointsKO-Adjacents,420
Quercus_viminea,263,234,29,Alphahull-PointsKO-Adjacents,3976
Quercus_virginiana,4901,4458,443,Alphahull-PointsKO-Adjacents,13081
Quercus_vulcanica,0,0,0,NA,0
Quercus_welshii,26,17,9,Points-PointsKO-Adjacents,175
Quercus_wislizeni,1876,1767,109,Alphahull-PointsKO-Adjacents,3795
Quercus_wutaishanica,8,2,6,Points-PointsKO-Adjacents,72
Quercus_xalapensis,571,503,68,Alphahull-PointsKO-Adjacents,6003
Quercus_xanthoclada,1,1,0,Points-PointsKO-Adjacents,9
Quercus_xanthotricha,1,1,0,Points-PointsKO-Adjacents,9
Quercus_yiwuensis,NA,NA,NA,NA,NA
Quercus_yonganensis,NA,NA,NA,NA,NA
Quercus_yongchunana,NA,NA,NA,NA,NA
Quetzalia_ilicina,7,2,5,Points-PointsKO-Adjacents,39
Quetzalia_occidentalis,110,81,29,Alphahull-PointsKO-Adjacents,372
Quetzalia_reynae,4,4,0,Points-PointsKO-Adjacents,12
Quetzalia_schiedeana,70,50,20,Alphahull-PointsKO-Adjacents,1127
Quetzalia_stipitata,36,31,5,Alphahull-PointsKO-Adjacents,93
Quiabentia_verticillata,62,51,11,Alphahull-PointsKO-Adjacents,2539
Quiina_amazonica,100,62,38,Alphahull-PointsKO-Adjacents,8735
Quiina_attenuata,8,0,8,Points-PointsKO-Adjacents,53
Quiina_berryi,15,3,12,Points-PointsKO-Adjacents,129
Quiina_blackii,61,35,26,Alphahull-PointsKO-Adjacents,5068
Quiina_brevensis,9,0,9,Points-PointsKO-Adjacents,75
Quiina_cidiana,3,3,0,Points-PointsKO-Adjacents,21
Quiina_colonensis,75,0,75,Points-PointsKO-Adjacents,438
Quiina_congesta,1,1,0,Points-PointsKO-Adjacents,9
Quiina_cruegeriana,259,158,101,Alphahull-PointsKO-Adjacents,22981
Quiina_duckei,11,0,11,Points-PointsKO-Adjacents,98
Quiina_florida,437,346,91,Alphahull-PointsKO-Adjacents,48349
Quiina_glaziovii,194,143,51,Alphahull-PointsKO-Adjacents,2525
Quiina_grandifolia,16,0,16,Points-PointsKO-Adjacents,116
Quiina_guianensis,67,55,12,Alphahull-PointsKO-Adjacents,2173
Quiina_indigofera,23,14,9,Points-PointsKO-Adjacents,189
Quiina_integrifolia,28,7,21,Points-PointsKO-Adjacents,234
Quiina_jamaicensis,9,4,5,Points-PointsKO-Adjacents,48
Quiina_juruana,30,6,24,Points-PointsKO-Adjacents,237
Quiina_klugii,73,24,49,Alphahull-PointsKO-Adjacents,1889
Quiina_leptoclada,29,5,24,Points-PointsKO-Adjacents,244
Quiina_longifolia,63,48,15,Alphahull-PointsKO-Adjacents,1569
Quiina_macrophylla,200,128,72,Alphahull-PointsKO-Adjacents,10010
Quiina_magallano-gomesii,21,10,11,Points-PointsKO-Adjacents,159
Quiina_maguirei,7,1,6,Points-PointsKO-Adjacents,63
Quiina_negrensis,62,39,23,Alphahull-PointsKO-Adjacents,748
Quiina_nitens,42,16,26,Points-PointsKO-Adjacents,303
Quiina_obovata,129,0,129,Points-PointsKO-Adjacents,1029
Quiina_oiapocensis,27,10,17,Points-PointsKO-Adjacents,206
Quiina_paraensis,89,52,37,Alphahull-PointsKO-Adjacents,8463
Quiina_parvifolia,14,0,14,Points-PointsKO-Adjacents,126
Quiina_peruviana,36,25,11,Alphahull-PointsKO-Adjacents,210
Quiina_piresii,3,3,0,Points-PointsKO-Adjacents,27
Quiina_pteridophylla,102,35,67,Alphahull-PointsKO-Adjacents,1605
Quiina_pubescens,4,4,0,Points-PointsKO-Adjacents,36
Quiina_rhytidopus,330,247,83,Alphahull-PointsKO-Adjacents,44672
Quiina_schippii,85,47,38,Alphahull-PointsKO-Adjacents,1010
Quiina_sessilis,7,3,4,Points-PointsKO-Adjacents,45
Quiina_tessmannii,3,3,0,Points-PointsKO-Adjacents,27
Quiina_tinifolia,59,34,25,Alphahull-PointsKO-Adjacents,3430
Quiina_wurdackii,7,0,7,Points-PointsKO-Adjacents,59
Quiina_yatuensis,2,2,0,Points-PointsKO-Adjacents,18
Quillaja_brasiliensis,179,157,22,Alphahull-PointsKO-Adjacents,5085
Quillaja_saponaria,49,29,20,Alphahull-PointsKO-Adjacents,783
Quintinia_acutifolia,2557,2517,40,Alphahull-PointsKO-Adjacents,1156
Quintinia_altigena,15,4,11,Points-PointsKO-Adjacents,105
Quintinia_apoensis,3,3,0,Points-PointsKO-Adjacents,18
Quintinia_brassii,9,1,8,Points-PointsKO-Adjacents,51
Quintinia_elliptica,1,1,0,Points-PointsKO-Adjacents,9
Quintinia_fawkneri,78,67,11,Alphahull-PointsKO-Adjacents,174
Quintinia_kuborensis,12,7,5,Points-PointsKO-Adjacents,64
Quintinia_ledermannii,25,11,14,Points-PointsKO-Adjacents,157
Quintinia_major,12,5,7,Points-PointsKO-Adjacents,47
Quintinia_montiswilhelmii,11,6,5,Points-PointsKO-Adjacents,58
Quintinia_neoebudica,3,3,0,Points-PointsKO-Adjacents,25
Quintinia_oreophila,3,3,0,Points-PointsKO-Adjacents,18
Quintinia_parviflora,2,2,0,Points-PointsKO-Adjacents,17
Quintinia_quatrefagesii,74,59,15,Alphahull-PointsKO-Adjacents,85
Quintinia_resinosa,2,2,0,Points-PointsKO-Adjacents,14
Quintinia_schlechterana,2,2,0,Points-PointsKO-Adjacents,18
Quintinia_serrata,2840,2802,38,Alphahull-PointsKO-Adjacents,1822
Quintinia_sieberi,577,0,577,Points-PointsKO-Adjacents,1025
Quintinia_verdonii,616,594,22,Alphahull-PointsKO-Adjacents,835
Quivisianthe_papinae,27,15,12,Points-PointsKO-Adjacents,207
Racosperma_hopperianum,35,28,7,Alphahull-PointsKO-Adjacents,106
Racosperma_multispicatum,87,75,12,Alphahull-PointsKO-Adjacents,1361
Radcliffea_smithii,2,2,0,Points-PointsKO-Adjacents,18
Radermachera_boniana,1,1,0,Points-PointsKO-Adjacents,9
Radermachera_coriacea,3,3,0,Points-PointsKO-Adjacents,21
Radermachera_frondosa,19,5,14,Points-PointsKO-Adjacents,158
Radermachera_gigantea,9,0,9,Points-PointsKO-Adjacents,73
Radermachera_glandulosa,9,1,8,Points-PointsKO-Adjacents,72
Radermachera_hainanensis,7,1,6,Points-PointsKO-Adjacents,53
Radermachera_inflata,0,0,0,NA,0
Radermachera_microcalyx,10,2,8,Points-PointsKO-Adjacents,90
Radermachera_peninsularis,2,2,0,Points-PointsKO-Adjacents,18
Radermachera_pentandra,4,4,0,Points-PointsKO-Adjacents,36
Radermachera_ramiflora,2,2,0,Points-PointsKO-Adjacents,14
Radermachera_sinica,89,54,35,Alphahull-PointsKO-Adjacents,1104
Radermachera_stellata,1,1,0,Points-PointsKO-Adjacents,9
Radermachera_xylocarpa,1,1,0,Points-PointsKO-Adjacents,9
Radermachera_yunnanensis,14,6,8,Points-PointsKO-Adjacents,113
Radlkofera_calodendron,19,1,18,Points-PointsKO-Adjacents,129
Ramisia_brasiliensis,113,90,23,Alphahull-PointsKO-Adjacents,1653
Ramorinoa_girolae,6,0,6,Points-PointsKO-Adjacents,47
Ramosmania_rodriguesi,0,0,0,NA,0
Randia_aciculiflora,1,1,0,Points-PointsKO-Adjacents,9
Randia_aculeata,1451,1216,235,Alphahull-PointsKO-Adjacents,29287
Randia_amazonasensis,9,3,6,Points-PointsKO-Adjacents,72
Randia_armata,2749,2449,300,Alphahull-PointsKO-Adjacents,125225
Randia_boliviana,16,8,8,Points-PointsKO-Adjacents,119
Randia_brenesii,84,0,84,Points-PointsKO-Adjacents,260
Randia_brevipes,4,4,0,Points-PointsKO-Adjacents,32
Randia_calycina,273,154,119,Alphahull-PointsKO-Adjacents,24542
Randia_calycosa,48,37,11,Alphahull-PointsKO-Adjacents,228
Randia_canescens,12,3,9,Points-PointsKO-Adjacents,70
Randia_capitata,242,194,48,Alphahull-PointsKO-Adjacents,6108
Randia_chiapensis,37,0,37,Points-PointsKO-Adjacents,215
Randia_ciliolata,1,1,0,Points-PointsKO-Adjacents,8
Randia_cinerea,60,36,24,Alphahull-PointsKO-Adjacents,418
Randia_cookii,24,6,18,Points-PointsKO-Adjacents,162
Randia_coronata,NA,NA,NA,NA,NA
Randia_dioica,61,39,22,Alphahull-PointsKO-Adjacents,3120
Randia_echinocarpa,157,134,23,Alphahull-PointsKO-Adjacents,1550
Randia_erythrocarpa,2,2,0,Points-PointsKO-Adjacents,18
Randia_ferox,205,173,32,Alphahull-PointsKO-Adjacents,5682
Randia_genipifolia,18,8,10,Points-PointsKO-Adjacents,95
Randia_genipoides,68,60,8,Alphahull-PointsKO-Adjacents,715
Randia_gentryi,44,26,18,Alphahull-PointsKO-Adjacents,622
Randia_grandifolia,335,297,38,Alphahull-PointsKO-Adjacents,2259
Randia_grayumii,14,6,8,Points-PointsKO-Adjacents,82
Randia_guerrerensis,3,2,1,Points-PointsKO-Adjacents,26
Randia_hebecarpa,75,45,30,Alphahull-PointsKO-Adjacents,2882
Randia_hondensis,58,32,26,Alphahull-PointsKO-Adjacents,1935
Randia_hypoleuca,NA,NA,NA,NA,NA
Randia_itatiaiae,3,3,0,Points-PointsKO-Adjacents,25
Randia_killipii,45,15,30,Points-PointsKO-Adjacents,385
Randia_laetevirens,249,206,43,Alphahull-PointsKO-Adjacents,2501
Randia_laevigata,64,37,27,Alphahull-PointsKO-Adjacents,1183
Randia_laevigatoides,3,3,0,Points-PointsKO-Adjacents,10
Randia_lasiantha,34,14,20,Points-PointsKO-Adjacents,210
Randia_longifolia,11,6,5,Points-PointsKO-Adjacents,88
Randia_longiloba,213,0,213,Points-PointsKO-Adjacents,684
Randia_malacocarpa,17,3,14,Points-PointsKO-Adjacents,96
Randia_matudae,92,66,26,Alphahull-PointsKO-Adjacents,1575
Randia_mayana,8,5,3,Points-PointsKO-Adjacents,52
Randia_mendozae,NA,NA,NA,NA,NA
Randia_micracantha,54,34,20,Alphahull-PointsKO-Adjacents,606
Randia_mira,30,14,16,Points-PointsKO-Adjacents,189
Randia_mixe,NA,NA,NA,NA,NA
Randia_monantha,205,150,55,Alphahull-PointsKO-Adjacents,3288
Randia_nelsonii,44,27,17,Alphahull-PointsKO-Adjacents,959
Randia_nicaraguensis,53,42,11,Alphahull-PointsKO-Adjacents,339
Randia_nitida,163,84,79,Alphahull-PointsKO-Adjacents,9023
Randia_oaxacana,9,2,7,Points-PointsKO-Adjacents,54
Randia_obcordata,280,194,86,Alphahull-PointsKO-Adjacents,4223
Randia_obovata,1,1,0,Points-PointsKO-Adjacents,9
Randia_parvifolia,6,0,6,Points-PointsKO-Adjacents,52
Randia_pascualii,NA,NA,NA,NA,NA
Randia_petenensis,40,27,13,Alphahull-PointsKO-Adjacents,907
Randia_pittieri,8,0,8,Points-PointsKO-Adjacents,52
Randia_pringlei,69,60,9,Alphahull-PointsKO-Adjacents,1034
Randia_pterocarpa,46,38,8,Alphahull-PointsKO-Adjacents,341
Randia_pubistyla,23,8,15,Points-PointsKO-Adjacents,138
Randia_serboi,1,1,0,Points-PointsKO-Adjacents,9
Randia_sezitat,2,2,0,Points-PointsKO-Adjacents,11
Randia_tessmannii,21,8,13,Points-PointsKO-Adjacents,174
Randia_tetracantha,86,58,28,Alphahull-PointsKO-Adjacents,1947
Randia_thurberi,277,220,57,Alphahull-PointsKO-Adjacents,5795
Randia_truncata,103,80,23,Alphahull-PointsKO-Adjacents,727
Randia_tubericollis,NA,NA,NA,NA,NA
Randia_vazquezii,9,1,8,Points-PointsKO-Adjacents,72
Randia_veracruzana,NA,NA,NA,NA,NA
Randia_xalapensis,125,97,28,Alphahull-PointsKO-Adjacents,1530
Rapanea_avenis,8,0,8,Points-PointsKO-Adjacents,54
Rapanea_capitellata,81,41,40,Alphahull-PointsKO-Adjacents,423
Rapanea_collina,4,4,0,Points-PointsKO-Adjacents,18
Rapanea_daphnites,89,0,89,Points-PointsKO-Adjacents,618
Rapanea_erythroxyloides,33,15,18,Points-PointsKO-Adjacents,144
Rapanea_fosbergii,3,3,0,Points-PointsKO-Adjacents,15
Rapanea_gilliana,6,2,4,Points-PointsKO-Adjacents,46
Rapanea_hasseltii,6,2,4,Points-PointsKO-Adjacents,54
Rapanea_longifolia,2,2,0,Points-PointsKO-Adjacents,18
Rapanea_melanophloeos,283,199,84,Alphahull-PointsKO-Adjacents,12689
Rapanea_myricifolia,6,1,5,Points-PointsKO-Adjacents,18
Rapanea_ovalis,8,0,8,Points-PointsKO-Adjacents,25
Rapanea_perakensis,0,0,0,NA,0
Rapanea_porteriana,8,0,8,Points-PointsKO-Adjacents,72
Rapanea_rawacensis,42,9,33,Points-PointsKO-Adjacents,318
Rapanea_rhododendroides,0,0,0,NA,0
Rapanea_salicina,151,131,20,Alphahull-PointsKO-Adjacents,1256
Rapanea_trinitatis,2,2,0,Points-PointsKO-Adjacents,12
Rapanea_umbellulata,79,39,40,Alphahull-PointsKO-Adjacents,424
Rapanea_wightiana,3,3,0,Points-PointsKO-Adjacents,27
Raphia_africana,3,3,0,Points-PointsKO-Adjacents,24
Raphia_australis,15,0,15,Points-PointsKO-Adjacents,78
Raphia_farinifera,70,29,41,Alphahull-PointsKO-Adjacents,1014
Raphia_gentiliana,8,0,8,Points-PointsKO-Adjacents,60
Raphia_hookeri,181,125,56,Alphahull-PointsKO-Adjacents,5130
Raphia_laurentii,9,3,6,Points-PointsKO-Adjacents,62
Raphia_longiflora,1,1,0,Points-PointsKO-Adjacents,5
Raphia_monbuttorum,9,0,9,Points-PointsKO-Adjacents,77
Raphia_palma-pinus,55,29,26,Alphahull-PointsKO-Adjacents,538
Raphia_regalis,28,14,14,Points-PointsKO-Adjacents,187
Raphia_rostrata,3,3,0,Points-PointsKO-Adjacents,27
Raphia_ruwenzorica,3,3,0,Points-PointsKO-Adjacents,27
Raphia_sese,14,4,10,Points-PointsKO-Adjacents,90
Raphia_sudanica,328,291,37,Alphahull-PointsKO-Adjacents,6462
Raphia_taedigera,40,15,25,Points-PointsKO-Adjacents,273
Raphia_textilis,4,4,0,Points-PointsKO-Adjacents,36
Raphia_vinifera,28,12,16,Points-PointsKO-Adjacents,186
Raphistemma_hooperianum,0,0,0,NA,0
Raputia_amazonica,7,0,7,Points-PointsKO-Adjacents,54
Raputia_aromatica,7,1,6,Points-PointsKO-Adjacents,63
Raputia_heptaphylla,88,48,40,Alphahull-PointsKO-Adjacents,2045
Raputia_maroana,10,5,5,Points-PointsKO-Adjacents,55
Raputia_megalantha,20,14,6,Points-PointsKO-Adjacents,142
Raputia_neblinensis,4,4,0,Points-PointsKO-Adjacents,23
Raputia_szczerbanii,7,4,3,Points-PointsKO-Adjacents,46
Raputiarana_heptaphylla,4,4,0,Points-PointsKO-Adjacents,15
Raputiarana_subsigmoidea,41,10,31,Points-PointsKO-Adjacents,313
Raritebe_palicoureoides,541,492,49,Alphahull-PointsKO-Adjacents,10453
Rauia_nodosa,98,56,42,Alphahull-PointsKO-Adjacents,462
Rauia_prancei,33,11,22,Points-PointsKO-Adjacents,277
Rauia_resinosa,147,84,63,Alphahull-PointsKO-Adjacents,1628
Rauia_spicata,7,3,4,Points-PointsKO-Adjacents,63
Rauia_subtruncata,5,5,0,Points-PointsKO-Adjacents,45
Raukaua_edgerleyi,2476,2423,53,Alphahull-PointsKO-Adjacents,4354
Raukaua_gunnii,108,97,11,Alphahull-PointsKO-Adjacents,234
Raukaua_laetevirens,63,0,63,Points-PointsKO-Adjacents,452
Raukaua_simplex,7648,7583,65,Alphahull-PointsKO-Adjacents,3954
Raukaua_valdiviensis,8,3,5,Points-PointsKO-Adjacents,62
Raulinoreitzia_crenulata,167,105,62,Alphahull-PointsKO-Adjacents,13883
Rauvolfia_amsoniifolia,4,0,4,Points-PointsKO-Adjacents,32
Rauvolfia_andina,6,0,6,Points-PointsKO-Adjacents,48
Rauvolfia_aphlebia,102,80,22,Alphahull-PointsKO-Adjacents,556
Rauvolfia_bahiensis,65,0,65,Points-PointsKO-Adjacents,330
Rauvolfia_balansae,28,15,13,Points-PointsKO-Adjacents,119
Rauvolfia_biauriculata,19,4,15,Points-PointsKO-Adjacents,150
Rauvolfia_caffra,275,177,98,Alphahull-PointsKO-Adjacents,15270
Rauvolfia_capixabae,21,12,9,Points-PointsKO-Adjacents,132
Rauvolfia_capuronii,15,9,6,Points-PointsKO-Adjacents,63
Rauvolfia_chaudocensis,0,0,0,NA,0
Rauvolfia_cubana,7,3,4,Points-PointsKO-Adjacents,53
Rauvolfia_dichotoma,1,1,0,Points-PointsKO-Adjacents,8
Rauvolfia_gracilis,5,5,0,Points-PointsKO-Adjacents,40
Rauvolfia_grandiflora,170,0,170,Points-PointsKO-Adjacents,903
Rauvolfia_insularis,NA,NA,NA,NA,NA
Rauvolfia_javanica,2,2,0,Points-PointsKO-Adjacents,9
Rauvolfia_leptophylla,142,117,25,Alphahull-PointsKO-Adjacents,4242
Rauvolfia_letouzeyi,38,28,10,Alphahull-PointsKO-Adjacents,545
Rauvolfia_ligustrina,175,73,102,Alphahull-PointsKO-Adjacents,5982
Rauvolfia_linearifolia,0,0,0,NA,0
Rauvolfia_littoralis,169,121,48,Alphahull-PointsKO-Adjacents,1745
Rauvolfia_macrantha,54,24,30,Alphahull-PointsKO-Adjacents,2089
Rauvolfia_mannii,116,67,49,Alphahull-PointsKO-Adjacents,1582
Rauvolfia_mattfeldiana,40,12,28,Points-PointsKO-Adjacents,272
Rauvolfia_maxima,5,0,5,Points-PointsKO-Adjacents,44
Rauvolfia_media,91,68,23,Alphahull-PointsKO-Adjacents,2695
Rauvolfia_moluccana,9,2,7,Points-PointsKO-Adjacents,39
Rauvolfia_mombasiana,45,0,45,Points-PointsKO-Adjacents,291
Rauvolfia_nitida,118,68,50,Alphahull-PointsKO-Adjacents,1212
Rauvolfia_nukuhivensis,0,0,0,NA,0
Rauvolfia_obtusiflora,75,63,12,Alphahull-PointsKO-Adjacents,874
Rauvolfia_oligantha,0,0,0,NA,0
Rauvolfia_pachyphylla,8,2,6,Points-PointsKO-Adjacents,61
Rauvolfia_paraensis,85,38,47,Alphahull-PointsKO-Adjacents,5581
Rauvolfia_pentaphylla,44,12,32,Points-PointsKO-Adjacents,376
Rauvolfia_polyphylla,75,1,74,Points-PointsKO-Adjacents,544
Rauvolfia_praecox,89,0,89,Points-PointsKO-Adjacents,666
Rauvolfia_pruinosifolia,6,0,6,Points-PointsKO-Adjacents,50
Rauvolfia_purpurascens,45,22,23,Alphahull-PointsKO-Adjacents,319
Rauvolfia_rostrata,4,4,0,Points-PointsKO-Adjacents,30
Rauvolfia_sachetiae,2,2,0,Points-PointsKO-Adjacents,15
Rauvolfia_salicifolia,14,0,14,Points-PointsKO-Adjacents,72
Rauvolfia_sanctorum,10,0,10,Points-PointsKO-Adjacents,87
Rauvolfia_sandwicensis,15,3,12,Points-PointsKO-Adjacents,102
Rauvolfia_schuelii,14,2,12,Points-PointsKO-Adjacents,104
Rauvolfia_sellowii,243,196,47,Alphahull-PointsKO-Adjacents,7235
Rauvolfia_semperflorens,19,7,12,Points-PointsKO-Adjacents,110
Rauvolfia_serpentina,8,1,7,Points-PointsKO-Adjacents,69
Rauvolfia_sprucei,128,79,49,Alphahull-PointsKO-Adjacents,3576
Rauvolfia_steyermarkii,2,2,0,Points-PointsKO-Adjacents,18
Rauvolfia_sumatrana,22,3,19,Points-PointsKO-Adjacents,167
Rauvolfia_tetraphylla,1404,1138,266,Alphahull-PointsKO-Adjacents,20748
Rauvolfia_verticillata,165,96,69,Alphahull-PointsKO-Adjacents,6423
Rauvolfia_viridis,64,25,39,Alphahull-PointsKO-Adjacents,371
Rauvolfia_volkensii,39,34,5,Alphahull-PointsKO-Adjacents,64
Rauvolfia_vomitoria,924,811,113,Alphahull-PointsKO-Adjacents,24038
Ravenala_madagascariensis,32,18,14,Points-PointsKO-Adjacents,190
Ravenea_albicans,8,5,3,Points-PointsKO-Adjacents,61
Ravenea_beentjei,4,4,0,Points-PointsKO-Adjacents,19
Ravenea_delicatula,1,1,0,Points-PointsKO-Adjacents,9
Ravenea_dransfieldii,18,10,8,Points-PointsKO-Adjacents,124
Ravenea_glauca,15,8,7,Points-PointsKO-Adjacents,83
Ravenea_hildebrandtii,9,2,7,Points-PointsKO-Adjacents,33
Ravenea_hypoleuca,3,3,0,Points-PointsKO-Adjacents,17
Ravenea_julietiae,11,4,7,Points-PointsKO-Adjacents,84
Ravenea_krociana,4,4,0,Points-PointsKO-Adjacents,27
Ravenea_lakatra,13,2,11,Points-PointsKO-Adjacents,92
Ravenea_latisecta,3,3,0,Points-PointsKO-Adjacents,25
Ravenea_louvelii,7,1,6,Points-PointsKO-Adjacents,30
Ravenea_madagascariensis,49,36,13,Alphahull-PointsKO-Adjacents,418
Ravenea_moorei,5,5,0,Points-PointsKO-Adjacents,8
Ravenea_musicalis,4,4,0,Points-PointsKO-Adjacents,9
Ravenea_nana,11,6,5,Points-PointsKO-Adjacents,81
Ravenea_rivularis,9,3,6,Points-PointsKO-Adjacents,44
Ravenea_robustior,52,30,22,Alphahull-PointsKO-Adjacents,441
Ravenea_sambiranensis,65,44,21,Alphahull-PointsKO-Adjacents,3259
Ravenea_xerophila,15,10,5,Points-PointsKO-Adjacents,77
Ravenia_biramosa,25,4,21,Points-PointsKO-Adjacents,184
Ravenia_infelix,20,12,8,Points-PointsKO-Adjacents,126
Ravenia_polygalaecalyx,2,2,0,Points-PointsKO-Adjacents,18
Ravenia_pseudalterna,4,4,0,Points-PointsKO-Adjacents,35
Ravenia_rosea,161,140,21,Alphahull-PointsKO-Adjacents,1270
Ravenia_spectabilis,13,0,13,Points-PointsKO-Adjacents,88
Ravenia_urbanii,8,4,4,Points-PointsKO-Adjacents,32
Raveniopsis_ruellioides,49,27,22,Alphahull-PointsKO-Adjacents,501
Raveniopsis_stelligera,19,4,15,Points-PointsKO-Adjacents,92
Ravensara_acutifolia,1,1,0,Points-PointsKO-Adjacents,9
Ravensara_affinis,0,0,0,NA,0
Ravensara_coriacea,4,4,0,Points-PointsKO-Adjacents,36
Ravensara_elliptica,19,15,4,Points-PointsKO-Adjacents,92
Ravensara_floribunda,9,7,2,Points-PointsKO-Adjacents,53
Ravensara_impressa,0,0,0,NA,0
Ravensara_macrophylla,0,0,0,NA,0
Ravensara_montana,1,1,0,Points-PointsKO-Adjacents,9
Ravensara_perareolata,2,2,0,Points-PointsKO-Adjacents,9
Ravensara_perrieri,21,9,12,Points-PointsKO-Adjacents,173
Rawsonia_burtt-davyi,4,4,0,Points-PointsKO-Adjacents,15
Rawsonia_lucida,143,0,143,Points-PointsKO-Adjacents,1010
Razafimandimbisonia_humblotii,61,49,12,Alphahull-PointsKO-Adjacents,646
Razafimandimbisonia_minor,120,91,29,Alphahull-PointsKO-Adjacents,2584
Razafimandimbisonia_orientalis,7,0,7,Points-PointsKO-Adjacents,54
Razafimandimbisonia_regalis,2,2,0,Points-PointsKO-Adjacents,14
Readea_membranacea,0,0,0,NA,0
Reaumuria_oxiana,0,0,0,NA,0
Recchia_connaroides,15,9,6,Points-PointsKO-Adjacents,70
Recchia_mexicana,51,37,14,Alphahull-PointsKO-Adjacents,652
Recchia_simplicifolia,30,25,5,Alphahull-PointsKO-Adjacents,96
Recordia_boliviana,31,22,9,Alphahull-PointsKO-Adjacents,199
Recordia_reitzii,50,38,12,Alphahull-PointsKO-Adjacents,230
Recordoxylon_pulcherrimum,5,5,0,Points-PointsKO-Adjacents,17
Recordoxylon_speciosum,46,15,31,Points-PointsKO-Adjacents,339
Recordoxylon_stenopetalum,14,0,14,Points-PointsKO-Adjacents,103
Reevesia_botingensis,4,4,0,Points-PointsKO-Adjacents,36
Reevesia_formosana,61,47,14,Alphahull-PointsKO-Adjacents,108
Reevesia_glaucophylla,6,0,6,Points-PointsKO-Adjacents,54
Reevesia_lancifolia,3,3,0,Points-PointsKO-Adjacents,27
Reevesia_lofouensis,3,3,0,Points-PointsKO-Adjacents,27
Reevesia_longipetiolata,6,0,6,Points-PointsKO-Adjacents,45
Reevesia_lumlingensis,1,1,0,Points-PointsKO-Adjacents,9
Reevesia_orbicularifolia,2,2,0,Points-PointsKO-Adjacents,18
Reevesia_pubescens,32,10,22,Points-PointsKO-Adjacents,278
Reevesia_pycnantha,2,2,0,Points-PointsKO-Adjacents,18
Reevesia_rotundifolia,1,1,0,Points-PointsKO-Adjacents,9
Reevesia_rubronervia,1,1,0,Points-PointsKO-Adjacents,9
Reevesia_shangszeensis,1,1,0,Points-PointsKO-Adjacents,9
Reevesia_thyrsoidea,34,13,21,Points-PointsKO-Adjacents,287
Reevesia_tomentosa,0,0,0,NA,0
Regelia_velutina,18,10,8,Points-PointsKO-Adjacents,43
Rehdera_penninervia,29,23,6,Alphahull-PointsKO-Adjacents,520
Rehdera_trinervis,172,0,172,Points-PointsKO-Adjacents,661
Rehderodendron_gongshanense,2,2,0,Points-PointsKO-Adjacents,18
Rehderodendron_indochinense,5,5,0,Points-PointsKO-Adjacents,45
Rehderodendron_kwangtungense,13,3,10,Points-PointsKO-Adjacents,117
Rehderodendron_kweichowense,7,0,7,Points-PointsKO-Adjacents,63
Rehderodendron_macrocarpum,15,5,10,Points-PointsKO-Adjacents,105
Reinhardtia_elegans,7,0,7,Points-PointsKO-Adjacents,63
Reinhardtia_koschnyana,45,26,19,Alphahull-PointsKO-Adjacents,220
Reinhardtia_latisecta,46,31,15,Alphahull-PointsKO-Adjacents,965
Reinhardtia_paiewonskiana,10,4,6,Points-PointsKO-Adjacents,68
Reinwardtiodendron_humile,9,1,8,Points-PointsKO-Adjacents,78
Reissantia_buchananii,18,1,17,Points-PointsKO-Adjacents,152
Remijia_amazonica,179,132,47,Alphahull-PointsKO-Adjacents,14056
Remijia_aracamuniensis,3,3,0,Points-PointsKO-Adjacents,15
Remijia_argentea,11,6,5,Points-PointsKO-Adjacents,95
Remijia_asperula,14,2,12,Points-PointsKO-Adjacents,115
Remijia_berryi,0,0,0,NA,0
Remijia_chelomaphylla,54,35,19,Alphahull-PointsKO-Adjacents,289
Remijia_cinchonicarpa,2,2,0,Points-PointsKO-Adjacents,18
Remijia_densiflora,90,66,24,Alphahull-PointsKO-Adjacents,3313
Remijia_duckei,24,10,14,Points-PointsKO-Adjacents,192
Remijia_ferruginea,219,180,39,Alphahull-PointsKO-Adjacents,2293
Remijia_firmula,92,54,38,Alphahull-PointsKO-Adjacents,7208
Remijia_globosa,4,4,0,Points-PointsKO-Adjacents,33
Remijia_glomerata,33,0,33,Points-PointsKO-Adjacents,255
Remijia_hirsuta,5,5,0,Points-PointsKO-Adjacents,44
Remijia_hispida,42,26,16,Alphahull-PointsKO-Adjacents,1451
Remijia_hubbardiorum,9,3,6,Points-PointsKO-Adjacents,76
Remijia_longifolia,18,7,11,Points-PointsKO-Adjacents,128
Remijia_macrocnemia,48,38,10,Alphahull-PointsKO-Adjacents,611
Remijia_maguirei,18,10,8,Points-PointsKO-Adjacents,57
Remijia_morilloi,28,12,16,Points-PointsKO-Adjacents,170
Remijia_pacimonica,75,49,26,Alphahull-PointsKO-Adjacents,3805
Remijia_physophora,5,5,0,Points-PointsKO-Adjacents,35
Remijia_pilosinervula,7,0,7,Points-PointsKO-Adjacents,47
Remijia_roraimae,62,46,16,Alphahull-PointsKO-Adjacents,4012
Remijia_sipapoensis,4,4,0,Points-PointsKO-Adjacents,32
Remijia_steyermarkii,4,4,0,Points-PointsKO-Adjacents,33
Remijia_tenuiflora,38,17,21,Points-PointsKO-Adjacents,269
Remijia_ulei,72,37,35,Alphahull-PointsKO-Adjacents,4460
Remijia_vaupesiana,4,4,0,Points-PointsKO-Adjacents,35
Remijia_wurdackii,14,9,5,Points-PointsKO-Adjacents,60
Renistipula_galeottii,61,50,11,Alphahull-PointsKO-Adjacents,277
Rennellia_borneensis,0,0,0,NA,0
Rennellia_elliptica,16,4,12,Points-PointsKO-Adjacents,111
Rennellia_elongata,0,0,0,NA,0
Rennellia_microcephala,2,2,0,Points-PointsKO-Adjacents,15
Rennellia_morindiformis,1,1,0,Points-PointsKO-Adjacents,9
Rennellia_paniculata,0,0,0,NA,0
Rennellia_speciosa,2,2,0,Points-PointsKO-Adjacents,18
Retiniphyllum_chloranthum,143,111,32,Alphahull-PointsKO-Adjacents,8137
Retiniphyllum_concolor,204,157,47,Alphahull-PointsKO-Adjacents,5939
Retiniphyllum_fuchsioides,20,9,11,Points-PointsKO-Adjacents,110
Retiniphyllum_kuhlmannii,62,30,32,Alphahull-PointsKO-Adjacents,1422
Retiniphyllum_laxiflorum,148,0,148,Points-PointsKO-Adjacents,805
Retiniphyllum_secundiflorum,60,45,15,Alphahull-PointsKO-Adjacents,1088
Retiniphyllum_speciosum,40,22,18,Alphahull-PointsKO-Adjacents,1082
Retiniphyllum_tepuiense,19,0,19,Points-PointsKO-Adjacents,93
Retrophyllum_comptonii,82,68,14,Alphahull-PointsKO-Adjacents,145
Retrophyllum_minus,42,31,11,Alphahull-PointsKO-Adjacents,60
Retrophyllum_piresii,4,4,0,Points-PointsKO-Adjacents,32
Retrophyllum_rospigliosii,132,79,53,Alphahull-PointsKO-Adjacents,999
Retrophyllum_vitiense,33,7,26,Points-PointsKO-Adjacents,212
Reutealis_trisperma,1,1,0,Points-PointsKO-Adjacents,6
Reynosia_barbatula,6,2,4,Points-PointsKO-Adjacents,37
Reynosia_guama,2,2,0,Points-PointsKO-Adjacents,15
Reynosia_krugii,12,8,4,Points-PointsKO-Adjacents,46
Reynosia_septentrionalis,10,3,7,Points-PointsKO-Adjacents,53
Reynosia_uncinata,25,0,25,Points-PointsKO-Adjacents,94
Rhabdodendron_amazonicum,230,196,34,Alphahull-PointsKO-Adjacents,16086
Rhabdodendron_gardnerianum,6,1,5,Points-PointsKO-Adjacents,44
Rhabdodendron_macrophyllum,47,0,47,Points-PointsKO-Adjacents,230
Rhadinopus_kurivana,3,3,0,Points-PointsKO-Adjacents,18
Rhadinopus_papuana,4,4,0,Points-PointsKO-Adjacents,30
Rhamnella_caudata,3,3,0,Points-PointsKO-Adjacents,27
Rhamnella_forrestii,8,1,7,Points-PointsKO-Adjacents,72
Rhamnella_franguloides,11,1,10,Points-PointsKO-Adjacents,98
Rhamnella_gilgitica,7,4,3,Points-PointsKO-Adjacents,36
Rhamnella_martinii,11,0,11,Points-PointsKO-Adjacents,99
Rhamnella_rubrinervis,33,17,16,Points-PointsKO-Adjacents,297
Rhamnella_wilsonii,2,2,0,Points-PointsKO-Adjacents,18
Rhamnidium_caloneurum,2,2,0,Points-PointsKO-Adjacents,18
Rhamnidium_elaeocarpum,1102,973,129,Alphahull-PointsKO-Adjacents,48243
Rhamnidium_glabrum,45,15,30,Points-PointsKO-Adjacents,317
Rhamnidium_molle,72,49,23,Alphahull-PointsKO-Adjacents,2577
Rhamnoneuron_balansae,10,3,7,Points-PointsKO-Adjacents,80
Rhamnus_alaternus,10925,9355,1570,Alphahull-PointsKO-Adjacents,22013
Rhamnus_alpina,331,285,46,Alphahull-PointsKO-Adjacents,2837
Rhamnus_arguta,4,4,0,Points-PointsKO-Adjacents,36
Rhamnus_cathartica,25939,0,25939,Points-PointsKO-Adjacents,29610
Rhamnus_coriophylla,8,3,5,Points-PointsKO-Adjacents,72
Rhamnus_crocea,897,692,205,Alphahull-PointsKO-Adjacents,6847
Rhamnus_davurica,8,1,7,Points-PointsKO-Adjacents,72
Rhamnus_dumetorum,48,33,15,Alphahull-PointsKO-Adjacents,4739
Rhamnus_erythroxylum,3,2,1,Points-PointsKO-Adjacents,27
Rhamnus_esquirolii,25,7,18,Points-PointsKO-Adjacents,223
Rhamnus_globosa,23,7,16,Points-PointsKO-Adjacents,199
Rhamnus_hemsleyana,23,0,23,Points-PointsKO-Adjacents,207
Rhamnus_hintonii,54,43,11,Alphahull-PointsKO-Adjacents,544
Rhamnus_ilicifolia,1870,1704,166,Alphahull-PointsKO-Adjacents,7820
Rhamnus_imeretina,4,4,0,Points-PointsKO-Adjacents,32
Rhamnus_lamprophylla,31,12,19,Points-PointsKO-Adjacents,275
Rhamnus_lanceolata,522,383,139,Alphahull-PointsKO-Adjacents,15800
Rhamnus_leptophylla,117,85,32,Alphahull-PointsKO-Adjacents,13663
Rhamnus_liukiuensis,17,8,9,Points-PointsKO-Adjacents,104
Rhamnus_longistyla,164,146,18,Alphahull-PointsKO-Adjacents,670
Rhamnus_napalensis,83,50,33,Alphahull-PointsKO-Adjacents,5331
Rhamnus_nigricans,8,1,7,Points-PointsKO-Adjacents,72
Rhamnus_oreodendron,139,130,9,Alphahull-PointsKO-Adjacents,145
Rhamnus_persicifolia,16,13,3,Points-PointsKO-Adjacents,32
Rhamnus_pirifolia,442,380,62,Alphahull-PointsKO-Adjacents,3738
Rhamnus_pompana,158,121,37,Alphahull-PointsKO-Adjacents,1879
Rhamnus_prinoides,326,78,248,Alphahull-PointsKO-Adjacents,11049
Rhamnus_rosthornii,32,10,22,Points-PointsKO-Adjacents,288
Rhamnus_sargentiana,21,10,11,Points-PointsKO-Adjacents,188
Rhamnus_serrata,239,199,40,Alphahull-PointsKO-Adjacents,1933
Rhamnus_staddo,42,17,25,Points-PointsKO-Adjacents,306
Rhamnus_subapetala,7,1,6,Points-PointsKO-Adjacents,63
Rhamnus_tangutica,42,25,17,Alphahull-PointsKO-Adjacents,1905
Rhamnus_triquetra,9,4,5,Points-PointsKO-Adjacents,77
Rhamnus_ussuriensis,12,1,11,Points-PointsKO-Adjacents,108
Rhamnus_utilis,145,105,40,Alphahull-PointsKO-Adjacents,12696
Rhamnus_virgata,85,0,85,Points-PointsKO-Adjacents,726
Rhamnus_wumingensis,1,1,0,Points-PointsKO-Adjacents,9
Rhamnus_xizangensis,3,3,0,Points-PointsKO-Adjacents,27
Rhaphiolepis_ferruginea,3,3,0,Points-PointsKO-Adjacents,27
Rhaphiolepis_indica,335,214,121,Alphahull-PointsKO-Adjacents,5247
Rhaphiolepis_lanceolata,0,0,0,NA,0
Rhaphiolepis_salicifolia,3,3,0,Points-PointsKO-Adjacents,27
Rhaphiolepis_umbellata,70,15,55,Points-PointsKO-Adjacents,347
Rhaphiostylis_beninensis,178,104,74,Alphahull-PointsKO-Adjacents,6911
Rhaphiostylis_cordifolia,42,33,9,Alphahull-PointsKO-Adjacents,453
Rhaphithamnus_spinosus,56,34,22,Alphahull-PointsKO-Adjacents,1291
Rhaphithamnus_venustus,10,3,7,Points-PointsKO-Adjacents,18
Rhapis_excelsa,25,2,23,Points-PointsKO-Adjacents,207
Rhapis_vidalii,6,1,5,Points-PointsKO-Adjacents,31
Rhaptopetalum_beguei,48,39,9,Alphahull-PointsKO-Adjacents,239
Rhaptopetalum_breteleri,2,2,0,Points-PointsKO-Adjacents,18
Rhaptopetalum_coriaceum,35,26,9,Alphahull-PointsKO-Adjacents,136
Rhaptopetalum_depressum,3,3,0,Points-PointsKO-Adjacents,18
Rhaptopetalum_pachyphyllum,14,8,6,Points-PointsKO-Adjacents,110
Rhaptopetalum_roseum,1,1,0,Points-PointsKO-Adjacents,9
Rhaptopetalum_sindarense,14,11,3,Points-PointsKO-Adjacents,90
Rheedia_arubayensis,76,26,50,Alphahull-PointsKO-Adjacents,1690
Rheedia_martinii,4,4,0,Points-PointsKO-Adjacents,27
Rhigospira_quadrangularis,178,128,50,Alphahull-PointsKO-Adjacents,19942
Rhigozum_brevispinosum,75,45,30,Alphahull-PointsKO-Adjacents,4590
Rhigozum_madagascariense,30,22,8,Alphahull-PointsKO-Adjacents,491
Rhigozum_obovatum,102,75,27,Alphahull-PointsKO-Adjacents,4315
Rhigozum_zambesiacum,24,14,10,Points-PointsKO-Adjacents,216
Rhipidantha_chlorantha,13,8,5,Points-PointsKO-Adjacents,30
Rhizophora_apiculata,210,97,113,Alphahull-PointsKO-Adjacents,2433
Rhizophora_mangle,1737,1246,491,Alphahull-PointsKO-Adjacents,25596
Rhizophora_mucronata,166,46,120,Alphahull-PointsKO-Adjacents,1581
Rhizophora_racemosa,252,134,118,Alphahull-PointsKO-Adjacents,1599
Rhizophora_samoensis,1,1,0,Points-PointsKO-Adjacents,7
Rhizophora_stylosa,527,367,160,Alphahull-PointsKO-Adjacents,5149
Rhodamnia_acuminata,42,30,12,Alphahull-PointsKO-Adjacents,165
Rhodamnia_andromedoides,16,9,7,Points-PointsKO-Adjacents,57
Rhodamnia_angustifolia,7,4,3,Points-PointsKO-Adjacents,19
Rhodamnia_arenaria,10,7,3,Points-PointsKO-Adjacents,44
Rhodamnia_argentea,203,175,28,Alphahull-PointsKO-Adjacents,1075
Rhodamnia_australis,143,120,23,Alphahull-PointsKO-Adjacents,1132
Rhodamnia_blairiana,142,121,21,Alphahull-PointsKO-Adjacents,449
Rhodamnia_cinerea,38,12,26,Points-PointsKO-Adjacents,304
Rhodamnia_costata,66,41,25,Alphahull-PointsKO-Adjacents,240
Rhodamnia_dumetorum,12,1,11,Points-PointsKO-Adjacents,102
Rhodamnia_dumicola,106,91,15,Alphahull-PointsKO-Adjacents,618
Rhodamnia_fordii,25,15,10,Points-PointsKO-Adjacents,87
Rhodamnia_glabrescens,23,17,6,Points-PointsKO-Adjacents,50
Rhodamnia_glauca,131,88,43,Alphahull-PointsKO-Adjacents,465
Rhodamnia_hylandii,8,4,4,Points-PointsKO-Adjacents,18
Rhodamnia_kamialiensis,1,1,0,Points-PointsKO-Adjacents,9
Rhodamnia_lancifolia,6,1,5,Points-PointsKO-Adjacents,36
Rhodamnia_latifolia,67,40,27,Alphahull-PointsKO-Adjacents,867
Rhodamnia_longisepala,4,4,0,Points-PointsKO-Adjacents,24
Rhodamnia_maideniana,145,0,145,Points-PointsKO-Adjacents,129
Rhodamnia_moluccana,20,1,19,Points-PointsKO-Adjacents,120
Rhodamnia_mulleri,1,1,0,Points-PointsKO-Adjacents,9
Rhodamnia_novoguineensis,17,12,5,Points-PointsKO-Adjacents,97
Rhodamnia_pachyloba,9,1,8,Points-PointsKO-Adjacents,61
Rhodamnia_pauciovulata,37,0,37,Points-PointsKO-Adjacents,146
Rhodamnia_reticulata,4,4,0,Points-PointsKO-Adjacents,17
Rhodamnia_rubescens,1949,1817,132,Alphahull-PointsKO-Adjacents,1703
Rhodamnia_sepicana,1,1,0,Points-PointsKO-Adjacents,9
Rhodamnia_sessiliflora,126,105,21,Alphahull-PointsKO-Adjacents,250
Rhodamnia_sharpeana,37,28,9,Alphahull-PointsKO-Adjacents,110
Rhodamnia_tessellata,0,0,0,NA,0
Rhodamnia_uniflora,0,0,0,NA,0
Rhodamnia_whiteana,31,26,5,Alphahull-PointsKO-Adjacents,72
Rhodocolea_boivinii,14,0,14,Points-PointsKO-Adjacents,87
Rhodocolea_involucrata,10,2,8,Points-PointsKO-Adjacents,68
Rhodocolea_lemuriphila,4,4,0,Points-PointsKO-Adjacents,26
Rhodocolea_multiflora,1,1,0,Points-PointsKO-Adjacents,9
Rhodocolea_nobilis,3,3,0,Points-PointsKO-Adjacents,23
Rhodocolea_perrieri,1,1,0,Points-PointsKO-Adjacents,6
Rhodocolea_racemosa,80,52,28,Alphahull-PointsKO-Adjacents,875
Rhodocolea_telfairiae,6,3,3,Points-PointsKO-Adjacents,42
Rhododendron_alabamense,74,53,21,Alphahull-PointsKO-Adjacents,1872
Rhododendron_anthosphaerum,43,33,10,Alphahull-PointsKO-Adjacents,585
Rhododendron_arborescens,196,151,45,Alphahull-PointsKO-Adjacents,5338
Rhododendron_arboreum,76,27,49,Alphahull-PointsKO-Adjacents,1678
Rhododendron_argipeplum,2,2,0,Points-PointsKO-Adjacents,18
Rhododendron_argyrophyllum,34,22,12,Alphahull-PointsKO-Adjacents,854
Rhododendron_arizelum,35,28,7,Alphahull-PointsKO-Adjacents,154
Rhododendron_asterochnoum,9,4,5,Points-PointsKO-Adjacents,80
Rhododendron_atlanticum,147,103,44,Alphahull-PointsKO-Adjacents,1950
Rhododendron_auriculatum,8,3,5,Points-PointsKO-Adjacents,72
Rhododendron_barbatum,17,3,14,Points-PointsKO-Adjacents,108
Rhododendron_basilicum,9,3,6,Points-PointsKO-Adjacents,67
Rhododendron_beesianum,56,44,12,Alphahull-PointsKO-Adjacents,846
Rhododendron_brevinerve,14,4,10,Points-PointsKO-Adjacents,126
Rhododendron_calendulaceum,600,554,46,Alphahull-PointsKO-Adjacents,3248
Rhododendron_calophytum,26,16,10,Points-PointsKO-Adjacents,188
Rhododendron_campanulatum,39,15,24,Points-PointsKO-Adjacents,255
Rhododendron_campylocarpum,31,18,13,Points-PointsKO-Adjacents,207
Rhododendron_canescens,539,430,109,Alphahull-PointsKO-Adjacents,11532
Rhododendron_championiae,0,0,0,NA,0
Rhododendron_chihsinianum,2,2,0,Points-PointsKO-Adjacents,18
Rhododendron_ciliicalyx,48,24,24,Alphahull-PointsKO-Adjacents,1867
Rhododendron_cinnabarinum,13,1,12,Points-PointsKO-Adjacents,101
Rhododendron_coeloneurum,7,1,6,Points-PointsKO-Adjacents,59
Rhododendron_coriaceum,25,1,24,Points-PointsKO-Adjacents,130
Rhododendron_coryanum,7,2,5,Points-PointsKO-Adjacents,50
Rhododendron_crinigerum,17,0,17,Points-PointsKO-Adjacents,99
Rhododendron_cumberlandense,49,33,16,Alphahull-PointsKO-Adjacents,802
Rhododendron_cyanocarpum,10,4,6,Points-PointsKO-Adjacents,63
Rhododendron_dasycladoides,4,4,0,Points-PointsKO-Adjacents,35
Rhododendron_davidii,18,8,10,Points-PointsKO-Adjacents,145
Rhododendron_dayaoshanense,NA,NA,NA,NA,NA
Rhododendron_decorum,184,158,26,Alphahull-PointsKO-Adjacents,5618
Rhododendron_delavayi,112,88,24,Alphahull-PointsKO-Adjacents,3609
Rhododendron_dignabile,7,2,5,Points-PointsKO-Adjacents,52
Rhododendron_discolor,18,3,15,Points-PointsKO-Adjacents,156
Rhododendron_eastmanii,3,2,1,Points-PointsKO-Adjacents,25
Rhododendron_ebianense,NA,NA,NA,NA,NA
Rhododendron_erosum,1,1,0,Points-PointsKO-Adjacents,9
Rhododendron_exasperatum,2,2,0,Points-PointsKO-Adjacents,18
Rhododendron_faberi,22,13,9,Points-PointsKO-Adjacents,159
Rhododendron_facetum,33,21,12,Alphahull-PointsKO-Adjacents,370
Rhododendron_faucium,11,6,5,Points-PointsKO-Adjacents,51
Rhododendron_flammeum,13,4,9,Points-PointsKO-Adjacents,114
Rhododendron_flavoflorum,NA,NA,NA,NA,NA
Rhododendron_floribundum,14,6,8,Points-PointsKO-Adjacents,108
Rhododendron_flosculum,2,2,0,Points-PointsKO-Adjacents,18
Rhododendron_formosanum,167,155,12,Alphahull-PointsKO-Adjacents,244
Rhododendron_fortunei,47,27,20,Alphahull-PointsKO-Adjacents,4503
Rhododendron_fulvum,46,35,11,Alphahull-PointsKO-Adjacents,799
Rhododendron_galactinum,4,4,0,Points-PointsKO-Adjacents,30
Rhododendron_gannanense,NA,NA,NA,NA,NA
Rhododendron_glischrum,19,0,19,Points-PointsKO-Adjacents,115
Rhododendron_grande,4,3,1,Points-PointsKO-Adjacents,36
Rhododendron_griffithianum,2,2,0,Points-PointsKO-Adjacents,16
Rhododendron_guangnanense,1,1,0,Points-PointsKO-Adjacents,9
Rhododendron_guihainianum,NA,NA,NA,NA,NA
Rhododendron_guizhouense,NA,NA,NA,NA,NA
Rhododendron_hancockii,18,10,8,Points-PointsKO-Adjacents,142
Rhododendron_hemsleyanum,6,0,6,Points-PointsKO-Adjacents,39
Rhododendron_hirtipes,11,0,11,Points-PointsKO-Adjacents,77
Rhododendron_hodgsonii,6,1,5,Points-PointsKO-Adjacents,54
Rhododendron_hookeri,0,0,0,NA,0
Rhododendron_huanum,3,3,0,Points-PointsKO-Adjacents,27
Rhododendron_hunnewellianum,7,1,6,Points-PointsKO-Adjacents,50
Rhododendron_hylaeum,8,5,3,Points-PointsKO-Adjacents,60
Rhododendron_irroratum,76,52,24,Alphahull-PointsKO-Adjacents,2276
Rhododendron_jinchangense,NA,NA,NA,NA,NA
Rhododendron_kendrickii,0,0,0,NA,0
Rhododendron_konori,71,0,71,Points-PointsKO-Adjacents,345
Rhododendron_lacteum,15,8,7,Points-PointsKO-Adjacents,117
Rhododendron_lanigerum,0,0,0,NA,0
Rhododendron_laojunshanense,NA,NA,NA,NA,NA
Rhododendron_leptopeplum,0,0,0,NA,0
Rhododendron_liboense,NA,NA,NA,NA,NA
Rhododendron_longicalyx,NA,NA,NA,NA,NA
Rhododendron_longilobum,NA,NA,NA,NA,NA
Rhododendron_longipes,6,1,5,Points-PointsKO-Adjacents,45
Rhododendron_lukiangense,41,34,7,Alphahull-PointsKO-Adjacents,247
Rhododendron_lulangense,NA,NA,NA,NA,NA
Rhododendron_mackenzianum,5,5,0,Points-PointsKO-Adjacents,42
Rhododendron_maculiferum,19,6,13,Points-PointsKO-Adjacents,171
Rhododendron_maddenii,56,0,56,Points-PointsKO-Adjacents,369
Rhododendron_magnificum,0,0,0,NA,0
Rhododendron_magniflorum,NA,NA,NA,NA,NA
Rhododendron_mallotum,6,1,5,Points-PointsKO-Adjacents,45
Rhododendron_maoerense,1,1,0,Points-PointsKO-Adjacents,9
Rhododendron_mariesii,145,111,34,Alphahull-PointsKO-Adjacents,9976
Rhododendron_maximum,1239,1154,85,Alphahull-PointsKO-Adjacents,7907
Rhododendron_megalanthum,NA,NA,NA,NA,NA
Rhododendron_mengtszense,3,3,0,Points-PointsKO-Adjacents,27
Rhododendron_mitriforme,7,1,6,Points-PointsKO-Adjacents,63
Rhododendron_montiganum,NA,NA,NA,NA,NA
Rhododendron_montroseanum,0,0,0,NA,0
Rhododendron_morii,79,70,9,Alphahull-PointsKO-Adjacents,181
Rhododendron_moulmainense,126,81,45,Alphahull-PointsKO-Adjacents,8768
Rhododendron_niveum,2,1,1,Points-PointsKO-Adjacents,18
Rhododendron_nuttallii,9,4,5,Points-PointsKO-Adjacents,60
Rhododendron_nymphaeoides,NA,NA,NA,NA,NA
Rhododendron_ochraceum,10,3,7,Points-PointsKO-Adjacents,81
Rhododendron_oligocarpum,4,4,0,Points-PointsKO-Adjacents,36
Rhododendron_orbiculare,23,9,14,Points-PointsKO-Adjacents,196
Rhododendron_oreodoxa,36,17,19,Points-PointsKO-Adjacents,278
Rhododendron_oreogenum,NA,NA,NA,NA,NA
Rhododendron_oreotrephes,52,42,10,Alphahull-PointsKO-Adjacents,977
Rhododendron_pachyphyllum,3,3,0,Points-PointsKO-Adjacents,27
Rhododendron_pachypodum,42,30,12,Alphahull-PointsKO-Adjacents,1697
Rhododendron_pachytrichum,29,17,12,Points-PointsKO-Adjacents,222
Rhododendron_papillatum,0,0,0,NA,0
Rhododendron_periclymenoides,904,0,904,Points-PointsKO-Adjacents,5041
Rhododendron_pilostylum,NA,NA,NA,NA,NA
Rhododendron_pingbianense,NA,NA,NA,NA,NA
Rhododendron_pingianum,9,3,6,Points-PointsKO-Adjacents,73
Rhododendron_platypodum,7,1,6,Points-PointsKO-Adjacents,54
Rhododendron_polylepis,24,15,9,Points-PointsKO-Adjacents,187
Rhododendron_populare,1,1,0,Points-PointsKO-Adjacents,9
Rhododendron_potaninii,NA,NA,NA,NA,NA
Rhododendron_praestans,12,0,12,Points-PointsKO-Adjacents,97
Rhododendron_preptum,0,0,0,NA,0
Rhododendron_prinophyllum,348,280,68,Alphahull-PointsKO-Adjacents,7742
Rhododendron_protistum,23,16,7,Points-PointsKO-Adjacents,118
Rhododendron_prunifolium,8,0,8,Points-PointsKO-Adjacents,56
Rhododendron_pudorosum,2,2,0,Points-PointsKO-Adjacents,18
Rhododendron_retusum,11,0,11,Points-PointsKO-Adjacents,78
Rhododendron_rex,63,53,10,Alphahull-PointsKO-Adjacents,1929
Rhododendron_ririei,8,1,7,Points-PointsKO-Adjacents,57
Rhododendron_rothschildii,5,5,0,Points-PointsKO-Adjacents,33
Rhododendron_rubiginosum,102,90,12,Alphahull-PointsKO-Adjacents,2042
Rhododendron_schlippenbachii,28,13,15,Points-PointsKO-Adjacents,172
Rhododendron_selense,37,0,37,Points-PointsKO-Adjacents,264
Rhododendron_shanii,0,0,0,NA,0
Rhododendron_sherriffii,1,1,0,Points-PointsKO-Adjacents,9
Rhododendron_sidereum,16,13,3,Points-PointsKO-Adjacents,98
Rhododendron_sikangense,9,4,5,Points-PointsKO-Adjacents,75
Rhododendron_sinofalconeri,7,3,4,Points-PointsKO-Adjacents,35
Rhododendron_sinogrande,41,29,12,Alphahull-PointsKO-Adjacents,337
Rhododendron_sinonuttallii,11,1,10,Points-PointsKO-Adjacents,69
Rhododendron_spanotrichum,3,3,0,Points-PointsKO-Adjacents,27
Rhododendron_stamineum,63,38,25,Alphahull-PointsKO-Adjacents,3652
Rhododendron_strigillosum,18,9,9,Points-PointsKO-Adjacents,136
Rhododendron_taishunense,NA,NA,NA,NA,NA
Rhododendron_tanastylum,28,19,9,Points-PointsKO-Adjacents,138
Rhododendron_thomsonii,9,2,7,Points-PointsKO-Adjacents,75
Rhododendron_tianlinense,1,1,0,Points-PointsKO-Adjacents,9
Rhododendron_traillianum,47,35,12,Alphahull-PointsKO-Adjacents,1226
Rhododendron_triflorum,16,3,13,Points-PointsKO-Adjacents,127
Rhododendron_truncatovarium,1,1,0,Points-PointsKO-Adjacents,9
Rhododendron_tutcherae,9,4,5,Points-PointsKO-Adjacents,79
Rhododendron_uvariifolium,47,1,46,Points-PointsKO-Adjacents,315
Rhododendron_vaniotii,0,0,0,NA,0
Rhododendron_vaseyi,26,16,10,Points-PointsKO-Adjacents,119
Rhododendron_vernicosum,62,50,12,Alphahull-PointsKO-Adjacents,2269
Rhododendron_vesiculiferum,1,1,0,Points-PointsKO-Adjacents,9
Rhododendron_viscosum,810,619,191,Alphahull-PointsKO-Adjacents,16036
Rhododendron_wardii,78,58,20,Alphahull-PointsKO-Adjacents,910
Rhododendron_watsonii,13,4,9,Points-PointsKO-Adjacents,105
Rhododendron_websterianum,9,3,6,Points-PointsKO-Adjacents,81
Rhododendron_westlandii,14,6,8,Points-PointsKO-Adjacents,126
Rhododendron_weyrichii,96,65,31,Alphahull-PointsKO-Adjacents,378
Rhododendron_wolongense,NA,NA,NA,NA,NA
Rhododendron_xanthocodon,1,1,0,Points-PointsKO-Adjacents,9
Rhododendron_zaleucum,19,10,9,Points-PointsKO-Adjacents,120
Rhododendron_ziyuanense,3,3,0,Points-PointsKO-Adjacents,27
Rhodognaphalon_brevicuspe,34,10,24,Points-PointsKO-Adjacents,261
Rhodognaphalon_lukayense,9,1,8,Points-PointsKO-Adjacents,64
Rhodolaena_acutifolia,20,1,19,Points-PointsKO-Adjacents,70
Rhodolaena_altivola,20,12,8,Points-PointsKO-Adjacents,115
Rhodolaena_bakeriana,56,40,16,Alphahull-PointsKO-Adjacents,433
Rhodolaena_coriacea,48,33,15,Alphahull-PointsKO-Adjacents,431
Rhodolaena_humblotii,30,22,8,Alphahull-PointsKO-Adjacents,164
Rhodolaena_leroyana,7,2,5,Points-PointsKO-Adjacents,24
Rhodolaena_macrocarpa,5,5,0,Points-PointsKO-Adjacents,15
Rhodoleia_championii,42,13,29,Points-PointsKO-Adjacents,256
Rhodoleia_forrestii,8,2,6,Points-PointsKO-Adjacents,63
Rhodoleia_henryi,3,3,0,Points-PointsKO-Adjacents,27
Rhodoleia_macrocarpa,2,2,0,Points-PointsKO-Adjacents,18
Rhodoleia_parvipetala,19,3,16,Points-PointsKO-Adjacents,171
Rhodoleia_stenopetala,3,3,0,Points-PointsKO-Adjacents,27
Rhodomyrtus_elegans,28,16,12,Points-PointsKO-Adjacents,156
Rhodomyrtus_kaweaensis,2,2,0,Points-PointsKO-Adjacents,13
Rhodomyrtus_lanata,37,31,6,Alphahull-PointsKO-Adjacents,105
Rhodomyrtus_locellata,23,15,8,Points-PointsKO-Adjacents,58
Rhodomyrtus_macrocarpa,246,208,38,Alphahull-PointsKO-Adjacents,823
Rhodomyrtus_mengenensis,2,2,0,Points-PointsKO-Adjacents,9
Rhodomyrtus_montana,4,4,0,Points-PointsKO-Adjacents,24
Rhodomyrtus_obovata,4,4,0,Points-PointsKO-Adjacents,30
Rhodomyrtus_pervagata,157,146,11,Alphahull-PointsKO-Adjacents,199
Rhodomyrtus_pinnatinervis,35,24,11,Alphahull-PointsKO-Adjacents,202
Rhodomyrtus_psidioides,508,440,68,Alphahull-PointsKO-Adjacents,1053
Rhodomyrtus_salomonensis,0,0,0,NA,0
Rhodomyrtus_sericea,90,77,13,Alphahull-PointsKO-Adjacents,181
Rhodomyrtus_surigaoensis,0,0,0,NA,0
Rhodomyrtus_takeuchii,1,1,0,Points-PointsKO-Adjacents,7
Rhodomyrtus_tomentosa,227,113,114,Alphahull-PointsKO-Adjacents,6078
Rhodomyrtus_trineura,343,279,64,Alphahull-PointsKO-Adjacents,3996
Rhodostemonodaphne_anomala,8,0,8,Points-PointsKO-Adjacents,62
Rhodostemonodaphne_antioquensis,3,3,0,Points-PointsKO-Adjacents,21
Rhodostemonodaphne_avilensis,3,3,0,Points-PointsKO-Adjacents,18
Rhodostemonodaphne_capixabensis,26,11,15,Points-PointsKO-Adjacents,146
Rhodostemonodaphne_crenaticupula,77,47,30,Alphahull-PointsKO-Adjacents,732
Rhodostemonodaphne_curicuriariensis,1,1,0,Points-PointsKO-Adjacents,9
Rhodostemonodaphne_cyclops,8,4,4,Points-PointsKO-Adjacents,40
Rhodostemonodaphne_debilis,3,3,0,Points-PointsKO-Adjacents,27
Rhodostemonodaphne_dioica,17,7,10,Points-PointsKO-Adjacents,153
Rhodostemonodaphne_elephantopus,5,0,5,Points-PointsKO-Adjacents,18
Rhodostemonodaphne_frontinensis,2,2,0,Points-PointsKO-Adjacents,16
Rhodostemonodaphne_grandis,118,53,65,Alphahull-PointsKO-Adjacents,3773
Rhodostemonodaphne_juruensis,46,12,34,Points-PointsKO-Adjacents,365
Rhodostemonodaphne_kunthiana,517,403,114,Alphahull-PointsKO-Adjacents,39681
Rhodostemonodaphne_laxa,31,23,8,Alphahull-PointsKO-Adjacents,167
Rhodostemonodaphne_leptoclada,1,1,0,Points-PointsKO-Adjacents,9
Rhodostemonodaphne_licanioides,16,7,9,Points-PointsKO-Adjacents,103
Rhodostemonodaphne_longiflora,8,0,8,Points-PointsKO-Adjacents,62
Rhodostemonodaphne_longipetiolata,5,5,0,Points-PointsKO-Adjacents,44
Rhodostemonodaphne_macrocalyx,154,0,154,Points-PointsKO-Adjacents,907
Rhodostemonodaphne_mirecolorata,4,4,0,Points-PointsKO-Adjacents,32
Rhodostemonodaphne_morii,9,2,7,Points-PointsKO-Adjacents,63
Rhodostemonodaphne_napoensis,8,0,8,Points-PointsKO-Adjacents,68
Rhodostemonodaphne_negrensis,30,0,30,Points-PointsKO-Adjacents,161
Rhodostemonodaphne_ovatifolia,2,2,0,Points-PointsKO-Adjacents,18
Rhodostemonodaphne_parvifolia,7,4,3,Points-PointsKO-Adjacents,30
Rhodostemonodaphne_peneia,31,15,16,Points-PointsKO-Adjacents,229
Rhodostemonodaphne_praeclara,51,17,34,Points-PointsKO-Adjacents,404
Rhodostemonodaphne_recurva,12,8,4,Points-PointsKO-Adjacents,75
Rhodostemonodaphne_revolutifolia,6,2,4,Points-PointsKO-Adjacents,33
Rhodostemonodaphne_rufovirgata,5,4,1,Points-PointsKO-Adjacents,30
Rhodostemonodaphne_scandens,29,15,14,Points-PointsKO-Adjacents,169
Rhodostemonodaphne_sordida,15,5,10,Points-PointsKO-Adjacents,118
Rhodostemonodaphne_synandra,13,4,9,Points-PointsKO-Adjacents,115
Rhodostemonodaphne_tumucumaquensis,3,3,0,Points-PointsKO-Adjacents,27
Rhodostemonodaphne_velutina,7,2,5,Points-PointsKO-Adjacents,36
Rhodothyrsus_hirsutus,4,4,0,Points-PointsKO-Adjacents,30
Rhodothyrsus_macrophyllus,200,144,56,Alphahull-PointsKO-Adjacents,15609
Rhoicissus_revoilii,176,114,62,Alphahull-PointsKO-Adjacents,5598
Rhoicissus_tridentata,443,344,99,Alphahull-PointsKO-Adjacents,13380
Rhoiptelea_chiliantha,32,17,15,Points-PointsKO-Adjacents,214
Rhopaloblaste_augusta,0,0,0,NA,0
Rhopaloblaste_ceramica,7,1,6,Points-PointsKO-Adjacents,57
Rhopaloblaste_elegans,1,1,0,Points-PointsKO-Adjacents,6
Rhopaloblaste_gideonii,NA,NA,NA,NA,NA
Rhopaloblaste_ledermanniana,8,2,6,Points-PointsKO-Adjacents,66
Rhopaloblaste_singaporensis,1,0,1,Points-PointsKO-Adjacents,9
Rhopalocarpus_alternifolius,26,16,10,Points-PointsKO-Adjacents,151
Rhopalocarpus_binervius,9,5,4,Points-PointsKO-Adjacents,40
Rhopalocarpus_coriaceus,62,43,19,Alphahull-PointsKO-Adjacents,231
Rhopalocarpus_crassinervius,10,0,10,Points-PointsKO-Adjacents,61
Rhopalocarpus_excelsus,9,3,6,Points-PointsKO-Adjacents,64
Rhopalocarpus_longipetiolatus,18,10,8,Points-PointsKO-Adjacents,78
Rhopalocarpus_louvelii,80,56,24,Alphahull-PointsKO-Adjacents,1262
Rhopalocarpus_lucidus,191,165,26,Alphahull-PointsKO-Adjacents,4071
Rhopalocarpus_macrorhamnifolius,34,18,16,Points-PointsKO-Adjacents,183
Rhopalocarpus_mollis,9,4,5,Points-PointsKO-Adjacents,61
Rhopalocarpus_parvifolius,6,1,5,Points-PointsKO-Adjacents,20
Rhopalocarpus_randrianaivoi,3,3,0,Points-PointsKO-Adjacents,22
Rhopalocarpus_similis,131,105,26,Alphahull-PointsKO-Adjacents,3256
Rhopalocarpus_suarezensis,19,14,5,Points-PointsKO-Adjacents,53
Rhopalocarpus_thouarsianus,21,10,11,Points-PointsKO-Adjacents,93
Rhopalocarpus_undulatus,25,17,8,Points-PointsKO-Adjacents,110
Rhopalopilia_pallens,18,1,17,Points-PointsKO-Adjacents,146
Rhopalostylis_baueri,9,1,8,Points-PointsKO-Adjacents,25
Rhopalostylis_sapida,1902,1827,75,Alphahull-PointsKO-Adjacents,2720
Rhus_chinensis,661,405,256,Alphahull-PointsKO-Adjacents,32570
Rhus_choriophylla,132,90,42,Alphahull-PointsKO-Adjacents,3607
Rhus_copallinum,2574,2084,490,Alphahull-PointsKO-Adjacents,40104
Rhus_coriaria,716,521,195,Alphahull-PointsKO-Adjacents,10492
Rhus_glabra,2859,2207,652,Alphahull-PointsKO-Adjacents,74953
Rhus_hypoleuca,10,1,9,Points-PointsKO-Adjacents,80
Rhus_integrifolia,1022,0,1022,Points-PointsKO-Adjacents,895
Rhus_kearneyi,60,1,59,Points-PointsKO-Adjacents,205
Rhus_lanceolata,191,146,45,Alphahull-PointsKO-Adjacents,4263
Rhus_microphylla,531,486,45,Alphahull-PointsKO-Adjacents,13491
Rhus_ovata,1375,1185,190,Alphahull-PointsKO-Adjacents,5053
Rhus_oxyacantha,0,0,0,NA,0
Rhus_pachyrrhachis,157,138,19,Alphahull-PointsKO-Adjacents,1956
Rhus_perrieri,71,49,22,Alphahull-PointsKO-Adjacents,962
Rhus_potaninii,36,15,21,Points-PointsKO-Adjacents,319
Rhus_punjabensis,74,44,30,Alphahull-PointsKO-Adjacents,4157
Rhus_sandwicensis,8,2,6,Points-PointsKO-Adjacents,51
Rhus_taitensis,236,166,70,Alphahull-PointsKO-Adjacents,2719
Rhus_taratana,118,103,15,Alphahull-PointsKO-Adjacents,1392
Rhus_terebinthifolia,506,431,75,Alphahull-PointsKO-Adjacents,8025
Rhus_thouarsii,91,70,21,Alphahull-PointsKO-Adjacents,2251
Rhus_typhina,2109,1348,761,Alphahull-PointsKO-Adjacents,31667
Rhus_virens,719,652,67,Alphahull-PointsKO-Adjacents,13668
Rhynchocalyx_lawsonioides,13,5,8,Points-PointsKO-Adjacents,79
Rhynchosia_calosperma,0,0,0,NA,0
Rhynchosia_clivorum,72,39,33,Alphahull-PointsKO-Adjacents,1179
Rhynchosia_divaricata,13,5,8,Points-PointsKO-Adjacents,108
Rhynchosia_laetissima,3,3,0,Points-PointsKO-Adjacents,21
Rhyticaryum_longifolium,45,27,18,Alphahull-PointsKO-Adjacents,592
Rhyticaryum_lucidum,NA,NA,NA,NA,NA
Rhyticaryum_macrocarpum,2,2,0,Points-PointsKO-Adjacents,12
Rhyticaryum_novoguineense,6,0,6,Points-PointsKO-Adjacents,39
Rhyticaryum_oleraceum,5,5,0,Points-PointsKO-Adjacents,37
Rhyticaryum_oxycarpum,1,1,0,Points-PointsKO-Adjacents,9
Rhyticaryum_rotundatum,NA,NA,NA,NA,NA
Rhytidanthera_splendida,33,22,11,Alphahull-PointsKO-Adjacents,705
Rhytidophyllum_grande,15,4,11,Points-PointsKO-Adjacents,62
Ribes_albifolium,1,1,0,Points-PointsKO-Adjacents,9
Ribes_brachybotrys,20,9,11,Points-PointsKO-Adjacents,139
Ribes_canescens,6,0,6,Points-PointsKO-Adjacents,45
Ribes_cuneifolium,21,12,9,Points-PointsKO-Adjacents,92
Ribes_ecuadorense,39,28,11,Alphahull-PointsKO-Adjacents,277
Ribes_elegans,8,4,4,Points-PointsKO-Adjacents,48
Ribes_sardoum,6,2,4,Points-PointsKO-Adjacents,37
Ribes_viscosum,9,0,9,Points-PointsKO-Adjacents,75
Richeria_australis,4,4,0,Points-PointsKO-Adjacents,30
Richeria_dressleri,74,54,20,Alphahull-PointsKO-Adjacents,723
Richeria_grandis,1098,925,173,Alphahull-PointsKO-Adjacents,91338
Richeria_obovata,7,0,7,Points-PointsKO-Adjacents,48
Richeria_tomentosa,24,14,10,Points-PointsKO-Adjacents,134
Ricinocarpos_stylosus,78,69,9,Alphahull-PointsKO-Adjacents,226
Ricinocarpos_verrucosus,23,13,10,Points-PointsKO-Adjacents,83
Ricinodendron_heudelotii,213,132,81,Alphahull-PointsKO-Adjacents,6972
Ricinus_communis,5818,3716,2102,Alphahull-PointsKO-Adjacents,103819
Rinorea_albidiflora,16,7,9,Points-PointsKO-Adjacents,124
Rinorea_amapensis,119,89,30,Alphahull-PointsKO-Adjacents,6789
Rinorea_angustifolia,219,135,84,Alphahull-PointsKO-Adjacents,5499
Rinorea_antioquiensis,0,0,0,NA,0
Rinorea_apiculata,162,121,41,Alphahull-PointsKO-Adjacents,5063
Rinorea_arborea,241,199,42,Alphahull-PointsKO-Adjacents,5725
Rinorea_aylmeri,27,15,12,Points-PointsKO-Adjacents,220
Rinorea_bahiensis,65,0,65,Points-PointsKO-Adjacents,443
Rinorea_batesii,14,7,7,Points-PointsKO-Adjacents,102
Rinorea_bengalensis,61,29,32,Alphahull-PointsKO-Adjacents,285
Rinorea_beniensis,20,11,9,Points-PointsKO-Adjacents,122
Rinorea_bicornuta,0,0,0,NA,0
Rinorea_brachypetala,71,27,44,Alphahull-PointsKO-Adjacents,1882
Rinorea_brachythrix,5,5,0,Points-PointsKO-Adjacents,44
Rinorea_brevipes,69,49,20,Alphahull-PointsKO-Adjacents,1286
Rinorea_breviracemosa,59,32,27,Alphahull-PointsKO-Adjacents,820
Rinorea_bullata,7,3,4,Points-PointsKO-Adjacents,30
Rinorea_camptoneura,49,21,28,Alphahull-PointsKO-Adjacents,768
Rinorea_cerasifolia,47,27,20,Alphahull-PointsKO-Adjacents,1629
Rinorea_claessensii,25,6,19,Points-PointsKO-Adjacents,192
Rinorea_convallarioides,36,9,27,Points-PointsKO-Adjacents,242
Rinorea_cordata,1,1,0,Points-PointsKO-Adjacents,9
Rinorea_cornigera,6,2,4,Points-PointsKO-Adjacents,48
Rinorea_crassifolia,3,3,0,Points-PointsKO-Adjacents,15
Rinorea_crenata,62,46,16,Alphahull-PointsKO-Adjacents,533
Rinorea_dasyadena,142,105,37,Alphahull-PointsKO-Adjacents,1977
Rinorea_deflexa,9,6,3,Points-PointsKO-Adjacents,36
Rinorea_deflexiflora,155,124,31,Alphahull-PointsKO-Adjacents,841
Rinorea_dentata,139,99,40,Alphahull-PointsKO-Adjacents,4400
Rinorea_djalonensis,0,0,0,NA,0
Rinorea_domatiosa,6,2,4,Points-PointsKO-Adjacents,43
Rinorea_ebolowensis,8,1,7,Points-PointsKO-Adjacents,72
Rinorea_elliotii,9,4,5,Points-PointsKO-Adjacents,72
Rinorea_elliptica,23,8,15,Points-PointsKO-Adjacents,187
Rinorea_endotricha,7,1,6,Points-PointsKO-Adjacents,63
Rinorea_falcata,252,179,73,Alphahull-PointsKO-Adjacents,38547
Rinorea_ferruginea,50,27,23,Alphahull-PointsKO-Adjacents,1014
Rinorea_flavescens,409,310,99,Alphahull-PointsKO-Adjacents,59142
Rinorea_gracilipes,9,2,7,Points-PointsKO-Adjacents,75
Rinorea_greveana,69,46,23,Alphahull-PointsKO-Adjacents,1225
Rinorea_guatemalensis,315,280,35,Alphahull-PointsKO-Adjacents,3168
Rinorea_guianensis,357,250,107,Alphahull-PointsKO-Adjacents,33499
Rinorea_haughtii,10,4,6,Points-PointsKO-Adjacents,81
Rinorea_hirsuta,33,24,9,Alphahull-PointsKO-Adjacents,897
Rinorea_hummelii,410,366,44,Alphahull-PointsKO-Adjacents,4561
Rinorea_hymenosepala,2,2,0,Points-PointsKO-Adjacents,9
Rinorea_ilicifolia,259,161,98,Alphahull-PointsKO-Adjacents,6091
Rinorea_keayi,7,2,5,Points-PointsKO-Adjacents,63
Rinorea_kibbiensis,42,0,42,Points-PointsKO-Adjacents,290
Rinorea_laevigata,19,7,12,Points-PointsKO-Adjacents,118
Rinorea_laurentii,9,2,7,Points-PointsKO-Adjacents,73
Rinorea_laurifolia,0,0,0,NA,0
Rinorea_leiophylla,48,32,16,Alphahull-PointsKO-Adjacents,831
Rinorea_lindeniana,909,814,95,Alphahull-PointsKO-Adjacents,60469
Rinorea_longicuspis,124,95,29,Alphahull-PointsKO-Adjacents,3506
Rinorea_longiracemosa,17,0,17,Points-PointsKO-Adjacents,111
Rinorea_longistipulata,6,0,6,Points-PointsKO-Adjacents,54
Rinorea_macrocarpa,340,299,41,Alphahull-PointsKO-Adjacents,30577
Rinorea_marginata,2,2,0,Points-PointsKO-Adjacents,18
Rinorea_maximiliani,3,2,1,Points-PointsKO-Adjacents,18
Rinorea_melanodonta,35,12,23,Points-PointsKO-Adjacents,270
Rinorea_mildbraedii,29,13,16,Points-PointsKO-Adjacents,238
Rinorea_multivenosa,19,3,16,Points-PointsKO-Adjacents,164
Rinorea_neglecta,157,95,62,Alphahull-PointsKO-Adjacents,11596
Rinorea_oblongifolia,257,206,51,Alphahull-PointsKO-Adjacents,8385
Rinorea_oraria,3,3,0,Points-PointsKO-Adjacents,18
Rinorea_ovalifolia,75,36,39,Alphahull-PointsKO-Adjacents,4246
Rinorea_paniculata,342,226,116,Alphahull-PointsKO-Adjacents,27130
Rinorea_pectinosquamata,7,5,2,Points-PointsKO-Adjacents,55
Rinorea_preussii,20,15,5,Points-PointsKO-Adjacents,114
Rinorea_pubiflora,1084,1004,80,Alphahull-PointsKO-Adjacents,79160
Rinorea_pugionifera,45,1,44,Points-PointsKO-Adjacents,202
Rinorea_racemosa,399,334,65,Alphahull-PointsKO-Adjacents,28268
Rinorea_ramiziana,9,1,8,Points-PointsKO-Adjacents,70
Rinorea_riana,278,226,52,Alphahull-PointsKO-Adjacents,21559
Rinorea_rubra,6,1,5,Points-PointsKO-Adjacents,32
Rinorea_rubrotincta,11,0,11,Points-PointsKO-Adjacents,94
Rinorea_scheffleri,5,5,0,Points-PointsKO-Adjacents,18
Rinorea_sclerocarpa,9,1,8,Points-PointsKO-Adjacents,70
Rinorea_seleensis,5,5,0,Points-PointsKO-Adjacents,43
Rinorea_sprucei,79,49,30,Alphahull-PointsKO-Adjacents,1694
Rinorea_squamata,0,0,0,NA,0
Rinorea_subsessilis,94,69,25,Alphahull-PointsKO-Adjacents,3944
Rinorea_sylvatica,81,57,24,Alphahull-PointsKO-Adjacents,877
Rinorea_tshingandaensis,4,3,1,Points-PointsKO-Adjacents,30
Rinorea_ulmifolia,8,4,4,Points-PointsKO-Adjacents,70
Rinorea_urschii,37,23,14,Alphahull-PointsKO-Adjacents,126
Rinorea_uxpanapana,4,4,0,Points-PointsKO-Adjacents,21
Rinorea_vaupesana,11,0,11,Points-PointsKO-Adjacents,90
Rinorea_villosiflora,1,0,1,Points-PointsKO-Adjacents,9
Rinorea_viridifolia,578,505,73,Alphahull-PointsKO-Adjacents,26032
Rinorea_welwitschii,275,217,58,Alphahull-PointsKO-Adjacents,6550
Rinorea_zygomorpha,18,0,18,Points-PointsKO-Adjacents,134
Rinoreocarpus_ulei,459,376,83,Alphahull-PointsKO-Adjacents,31910
Riodocea_pulcherrima,7,3,4,Points-PointsKO-Adjacents,49
Ristantia_gouldii,18,11,7,Points-PointsKO-Adjacents,57
Ristantia_pachysperma,55,41,14,Alphahull-PointsKO-Adjacents,102
Ristantia_waterhousei,10,7,3,Points-PointsKO-Adjacents,16
Ritchiea_albersii,99,62,37,Alphahull-PointsKO-Adjacents,4223
Ritchiea_aprevaliana,23,15,8,Points-PointsKO-Adjacents,120
Ritchiea_capparoides,282,217,65,Alphahull-PointsKO-Adjacents,4974
Ritchiea_insignis,3,3,0,Points-PointsKO-Adjacents,27
Rivea_hypocrateriformis,3,2,1,Points-PointsKO-Adjacents,27
Robbrechtia_grandifolia,40,25,15,Alphahull-PointsKO-Adjacents,219
Robinia_hispida,619,424,195,Alphahull-PointsKO-Adjacents,31191
Robinia_luxurians,1,1,0,Points-PointsKO-Adjacents,9
Robinia_neomexicana,719,0,719,Points-PointsKO-Adjacents,2091
Robinia_pseudoacacia,34184,28611,5573,Alphahull-PointsKO-Adjacents,123297
Robinia_viscosa,189,1,188,Points-PointsKO-Adjacents,1445
Robinsonella_brevituba,9,3,6,Points-PointsKO-Adjacents,60
Robinsonella_cordata,46,29,17,Alphahull-PointsKO-Adjacents,208
Robinsonella_densiflora,9,3,6,Points-PointsKO-Adjacents,78
Robinsonella_lindeniana,17,10,7,Points-PointsKO-Adjacents,34
Robinsonella_macvaughii,5,2,3,Points-PointsKO-Adjacents,31
Robinsonella_mirandae,152,139,13,Alphahull-PointsKO-Adjacents,756
Robinsonella_pleiopoda,3,3,0,Points-PointsKO-Adjacents,27
Robinsonella_samaricarpa,38,27,11,Alphahull-PointsKO-Adjacents,267
Robinsonella_speciosa,38,24,14,Alphahull-PointsKO-Adjacents,332
Cassine_eucleiformis,54,19,35,Points-PointsKO-Adjacents,438
Robynsia_glabrata,22,12,10,Points-PointsKO-Adjacents,164
Rochefortia_acanthophora,51,31,20,Alphahull-PointsKO-Adjacents,474
Rochefortia_lundellii,131,100,31,Alphahull-PointsKO-Adjacents,984
Rochefortia_spinosa,16,0,16,Points-PointsKO-Adjacents,119
Rockinghamia_angustifolia,139,119,20,Alphahull-PointsKO-Adjacents,240
Rockinghamia_brevipes,46,37,9,Alphahull-PointsKO-Adjacents,64
Rogersonanthus_arboreus,27,15,12,Points-PointsKO-Adjacents,135
Rogersonanthus_quelchii,14,5,9,Points-PointsKO-Adjacents,97
Rogiera_amoena,296,241,55,Alphahull-PointsKO-Adjacents,1738
Rogiera_cordata,116,0,116,Points-PointsKO-Adjacents,439
Rogiera_edwardsii,15,4,11,Points-PointsKO-Adjacents,102
Rogiera_langlassei,13,6,7,Points-PointsKO-Adjacents,81
Rogiera_ligustroides,42,30,12,Alphahull-PointsKO-Adjacents,115
Rogiera_nicaraguensis,21,13,8,Points-PointsKO-Adjacents,134
Rogiera_standleyana,2,2,0,Points-PointsKO-Adjacents,18
Rogiera_stenosiphon,155,137,18,Alphahull-PointsKO-Adjacents,917
Rojasianthe_superba,21,14,7,Points-PointsKO-Adjacents,75
Rollinia_elliptica,9,4,5,Points-PointsKO-Adjacents,45
Romeroa_verticillata,9,4,5,Points-PointsKO-Adjacents,62
Ronabea_latifolia,643,507,136,Alphahull-PointsKO-Adjacents,27508
Rondeletia_adamsii,3,3,0,Points-PointsKO-Adjacents,22
Rondeletia_amplexicaulis,0,0,0,NA,0
Rondeletia_areolata,0,0,0,NA,0
Rondeletia_aristeguietae,7,1,6,Points-PointsKO-Adjacents,55
Rondeletia_aurantiaca,1,1,0,Points-PointsKO-Adjacents,7
Rondeletia_barahonensis,7,3,4,Points-PointsKO-Adjacents,35
Rondeletia_belizensis,23,15,8,Points-PointsKO-Adjacents,137
Rondeletia_berteroana,3,2,1,Points-PointsKO-Adjacents,21
Rondeletia_brachyantha,0,0,0,NA,0
Rondeletia_brachyphylla,1,1,0,Points-PointsKO-Adjacents,9
Rondeletia_brauseana,1,1,0,Points-PointsKO-Adjacents,7
Rondeletia_brigandina,1,1,0,Points-PointsKO-Adjacents,9
Rondeletia_cacuminis,0,0,0,NA,0
Rondeletia_carnea,7,3,4,Points-PointsKO-Adjacents,57
Rondeletia_chinajensis,4,4,0,Points-PointsKO-Adjacents,36
Rondeletia_christii,11,4,7,Points-PointsKO-Adjacents,88
Rondeletia_cincta,0,0,0,NA,0
Rondeletia_clarendonensis,1,1,0,Points-PointsKO-Adjacents,9
Rondeletia_conferta,8,4,4,Points-PointsKO-Adjacents,50
Rondeletia_crassinervis,0,0,0,NA,0
Rondeletia_dolphinensis,NA,NA,NA,NA,NA
Rondeletia_domatiata,0,0,0,NA,0
Rondeletia_elegans,NA,NA,NA,NA,NA
Rondeletia_exasperata,2,2,0,Points-PointsKO-Adjacents,12
Rondeletia_feketeana,NA,NA,NA,NA,NA
Rondeletia_filisepala,1,1,0,Points-PointsKO-Adjacents,7
Rondeletia_formonia,0,0,0,NA,0
Rondeletia_fuertesii,3,3,0,Points-PointsKO-Adjacents,23
Rondeletia_glauca,2,2,0,Points-PointsKO-Adjacents,18
Rondeletia_hameliifolia,35,22,13,Alphahull-PointsKO-Adjacents,247
Rondeletia_harrisii,2,2,0,Points-PointsKO-Adjacents,12
Rondeletia_heterochroa,0,0,0,NA,0
Rondeletia_hirsuta,1,1,0,Points-PointsKO-Adjacents,9
Rondeletia_hirta,3,2,1,Points-PointsKO-Adjacents,18
Rondeletia_holdridgei,NA,NA,NA,NA,NA
Rondeletia_inermis,36,24,12,Alphahull-PointsKO-Adjacents,92
Rondeletia_liogieri,NA,NA,NA,NA,NA
Rondeletia_microcarpa,0,0,0,NA,0
Rondeletia_mornicola,1,1,0,Points-PointsKO-Adjacents,9
Rondeletia_nalgensis,1,1,0,Points-PointsKO-Adjacents,9
Rondeletia_nimanimae,1,1,0,Points-PointsKO-Adjacents,8
Rondeletia_ochracea,37,30,7,Alphahull-PointsKO-Adjacents,112
Rondeletia_orinocensis,9,4,5,Points-PointsKO-Adjacents,75
Rondeletia_pallida,NA,NA,NA,NA,NA
Rondeletia_panamensis,33,17,16,Points-PointsKO-Adjacents,124
Rondeletia_parviflora,8,1,7,Points-PointsKO-Adjacents,29
Rondeletia_pilosa,3,1,2,Points-PointsKO-Adjacents,15
Rondeletia_pitreana,2,2,0,Points-PointsKO-Adjacents,15
Rondeletia_portlandensis,1,1,0,Points-PointsKO-Adjacents,9
Rondeletia_portoricensis,13,9,4,Points-PointsKO-Adjacents,52
Rondeletia_pulchella,NA,NA,NA,NA,NA
Rondeletia_purdiei,40,21,19,Alphahull-PointsKO-Adjacents,333
Rondeletia_racemosa,1,1,0,Points-PointsKO-Adjacents,9
Rondeletia_roynaefolia,1,1,0,Points-PointsKO-Adjacents,9
Rondeletia_selleana,0,0,0,NA,0
Rondeletia_stipularis,2,2,0,Points-PointsKO-Adjacents,17
Rondeletia_subcordata,NA,NA,NA,NA,NA
Rondeletia_subsessilifolia,0,0,0,NA,0
Rondeletia_virgata,0,0,0,NA,0
Roscheria_melanochaetes,3,3,0,Points-PointsKO-Adjacents,15
Rosenbergiodendron_formosum,163,113,50,Alphahull-PointsKO-Adjacents,6645
Rosenbergiodendron_longiflorum,257,163,94,Alphahull-PointsKO-Adjacents,20109
Rosenbergiodendron_reflexum,14,0,14,Points-PointsKO-Adjacents,106
Roseodendron_chryseum,33,22,11,Alphahull-PointsKO-Adjacents,1189
Roseodendron_donnell-smithii,102,48,54,Alphahull-PointsKO-Adjacents,1902
Rotheca_cyanea,0,0,0,NA,0
Rotheca_farinosa,1,1,0,Points-PointsKO-Adjacents,9
Rotheca_myricoides,413,296,117,Alphahull-PointsKO-Adjacents,23791
Rotheca_reflexa,0,0,0,NA,0
Rotheca_sansibarensis,24,12,12,Points-PointsKO-Adjacents,189
Rotheca_suffruticosa,29,16,13,Points-PointsKO-Adjacents,253
Rotheca_verdcourtii,0,0,0,NA,0
Rotheca_wildii,9,0,9,Points-PointsKO-Adjacents,81
Rothmannia_annae,0,0,0,NA,0
Rothmannia_capensis,89,51,38,Alphahull-PointsKO-Adjacents,2306
Rothmannia_daweishanensis,NA,NA,NA,NA,NA
Rothmannia_ebamutensis,10,8,2,Points-PointsKO-Adjacents,39
Rothmannia_engleriana,106,66,40,Alphahull-PointsKO-Adjacents,8498
Rothmannia_eucodon,3,3,0,Points-PointsKO-Adjacents,18
Rothmannia_fischeri,100,51,49,Alphahull-PointsKO-Adjacents,4474
Rothmannia_globosa,57,25,32,Alphahull-PointsKO-Adjacents,1180
Rothmannia_hispida,160,116,44,Alphahull-PointsKO-Adjacents,6762
Rothmannia_kampucheana,0,0,0,NA,0
Rothmannia_kuchingensis,1,1,0,Points-PointsKO-Adjacents,9
Rothmannia_libisa,13,0,13,Points-PointsKO-Adjacents,69
Rothmannia_longiflora,325,256,69,Alphahull-PointsKO-Adjacents,7589
Rothmannia_lujae,51,31,20,Alphahull-PointsKO-Adjacents,2399
Rothmannia_macrocarpa,40,19,21,Points-PointsKO-Adjacents,313
Rothmannia_macrosiphon,38,23,15,Alphahull-PointsKO-Adjacents,406
Rothmannia_malayana,1,1,0,Points-PointsKO-Adjacents,9
Rothmannia_manganjae,33,11,22,Points-PointsKO-Adjacents,242
Rothmannia_mayumbensis,8,1,7,Points-PointsKO-Adjacents,39
Rothmannia_munsae,51,15,36,Points-PointsKO-Adjacents,214
Rothmannia_octomera,124,84,40,Alphahull-PointsKO-Adjacents,7298
Rothmannia_pulcherrima,0,0,0,NA,0
Rothmannia_ravae,42,25,17,Alphahull-PointsKO-Adjacents,573
Rothmannia_schoemanii,3,3,0,Points-PointsKO-Adjacents,27
Rothmannia_sootepensis,8,2,6,Points-PointsKO-Adjacents,66
Rothmannia_talbotii,82,0,82,Points-PointsKO-Adjacents,479
Rothmannia_thailandica,0,0,0,NA,0
Rothmannia_uranthera,0,0,0,NA,0
Rothmannia_urcelliformis,210,127,83,Alphahull-PointsKO-Adjacents,8466
Rothmannia_vidalii,0,0,0,NA,0
Rothmannia_vietnamensis,0,0,0,NA,0
Rothmannia_whitfieldii,295,199,96,Alphahull-PointsKO-Adjacents,14803
Rothmannia_wittii,3,2,1,Points-PointsKO-Adjacents,27
Roucheria_calophylla,140,94,46,Alphahull-PointsKO-Adjacents,5716
Roucheria_columbiana,210,135,75,Alphahull-PointsKO-Adjacents,15120
Roucheria_laxiflora,81,38,43,Alphahull-PointsKO-Adjacents,1419
Roucheria_schomburgkii,24,2,22,Points-PointsKO-Adjacents,216
Roupala_asplenioides,47,38,9,Alphahull-PointsKO-Adjacents,581
Roupala_barnettiae,3,3,0,Points-PointsKO-Adjacents,20
Roupala_brachybotrys,2,2,0,Points-PointsKO-Adjacents,18
Roupala_caparoensis,7,3,4,Points-PointsKO-Adjacents,40
Roupala_consimilis,64,41,23,Alphahull-PointsKO-Adjacents,683
Roupala_cordifolia,16,6,10,Points-PointsKO-Adjacents,110
Roupala_dielsii,27,1,26,Points-PointsKO-Adjacents,232
Roupala_filiflora,10,7,3,Points-PointsKO-Adjacents,61
Roupala_glaberrima,119,98,21,Alphahull-PointsKO-Adjacents,1379
Roupala_longepetiolata,36,22,14,Alphahull-PointsKO-Adjacents,882
Roupala_meisneri,124,97,27,Alphahull-PointsKO-Adjacents,3226
Roupala_mexicana,4,3,1,Points-PointsKO-Adjacents,32
Roupala_monosperma,170,122,48,Alphahull-PointsKO-Adjacents,2987
Roupala_montana,3844,3549,295,Alphahull-PointsKO-Adjacents,111613
Roupala_nitida,26,6,20,Points-PointsKO-Adjacents,221
Roupala_nonscripta,1,1,0,Points-PointsKO-Adjacents,9
Roupala_obtusata,167,110,57,Alphahull-PointsKO-Adjacents,11852
Roupala_pachypoda,83,0,83,Points-PointsKO-Adjacents,474
Roupala_pallida,14,0,14,Points-PointsKO-Adjacents,61
Roupala_paulensis,91,54,37,Alphahull-PointsKO-Adjacents,3092
Roupala_percoriacea,7,5,2,Points-PointsKO-Adjacents,34
Roupala_pseudocordata,38,25,13,Alphahull-PointsKO-Adjacents,766
Roupala_psilocarpa,6,1,5,Points-PointsKO-Adjacents,53
Roupala_sculpta,10,0,10,Points-PointsKO-Adjacents,69
Roupala_sessiliflora,4,4,0,Points-PointsKO-Adjacents,34
Roupala_sphenophyllum,0,0,0,NA,0
Roupala_spicata,2,2,0,Points-PointsKO-Adjacents,18
Roupala_steinbachii,2,2,0,Points-PointsKO-Adjacents,18
Roupala_suaveolens,48,32,16,Alphahull-PointsKO-Adjacents,1905
Rourea_adenophora,19,13,6,Points-PointsKO-Adjacents,75
Rourea_amazonica,219,146,73,Alphahull-PointsKO-Adjacents,22885
Rourea_antioquensis,13,7,6,Points-PointsKO-Adjacents,115
Rourea_bahiensis,20,10,10,Points-PointsKO-Adjacents,150
Rourea_blanchetiana,4,4,0,Points-PointsKO-Adjacents,36
Rourea_coccinea,198,129,69,Alphahull-PointsKO-Adjacents,9076
Rourea_discolor,25,0,25,Points-PointsKO-Adjacents,134
Rourea_induta,811,753,58,Alphahull-PointsKO-Adjacents,28655
Rourea_martiana,28,15,13,Points-PointsKO-Adjacents,175
Rourea_minor,322,143,179,Alphahull-PointsKO-Adjacents,18780
Rourea_orientalis,229,178,51,Alphahull-PointsKO-Adjacents,21553
Rourea_psammophila,10,0,10,Points-PointsKO-Adjacents,84
Rourea_pseudogardneriana,5,5,0,Points-PointsKO-Adjacents,36
Rourea_puberula,54,16,38,Points-PointsKO-Adjacents,448
Rourea_surinamensis,84,48,36,Alphahull-PointsKO-Adjacents,1624
Rourea_thomsonii,260,182,78,Alphahull-PointsKO-Adjacents,19367
Rousseauxia_chrysophylla,15,6,9,Points-PointsKO-Adjacents,64
Rousseauxia_tamatavensis,3,3,0,Points-PointsKO-Adjacents,10
Roystonea_altissima,6,2,4,Points-PointsKO-Adjacents,46
Roystonea_dunlapiana,9,2,7,Points-PointsKO-Adjacents,61
Roystonea_lenis,2,2,0,Points-PointsKO-Adjacents,18
Roystonea_maisiana,2,2,0,Points-PointsKO-Adjacents,18
Roystonea_oleracea,37,14,23,Points-PointsKO-Adjacents,293
Roystonea_princeps,4,3,1,Points-PointsKO-Adjacents,34
Roystonea_regia,88,35,53,Alphahull-PointsKO-Adjacents,1178
Roystonea_stellata,1,1,0,Points-PointsKO-Adjacents,9
Roystonea_violacea,1,1,0,Points-PointsKO-Adjacents,9
Ruagea_glabra,517,443,74,Alphahull-PointsKO-Adjacents,9392
Ruagea_hirsuta,107,63,44,Alphahull-PointsKO-Adjacents,1288
Ruagea_insignis,98,52,46,Alphahull-PointsKO-Adjacents,1306
Ruagea_membranacea,8,3,5,Points-PointsKO-Adjacents,48
Ruagea_microphylla,9,5,4,Points-PointsKO-Adjacents,28
Ruagea_ovalis,32,17,15,Points-PointsKO-Adjacents,140
Ruagea_pubescens,182,137,45,Alphahull-PointsKO-Adjacents,4507
Ruagea_smithii,7,0,7,Points-PointsKO-Adjacents,49
Ruagea_tomentosa,6,3,3,Points-PointsKO-Adjacents,54
Ruagea_trisperma,91,46,45,Alphahull-PointsKO-Adjacents,1873
Rubovietnamia_aristata,6,1,5,Points-PointsKO-Adjacents,54
Rubovietnamia_nonggangensis,NA,NA,NA,NA,NA
Rubus_steudneri,52,29,23,Alphahull-PointsKO-Adjacents,1151
Rudgea_amplexicaulis,14,6,8,Points-PointsKO-Adjacents,52
Rudgea_apodantha,3,3,0,Points-PointsKO-Adjacents,21
Rudgea_ayangannensis,2,2,0,Points-PointsKO-Adjacents,18
Rudgea_bracteata,74,51,23,Alphahull-PointsKO-Adjacents,4263
Rudgea_buntingii,5,5,0,Points-PointsKO-Adjacents,33
Rudgea_burchelliana,14,3,11,Points-PointsKO-Adjacents,126
Rudgea_cardonae,5,5,0,Points-PointsKO-Adjacents,39
Rudgea_ceriantha,8,2,6,Points-PointsKO-Adjacents,66
Rudgea_ciliata,74,52,22,Alphahull-PointsKO-Adjacents,964
Rudgea_citrifolia,25,14,11,Points-PointsKO-Adjacents,48
Rudgea_colombiana,63,41,22,Alphahull-PointsKO-Adjacents,1692
Rudgea_coriacea,133,101,32,Alphahull-PointsKO-Adjacents,940
Rudgea_cornifolia,1252,1108,144,Alphahull-PointsKO-Adjacents,92065
Rudgea_coronata,81,39,42,Alphahull-PointsKO-Adjacents,1752
Rudgea_costanensis,1,1,0,Points-PointsKO-Adjacents,9
Rudgea_crassifolia,21,4,17,Points-PointsKO-Adjacents,139
Rudgea_crassiloba,258,186,72,Alphahull-PointsKO-Adjacents,23319
Rudgea_erioloba,191,148,43,Alphahull-PointsKO-Adjacents,13286
Rudgea_erythrocarpa,11,0,11,Points-PointsKO-Adjacents,84
Rudgea_foveolata,26,8,18,Points-PointsKO-Adjacents,197
Rudgea_gardenioides,120,0,120,Points-PointsKO-Adjacents,644
Rudgea_graciliflora,121,70,51,Alphahull-PointsKO-Adjacents,5370
Rudgea_grandifructa,17,11,6,Points-PointsKO-Adjacents,102
Rudgea_guyanensis,101,60,41,Alphahull-PointsKO-Adjacents,3737
Rudgea_hemisphaerica,8,4,4,Points-PointsKO-Adjacents,30
Rudgea_horquetensis,0,0,0,NA,0
Rudgea_hostmanniana,283,229,54,Alphahull-PointsKO-Adjacents,16211
Rudgea_insignis,5,5,0,Points-PointsKO-Adjacents,39
Rudgea_interrupta,69,46,23,Alphahull-PointsKO-Adjacents,586
Rudgea_isthmensis,8,4,4,Points-PointsKO-Adjacents,41
Rudgea_jasminoides,1044,931,113,Alphahull-PointsKO-Adjacents,11046
Rudgea_karstenii,8,2,6,Points-PointsKO-Adjacents,55
Rudgea_laevis,17,12,5,Points-PointsKO-Adjacents,49
Rudgea_lanceifolia,146,78,68,Alphahull-PointsKO-Adjacents,8788
Rudgea_longiflora,105,61,44,Alphahull-PointsKO-Adjacents,7584
Rudgea_loretensis,23,6,17,Points-PointsKO-Adjacents,198
Rudgea_lucentifolia,0,0,0,NA,0
Rudgea_magna,1,0,1,Points-PointsKO-Adjacents,7
Rudgea_mandevilliifolia,2,2,0,Points-PointsKO-Adjacents,9
Rudgea_mcphersonii,6,1,5,Points-PointsKO-Adjacents,25
Rudgea_minor,68,35,33,Alphahull-PointsKO-Adjacents,396
Rudgea_monofructus,47,36,11,Alphahull-PointsKO-Adjacents,138
Rudgea_mouririoides,8,0,8,Points-PointsKO-Adjacents,71
Rudgea_nebulicola,7,2,5,Points-PointsKO-Adjacents,53
Rudgea_nodosa,52,29,23,Alphahull-PointsKO-Adjacents,912
Rudgea_obesiflora,11,2,9,Points-PointsKO-Adjacents,84
Rudgea_pachyphylla,7,0,7,Points-PointsKO-Adjacents,44
Rudgea_palicoureoides,72,26,46,Alphahull-PointsKO-Adjacents,1806
Rudgea_panamensis,4,4,0,Points-PointsKO-Adjacents,23
Rudgea_panurensis,155,122,33,Alphahull-PointsKO-Adjacents,6339
Rudgea_phaneroneura,7,2,5,Points-PointsKO-Adjacents,50
Rudgea_pittieri,64,42,22,Alphahull-PointsKO-Adjacents,341
Rudgea_raveniana,60,55,5,Alphahull-PointsKO-Adjacents,66
Rudgea_recurva,241,195,46,Alphahull-PointsKO-Adjacents,2384
Rudgea_reducticalyx,105,92,13,Alphahull-PointsKO-Adjacents,1530
Rudgea_reticulata,54,37,17,Alphahull-PointsKO-Adjacents,1365
Rudgea_sanblasensis,4,4,0,Points-PointsKO-Adjacents,11
Rudgea_sanarensis,21,2,19,Points-PointsKO-Adjacents,156
Rudgea_sclerocalyx,227,177,50,Alphahull-PointsKO-Adjacents,11002
Rudgea_sessilis,164,129,35,Alphahull-PointsKO-Adjacents,5354
Rudgea_skutchii,146,111,35,Alphahull-PointsKO-Adjacents,2717
Rudgea_sprucei,2,2,0,Points-PointsKO-Adjacents,18
Rudgea_stenophylla,21,4,17,Points-PointsKO-Adjacents,163
Rudgea_stipulacea,237,173,64,Alphahull-PointsKO-Adjacents,16586
Rudgea_tambillensis,6,2,4,Points-PointsKO-Adjacents,52
Rudgea_tayloriae,4,4,0,Points-PointsKO-Adjacents,21
Rudgea_tomentosa,99,66,33,Alphahull-PointsKO-Adjacents,797
Rudgea_trianae,14,7,7,Points-PointsKO-Adjacents,93
Rudgea_triflora,48,36,12,Alphahull-PointsKO-Adjacents,556
Rudgea_trifurcata,40,32,8,Alphahull-PointsKO-Adjacents,224
Rudgea_trujilloi,9,3,6,Points-PointsKO-Adjacents,79
Rudgea_umbrosa,29,0,29,Points-PointsKO-Adjacents,147
Rudgea_vareschii,NA,NA,NA,NA,NA
Rudgea_vellerea,47,0,47,Points-PointsKO-Adjacents,177
Rudgea_verticillata,144,108,36,Alphahull-PointsKO-Adjacents,4467
Rudgea_viburnoides,1045,941,104,Alphahull-PointsKO-Adjacents,50695
Rudgea_villiflora,13,0,13,Points-PointsKO-Adjacents,82
Ruellia_chartacea,104,82,22,Alphahull-PointsKO-Adjacents,1270
Ruizia_cordata,1,1,0,Points-PointsKO-Adjacents,9
Ruizodendron_ovale,278,239,39,Alphahull-PointsKO-Adjacents,8728
Ruizterania_albiflora,131,80,51,Alphahull-PointsKO-Adjacents,9688
Ruizterania_belemnensis,6,0,6,Points-PointsKO-Adjacents,54
Ruizterania_cassiquiarensis,35,18,17,Points-PointsKO-Adjacents,256
Ruizterania_clavata,6,0,6,Points-PointsKO-Adjacents,48
Ruizterania_esmeraldae,34,24,10,Alphahull-PointsKO-Adjacents,518
Ruizterania_ferruginea,77,61,16,Alphahull-PointsKO-Adjacents,2229
Ruizterania_gardneriana,21,2,19,Points-PointsKO-Adjacents,183
Ruizterania_obtusata,38,26,12,Alphahull-PointsKO-Adjacents,493
Ruizterania_retusa,180,126,54,Alphahull-PointsKO-Adjacents,9529
Ruizterania_rigida,7,4,3,Points-PointsKO-Adjacents,48
Ruizterania_sacculata,6,0,6,Points-PointsKO-Adjacents,39
Ruizterania_trichanthera,13,3,10,Points-PointsKO-Adjacents,104
Ruizterania_urceolata,1,0,1,Points-PointsKO-Adjacents,9
Ruizterania_wittrockii,111,66,45,Alphahull-PointsKO-Adjacents,15406
Ruprechtia_aperta,13,7,6,Points-PointsKO-Adjacents,96
Ruprechtia_apetala,198,54,144,Alphahull-PointsKO-Adjacents,3260
Ruprechtia_apurensis,11,3,8,Points-PointsKO-Adjacents,99
Ruprechtia_brachysepala,124,55,69,Alphahull-PointsKO-Adjacents,9003
Ruprechtia_brachystachya,17,3,14,Points-PointsKO-Adjacents,125
Ruprechtia_carina,7,0,7,Points-PointsKO-Adjacents,46
Ruprechtia_chiapensis,105,62,43,Alphahull-PointsKO-Adjacents,4459
Ruprechtia_coriacea,2,2,0,Points-PointsKO-Adjacents,16
Ruprechtia_costaricensis,24,18,6,Points-PointsKO-Adjacents,100
Ruprechtia_costata,94,65,29,Alphahull-PointsKO-Adjacents,1014
Ruprechtia_crenata,5,5,0,Points-PointsKO-Adjacents,36
Ruprechtia_cruegeri,21,9,12,Points-PointsKO-Adjacents,167
Ruprechtia_curranii,5,5,0,Points-PointsKO-Adjacents,39
Ruprechtia_exploratricis,58,39,19,Alphahull-PointsKO-Adjacents,2561
Ruprechtia_fusca,199,159,40,Alphahull-PointsKO-Adjacents,2247
Ruprechtia_glauca,26,18,8,Points-PointsKO-Adjacents,125
Ruprechtia_howardiana,0,0,0,NA,0
Ruprechtia_jamesonii,4,4,0,Points-PointsKO-Adjacents,36
Ruprechtia_laevigata,6,1,5,Points-PointsKO-Adjacents,45
Ruprechtia_latifunda,5,5,0,Points-PointsKO-Adjacents,38
Ruprechtia_laxiflora,970,865,105,Alphahull-PointsKO-Adjacents,39247
Ruprechtia_lundii,28,17,11,Points-PointsKO-Adjacents,170
Ruprechtia_maracensis,7,0,7,Points-PointsKO-Adjacents,57
Ruprechtia_nicaraguensis,29,21,8,Alphahull-PointsKO-Adjacents,109
Ruprechtia_obovata,2,2,0,Points-PointsKO-Adjacents,18
Ruprechtia_pallida,92,55,37,Alphahull-PointsKO-Adjacents,3073
Ruprechtia_paranensis,17,7,10,Points-PointsKO-Adjacents,131
Ruprechtia_peruviana,3,3,0,Points-PointsKO-Adjacents,18
Ruprechtia_ramiflora,141,108,33,Alphahull-PointsKO-Adjacents,4970
Ruprechtia_salicifolia,64,47,17,Alphahull-PointsKO-Adjacents,3105
Ruprechtia_standleyana,8,2,6,Points-PointsKO-Adjacents,70
Ruprechtia_tangarana,57,17,40,Points-PointsKO-Adjacents,457
Ruprechtia_tenuiflora,97,61,36,Alphahull-PointsKO-Adjacents,3534
Ruptiliocarpon_caracolito,110,84,26,Alphahull-PointsKO-Adjacents,640
Rustia_alba,6,2,4,Points-PointsKO-Adjacents,27
Rustia_angustifolia,13,1,12,Points-PointsKO-Adjacents,90
Rustia_bilsana,5,5,0,Points-PointsKO-Adjacents,33
Rustia_condamineoides,7,1,6,Points-PointsKO-Adjacents,54
Rustia_costaricensis,35,23,12,Alphahull-PointsKO-Adjacents,214
Rustia_dressleri,7,4,3,Points-PointsKO-Adjacents,35
Rustia_formosa,188,151,37,Alphahull-PointsKO-Adjacents,5783
Rustia_gracilis,18,8,10,Points-PointsKO-Adjacents,104
Rustia_haitiensis,0,0,0,NA,0
Rustia_occidentalis,123,78,45,Alphahull-PointsKO-Adjacents,3023
Rustia_rubra,39,18,21,Points-PointsKO-Adjacents,250
Rustia_schunkeana,32,15,17,Points-PointsKO-Adjacents,255
Rustia_simpsonii,4,4,0,Points-PointsKO-Adjacents,32
Rustia_thibaudioides,5,5,0,Points-PointsKO-Adjacents,30
Rustia_venezuelensis,2,2,0,Points-PointsKO-Adjacents,18
Rustia_viridiflora,7,3,4,Points-PointsKO-Adjacents,60
Rutaneblina_pusilla,8,0,8,Points-PointsKO-Adjacents,27
Rutidea_orientalis,80,48,32,Alphahull-PointsKO-Adjacents,2697
Ruyschia_pavonii,7,0,7,Points-PointsKO-Adjacents,49
Ryania_angustifolia,171,110,61,Alphahull-PointsKO-Adjacents,26907
Ryania_canescens,46,17,29,Points-PointsKO-Adjacents,372
Ryania_mansoana,35,17,18,Points-PointsKO-Adjacents,268
Ryania_pyrifera,122,73,49,Alphahull-PointsKO-Adjacents,9625
Ryania_speciosa,1126,1002,124,Alphahull-PointsKO-Adjacents,72411
Ryania_spruceana,105,58,47,Alphahull-PointsKO-Adjacents,3976
Ryparosa_javanica,43,15,28,Points-PointsKO-Adjacents,253
Rytigynia_acuminatissima,6,0,6,Points-PointsKO-Adjacents,52
Rytigynia_adenodonta,27,15,12,Points-PointsKO-Adjacents,173
Rytigynia_binata,11,5,6,Points-PointsKO-Adjacents,74
Rytigynia_bridsoniae,31,22,9,Alphahull-PointsKO-Adjacents,115
Rytigynia_bugoyensis,44,21,23,Alphahull-PointsKO-Adjacents,466
Rytigynia_caudatissima,8,4,4,Points-PointsKO-Adjacents,46
Rytigynia_celastroides,94,71,23,Alphahull-PointsKO-Adjacents,1662
Rytigynia_dewevrei,16,11,5,Points-PointsKO-Adjacents,107
Rytigynia_dubiosa,7,1,6,Points-PointsKO-Adjacents,47
Rytigynia_eickii,36,23,13,Alphahull-PointsKO-Adjacents,175
Rytigynia_ferruginea,NA,NA,NA,NA,NA
Rytigynia_hirsutiflora,8,3,5,Points-PointsKO-Adjacents,41
Rytigynia_kigeziensis,22,15,7,Points-PointsKO-Adjacents,83
Rytigynia_lecomtei,7,2,5,Points-PointsKO-Adjacents,51
Rytigynia_lichenoxenos,36,27,9,Alphahull-PointsKO-Adjacents,133
Rytigynia_longipedicellata,4,4,0,Points-PointsKO-Adjacents,23
Rytigynia_macrura,3,3,0,Points-PointsKO-Adjacents,27
Rytigynia_membranacea,12,8,4,Points-PointsKO-Adjacents,70
Rytigynia_monantha,57,37,20,Alphahull-PointsKO-Adjacents,488
Rytigynia_mrimaensis,14,7,7,Points-PointsKO-Adjacents,77
Rytigynia_neglecta,29,11,18,Points-PointsKO-Adjacents,203
Rytigynia_nodulosa,4,4,0,Points-PointsKO-Adjacents,22
Rytigynia_pseudolongicaudata,22,12,10,Points-PointsKO-Adjacents,108
Rytigynia_rhamnoides,0,0,0,NA,0
Rytigynia_rubiginosa,4,4,0,Points-PointsKO-Adjacents,36
Rytigynia_ruwenzoriensis,14,8,6,Points-PointsKO-Adjacents,94
Rytigynia_senegalensis,131,0,131,Points-PointsKO-Adjacents,680
Rytigynia_squamata,1,1,0,Points-PointsKO-Adjacents,9
Rytigynia_torrei,0,0,0,NA,0
Rytigynia_uhligii,60,36,24,Alphahull-PointsKO-Adjacents,860
Rytigynia_umbellulata,202,118,84,Alphahull-PointsKO-Adjacents,2422
Rytigynia_verruculosa,17,1,16,Points-PointsKO-Adjacents,144
Sabal_bermudana,1,0,1,Points-PointsKO-Adjacents,6
Sabal_causiarum,32,16,16,Points-PointsKO-Adjacents,217
Sabal_domingensis,6,1,5,Points-PointsKO-Adjacents,46
Sabal_etonia,70,54,16,Alphahull-PointsKO-Adjacents,555
Sabal_gretherae,13,5,8,Points-PointsKO-Adjacents,49
Sabal_maritima,11,4,7,Points-PointsKO-Adjacents,94
Sabal_mauritiiformis,232,170,62,Alphahull-PointsKO-Adjacents,7155
Sabal_mexicana,265,200,65,Alphahull-PointsKO-Adjacents,11616
Sabal_minor,673,513,160,Alphahull-PointsKO-Adjacents,10173
Sabal_palmetto,1152,1020,132,Alphahull-PointsKO-Adjacents,2382
Sabal_pumos,18,6,12,Points-PointsKO-Adjacents,152
Sabal_rosei,26,0,26,Points-PointsKO-Adjacents,208
Sabal_uresana,32,17,15,Points-PointsKO-Adjacents,230
Sabal_yapa,165,140,25,Alphahull-PointsKO-Adjacents,1600
Sabicea_dewevrei,29,17,12,Points-PointsKO-Adjacents,199
Sabicea_gigantea,1,1,0,Points-PointsKO-Adjacents,9
Sabicea_villosa,651,488,163,Alphahull-PointsKO-Adjacents,32294
Sacleuxia_tuberosa,1,1,0,Points-PointsKO-Adjacents,9
Sacoglottis_amazonica,52,12,40,Points-PointsKO-Adjacents,391
Sacoglottis_ceratocarpa,40,19,21,Points-PointsKO-Adjacents,306
Sacoglottis_cydonioides,67,36,31,Alphahull-PointsKO-Adjacents,2799
Sacoglottis_gabonensis,152,110,42,Alphahull-PointsKO-Adjacents,2442
Sacoglottis_guianensis,675,578,97,Alphahull-PointsKO-Adjacents,59699
Sacoglottis_holdridgei,7,2,5,Points-PointsKO-Adjacents,2
Sacoglottis_maguirei,1,1,0,Points-PointsKO-Adjacents,9
Sacoglottis_mattogrossensis,673,508,165,Alphahull-PointsKO-Adjacents,60366
Sacoglottis_ovicarpa,53,34,19,Alphahull-PointsKO-Adjacents,500
Sacoglottis_trichogyna,69,55,14,Alphahull-PointsKO-Adjacents,424
Sadymia_villosa,1,1,0,Points-PointsKO-Adjacents,9
Sageraea_elliptica,11,0,11,Points-PointsKO-Adjacents,90
Sageraea_grandiflora,0,0,0,NA,0
Sageraea_lanceolata,10,1,9,Points-PointsKO-Adjacents,60
Guatteria_laurifolia,NA,NA,NA,NA,NA
Bocagea_dalzellii,0,0,0,NA,0
Sageraea_sarawakensis,1,0,1,Points-PointsKO-Adjacents,9
Bocagea_thwaitesii,1,1,0,Points-PointsKO-Adjacents,9
Sageretia_henryi,30,11,19,Points-PointsKO-Adjacents,269
Sageretia_laxiflora,11,1,10,Points-PointsKO-Adjacents,99
Sageretia_paucicostata,29,8,21,Points-PointsKO-Adjacents,259
Sageretia_rugosa,36,14,22,Points-PointsKO-Adjacents,324
Sagotia_brachysepala,201,136,65,Alphahull-PointsKO-Adjacents,19662
Sagotia_racemosa,411,309,102,Alphahull-PointsKO-Adjacents,27826
Sagraea_abbottii,NA,NA,NA,NA,NA
Sagraea_capillaris,6,0,6,Points-PointsKO-Adjacents,52
Sagraea_umbrosa,40,25,15,Alphahull-PointsKO-Adjacents,94
Sagraea_woodsii,2,2,0,Points-PointsKO-Adjacents,9
Sakoanala_madagascariensis,4,2,2,Points-PointsKO-Adjacents,31
Sakoanala_villosa,11,0,11,Points-PointsKO-Adjacents,43
Salacca_glabrescens,2,2,0,Points-PointsKO-Adjacents,18
Salacca_secunda,0,0,0,NA,0
Salacca_stolonifera,NA,NA,NA,NA,NA
Salacca_wallichiana,9,2,7,Points-PointsKO-Adjacents,66
Salacca_zalacca,0,0,0,NA,0
Salacia_bussei,5,5,0,Points-PointsKO-Adjacents,45
Salacia_chinensis,46,7,39,Points-PointsKO-Adjacents,331
Salacia_cordata,324,217,107,Alphahull-PointsKO-Adjacents,8732
Salacia_crassifolia,379,341,38,Alphahull-PointsKO-Adjacents,17406
Salacia_duckei,99,31,68,Alphahull-PointsKO-Adjacents,3629
Salacia_elliptica,1080,922,158,Alphahull-PointsKO-Adjacents,74845
Salacia_fimbrisepala,2,2,0,Points-PointsKO-Adjacents,18
Salacia_gigantea,116,66,50,Alphahull-PointsKO-Adjacents,7467
Salacia_grandifolia,83,47,36,Alphahull-PointsKO-Adjacents,5218
Salacia_impressifolia,432,320,112,Alphahull-PointsKO-Adjacents,50498
Salacia_insignis,81,34,47,Alphahull-PointsKO-Adjacents,2773
Salacia_juruana,84,36,48,Alphahull-PointsKO-Adjacents,2237
Salacia_lehmbachii,176,134,42,Alphahull-PointsKO-Adjacents,4993
Salacia_leptoclada,23,3,20,Points-PointsKO-Adjacents,197
Salacia_loloensis,92,68,24,Alphahull-PointsKO-Adjacents,1652
Salacia_maburensis,23,14,9,Points-PointsKO-Adjacents,126
Salacia_macrantha,149,98,51,Alphahull-PointsKO-Adjacents,9486
Salacia_mamba,8,2,6,Points-PointsKO-Adjacents,63
Salacia_mannii,56,0,56,Points-PointsKO-Adjacents,388
Salacia_miqueliana,27,14,13,Points-PointsKO-Adjacents,205
Salacia_multiflora,199,102,97,Alphahull-PointsKO-Adjacents,8394
Salacia_ndakala,4,4,0,Points-PointsKO-Adjacents,24
Salacia_negrensis,22,5,17,Points-PointsKO-Adjacents,176
Salacia_opacifolia,29,11,18,Points-PointsKO-Adjacents,204
Salacia_pachyphylla,1,1,0,Points-PointsKO-Adjacents,9
Salacia_pallescens,114,77,37,Alphahull-PointsKO-Adjacents,3322
Salacia_panamensis,16,9,7,Points-PointsKO-Adjacents,71
Salacia_petenensis,89,76,13,Alphahull-PointsKO-Adjacents,236
Salacia_pyriformis,60,21,39,Alphahull-PointsKO-Adjacents,691
Salacia_rhodesiaca,6,4,2,Points-PointsKO-Adjacents,33
Salacia_solimoesensis,36,8,28,Points-PointsKO-Adjacents,302
Salacia_spectabilis,43,19,24,Points-PointsKO-Adjacents,265
Salacia_stuhlmanniana,53,19,34,Points-PointsKO-Adjacents,375
Lecardia_megaphylla,15,8,7,Points-PointsKO-Adjacents,46
Saldinia_pycnophylla,6,1,5,Points-PointsKO-Adjacents,41
Saldinia_subacuminata,51,30,21,Alphahull-PointsKO-Adjacents,289
Salix_abscondita,8,0,8,Points-PointsKO-Adjacents,64
Salix_acmophylla,303,239,64,Alphahull-PointsKO-Adjacents,1943
Salix_acutifolia,268,236,32,Alphahull-PointsKO-Adjacents,1344
Salix_aegyptiaca,4,4,0,Points-PointsKO-Adjacents,36
Salix_alaxensis,672,495,177,Alphahull-PointsKO-Adjacents,64187
Salix_alba,7630,0,7630,Points-PointsKO-Adjacents,10977
Salix_alfredii,0,0,0,NA,0
Salix_amygdaloides,2088,1716,372,Alphahull-PointsKO-Adjacents,73817
Salix_appendiculata,1225,1137,88,Alphahull-PointsKO-Adjacents,5619
Salix_araeostachya,23,12,11,Points-PointsKO-Adjacents,201
Salix_arbusculoides,600,444,156,Alphahull-PointsKO-Adjacents,62798
Salix_arbutifolia,2,2,0,Points-PointsKO-Adjacents,18
Salix_argyrophegga,7,2,5,Points-PointsKO-Adjacents,63
Salix_armeno-rossica,0,0,0,NA,0
Salix_atrocinerea,13914,11856,2058,Alphahull-PointsKO-Adjacents,29091
Salix_babylonica,1140,714,426,Alphahull-PointsKO-Adjacents,33107
Salix_baileyi,0,0,0,NA,0
Salix_balansaei,1,1,0,Points-PointsKO-Adjacents,9
Salix_balfouriana,9,6,3,Points-PointsKO-Adjacents,81
Salix_bangongensis,NA,NA,NA,NA,NA
Salix_barclayi,692,0,692,Points-PointsKO-Adjacents,4087
Salix_bebbiana,3600,3030,570,Alphahull-PointsKO-Adjacents,170355
Salix_bhutanensis,2,2,0,Points-PointsKO-Adjacents,18
Salix_bikouensis,1,1,0,Points-PointsKO-Adjacents,9
Salix_biondiana,5,5,0,Points-PointsKO-Adjacents,45
Salix_bonplandiana,1206,1033,173,Alphahull-PointsKO-Adjacents,19350
Salix_breweri,140,127,13,Alphahull-PointsKO-Adjacents,693
Salix_caprea,83146,70254,12892,Alphahull-PointsKO-Adjacents,83943
Salix_capusii,14,5,9,Points-PointsKO-Adjacents,108
Salix_cardiophylla,66,49,17,Alphahull-PointsKO-Adjacents,430
Salix_caroliniana,1068,831,237,Alphahull-PointsKO-Adjacents,26822
Salix_cavaleriei,28,18,10,Points-PointsKO-Adjacents,251
Salix_chaenomeloides,263,117,146,Alphahull-PointsKO-Adjacents,1746
Salix_cheilophila,46,12,34,Points-PointsKO-Adjacents,412
Salix_chekiangensis,3,2,1,Points-PointsKO-Adjacents,27
Salix_chevalieri,1,1,0,Points-PointsKO-Adjacents,9
Salix_chienii,17,7,10,Points-PointsKO-Adjacents,153
Salix_chikungensis,3,3,0,Points-PointsKO-Adjacents,27
Salix_chingiana,0,0,0,NA,0
Salix_coluteoides,1,1,0,Points-PointsKO-Adjacents,9
Salix_daltoniana,27,12,15,Points-PointsKO-Adjacents,188
Salix_dalungensis,NA,NA,NA,NA,NA
Salix_daphnoides,2005,1592,413,Alphahull-PointsKO-Adjacents,21640
Salix_delavayana,29,1,28,Points-PointsKO-Adjacents,254
Salix_denticulata,28,13,15,Points-PointsKO-Adjacents,225
Salix_discolor,1648,1127,521,Alphahull-PointsKO-Adjacents,72141
Salix_divergentistyla,3,3,0,Points-PointsKO-Adjacents,27
Salix_elbursensis,7,1,6,Points-PointsKO-Adjacents,45
Salix_eleagnos,3774,3287,487,Alphahull-PointsKO-Adjacents,21312
Salix_eriocephala,1680,1210,470,Alphahull-PointsKO-Adjacents,73908
Salix_erioclada,6,0,6,Points-PointsKO-Adjacents,54
Salix_etosia,6,1,5,Points-PointsKO-Adjacents,54
Salix_euxina,0,0,0,NA,0
Salix_excelsa,22,0,22,Points-PointsKO-Adjacents,183
Salix_exigua,3939,3408,531,Alphahull-PointsKO-Adjacents,89891
Salix_famelica,94,47,47,Alphahull-PointsKO-Adjacents,7689
Salix_fargesii,15,6,9,Points-PointsKO-Adjacents,135
Salix_floridana,6,1,5,Points-PointsKO-Adjacents,54
Salix_fulvopubescens,50,41,9,Alphahull-PointsKO-Adjacents,123
Salix_geyeriana,1253,1184,69,Alphahull-PointsKO-Adjacents,27911
Salix_glauca,14807,14275,532,Alphahull-PointsKO-Adjacents,153363
Salix_gmelinii,218,126,92,Alphahull-PointsKO-Adjacents,3743
Salix_gooddingii,1461,1233,228,Alphahull-PointsKO-Adjacents,27220
Salix_gussonei,1,1,0,Points-PointsKO-Adjacents,9
Salix_heterochroma,22,8,14,Points-PointsKO-Adjacents,186
Salix_heteromera,9,2,7,Points-PointsKO-Adjacents,80
Salix_hookeriana,323,215,108,Alphahull-PointsKO-Adjacents,2851
Salix_hukaoana,3,3,0,Points-PointsKO-Adjacents,16
Salix_humaensis,0,0,0,NA,0
Salix_hylonoma,20,9,11,Points-PointsKO-Adjacents,179
Salix_interior,2372,1823,549,Alphahull-PointsKO-Adjacents,65194
Salix_irrorata,328,296,32,Alphahull-PointsKO-Adjacents,3628
Salix_kangensis,1,1,0,Points-PointsKO-Adjacents,9
Salix_kirilowiana,0,0,0,NA,0
Salix_kongbanica,NA,NA,NA,NA,NA
Salix_kouytchensis,4,4,0,Points-PointsKO-Adjacents,36
Salix_kusanoi,24,15,9,Points-PointsKO-Adjacents,105
Salix_laevigata,1602,0,1602,Points-PointsKO-Adjacents,3983
Salix_lasiandra,1355,1047,308,Alphahull-PointsKO-Adjacents,49929
Salix_lasiolepis,3135,2641,494,Alphahull-PointsKO-Adjacents,32296
Salix_ledermannii,10,6,4,Points-PointsKO-Adjacents,58
Salix_leveilleana,3,3,0,Points-PointsKO-Adjacents,27
Salix_ligulifolia,469,432,37,Alphahull-PointsKO-Adjacents,8789
Salix_longistamina,NA,NA,NA,NA,NA
Salix_lucida,3209,2559,650,Alphahull-PointsKO-Adjacents,102196
Salix_lutea,780,684,96,Alphahull-PointsKO-Adjacents,50591
Salix_maccalliana,147,69,78,Alphahull-PointsKO-Adjacents,11901
Salix_magnifica,9,3,6,Points-PointsKO-Adjacents,81
Salix_medogensis,1,1,0,Points-PointsKO-Adjacents,9
Salix_melanopsis,608,0,608,Points-PointsKO-Adjacents,3311
Salix_mesnyi,25,0,25,Points-PointsKO-Adjacents,224
Salix_michelsonii,1,1,0,Points-PointsKO-Adjacents,9
Salix_miyabeana,56,0,56,Points-PointsKO-Adjacents,176
Salix_monticola,758,712,46,Alphahull-PointsKO-Adjacents,7675
Salix_moupinensis,9,2,7,Points-PointsKO-Adjacents,80
Salix_mucronata,301,13,288,Points-PointsKO-Adjacents,2484
Salix_myricoides,231,118,113,Alphahull-PointsKO-Adjacents,11390
Salix_myrsinifolia,25168,23220,1948,Alphahull-PointsKO-Adjacents,52234
Salix_myrtillifolia,468,311,157,Alphahull-PointsKO-Adjacents,44121
Salix_nankingensis,2,2,0,Points-PointsKO-Adjacents,18
Salix_neowilsonii,1,0,1,Points-PointsKO-Adjacents,9
Salix_niedzwieckii,13,4,9,Points-PointsKO-Adjacents,99
Salix_nigra,5141,4180,961,Alphahull-PointsKO-Adjacents,67647
Salix_nipponica,110,34,76,Alphahull-PointsKO-Adjacents,619
Salix_omeiensis,6,2,4,Points-PointsKO-Adjacents,44
Salix_oreinoma,9,0,9,Points-PointsKO-Adjacents,81
Salix_paraplesia,31,13,18,Points-PointsKO-Adjacents,273
Salix_pedicellata,485,433,52,Alphahull-PointsKO-Adjacents,2153
Salix_pellita,233,152,81,Alphahull-PointsKO-Adjacents,20454
Salix_pentandra,29134,25831,3303,Alphahull-PointsKO-Adjacents,67808
Salix_permollis,2,2,0,Points-PointsKO-Adjacents,18
Salix_petiolaris,821,563,258,Alphahull-PointsKO-Adjacents,43261
Salix_phaidima,6,0,6,Points-PointsKO-Adjacents,54
Salix_phanera,9,2,7,Points-PointsKO-Adjacents,81
Salix_pierotii,239,140,99,Alphahull-PointsKO-Adjacents,1603
Salix_pingliensis,NA,NA,NA,NA,NA
Salix_planifolia,1723,1475,248,Alphahull-PointsKO-Adjacents,123116
Salix_prolixa,411,0,411,Points-PointsKO-Adjacents,2926
Salix_pseudomedemii,2,2,0,Points-PointsKO-Adjacents,18
Salix_pseudomyrsinites,416,291,125,Alphahull-PointsKO-Adjacents,16992
Salix_pseudopentandra,7,0,7,Points-PointsKO-Adjacents,63
Salix_pseudopermollis,1,1,0,Points-PointsKO-Adjacents,9
Salix_pseudowallichiana,3,3,0,Points-PointsKO-Adjacents,25
Salix_psilostigma,4,4,0,Points-PointsKO-Adjacents,34
Salix_purpurea,18660,15541,3119,Alphahull-PointsKO-Adjacents,56821
Salix_pycnostachya,87,66,21,Alphahull-PointsKO-Adjacents,2012
Salix_pyrifolia,430,301,129,Alphahull-PointsKO-Adjacents,30901
Salix_pyrolifolia,29,5,24,Points-PointsKO-Adjacents,180
Salix_qinghaiensis,NA,NA,NA,NA,NA
Salix_rehderiana,31,14,17,Points-PointsKO-Adjacents,279
Salix_rorida,13,2,11,Points-PointsKO-Adjacents,105
Salix_sajanensis,0,0,0,NA,0
Salix_salviifolia,237,204,33,Alphahull-PointsKO-Adjacents,3628
Salix_schwerinii,84,19,65,Points-PointsKO-Adjacents,512
Salix_scouleriana,1989,1790,199,Alphahull-PointsKO-Adjacents,50541
Salix_sericea,874,0,874,Points-PointsKO-Adjacents,6051
Salix_sericocarpa,80,56,24,Alphahull-PointsKO-Adjacents,748
Salix_serissima,423,272,151,Alphahull-PointsKO-Adjacents,30939
Salix_sessilifolia,183,0,183,Points-PointsKO-Adjacents,1069
Salix_shihtsuanensis,3,2,1,Points-PointsKO-Adjacents,27
Salix_sieboldiana,206,181,25,Alphahull-PointsKO-Adjacents,798
Salix_sinica,19,8,11,Points-PointsKO-Adjacents,171
Salix_sitchensis,968,752,216,Alphahull-PointsKO-Adjacents,21924
Salix_songarica,0,0,0,NA,0
Salix_sphaeronymphe,7,1,6,Points-PointsKO-Adjacents,63
Salix_sumiyosensis,0,0,0,NA,0
Salix_taraikensis,28,5,23,Points-PointsKO-Adjacents,211
Salix_taxifolia,405,335,70,Alphahull-PointsKO-Adjacents,16551
Salix_tetrasperma,62,36,26,Alphahull-PointsKO-Adjacents,4321
Salix_thurberi,110,42,68,Alphahull-PointsKO-Adjacents,2922
Salix_triandra,15094,12003,3091,Alphahull-PointsKO-Adjacents,54898
Salix_triandroides,0,0,0,NA,0
Salix_trichocarpa,0,0,0,NA,0
Salix_turanica,26,16,10,Points-PointsKO-Adjacents,190
Salix_udensis,728,0,728,Points-PointsKO-Adjacents,2683
Salix_starkeana,5317,0,5317,Points-PointsKO-Adjacents,11982
Salix_repens,37679,0,37679,Points-PointsKO-Adjacents,28001
Salix_viminalis,29300,22411,6889,Alphahull-PointsKO-Adjacents,56114
Salix_weixiensis,1,1,0,Points-PointsKO-Adjacents,9
Salix_wilhelmsiana,34,0,34,Points-PointsKO-Adjacents,268
Salix_yadongensis,NA,NA,NA,NA,NA
Salix_yuhuangshanensis,NA,NA,NA,NA,NA
Salpianthus_arenarius,227,169,58,Alphahull-PointsKO-Adjacents,2251
Salsola_paletzkiana,0,0,0,NA,0
Salsola_richteri,0,0,0,NA,0
Salta_triflora,143,112,31,Alphahull-PointsKO-Adjacents,5905
Salvadora_australis,25,14,11,Points-PointsKO-Adjacents,215
Salvadora_oleoides,4,4,0,Points-PointsKO-Adjacents,36
Salvadora_persica,325,207,118,Alphahull-PointsKO-Adjacents,13291
Salvadoropsis_arenicola,4,4,0,Points-PointsKO-Adjacents,26
Salvertia_convallariodora,768,693,75,Alphahull-PointsKO-Adjacents,31361
Salvia_arborescens,1,1,0,Points-PointsKO-Adjacents,9
Salvia_breviflora,62,47,15,Alphahull-PointsKO-Adjacents,471
Salvia_dryophila,9,4,5,Points-PointsKO-Adjacents,44
Salvia_lachnaioclada,1,1,0,Points-PointsKO-Adjacents,7
Salvia_paryskii,0,0,0,NA,0
Salvia_sessei,224,191,33,Alphahull-PointsKO-Adjacents,2063
Samaipaticereus_corroanus,6,2,4,Points-PointsKO-Adjacents,37
Samanea_guineensis,0,0,0,NA,0
Samanea_inopinata,250,174,76,Alphahull-PointsKO-Adjacents,8598
Samanea_leptophylla,21,2,19,Points-PointsKO-Adjacents,171
Samanea_saman,533,413,120,Alphahull-PointsKO-Adjacents,15305
Samanea_tubulosa,364,245,119,Alphahull-PointsKO-Adjacents,32374
Sambucus_australis,384,301,83,Alphahull-PointsKO-Adjacents,16279
Sambucus_canadensis,1813,1323,490,Alphahull-PointsKO-Adjacents,59119
Sambucus_javanica,190,82,108,Alphahull-PointsKO-Adjacents,1641
Sambucus_lanceolata,4,4,0,Points-PointsKO-Adjacents,13
Sambucus_nigra,15659,12821,2838,Alphahull-PointsKO-Adjacents,111627
Sambucus_peruviana,107,69,38,Alphahull-PointsKO-Adjacents,925
Sambucus_racemosa,3629,3086,543,Alphahull-PointsKO-Adjacents,90099
Sambucus_williamsii,104,45,59,Alphahull-PointsKO-Adjacents,10223
Sampantaea_amentiflora,3,3,0,Points-PointsKO-Adjacents,27
Samyda_dodecandra,89,57,32,Alphahull-PointsKO-Adjacents,878
Samyda_mexicana,46,21,25,Alphahull-PointsKO-Adjacents,183
Samyda_yucatanensis,121,98,23,Alphahull-PointsKO-Adjacents,1100
Sanango_racemosum,61,33,28,Alphahull-PointsKO-Adjacents,818
Sanchezia_arborea,9,4,5,Points-PointsKO-Adjacents,81
Sanchezia_klugii,8,1,7,Points-PointsKO-Adjacents,72
Sanchezia_scandens,12,0,12,Points-PointsKO-Adjacents,90
Sanchezia_tigrina,8,1,7,Points-PointsKO-Adjacents,66
Sandoricum_beccarianum,1,1,0,Points-PointsKO-Adjacents,9
Sandoricum_koetjape,26,2,24,Points-PointsKO-Adjacents,212
Sandwithia_guyanensis,116,0,116,Points-PointsKO-Adjacents,853
Sandwithia_heterocalyx,73,48,25,Alphahull-PointsKO-Adjacents,3174
Sankowskya_stipularis,9,7,2,Points-PointsKO-Adjacents,12
Sannantha_bidwillii,71,54,17,Alphahull-PointsKO-Adjacents,173
Sannantha_brachypoda,16,12,4,Points-PointsKO-Adjacents,72
Sannantha_pinifolia,17,7,10,Points-PointsKO-Adjacents,93
Sannantha_pluriflora,787,728,59,Alphahull-PointsKO-Adjacents,1817
Sannantha_virgata,53,38,15,Alphahull-PointsKO-Adjacents,182
Sanrafaelia_ruffonammari,11,9,2,Points-PointsKO-Adjacents,18
Santalum_acuminatum,3983,3852,131,Alphahull-PointsKO-Adjacents,43343
Santalum_album,4,0,4,Points-PointsKO-Adjacents,36
Santalum_ellipticum,35,19,16,Points-PointsKO-Adjacents,137
Santalum_fernandezianum,3,3,0,Points-PointsKO-Adjacents,5
Santalum_freycinetianum,39,29,10,Alphahull-PointsKO-Adjacents,78
Santalum_haleakalae,32,21,11,Alphahull-PointsKO-Adjacents,56
Santalum_paniculatum,20,9,11,Points-PointsKO-Adjacents,70
Santalum_pyrularium,40,29,11,Alphahull-PointsKO-Adjacents,79
Santalum_salicifolium,0,0,0,NA,0
Santiria_trimera,761,718,43,Alphahull-PointsKO-Adjacents,8187
Santisukia_kerrii,0,0,0,NA,0
Santisukia_pagetii,3,3,0,Points-PointsKO-Adjacents,21
Santomasia_steyermarkii,3,3,0,Points-PointsKO-Adjacents,18
Sapindus_delavayi,30,12,18,Points-PointsKO-Adjacents,251
Sapindus_drummondii,199,115,84,Alphahull-PointsKO-Adjacents,7784
Sapindus_emarginatus,0,0,0,NA,0
Sapindus_marginatus,112,38,74,Alphahull-PointsKO-Adjacents,1396
Sapindus_mukorossi,394,254,140,Alphahull-PointsKO-Adjacents,19889
Sapindus_oahuensis,9,5,4,Points-PointsKO-Adjacents,36
Sapindus_rarak,14,2,12,Points-PointsKO-Adjacents,120
Sapindus_saponaria,3231,2667,564,Alphahull-PointsKO-Adjacents,111547
Sapindus_tomentosus,2,2,0,Points-PointsKO-Adjacents,18
Sapindus_trifoliatus,9,0,9,Points-PointsKO-Adjacents,71
Sapindus_vitiensis,5,5,0,Points-PointsKO-Adjacents,36
Sapium_adenodon,9,5,4,Points-PointsKO-Adjacents,59
Sapium_allenii,18,13,5,Points-PointsKO-Adjacents,53
Sapium_argutum,364,304,60,Alphahull-PointsKO-Adjacents,19744
Sapium_ciliatum,29,9,20,Points-PointsKO-Adjacents,239
Sapium_cuneatum,3,3,0,Points-PointsKO-Adjacents,21
Sapium_daphnoides,18,0,18,Points-PointsKO-Adjacents,126
Sapium_glandulosum,1363,1151,212,Alphahull-PointsKO-Adjacents,52645
Sapium_haematospermum,637,564,73,Alphahull-PointsKO-Adjacents,40197
Sapium_haitiense,1,1,0,Points-PointsKO-Adjacents,9
Sapium_jenmannii,55,24,31,Alphahull-PointsKO-Adjacents,7204
Sapium_lateriflorum,124,96,28,Alphahull-PointsKO-Adjacents,3082
Sapium_laurifolium,467,325,142,Alphahull-PointsKO-Adjacents,21951
Sapium_laurocerasus,19,16,3,Points-PointsKO-Adjacents,67
Sapium_leucogynum,2,2,0,Points-PointsKO-Adjacents,17
Sapium_macrocarpum,272,207,65,Alphahull-PointsKO-Adjacents,5034
Sapium_marmieri,521,452,69,Alphahull-PointsKO-Adjacents,37762
Sapium_obovatum,143,86,57,Alphahull-PointsKO-Adjacents,8574
Sapium_pachystachys,67,56,11,Alphahull-PointsKO-Adjacents,522
Sapium_pallidum,72,28,44,Alphahull-PointsKO-Adjacents,1545
Sapium_paucinervium,72,30,42,Alphahull-PointsKO-Adjacents,900
Sapium_sellowianum,49,21,28,Alphahull-PointsKO-Adjacents,557
Sapium_stylare,320,279,41,Alphahull-PointsKO-Adjacents,3896
Sapranthus_campechianus,155,124,31,Alphahull-PointsKO-Adjacents,2798
Sapranthus_foetidus,22,7,15,Points-PointsKO-Adjacents,130
Sapranthus_microcarpus,137,105,32,Alphahull-PointsKO-Adjacents,2102
Sapranthus_palanga,89,78,11,Alphahull-PointsKO-Adjacents,338
Sapranthus_violaceus,107,76,31,Alphahull-PointsKO-Adjacents,1195
Sapranthus_viridiflorus,63,54,9,Alphahull-PointsKO-Adjacents,278
Saprosma_arboreum,13,0,13,Points-PointsKO-Adjacents,112
Saprosma_corymbosum,1,1,0,Points-PointsKO-Adjacents,9
Saprosma_crassipes,5,5,0,Points-PointsKO-Adjacents,36
Saprosma_fragrans,1,1,0,Points-PointsKO-Adjacents,9
Saprosma_scabridum,NA,NA,NA,NA,NA
Saprosma_ternatum,9,2,7,Points-PointsKO-Adjacents,81
Saraca_asoca,4,0,4,Points-PointsKO-Adjacents,36
Saraca_celebica,2,2,0,Points-PointsKO-Adjacents,18
Saraca_declinata,118,83,35,Alphahull-PointsKO-Adjacents,5139
Saraca_dives,25,17,8,Points-PointsKO-Adjacents,221
Saraca_griffithiana,0,0,0,NA,0
Saraca_hullettii,3,3,0,Points-PointsKO-Adjacents,27
Saraca_indica,10,1,9,Points-PointsKO-Adjacents,90
Saraca_monadelpha,4,4,0,Points-PointsKO-Adjacents,28
Saraca_schmidiana,0,0,0,NA,0
Saraca_thaipingensis,5,1,4,Points-PointsKO-Adjacents,45
Saracha_pubescens,0,0,0,NA,0
Saracha_punctata,285,228,57,Alphahull-PointsKO-Adjacents,2979
Saracha_quitensis,70,59,11,Alphahull-PointsKO-Adjacents,398
Sararanga_philippinensis,3,3,0,Points-PointsKO-Adjacents,17
Sararanga_sinuosa,3,3,0,Points-PointsKO-Adjacents,15
Sarcaulus_brasiliensis,554,421,133,Alphahull-PointsKO-Adjacents,39644
Sarcaulus_inflexus,11,0,11,Points-PointsKO-Adjacents,99
Sarcaulus_oblatus,6,0,6,Points-PointsKO-Adjacents,54
Sarcaulus_vestitus,14,2,12,Points-PointsKO-Adjacents,124
Sarcaulus_wurdackii,11,2,9,Points-PointsKO-Adjacents,98
Sarcochlamys_pulcherrima,6,1,5,Points-PointsKO-Adjacents,50
Sarcolaena_codonochlamys,55,48,7,Alphahull-PointsKO-Adjacents,131
Sarcolaena_delphinensis,10,8,2,Points-PointsKO-Adjacents,20
Sarcolaena_eriophora,34,17,17,Points-PointsKO-Adjacents,101
Sarcolaena_grandiflora,16,8,8,Points-PointsKO-Adjacents,48
Sarcolaena_humbertiana,4,4,0,Points-PointsKO-Adjacents,18
Sarcolaena_isaloensis,5,5,0,Points-PointsKO-Adjacents,31
Sarcolaena_multiflora,173,132,41,Alphahull-PointsKO-Adjacents,1367
Sarcolaena_oblongifolia,96,78,18,Alphahull-PointsKO-Adjacents,667
Acronychia_leiocarpa,4,3,1,Points-PointsKO-Adjacents,18
Sarcomphalus_havanensis,1,1,0,Points-PointsKO-Adjacents,8
Sarcopera_anomala,79,43,36,Alphahull-PointsKO-Adjacents,1913
Sarcopera_tepuiensis,47,31,16,Alphahull-PointsKO-Adjacents,619
Ratonia_stipitata,78,66,12,Alphahull-PointsKO-Adjacents,345
Sarcosperma_affine,1,1,0,Points-PointsKO-Adjacents,9
Sarcosperma_angustifolium,1,1,0,Points-PointsKO-Adjacents,9
Sarcosperma_arboreum,34,1,33,Points-PointsKO-Adjacents,306
Sarcosperma_griffithii,3,2,1,Points-PointsKO-Adjacents,27
Sarcosperma_kachinense,21,7,14,Points-PointsKO-Adjacents,167
Sarcosperma_kontumense,0,0,0,NA,0
Sarcosperma_laurinum,32,14,18,Points-PointsKO-Adjacents,273
Sarcosperma_ovatifolium,NA,NA,NA,NA,NA
Sarcosperma_paniculatum,15,1,14,Points-PointsKO-Adjacents,107
Sarcosperma_pedunculatum,22,10,12,Points-PointsKO-Adjacents,198
Sarcosperma_uittienii,1,1,0,Points-PointsKO-Adjacents,9
Rourea_diversifolia,23,11,12,Points-PointsKO-Adjacents,149
Sarcotheca_laxa,4,0,4,Points-PointsKO-Adjacents,36
Ratonia_tenax,63,46,17,Alphahull-PointsKO-Adjacents,285
Saribus_brevifolius,2,2,0,Points-PointsKO-Adjacents,8
Saribus_chocolatinus,3,3,0,Points-PointsKO-Adjacents,25
Saribus_jeanneneyi,4,4,0,Points-PointsKO-Adjacents,15
Saribus_merrillii,2,2,0,Points-PointsKO-Adjacents,18
Saribus_papuanus,0,0,0,NA,0
Saribus_rotundifolius,10,1,9,Points-PointsKO-Adjacents,87
Saribus_surru,2,2,0,Points-PointsKO-Adjacents,18
Saribus_tothur,2,2,0,Points-PointsKO-Adjacents,18
Saribus_woodfordii,4,4,0,Points-PointsKO-Adjacents,20
Sassafras_albidum,16412,15042,1370,Alphahull-PointsKO-Adjacents,34585
Sassafras_randaiense,39,31,8,Alphahull-PointsKO-Adjacents,114
Sassafras_tzumu,89,58,31,Alphahull-PointsKO-Adjacents,7910
Satakentia_liukiuensis,1,0,1,Points-PointsKO-Adjacents,8
Satranala_decussilvae,18,11,7,Points-PointsKO-Adjacents,69
Satyria_breviflora,9,2,7,Points-PointsKO-Adjacents,75
Saurauia_adenodonta,28,18,10,Points-PointsKO-Adjacents,163
Saurauia_aequatoriensis,18,9,9,Points-PointsKO-Adjacents,107
Saurauia_angustifolia,53,39,14,Alphahull-PointsKO-Adjacents,460
Saurauia_arnoldii,13,2,11,Points-PointsKO-Adjacents,95
Saurauia_aromatica,34,22,12,Alphahull-PointsKO-Adjacents,608
Saurauia_aspera,131,109,22,Alphahull-PointsKO-Adjacents,1753
Saurauia_brachybotrys,274,239,35,Alphahull-PointsKO-Adjacents,2329
Saurauia_bullosa,139,111,28,Alphahull-PointsKO-Adjacents,1642
Saurauia_cana,196,172,24,Alphahull-PointsKO-Adjacents,1899
Saurauia_cerea,7,1,6,Points-PointsKO-Adjacents,63
Saurauia_chiliantha,59,44,15,Alphahull-PointsKO-Adjacents,494
Saurauia_chocoensis,21,15,6,Points-PointsKO-Adjacents,128
Saurauia_choriophylla,36,25,11,Alphahull-PointsKO-Adjacents,584
Saurauia_comitis-rossei,30,19,11,Points-PointsKO-Adjacents,158
Saurauia_conzattii,40,28,12,Alphahull-PointsKO-Adjacents,302
Saurauia_crassisepala,16,9,7,Points-PointsKO-Adjacents,78
Saurauia_cuatrecasana,91,72,19,Alphahull-PointsKO-Adjacents,540
Saurauia_cuchumatanensis,36,27,9,Alphahull-PointsKO-Adjacents,282
Saurauia_erythrocarpa,9,3,6,Points-PointsKO-Adjacents,61
Saurauia_excelsa,33,14,19,Points-PointsKO-Adjacents,229
Saurauia_floccifera,64,48,16,Alphahull-PointsKO-Adjacents,1376
Saurauia_glabra,33,22,11,Alphahull-PointsKO-Adjacents,118
Saurauia_griffithii,2,2,0,Points-PointsKO-Adjacents,12
Saurauia_herthae,48,35,13,Alphahull-PointsKO-Adjacents,516
Saurauia_kegeliana,118,99,19,Alphahull-PointsKO-Adjacents,1176
Saurauia_laevigata,23,16,7,Points-PointsKO-Adjacents,146
Saurauia_laxiflora,4,4,0,Points-PointsKO-Adjacents,36
Saurauia_lehmannii,17,8,9,Points-PointsKO-Adjacents,116
Saurauia_leucocarpa,128,96,32,Alphahull-PointsKO-Adjacents,1525
Saurauia_macrotricha,5,5,0,Points-PointsKO-Adjacents,45
Saurauia_madrensis,46,39,7,Alphahull-PointsKO-Adjacents,434
Saurauia_magnifica,9,1,8,Points-PointsKO-Adjacents,64
Saurauia_matudae,23,19,4,Points-PointsKO-Adjacents,94
Saurauia_mexiae,2,2,0,Points-PointsKO-Adjacents,18
Saurauia_micayensis,18,0,18,Points-PointsKO-Adjacents,137
Saurauia_miniata,16,4,12,Points-PointsKO-Adjacents,131
Saurauia_molinae,3,3,0,Points-PointsKO-Adjacents,27
Saurauia_montana,261,232,29,Alphahull-PointsKO-Adjacents,880
Saurauia_napaulensis,111,66,45,Alphahull-PointsKO-Adjacents,5186
Saurauia_oreophila,113,101,12,Alphahull-PointsKO-Adjacents,1328
Saurauia_oroquensis,2,2,0,Points-PointsKO-Adjacents,18
Saurauia_parviflora,48,33,15,Alphahull-PointsKO-Adjacents,233
Saurauia_peduncularis,25,16,9,Points-PointsKO-Adjacents,137
Saurauia_pedunculata,98,74,24,Alphahull-PointsKO-Adjacents,134
Ternstroemia_pentapetala,21,10,11,Points-PointsKO-Adjacents,180
Saurauia_pittieri,87,76,11,Alphahull-PointsKO-Adjacents,222
Saurauia_polyneura,58,43,15,Alphahull-PointsKO-Adjacents,213
Saurauia_portachuelensis,13,4,9,Points-PointsKO-Adjacents,89
Saurauia_prainiana,110,88,22,Alphahull-PointsKO-Adjacents,1388
Saurauia_pringlei,34,23,11,Alphahull-PointsKO-Adjacents,633
Saurauia_pseudoleucocarpa,11,4,7,Points-PointsKO-Adjacents,84
Saurauia_pseudostrigillosa,41,32,9,Alphahull-PointsKO-Adjacents,292
Saurauia_pulchra,6,0,6,Points-PointsKO-Adjacents,54
Saurauia_punduana,2,2,0,Points-PointsKO-Adjacents,18
Saurauia_pustulata,9,3,6,Points-PointsKO-Adjacents,57
Saurauia_putumayonis,29,16,13,Points-PointsKO-Adjacents,196
Saurauia_rubiformis,119,95,24,Alphahull-PointsKO-Adjacents,353
Saurauia_rusbyi,13,5,8,Points-PointsKO-Adjacents,95
Saurauia_scabra,51,35,16,Alphahull-PointsKO-Adjacents,946
Saurauia_scabrida,406,375,31,Alphahull-PointsKO-Adjacents,2469
Saurauia_schultesiana,3,3,0,Points-PointsKO-Adjacents,21
Saurauia_schultzeorum,6,1,5,Points-PointsKO-Adjacents,54
Saurauia_seibertii,10,1,9,Points-PointsKO-Adjacents,32
Saurauia_selerorum,41,24,17,Alphahull-PointsKO-Adjacents,314
Saurauia_serrata,154,124,30,Alphahull-PointsKO-Adjacents,3672
Saurauia_sinohirsuta,NA,NA,NA,NA,NA
Saurauia_spectabilis,51,37,14,Alphahull-PointsKO-Adjacents,433
Saurauia_stapfiana,103,83,20,Alphahull-PointsKO-Adjacents,1553
Saurauia_strigillosa,66,55,11,Alphahull-PointsKO-Adjacents,313
Saurauia_thyrsiflora,18,8,10,Points-PointsKO-Adjacents,162
Saurauia_tomentosa,169,140,29,Alphahull-PointsKO-Adjacents,1476
Saurauia_tristyla,334,265,69,Alphahull-PointsKO-Adjacents,4540
Saurauia_ursina,180,0,180,Points-PointsKO-Adjacents,573
Saurauia_villosa,97,78,19,Alphahull-PointsKO-Adjacents,1612
Saurauia_waldheimii,94,81,13,Alphahull-PointsKO-Adjacents,577
Saurauia_yasicae,454,393,61,Alphahull-PointsKO-Adjacents,7560
Saurauia_yunnanensis,5,5,0,Points-PointsKO-Adjacents,45
Saurauia_zahlbruckneri,20,10,10,Points-PointsKO-Adjacents,90
Sauropus_assimilis,3,3,0,Points-PointsKO-Adjacents,27
Sauropus_quadrangularis,40,19,21,Points-PointsKO-Adjacents,320
Sauropus_similis,8,1,7,Points-PointsKO-Adjacents,72
Savia_dictyocarpa,180,130,50,Alphahull-PointsKO-Adjacents,6248
Savia_sessiliflora,157,91,66,Alphahull-PointsKO-Adjacents,1861
Saxegothaea_conspicua,69,50,19,Alphahull-PointsKO-Adjacents,1219
Scaevola_chamissoniana,23,12,11,Points-PointsKO-Adjacents,115
Scaevola_gaudichaudiana,14,8,6,Points-PointsKO-Adjacents,52
Scaevola_plumieri,396,206,190,Alphahull-PointsKO-Adjacents,3178
Scaevola_procera,7,2,5,Points-PointsKO-Adjacents,35
Scagea_depauperata,12,1,11,Points-PointsKO-Adjacents,76
Scalesia_affinis,8,2,6,Points-PointsKO-Adjacents,52
Scalesia_aspera,1,1,0,Points-PointsKO-Adjacents,9
Scalesia_atractyloides,0,0,0,NA,0
Scalesia_baurii,0,0,0,NA,0
Scalesia_cordata,0,0,0,NA,0
Scalesia_crockeri,2,2,0,Points-PointsKO-Adjacents,9
Scalesia_divisa,1,1,0,Points-PointsKO-Adjacents,8
Scalesia_gordilloi,0,0,0,NA,0
Scalesia_helleri,1,1,0,Points-PointsKO-Adjacents,9
Scalesia_incisa,2,2,0,Points-PointsKO-Adjacents,16
Scalesia_microcephala,0,0,0,NA,0
Scalesia_pedunculata,4,4,0,Points-PointsKO-Adjacents,20
Scalesia_stewartii,1,1,0,Points-PointsKO-Adjacents,9
Scalesia_villosa,0,0,0,NA,0
Scaphium_affine,3,3,0,Points-PointsKO-Adjacents,27
Scaphium_burkillfilii,0,0,0,NA,0
Scaphium_linearicarpum,3,1,2,Points-PointsKO-Adjacents,21
Scaphium_longiflorum,0,0,0,NA,0
Scaphium_longipetiolatum,4,0,4,Points-PointsKO-Adjacents,27
Scaphium_macropodum,17,4,13,Points-PointsKO-Adjacents,122
Scaphium_parviflorum,0,0,0,NA,0
Scaphium_scaphigerum,9,3,6,Points-PointsKO-Adjacents,57
Scaphopetalum_amoenum,73,47,26,Alphahull-PointsKO-Adjacents,625
Scaphopetalum_blackii,193,172,21,Alphahull-PointsKO-Adjacents,2541
Scaphopetalum_dewevrei,51,0,51,Points-PointsKO-Adjacents,358
Scaphopetalum_parvifolium,6,3,3,Points-PointsKO-Adjacents,39
Scaphopetalum_talbotii,5,5,0,Points-PointsKO-Adjacents,30
Scaphopetalum_zenkeri,39,29,10,Alphahull-PointsKO-Adjacents,571
Schaefferia_argentinensis,192,0,192,Points-PointsKO-Adjacents,1474
Schaefferia_frutescens,120,63,57,Alphahull-PointsKO-Adjacents,1984
Schaefferia_ovatifolia,1,1,0,Points-PointsKO-Adjacents,9
Schefflera_abyssinica,48,19,29,Points-PointsKO-Adjacents,321
Schefflera_acaropunctata,14,9,5,Points-PointsKO-Adjacents,35
Schefflera_actinophylla,595,450,145,Alphahull-PointsKO-Adjacents,2930
Schefflera_acuminata,38,21,17,Alphahull-PointsKO-Adjacents,635
Schefflera_acuminatissima,0,0,0,NA,0
Schefflera_acutissima,8,1,7,Points-PointsKO-Adjacents,70
Schefflera_agamae,0,0,0,NA,0
Schefflera_agasthiyamalayana,NA,NA,NA,NA,NA
Schefflera_albidobracteata,1,1,0,Points-PointsKO-Adjacents,9
Schefflera_albocapitata,4,4,0,Points-PointsKO-Adjacents,32
Schefflera_allocotantha,16,9,7,Points-PointsKO-Adjacents,101
Schefflera_altigena,1,1,0,Points-PointsKO-Adjacents,9
Schefflera_alvarezii,0,0,0,NA,0
Schefflera_amungwiwae,2,2,0,Points-PointsKO-Adjacents,12
Schefflera_angiensis,1,1,0,Points-PointsKO-Adjacents,9
Schefflera_angilogensis,0,0,0,NA,0
Schefflera_angustissima,372,317,55,Alphahull-PointsKO-Adjacents,3490
Schefflera_apiculata,1,1,0,Points-PointsKO-Adjacents,9
Schefflera_aquaverensis,3,3,0,Points-PointsKO-Adjacents,23
Schefflera_archeri,58,41,17,Alphahull-PointsKO-Adjacents,236
Schefflera_argophylla,2,2,0,Points-PointsKO-Adjacents,9
Schefflera_aromatica,2,2,0,Points-PointsKO-Adjacents,18
Schefflera_asymmetrica,1,1,0,Points-PointsKO-Adjacents,9
Schefflera_attenuata,19,9,10,Points-PointsKO-Adjacents,55
Schefflera_aurata,8,5,3,Points-PointsKO-Adjacents,40
Schefflera_auyantepuiensis,2,2,0,Points-PointsKO-Adjacents,15
Schefflera_awa,5,5,0,Points-PointsKO-Adjacents,21
Schefflera_ayangannensis,0,0,0,NA,0
Schefflera_baculosa,2,2,0,Points-PointsKO-Adjacents,15
Schefflera_balansaeana,NA,NA,NA,NA,NA
Schefflera_banahaensis,0,0,0,NA,0
Schefflera_bangii,5,5,0,Points-PointsKO-Adjacents,45
Schefflera_barbata,11,5,6,Points-PointsKO-Adjacents,81
Schefflera_beccariana,1,0,1,Points-PointsKO-Adjacents,9
Schefflera_benguetensis,1,1,0,Points-PointsKO-Adjacents,9
Schefflera_bifida,2,2,0,Points-PointsKO-Adjacents,18
Schefflera_binuangensis,0,0,0,NA,0
Schefflera_bipalmatifolia,8,3,5,Points-PointsKO-Adjacents,30
Schefflera_blancoi,2,2,0,Points-PointsKO-Adjacents,18
Schefflera_blepharidophylla,52,42,10,Alphahull-PointsKO-Adjacents,460
Schefflera_bodinieri,12,4,8,Points-PointsKO-Adjacents,104
Schefflera_bogotensis,93,79,14,Alphahull-PointsKO-Adjacents,1648
Schefflera_bojeri,88,76,12,Alphahull-PointsKO-Adjacents,514
Schefflera_boridiana,4,4,0,Points-PointsKO-Adjacents,24
Schefflera_borneensis,NA,NA,NA,NA,NA
Schefflera_bougainvilleana,10,1,9,Points-PointsKO-Adjacents,62
Schefflera_bourdillonii,0,0,0,NA,0
Schefflera_brachypoda,1,1,0,Points-PointsKO-Adjacents,9
Schefflera_bracteolifera,6,2,4,Points-PointsKO-Adjacents,35
Schefflera_bractescens,25,17,8,Points-PointsKO-Adjacents,71
Schefflera_brassaiella,3,3,0,Points-PointsKO-Adjacents,21
Schefflera_brenesii,65,49,16,Alphahull-PointsKO-Adjacents,205
Schefflera_brevipedicellata,9,3,6,Points-PointsKO-Adjacents,70
Schefflera_buchtienii,10,6,4,Points-PointsKO-Adjacents,69
Schefflera_burchellii,108,81,27,Alphahull-PointsKO-Adjacents,5465
Schefflera_buxifolioides,0,0,0,NA,0
Schefflera_caduca,1,1,0,Points-PointsKO-Adjacents,9
Schefflera_calva,532,475,57,Alphahull-PointsKO-Adjacents,15880
Schefflera_calycina,1,1,0,Points-PointsKO-Adjacents,9
Schefflera_calyptricuspidata,9,4,5,Points-PointsKO-Adjacents,69
Schefflera_candelabrum,7,2,5,Points-PointsKO-Adjacents,41
Schefflera_capitata,1,0,1,Points-PointsKO-Adjacents,9
Schefflera_capitulifera,0,0,0,NA,0
Schefflera_capixaba,7,4,3,Points-PointsKO-Adjacents,30
Schefflera_capuroniana,17,8,9,Points-PointsKO-Adjacents,62
Schefflera_carrii,2,2,0,Points-PointsKO-Adjacents,18
Schefflera_cartagoensis,7,1,6,Points-PointsKO-Adjacents,27
Schefflera_catanduanensis,0,0,0,NA,0
Schefflera_caudata,0,0,0,NA,0
Schefflera_cavaleriei,NA,NA,NA,NA,NA
Schefflera_cephalantha,3,3,0,Points-PointsKO-Adjacents,23
Schefflera_cephalotes,0,0,0,NA,0
Schefflera_chaetorrhachis,9,0,9,Points-PointsKO-Adjacents,58
Schefflera_chandrasekharanii,NA,NA,NA,NA,NA
Schefflera_chapana,9,6,3,Points-PointsKO-Adjacents,53
Schefflera_chimantensis,46,33,13,Alphahull-PointsKO-Adjacents,189
Schefflera_chinensis,7,1,6,Points-PointsKO-Adjacents,63
Schefflera_chococola,28,14,14,Points-PointsKO-Adjacents,205
Schefflera_cicatricata,10,7,3,Points-PointsKO-Adjacents,58
Schefflera_ciliatifolia,24,15,9,Points-PointsKO-Adjacents,158
Schefflera_cinnamomea,0,0,0,NA,0
Schefflera_clausa,7,3,4,Points-PointsKO-Adjacents,32
Schefflera_clavigera,23,17,6,Points-PointsKO-Adjacents,66
Schefflera_clementis,1,1,0,Points-PointsKO-Adjacents,9
Schefflera_clusietorum,1,1,0,Points-PointsKO-Adjacents,9
Schefflera_coclensis,6,1,5,Points-PointsKO-Adjacents,26
Schefflera_coenosa,NA,NA,NA,NA,NA
Schefflera_concolor,2,2,0,Points-PointsKO-Adjacents,18
Schefflera_confusa,35,17,18,Points-PointsKO-Adjacents,270
Schefflera_contracta,1,1,0,Points-PointsKO-Adjacents,9
Schefflera_coriacea,27,16,11,Points-PointsKO-Adjacents,211
Schefflera_cracens,2,2,0,Points-PointsKO-Adjacents,18
Schefflera_crassilimba,4,4,0,Points-PointsKO-Adjacents,24
Schefflera_crassissima,0,0,0,NA,0
Schefflera_cuatrecasasiana,3,3,0,Points-PointsKO-Adjacents,21
Schefflera_cuneata,2,2,0,Points-PointsKO-Adjacents,18
Schefflera_curranii,0,0,0,NA,0
Schefflera_decaphylla,65,28,37,Alphahull-PointsKO-Adjacents,807
Schefflera_delavayi,121,90,31,Alphahull-PointsKO-Adjacents,11289
Schefflera_dichotoma,4,4,0,Points-PointsKO-Adjacents,18
Schefflera_dielsii,44,33,11,Alphahull-PointsKO-Adjacents,515
Schefflera_digitata,5702,5606,96,Alphahull-PointsKO-Adjacents,4591
Schefflera_digyna,7,0,7,Points-PointsKO-Adjacents,48
Schefflera_diplodactyla,62,53,9,Alphahull-PointsKO-Adjacents,406
Schefflera_disparifolia,2,2,0,Points-PointsKO-Adjacents,18
Schefflera_dissidens,0,0,0,NA,0
Schefflera_distractiflora,278,236,42,Alphahull-PointsKO-Adjacents,16806
Schefflera_divaricata,1,1,0,Points-PointsKO-Adjacents,9
Schefflera_dolichostyla,5,5,0,Points-PointsKO-Adjacents,45
Schefflera_duidae,42,25,17,Alphahull-PointsKO-Adjacents,1392
Schefflera_dumicola,2,2,0,Points-PointsKO-Adjacents,18
Schefflera_elachistocephala,12,0,12,Points-PointsKO-Adjacents,97
Schefflera_elata,3,3,0,Points-PointsKO-Adjacents,27
Schefflera_elliptifoliola,0,0,0,NA,0
Schefflera_enneaphylla,NA,NA,NA,NA,NA
Schefflera_epiphytica,48,31,17,Alphahull-PointsKO-Adjacents,109
Schefflera_eriocephala,7,0,7,Points-PointsKO-Adjacents,53
Schefflera_euryphylla,3,3,0,Points-PointsKO-Adjacents,27
Schefflera_euthytricha,0,0,0,NA,0
Schefflera_evrardii,2,2,0,Points-PointsKO-Adjacents,18
Schefflera_exaltata,2,2,0,Points-PointsKO-Adjacents,18
Schefflera_eximia,2,2,0,Points-PointsKO-Adjacents,12
Schefflera_fantsipanensis,5,5,0,Points-PointsKO-Adjacents,21
Schefflera_fastigiata,1,1,0,Points-PointsKO-Adjacents,9
Schefflera_favargeri,30,23,7,Alphahull-PointsKO-Adjacents,219
Schefflera_fengii,6,1,5,Points-PointsKO-Adjacents,48
Schefflera_ferruginea,50,26,24,Alphahull-PointsKO-Adjacents,406
Schefflera_fimbriata,2,2,0,Points-PointsKO-Adjacents,18
Schefflera_fosbergiana,9,7,2,Points-PointsKO-Adjacents,25
Schefflera_foxworthyi,2,2,0,Points-PointsKO-Adjacents,15
Schefflera_frodiniana,3,3,0,Points-PointsKO-Adjacents,15
Schefflera_gigantifolia,0,0,0,NA,0
Schefflera_gjellerupii,0,0,0,NA,0
Schefflera_glabrata,10,2,8,Points-PointsKO-Adjacents,59
Schefflera_glabrescens,6,1,5,Points-PointsKO-Adjacents,39
Schefflera_glauca,1,1,0,Points-PointsKO-Adjacents,9
Schefflera_gleasonii,8,6,2,Points-PointsKO-Adjacents,28
Schefflera_goetzenii,33,15,18,Points-PointsKO-Adjacents,199
Schefflera_gracilis,0,0,0,NA,0
Schefflera_gracillima,6,1,5,Points-PointsKO-Adjacents,21
Schefflera_grandigemma,6,3,3,Points-PointsKO-Adjacents,16
Schefflera_guanayensis,4,4,0,Points-PointsKO-Adjacents,24
Schefflera_guizhouensis,NA,NA,NA,NA,NA
Schefflera_hainanensis,1,1,0,Points-PointsKO-Adjacents,9
Schefflera_halleana,12,9,3,Points-PointsKO-Adjacents,29
Schefflera_harmsii,9,6,3,Points-PointsKO-Adjacents,72
Schefflera_havilandii,0,0,0,NA,0
Schefflera_hellwigiana,1,1,0,Points-PointsKO-Adjacents,9
Schefflera_hemiepiphytica,0,0,0,NA,0
Schefflera_heptaphylla,124,71,53,Alphahull-PointsKO-Adjacents,5885
Schefflera_herzogii,58,46,12,Alphahull-PointsKO-Adjacents,417
Schefflera_heterobotrya,0,0,0,NA,0
Schefflera_heterophylla,7,1,6,Points-PointsKO-Adjacents,63
Schefflera_heterotricha,30,0,30,Points-PointsKO-Adjacents,178
Schefflera_hierniana,4,4,0,Points-PointsKO-Adjacents,30
Schefflera_hirsuta,1,1,0,Points-PointsKO-Adjacents,9
Schefflera_hitchcockii,9,5,4,Points-PointsKO-Adjacents,41
Schefflera_hoi,21,9,12,Points-PointsKO-Adjacents,162
Schefflera_huachamacarii,3,3,0,Points-PointsKO-Adjacents,23
Schefflera_huberi,2,2,0,Points-PointsKO-Adjacents,16
Schefflera_hullettii,5,5,0,Points-PointsKO-Adjacents,45
Schefflera_humblotiana,6,0,6,Points-PointsKO-Adjacents,42
Schefflera_humboldtiana,1,1,0,Points-PointsKO-Adjacents,9
Schefflera_hypochlora,0,0,0,NA,0
Schefflera_hypoleuca,13,4,9,Points-PointsKO-Adjacents,101
Schefflera_hypoleucoides,13,4,9,Points-PointsKO-Adjacents,102
Schefflera_inambarica,22,7,15,Points-PointsKO-Adjacents,174
Schefflera_insculpta,6,1,5,Points-PointsKO-Adjacents,35
Schefflera_insignis,2,2,0,Points-PointsKO-Adjacents,18
Schefflera_instita,17,8,9,Points-PointsKO-Adjacents,97
Schefflera_insularum,4,4,0,Points-PointsKO-Adjacents,36
Schefflera_ischnoacra,26,12,14,Points-PointsKO-Adjacents,169
Schefflera_ischyrocephala,1,1,0,Points-PointsKO-Adjacents,9
Schefflera_jahnii,2,2,0,Points-PointsKO-Adjacents,18
Schefflera_japurensis,80,52,28,Alphahull-PointsKO-Adjacents,4621
Schefflera_jauaensis,2,2,0,Points-PointsKO-Adjacents,12
Schefflera_jefensis,7,3,4,Points-PointsKO-Adjacents,28
Schefflera_kaniensis,0,0,0,NA,0
Schefflera_karsteniana,8,2,6,Points-PointsKO-Adjacents,57
Schefflera_kerchoveiana,NA,NA,NA,NA,NA
Schefflera_khasiana,9,2,7,Points-PointsKO-Adjacents,58
Schefflera_kollmannii,14,9,5,Points-PointsKO-Adjacents,30
Schefflera_kontumensis,NA,NA,NA,NA,NA
Schefflera_koresii,2,2,0,Points-PointsKO-Adjacents,18
Schefflera_kornasii,1,1,0,Points-PointsKO-Adjacents,9
Schefflera_kraemeri,0,0,0,NA,0
Schefflera_kuborensis,2,2,0,Points-PointsKO-Adjacents,9
Schefflera_kuchingensis,2,2,0,Points-PointsKO-Adjacents,12
Schefflera_kuntzei,4,4,0,Points-PointsKO-Adjacents,36
Schefflera_kurzii,NA,NA,NA,NA,NA
Schefflera_lancifoliolata,6,1,5,Points-PointsKO-Adjacents,38
Schefflera_lasiogyne,51,41,10,Alphahull-PointsKO-Adjacents,321
Schefflera_lasiosphaera,5,5,0,Points-PointsKO-Adjacents,30
Schefflera_latifoliolata,0,0,0,NA,0
Schefflera_lawranceana,0,0,0,NA,0
Schefflera_laxiuscula,2,2,0,Points-PointsKO-Adjacents,18
Schefflera_leiophylla,0,0,0,NA,0
Schefflera_leroyiana,0,0,0,NA,0
Schefflera_leucantha,52,29,23,Alphahull-PointsKO-Adjacents,690
Schefflera_littoralis,3,3,0,Points-PointsKO-Adjacents,27
Schefflera_littorea,3,3,0,Points-PointsKO-Adjacents,24
Schefflera_lociana,2,2,0,Points-PointsKO-Adjacents,18
Schefflera_longipetiolata,43,32,11,Alphahull-PointsKO-Adjacents,722
Schefflera_longifolia,1,1,0,Points-PointsKO-Adjacents,9
Schefflera_longipedicellata,112,91,21,Alphahull-PointsKO-Adjacents,1584
Schefflera_longistyla,2,2,0,Points-PointsKO-Adjacents,16
Schefflera_lorentzii,3,3,0,Points-PointsKO-Adjacents,9
Schefflera_lucescens,2,2,0,Points-PointsKO-Adjacents,18
Schefflera_lukwangulensis,19,10,9,Points-PointsKO-Adjacents,113
Schefflera_macerosa,7,1,6,Points-PointsKO-Adjacents,42
Schefflera_macphersonii,6,2,4,Points-PointsKO-Adjacents,18
Schefflera_macrantha,0,0,0,NA,0
Schefflera_macrocarpa,599,525,74,Alphahull-PointsKO-Adjacents,19607
Schefflera_macrophylla,18,0,18,Points-PointsKO-Adjacents,117
Schefflera_maduraiensis,0,0,0,NA,0
Schefflera_magnifolia,29,14,15,Points-PointsKO-Adjacents,204
Schefflera_maguireorum,1,1,0,Points-PointsKO-Adjacents,9
Schefflera_malmei,67,45,22,Alphahull-PointsKO-Adjacents,3974
Schefflera_mannii,39,25,14,Alphahull-PointsKO-Adjacents,272
Schefflera_manus-dei,6,0,6,Points-PointsKO-Adjacents,42
Schefflera_marahuacensis,8,2,6,Points-PointsKO-Adjacents,22
Schefflera_marginata,23,16,7,Points-PointsKO-Adjacents,91
Schefflera_marlipoensis,3,3,0,Points-PointsKO-Adjacents,16
Schefflera_mathewsii,7,1,6,Points-PointsKO-Adjacents,54
Schefflera_megacarpa,21,8,13,Points-PointsKO-Adjacents,159
Schefflera_megalantha,7,0,7,Points-PointsKO-Adjacents,52
Schefflera_meiurophylla,2,2,0,Points-PointsKO-Adjacents,15
Schefflera_merrillii,1,1,0,Points-PointsKO-Adjacents,9
Schefflera_metcalfiana,9,2,7,Points-PointsKO-Adjacents,57
Schefflera_micrantha,1,0,1,Points-PointsKO-Adjacents,9
Schefflera_microgyne,0,0,0,NA,0
Schefflera_minutiflora,113,87,26,Alphahull-PointsKO-Adjacents,1377
Schefflera_minutipetiolata,0,0,0,NA,0
Schefflera_minutistellata,33,11,22,Points-PointsKO-Adjacents,293
Schefflera_mjoebergii,2,2,0,Points-PointsKO-Adjacents,18
Schefflera_monophylla,44,21,23,Alphahull-PointsKO-Adjacents,461
Schefflera_monosperma,11,4,7,Points-PointsKO-Adjacents,62
Schefflera_montana,17,11,6,Points-PointsKO-Adjacents,94
Schefflera_monticola,7,4,3,Points-PointsKO-Adjacents,39
Schefflera_monzonensis,0,0,0,NA,0
Schefflera_moratii,9,3,6,Points-PointsKO-Adjacents,48
Schefflera_morobeana,3,3,0,Points-PointsKO-Adjacents,21
Schefflera_morototoni,2103,1866,237,Alphahull-PointsKO-Adjacents,141597
Schefflera_multifoliolata,1,1,0,Points-PointsKO-Adjacents,9
Schefflera_multinervia,1,1,0,Points-PointsKO-Adjacents,9
Schefflera_multiramosa,2,2,0,Points-PointsKO-Adjacents,18
Schefflera_munchiquensis,5,0,5,Points-PointsKO-Adjacents,41
Schefflera_myriantha,83,47,36,Alphahull-PointsKO-Adjacents,1114
Schefflera_myriocarpa,1,1,0,Points-PointsKO-Adjacents,9
Schefflera_myrioneura,1,1,0,Points-PointsKO-Adjacents,9
Schefflera_napuoensis,NA,NA,NA,NA,NA
Schefflera_neblinae,1,1,0,Points-PointsKO-Adjacents,9
Schefflera_nebularum,2,2,0,Points-PointsKO-Adjacents,18
Schefflera_neoebudica,20,8,12,Points-PointsKO-Adjacents,94
Schefflera_nephelophila,3,3,0,Points-PointsKO-Adjacents,27
Schefflera_nervosa,NA,NA,NA,NA,NA
Schefflera_nhatrangensis,1,1,0,Points-PointsKO-Adjacents,9
Schefflera_nicaraguensis,23,12,11,Points-PointsKO-Adjacents,119
Schefflera_nigrescens,3,3,0,Points-PointsKO-Adjacents,16
Schefflera_oblonga,1,1,0,Points-PointsKO-Adjacents,9
Schefflera_oblongifolia,2,2,0,Points-PointsKO-Adjacents,18
Schefflera_obovata,0,0,0,NA,0
Schefflera_obtusifolia,0,0,0,NA,0
Schefflera_octostyla,2,2,0,Points-PointsKO-Adjacents,12
Schefflera_oreopola,18,9,9,Points-PointsKO-Adjacents,86
Schefflera_ouveana,0,0,0,NA,0
Schefflera_ovoidea,2,2,0,Points-PointsKO-Adjacents,18
Schefflera_pachycephala,0,0,0,NA,0
Schefflera_pachystyla,9,1,8,Points-PointsKO-Adjacents,69
Schefflera_pacoensis,0,0,0,NA,0
Schefflera_pagiophylla,4,4,0,Points-PointsKO-Adjacents,36
Schefflera_palawanensis,1,1,0,Points-PointsKO-Adjacents,9
Schefflera_pallens,1,1,0,Points-PointsKO-Adjacents,9
Schefflera_palmiformis,0,0,0,NA,0
Schefflera_panamensis,14,9,5,Points-PointsKO-Adjacents,57
Schefflera_parasitica,2,2,0,Points-PointsKO-Adjacents,18
Schefflera_pardoana,7,0,7,Points-PointsKO-Adjacents,45
Schefflera_paruana,1,1,0,Points-PointsKO-Adjacents,9
Schefflera_parvifoliolata,1,1,0,Points-PointsKO-Adjacents,9
Schefflera_patula,59,35,24,Alphahull-PointsKO-Adjacents,1300
Schefflera_pauciflora,27,15,12,Points-PointsKO-Adjacents,233
Schefflera_pauciradiata,2,2,0,Points-PointsKO-Adjacents,9
Schefflera_pedicellata,33,18,15,Points-PointsKO-Adjacents,187
Schefflera_pedicelligera,2,2,0,Points-PointsKO-Adjacents,14
Schefflera_pentagyra,1,1,0,Points-PointsKO-Adjacents,9
Schefflera_pentandra,75,47,28,Alphahull-PointsKO-Adjacents,1385
Schefflera_peruviana,1,1,0,Points-PointsKO-Adjacents,9
Schefflera_pes-avis,7,1,6,Points-PointsKO-Adjacents,51
Schefflera_petelotii,7,0,7,Points-PointsKO-Adjacents,46
Schefflera_petiolosa,9,3,6,Points-PointsKO-Adjacents,59
Schefflera_phanerophlebia,1,1,0,Points-PointsKO-Adjacents,9
Schefflera_pilematophora,2,2,0,Points-PointsKO-Adjacents,18
Schefflera_pimichinensis,2,2,0,Points-PointsKO-Adjacents,12
Schefflera_pittieri,1,1,0,Points-PointsKO-Adjacents,9
Schefflera_planchoniana,6,1,5,Points-PointsKO-Adjacents,53
Schefflera_plurifolia,20,9,11,Points-PointsKO-Adjacents,136
Schefflera_plurispicata,1,1,0,Points-PointsKO-Adjacents,9
Schefflera_polyandra,NA,NA,NA,NA,NA
Schefflera_polyastra,NA,NA,NA,NA,NA
Schefflera_polybotrya,1,1,0,Points-PointsKO-Adjacents,9
Schefflera_polyclada,2,2,0,Points-PointsKO-Adjacents,9
Schefflera_procumbens,2,2,0,Points-PointsKO-Adjacents,14
Schefflera_pseudobrassaia,NA,NA,NA,NA,NA
Schefflera_pseudocandelabrum,10,3,7,Points-PointsKO-Adjacents,40
Schefflera_pseudospicata,1,1,0,Points-PointsKO-Adjacents,9
Schefflera_psilophylla,5,5,0,Points-PointsKO-Adjacents,45
Schefflera_pubens,12,5,7,Points-PointsKO-Adjacents,94
Schefflera_pueckleri,0,0,0,NA,0
Schefflera_pushpangadanii,NA,NA,NA,NA,NA
Schefflera_quangtriensis,2,2,0,Points-PointsKO-Adjacents,18
Schefflera_quinduensis,114,88,26,Alphahull-PointsKO-Adjacents,2626
Schefflera_quinquecarinata,6,1,5,Points-PointsKO-Adjacents,48
Schefflera_quinquestylorum,8,3,5,Points-PointsKO-Adjacents,72
Schefflera_racemifera,3,3,0,Points-PointsKO-Adjacents,18
Schefflera_racemosa,1,0,1,Points-PointsKO-Adjacents,9
Schefflera_rainaliana,13,7,6,Points-PointsKO-Adjacents,21
Schefflera_ramosissima,27,19,8,Points-PointsKO-Adjacents,120
Schefflera_rhododendrifolia,4,4,0,Points-PointsKO-Adjacents,21
Schefflera_ridleyi,1,1,0,Points-PointsKO-Adjacents,9
Schefflera_rigida,2,2,0,Points-PointsKO-Adjacents,18
Schefflera_robusta,95,80,15,Alphahull-PointsKO-Adjacents,419
Schefflera_rodriguesiana,110,93,17,Alphahull-PointsKO-Adjacents,212
Schefflera_rostrata,1,0,1,Points-PointsKO-Adjacents,9
Schefflera_rotundifolia,0,0,0,NA,0
Schefflera_roxburghii,0,0,0,NA,0
Schefflera_rufa,9,4,5,Points-PointsKO-Adjacents,48
Schefflera_rugosa,1,1,0,Points-PointsKO-Adjacents,9
Schefflera_ruschiana,5,5,0,Points-PointsKO-Adjacents,12
Schefflera_salweenensis,2,2,0,Points-PointsKO-Adjacents,18
Schefflera_samariana,4,4,0,Points-PointsKO-Adjacents,27
Schefflera_samoensis,6,1,5,Points-PointsKO-Adjacents,24
Schefflera_sandiana,3,3,0,Points-PointsKO-Adjacents,21
Schefflera_sanquininensis,0,0,0,NA,0
Schefflera_santosii,1,1,0,Points-PointsKO-Adjacents,9
Schefflera_sapoensis,2,2,0,Points-PointsKO-Adjacents,8
Schefflera_sararensis,2,2,0,Points-PointsKO-Adjacents,18
Schefflera_schizophylla,2,2,0,Points-PointsKO-Adjacents,18
Schefflera_schumanniana,10,5,5,Points-PointsKO-Adjacents,71
Schefflera_sciodaphyllum,1,0,1,Points-PointsKO-Adjacents,9
Schefflera_scytinophylla,NA,NA,NA,NA,NA
Schefflera_secunda,1,1,0,Points-PointsKO-Adjacents,9
Schefflera_seibertii,16,6,10,Points-PointsKO-Adjacents,101
Schefflera_selloi,64,38,26,Alphahull-PointsKO-Adjacents,370
Schefflera_sepikiana,0,0,0,NA,0
Schefflera_serrata,2,2,0,Points-PointsKO-Adjacents,18
Schefflera_sessiliflora,21,13,8,Points-PointsKO-Adjacents,104
Schefflera_setulosa,24,11,13,Points-PointsKO-Adjacents,145
Schefflera_shweliensis,14,4,10,Points-PointsKO-Adjacents,113
Schefflera_siamensis,2,2,0,Points-PointsKO-Adjacents,16
Schefflera_silvatica,7,3,4,Points-PointsKO-Adjacents,60
Schefflera_simbuensis,9,6,3,Points-PointsKO-Adjacents,51
Schefflera_simplex,2,2,0,Points-PointsKO-Adjacents,9
Schefflera_simulans,1,1,0,Points-PointsKO-Adjacents,9
Schefflera_sipapoensis,4,4,0,Points-PointsKO-Adjacents,21
Schefflera_sodiroi,41,30,11,Alphahull-PointsKO-Adjacents,318
Schefflera_spaniodon,NA,NA,NA,NA,NA
Schefflera_sphaerocoma,124,103,21,Alphahull-PointsKO-Adjacents,2376
Schefflera_spruceana,98,56,42,Alphahull-PointsKO-Adjacents,2290
Schefflera_sprucei,73,48,25,Alphahull-PointsKO-Adjacents,3374
Schefflera_staufferana,24,12,12,Points-PointsKO-Adjacents,174
Schefflera_stearnii,0,0,0,NA,0
Schefflera_stellata,0,0,0,NA,0
Schefflera_stellulata,1,1,0,Points-PointsKO-Adjacents,9
Schefflera_stenopetala,0,0,0,NA,0
Schefflera_steyermarkii,4,4,0,Points-PointsKO-Adjacents,12
Schefflera_stilpnophylla,3,3,0,Points-PointsKO-Adjacents,27
Schefflera_stolleana,1,1,0,Points-PointsKO-Adjacents,9
Schefflera_stolzii,13,7,6,Points-PointsKO-Adjacents,72
Schefflera_straminea,14,10,4,Points-PointsKO-Adjacents,52
Schefflera_suaveolens,26,12,14,Points-PointsKO-Adjacents,129
Schefflera_subavenis,2,2,0,Points-PointsKO-Adjacents,18
Schefflera_subintegra,6,1,5,Points-PointsKO-Adjacents,54
Schefflera_succinea,9,1,8,Points-PointsKO-Adjacents,60
Schefflera_systyla,152,134,18,Alphahull-PointsKO-Adjacents,724
Schefflera_tahanica,NA,NA,NA,NA,NA
Schefflera_taiwaniana,94,84,10,Alphahull-PointsKO-Adjacents,176
Schefflera_tamana,1,1,0,Points-PointsKO-Adjacents,9
Schefflera_tamatamaensis,4,4,0,Points-PointsKO-Adjacents,30
Schefflera_tanyrhachis,0,0,0,NA,0
Schefflera_tanytricha,NA,NA,NA,NA,NA
Schefflera_thaumasiantha,0,0,0,NA,0
Schefflera_tomentosa,3,3,0,Points-PointsKO-Adjacents,27
Schefflera_tremula,18,10,8,Points-PointsKO-Adjacents,77
Schefflera_tremuloidea,21,11,10,Points-PointsKO-Adjacents,60
Schefflera_trevesioides,4,4,0,Points-PointsKO-Adjacents,21
Schefflera_trianae,119,99,20,Alphahull-PointsKO-Adjacents,859
Schefflera_tribracteolata,3,3,0,Points-PointsKO-Adjacents,9
Schefflera_tristis,2,2,0,Points-PointsKO-Adjacents,18
Schefflera_trollii,27,19,8,Points-PointsKO-Adjacents,71
Schefflera_troyana,2,2,0,Points-PointsKO-Adjacents,18
Schefflera_trungii,0,0,0,NA,0
Schefflera_tunkinensis,3,3,0,Points-PointsKO-Adjacents,23
Schefflera_ulocephala,8,0,8,Points-PointsKO-Adjacents,33
Schefflera_umbellata,15,9,6,Points-PointsKO-Adjacents,61
Schefflera_umbellifera,58,28,30,Alphahull-PointsKO-Adjacents,497
Schefflera_umbraculifera,2,2,0,Points-PointsKO-Adjacents,16
Schefflera_urbaniana,1,1,0,Points-PointsKO-Adjacents,9
Schefflera_urdanetensis,0,0,0,NA,0
Schefflera_urostachya,21,12,9,Points-PointsKO-Adjacents,151
Schefflera_vanderwerffii,1,1,0,Points-PointsKO-Adjacents,9
Schefflera_vantsilana,52,30,22,Alphahull-PointsKO-Adjacents,391
Schefflera_varisiana,60,41,19,Alphahull-PointsKO-Adjacents,1189
Schefflera_vasqueziana,34,23,11,Alphahull-PointsKO-Adjacents,480
Schefflera_veitchii,17,3,14,Points-PointsKO-Adjacents,56
Schefflera_velutina,7,1,6,Points-PointsKO-Adjacents,45
Schefflera_venulosa,3,0,3,Points-PointsKO-Adjacents,27
Schefflera_versteegii,2,2,0,Points-PointsKO-Adjacents,9
Schefflera_vidaliana,3,3,0,Points-PointsKO-Adjacents,27
Schefflera_vieillardii,10,4,6,Points-PointsKO-Adjacents,43
Schefflera_viguieriana,1,1,0,Points-PointsKO-Adjacents,9
Schefflera_villosissima,9,4,5,Points-PointsKO-Adjacents,78
Schefflera_vinosa,578,491,87,Alphahull-PointsKO-Adjacents,18084
Schefflera_violacea,32,19,13,Points-PointsKO-Adjacents,224
Schefflera_violea,NA,NA,NA,NA,NA
Schefflera_vitiensis,5,5,0,Points-PointsKO-Adjacents,18
Schefflera_volkensii,40,24,16,Alphahull-PointsKO-Adjacents,803
Schefflera_wallichiana,0,0,0,NA,0
Schefflera_wangii,1,1,0,Points-PointsKO-Adjacents,9
Schefflera_wardii,8,4,4,Points-PointsKO-Adjacents,31
Schefflera_waterhousei,6,0,6,Points-PointsKO-Adjacents,39
Schefflera_weberbaueri,1,1,0,Points-PointsKO-Adjacents,9
Schefflera_weibeliana,1,1,0,Points-PointsKO-Adjacents,9
Schefflera_whitefoordiae,2,2,0,Points-PointsKO-Adjacents,18
Schefflera_winkleri,NA,NA,NA,NA,NA
Schefflera_wrayi,0,0,0,NA,0
Schefflera_yatesii,0,0,0,NA,0
Schefflera_yurumanguinis,8,3,5,Points-PointsKO-Adjacents,63
Schefflera_yutajensis,4,4,0,Points-PointsKO-Adjacents,21
Schefflera_zhuana,NA,NA,NA,NA,NA
Schefflerodendron_adenopetalum,8,3,5,Points-PointsKO-Adjacents,54
Schefflerodendron_gabonense,4,4,0,Points-PointsKO-Adjacents,32
Schefflerodendron_gilbertianum,5,5,0,Points-PointsKO-Adjacents,39
Schefflerodendron_usambarense,6,0,6,Points-PointsKO-Adjacents,36
Schima_brevipedicellata,7,2,5,Points-PointsKO-Adjacents,63
Schima_crenata,60,0,60,Points-PointsKO-Adjacents,310
Schima_khasiana,82,53,29,Alphahull-PointsKO-Adjacents,3562
Schima_multibracteata,1,1,0,Points-PointsKO-Adjacents,9
Schima_noronhae,14,3,11,Points-PointsKO-Adjacents,107
Schima_parviflora,32,10,22,Points-PointsKO-Adjacents,257
Schima_remotiserrata,8,0,8,Points-PointsKO-Adjacents,63
Schima_sericans,36,27,9,Alphahull-PointsKO-Adjacents,299
Schima_sinensis,19,8,11,Points-PointsKO-Adjacents,170
Schima_superba,467,392,75,Alphahull-PointsKO-Adjacents,11481
Schima_villosa,3,3,0,Points-PointsKO-Adjacents,27
Schima_wallichii,197,128,69,Alphahull-PointsKO-Adjacents,12302
Schindleria_densiflora,29,0,29,Points-PointsKO-Adjacents,217
Schinopsis_balansae,107,85,22,Alphahull-PointsKO-Adjacents,4309
Schinopsis_brasiliensis,875,813,62,Alphahull-PointsKO-Adjacents,13780
Schinopsis_cornuta,34,24,10,Alphahull-PointsKO-Adjacents,1077
Schinopsis_heterophylla,45,31,14,Alphahull-PointsKO-Adjacents,1264
Schinopsis_lorentzii,66,49,17,Alphahull-PointsKO-Adjacents,4485
Schinopsis_peruviana,9,2,7,Points-PointsKO-Adjacents,66
Schinopsis_quebracho-colorado,47,30,17,Alphahull-PointsKO-Adjacents,1554
Schinus_engleri,280,242,38,Alphahull-PointsKO-Adjacents,8622
Schinus_fasciculata,137,89,48,Alphahull-PointsKO-Adjacents,11954
Schinus_ferox,28,0,28,Points-PointsKO-Adjacents,207
Schinus_gracilipes,32,18,14,Points-PointsKO-Adjacents,216
Schinus_lentiscifolius,172,144,28,Alphahull-PointsKO-Adjacents,5594
Schinus_longifolia,69,43,26,Alphahull-PointsKO-Adjacents,3561
Schinus_meyeri,16,9,7,Points-PointsKO-Adjacents,97
Schinus_microphyllus,49,26,23,Alphahull-PointsKO-Adjacents,499
Schinus_molle,143,87,56,Alphahull-PointsKO-Adjacents,4324
Schinus_myrtifolia,98,75,23,Alphahull-PointsKO-Adjacents,525
Schinus_patagonicus,41,22,19,Alphahull-PointsKO-Adjacents,475
Schinus_pearcei,27,6,21,Points-PointsKO-Adjacents,183
Schinus_polygama,62,36,26,Alphahull-PointsKO-Adjacents,1173
Schinus_ramboi,2,2,0,Points-PointsKO-Adjacents,18
Schinus_spinosus,8,0,8,Points-PointsKO-Adjacents,54
Schinus_terebinthifolia,836,657,179,Alphahull-PointsKO-Adjacents,18997
Schinus_venturii,11,3,8,Points-PointsKO-Adjacents,93
Schinziophyton_rautanenii,43,18,25,Points-PointsKO-Adjacents,350
Schippia_concolor,22,17,5,Points-PointsKO-Adjacents,92
Schismatoclada_citrifolia,17,7,10,Points-PointsKO-Adjacents,91
Schismatoclada_concinna,32,23,9,Alphahull-PointsKO-Adjacents,191
Schismatoclada_farahimpensis,49,33,16,Alphahull-PointsKO-Adjacents,384
Schismatoclada_marojejyensis,7,3,4,Points-PointsKO-Adjacents,36
Schismatoclada_psychotrioides,92,71,21,Alphahull-PointsKO-Adjacents,817
Schismatoclada_purpurea,8,1,7,Points-PointsKO-Adjacents,66
Schismatoclada_villiflora,1,1,0,Points-PointsKO-Adjacents,9
Schistostemon_densiflorum,9,1,8,Points-PointsKO-Adjacents,81
Schistostemon_dichotomum,3,3,0,Points-PointsKO-Adjacents,27
Schistostemon_fernandezii,4,4,0,Points-PointsKO-Adjacents,36
Schistostemon_macrophyllum,82,59,23,Alphahull-PointsKO-Adjacents,1740
Schistostemon_oblongifolium,62,0,62,Points-PointsKO-Adjacents,443
Schistostemon_reticulatum,15,1,14,Points-PointsKO-Adjacents,132
Schistostemon_retusum,57,34,23,Alphahull-PointsKO-Adjacents,1372
Schistostemon_sylvaticum,1,1,0,Points-PointsKO-Adjacents,9
Schizenterospermum_analamerense,1,1,0,Points-PointsKO-Adjacents,9
Schizenterospermum_rotundifolium,8,3,5,Points-PointsKO-Adjacents,57
Schizocalyx_bracteosa,91,67,24,Alphahull-PointsKO-Adjacents,3047
Schizocalyx_bracteosus,128,107,21,Alphahull-PointsKO-Adjacents,4009
Schizocalyx_cuspidatus,170,134,36,Alphahull-PointsKO-Adjacents,3237
Schizocalyx_multiflorus,7,1,6,Points-PointsKO-Adjacents,57
Schizocalyx_obovatus,88,65,23,Alphahull-PointsKO-Adjacents,1005
Schizocalyx_peruvianus,117,91,26,Alphahull-PointsKO-Adjacents,2941
Schizocalyx_sterculioides,20,12,8,Points-PointsKO-Adjacents,113
Schizocolea_linderi,49,40,9,Alphahull-PointsKO-Adjacents,838
Schizolaena_capuronii,3,3,0,Points-PointsKO-Adjacents,21
Schizolaena_cauliflora,27,11,16,Points-PointsKO-Adjacents,140
Schizolaena_cavacoana,7,6,1,Points-PointsKO-Adjacents,25
Schizolaena_elongata,54,36,18,Alphahull-PointsKO-Adjacents,159
Schizolaena_exinvolucrata,35,17,18,Points-PointsKO-Adjacents,206
Schizolaena_gereaui,26,11,15,Points-PointsKO-Adjacents,111
Schizolaena_hystrix,21,14,7,Points-PointsKO-Adjacents,125
Schizolaena_isaloensis,11,0,11,Points-PointsKO-Adjacents,43
Schizolaena_laurina,5,2,3,Points-PointsKO-Adjacents,28
Schizolaena_manomboensis,7,2,5,Points-PointsKO-Adjacents,27
Schizolaena_masoalensis,4,4,0,Points-PointsKO-Adjacents,23
Schizolaena_microphylla,30,24,6,Alphahull-PointsKO-Adjacents,82
Schizolaena_milleri,12,0,12,Points-PointsKO-Adjacents,55
Schizolaena_parviflora,35,26,9,Alphahull-PointsKO-Adjacents,120
Schizolaena_pectinata,12,8,4,Points-PointsKO-Adjacents,70
Schizolaena_raymondii,3,3,0,Points-PointsKO-Adjacents,14
Schizolaena_rosea,19,10,9,Points-PointsKO-Adjacents,93
Schizolaena_tampoketsana,12,0,12,Points-PointsKO-Adjacents,55
Schizolaena_turkii,10,6,4,Points-PointsKO-Adjacents,39
Schizolaena_viscosa,28,0,28,Points-PointsKO-Adjacents,117
Schizolobium_parahyba,677,494,183,Alphahull-PointsKO-Adjacents,27087
Schizomussaenda_henryi,37,18,19,Points-PointsKO-Adjacents,322
Schizozygia_coffaeoides,48,0,48,Points-PointsKO-Adjacents,259
Schlegelia_fuscata,141,100,41,Alphahull-PointsKO-Adjacents,896
Schlegelia_monachinoi,18,5,13,Points-PointsKO-Adjacents,115
Schlegelia_pandurata,4,4,0,Points-PointsKO-Adjacents,36
Schlegelia_parviflora,342,250,92,Alphahull-PointsKO-Adjacents,4853
Schlegelia_sulphurea,27,0,27,Points-PointsKO-Adjacents,151
Schleichera_oleosa,39,9,30,Points-PointsKO-Adjacents,321
Schleinitzia_fosbergii,0,0,0,NA,0
Schleinitzia_insularum,2,2,0,Points-PointsKO-Adjacents,14
Schleinitzia_megaladenia,0,0,0,NA,0
Schleinitzia_novo-guineensis,46,22,24,Alphahull-PointsKO-Adjacents,438
Schmardaea_microphylla,32,11,21,Points-PointsKO-Adjacents,229
Schmidtottia_corymbosa,NA,NA,NA,NA,NA
Schmidtottia_stricta,NA,NA,NA,NA,NA
Schoenobiblus_amazonicus,10,0,10,Points-PointsKO-Adjacents,78
Schoenobiblus_coriaceus,10,2,8,Points-PointsKO-Adjacents,67
Schoenobiblus_crassisepala,31,19,12,Points-PointsKO-Adjacents,189
Schoenobiblus_daphnoides,148,91,57,Alphahull-PointsKO-Adjacents,7570
Schoenobiblus_panamensis,72,43,29,Alphahull-PointsKO-Adjacents,897
Schoenobiblus_peruvianus,153,114,39,Alphahull-PointsKO-Adjacents,10221
Schoepfia_arenaria,7,2,5,Points-PointsKO-Adjacents,22
Schoepfia_brasiliensis,707,570,137,Alphahull-PointsKO-Adjacents,25414
Schoepfia_californica,100,1,99,Points-PointsKO-Adjacents,373
Schoepfia_chinensis,46,26,20,Alphahull-PointsKO-Adjacents,2460
Schoepfia_flexuosa,24,7,17,Points-PointsKO-Adjacents,194
Schoepfia_fragrans,33,11,22,Points-PointsKO-Adjacents,293
Schoepfia_griffithii,0,0,0,NA,0
Schoepfia_haitiensis,1,1,0,Points-PointsKO-Adjacents,9
Schoepfia_harrisii,3,3,0,Points-PointsKO-Adjacents,22
Schoepfia_jasminodora,127,70,57,Alphahull-PointsKO-Adjacents,13669
Schoepfia_lucida,37,13,24,Points-PointsKO-Adjacents,268
Schoepfia_multiflora,2,2,0,Points-PointsKO-Adjacents,18
Schoepfia_obovata,20,3,17,Points-PointsKO-Adjacents,114
Schoepfia_schreberi,633,499,134,Alphahull-PointsKO-Adjacents,12413
Schoepfia_shreveana,4,4,0,Points-PointsKO-Adjacents,26
Schoepfia_tepuiensis,10,6,4,Points-PointsKO-Adjacents,45
Schoepfia_tetramera,42,21,21,Alphahull-PointsKO-Adjacents,245
Schoepfia_vacciniiflora,118,78,40,Alphahull-PointsKO-Adjacents,439
Schotia_afra,207,154,53,Alphahull-PointsKO-Adjacents,2908
Schotia_brachypetala,149,114,35,Alphahull-PointsKO-Adjacents,3663
Schotia_capitata,69,0,69,Points-PointsKO-Adjacents,539
Schotia_latifolia,64,37,27,Alphahull-PointsKO-Adjacents,854
Schradera_brasiliensis,2,2,0,Points-PointsKO-Adjacents,16
Schradera_cacuminis,1,1,0,Points-PointsKO-Adjacents,9
Schradera_involucrata,2,1,1,Points-PointsKO-Adjacents,9
Schradera_lehmannii,24,14,10,Points-PointsKO-Adjacents,133
Schradera_neeoides,59,41,18,Alphahull-PointsKO-Adjacents,213
Schradera_ramiflora,3,3,0,Points-PointsKO-Adjacents,27
Schradera_stellata,8,2,6,Points-PointsKO-Adjacents,53
Schrebera_alata,159,96,63,Alphahull-PointsKO-Adjacents,6799
Schrebera_americana,9,2,7,Points-PointsKO-Adjacents,63
Schrebera_arborea,70,38,32,Alphahull-PointsKO-Adjacents,1596
Schrebera_capuronii,9,0,9,Points-PointsKO-Adjacents,60
Schrebera_kusnotoi,1,1,0,Points-PointsKO-Adjacents,9
Schrebera_orientalis,1,1,0,Points-PointsKO-Adjacents,9
Schrebera_swietenioides,0,0,0,NA,0
Schrebera_trichoclada,101,49,52,Alphahull-PointsKO-Adjacents,7144
Schumanniophyton_hirsutum,4,1,3,Points-PointsKO-Adjacents,27
Schumanniophyton_magnificum,140,105,35,Alphahull-PointsKO-Adjacents,4116
Schwartzia_adamantium,118,92,26,Alphahull-PointsKO-Adjacents,4674
Schwenckia_trujilloi,1,1,0,Points-PointsKO-Adjacents,9
Sciadopitys_verticillata,51,23,28,Alphahull-PointsKO-Adjacents,432
Sclerocarya_birrea,415,301,114,Alphahull-PointsKO-Adjacents,17114
Sclerocarya_gillettii,6,2,4,Points-PointsKO-Adjacents,50
Sclerochiton_glandulosissimus,9,5,4,Points-PointsKO-Adjacents,45
Sclerochiton_obtusisepalus,5,5,0,Points-PointsKO-Adjacents,33
Sclerochiton_uluguruensis,8,3,5,Points-PointsKO-Adjacents,39
Sclerocroton_cornutus,81,53,28,Alphahull-PointsKO-Adjacents,3480
Sclerocroton_integerrimus,76,0,76,Points-PointsKO-Adjacents,520
Sclerocroton_melanostictus,129,105,24,Alphahull-PointsKO-Adjacents,2381
Sclerocroton_schmitzii,7,1,6,Points-PointsKO-Adjacents,58
Sclerolaena_bicornis,2361,2289,72,Alphahull-PointsKO-Adjacents,37769
Sclerolobium_herthae,NA,NA,NA,NA,NA
Sclerolobium_macrophyllum,1,1,0,Points-PointsKO-Adjacents,9
Sclerolobium_paniculatum,475,0,475,Points-PointsKO-Adjacents,2929
Sclerolobium_striatum,3,3,0,Points-PointsKO-Adjacents,27
Scleronema_micranthum,108,84,24,Alphahull-PointsKO-Adjacents,4057
Scleronema_praecox,13,0,13,Points-PointsKO-Adjacents,103
Scleropyrum_pentandrum,27,3,24,Points-PointsKO-Adjacents,234
Sclerotheca_arborea,3,3,0,Points-PointsKO-Adjacents,16
Sclerotheca_jayorum,3,3,0,Points-PointsKO-Adjacents,9
Sclerotheca_magdalenae,1,1,0,Points-PointsKO-Adjacents,9
Sclerotheca_oreades,1,1,0,Points-PointsKO-Adjacents,9
Scolopia_buxifolia,5,5,0,Points-PointsKO-Adjacents,35
Scolopia_chinensis,25,13,12,Points-PointsKO-Adjacents,219
Scolopia_erythrocarpa,57,33,24,Alphahull-PointsKO-Adjacents,290
Scolopia_flanaganii,19,9,10,Points-PointsKO-Adjacents,162
Scolopia_hazomby,8,2,6,Points-PointsKO-Adjacents,54
Scolopia_heterophylla,1,0,1,Points-PointsKO-Adjacents,9
Scolopia_inappendiculata,9,1,8,Points-PointsKO-Adjacents,51
Scolopia_lucida,1,1,0,Points-PointsKO-Adjacents,9
Scolopia_madagascariensis,64,44,20,Alphahull-PointsKO-Adjacents,530
Scolopia_manongarivae,17,10,7,Points-PointsKO-Adjacents,86
Scolopia_maoulidae,1,1,0,Points-PointsKO-Adjacents,5
Scolopia_meridionalis,4,4,0,Points-PointsKO-Adjacents,31
Scolopia_montana,5,5,0,Points-PointsKO-Adjacents,45
Scolopia_mundii,92,67,25,Alphahull-PointsKO-Adjacents,2960
Scolopia_oldhamii,147,99,48,Alphahull-PointsKO-Adjacents,462
Scolopia_oreophila,3,3,0,Points-PointsKO-Adjacents,27
Scolopia_orientalis,31,15,16,Points-PointsKO-Adjacents,131
Scolopia_rhamniphylla,44,30,14,Alphahull-PointsKO-Adjacents,653
Scolopia_saeva,18,0,18,Points-PointsKO-Adjacents,151
Scolopia_septentrionalis,1,1,0,Points-PointsKO-Adjacents,9
Scolopia_stolzii,14,1,13,Points-PointsKO-Adjacents,108
Scolopia_taimbarina,14,0,14,Points-PointsKO-Adjacents,34
Scolopia_theifolia,8,0,8,Points-PointsKO-Adjacents,48
Scolopia_thouvenoti,26,18,8,Points-PointsKO-Adjacents,78
Scolopia_zeyheri,133,95,38,Alphahull-PointsKO-Adjacents,5507
Scolosanthus_acanthodes,1,1,0,Points-PointsKO-Adjacents,9
Scolosanthus_densiflorus,1,1,0,Points-PointsKO-Adjacents,9
Scolosanthus_grandifolius,3,1,2,Points-PointsKO-Adjacents,21
Scolosanthus_howardii,0,0,0,NA,0
Scolosanthus_leonardii,0,0,0,NA,0
Scolosanthus_selleanus,4,4,0,Points-PointsKO-Adjacents,31
Scolosanthus_subsessilis,0,0,0,NA,0
Scolosanthus_triacanthus,6,1,5,Points-PointsKO-Adjacents,45
Scolosanthus_versicolor,5,3,2,Points-PointsKO-Adjacents,31
Scorodocarpus_borneensis,29,10,19,Points-PointsKO-Adjacents,217
Scorodophloeus_fischeri,73,60,13,Alphahull-PointsKO-Adjacents,618
Scorodophloeus_zenkeri,324,290,34,Alphahull-PointsKO-Adjacents,10390
Scottellia_klaineana,168,123,45,Alphahull-PointsKO-Adjacents,5035
Scottellia_leonensis,10,4,6,Points-PointsKO-Adjacents,65
Scottellia_orientalis,11,1,10,Points-PointsKO-Adjacents,99
Scutia_buxifolia,300,243,57,Alphahull-PointsKO-Adjacents,10679
Scutia_myrtina,217,111,106,Alphahull-PointsKO-Adjacents,5337
Scyphiphora_hydrophylacea,161,92,69,Alphahull-PointsKO-Adjacents,1758
Scyphocephalium_mannii,124,107,17,Alphahull-PointsKO-Adjacents,2038
Scyphocephalium_ochocoa,31,22,9,Alphahull-PointsKO-Adjacents,1041
Scyphonychium_multiflorum,34,13,21,Points-PointsKO-Adjacents,190
Scyphostachys_coffeoides,0,0,0,NA,0
Scyphostachys_pedunculatus,0,0,0,NA,0
Scytopetalum_klaineanum,152,133,19,Alphahull-PointsKO-Adjacents,1830
Scytopetalum_pierreanum,18,5,13,Points-PointsKO-Adjacents,114
Scytopetalum_tieghemii,70,46,24,Alphahull-PointsKO-Adjacents,780
Rhus_anchietae,39,16,23,Points-PointsKO-Adjacents,270
Searsia_burchellii,113,85,28,Alphahull-PointsKO-Adjacents,6066
Searsia_glutinosa,26,11,15,Points-PointsKO-Adjacents,179
Rhus_incisa,80,52,28,Alphahull-PointsKO-Adjacents,1400
Searsia_lancea,189,141,48,Alphahull-PointsKO-Adjacents,9511
Searsia_leptodictya,128,106,22,Alphahull-PointsKO-Adjacents,4379
Rhus_longipes,147,0,147,Points-PointsKO-Adjacents,1000
Searsia_marlothii,30,19,11,Points-PointsKO-Adjacents,264
Searsia_natalensis,247,160,87,Alphahull-PointsKO-Adjacents,9516
Searsia_pendulina,24,12,12,Points-PointsKO-Adjacents,202
Searsia_pentaphylla,18,4,14,Points-PointsKO-Adjacents,110
Searsia_populifolia,44,31,13,Alphahull-PointsKO-Adjacents,589
Searsia_pyroides,567,463,104,Alphahull-PointsKO-Adjacents,25154
Searsia_quartiniana,50,18,32,Points-PointsKO-Adjacents,374
Searsia_tenuinervis,120,87,33,Alphahull-PointsKO-Adjacents,7973
Searsia_tomentosa,96,58,38,Alphahull-PointsKO-Adjacents,1420
Searsia_tripartita,19,0,19,Points-PointsKO-Adjacents,142
Searsia_undulata,146,116,30,Alphahull-PointsKO-Adjacents,6252
Sebastiania_adenophora,166,145,21,Alphahull-PointsKO-Adjacents,1845
Sebastiania_appendiculata,54,34,20,Alphahull-PointsKO-Adjacents,257
Sebastiania_argutidens,67,48,19,Alphahull-PointsKO-Adjacents,968
Sebastiania_brasiliensis,1771,1634,137,Alphahull-PointsKO-Adjacents,52607
Sebastiania_catingae,5,4,1,Points-PointsKO-Adjacents,45
Sebastiania_chiapensis,3,3,0,Points-PointsKO-Adjacents,23
Sebastiania_cruenta,55,46,9,Alphahull-PointsKO-Adjacents,173
Sebastiania_haploclada,2,2,0,Points-PointsKO-Adjacents,18
Sebastiania_hintonii,22,13,9,Points-PointsKO-Adjacents,93
Sebastiania_huallagensis,2,2,0,Points-PointsKO-Adjacents,18
Sebastiania_jacobinensis,119,94,25,Alphahull-PointsKO-Adjacents,4926
Sebastiania_jaliscensis,11,5,6,Points-PointsKO-Adjacents,63
Sebastiania_klotzschiana,355,264,91,Alphahull-PointsKO-Adjacents,12704
Sebastiania_larensis,5,5,0,Points-PointsKO-Adjacents,45
Sebastiania_macrocarpa,189,164,25,Alphahull-PointsKO-Adjacents,4430
Sebastiania_pavoniana,239,203,36,Alphahull-PointsKO-Adjacents,7062
Sebastiania_riparia,22,9,13,Points-PointsKO-Adjacents,173
Sebastiania_schottiana,343,294,49,Alphahull-PointsKO-Adjacents,21787
Sebastiania_serrata,116,71,45,Alphahull-PointsKO-Adjacents,1976
Sebastiania_subulata,3,3,0,Points-PointsKO-Adjacents,27
Sebastiania_venezolana,1,1,0,Points-PointsKO-Adjacents,9
Secamone_nervosa,6,3,3,Points-PointsKO-Adjacents,30
Securidaca_diversifolia,624,428,196,Alphahull-PointsKO-Adjacents,19999
Securidaca_longipedunculata,126,59,67,Alphahull-PointsKO-Adjacents,9572
Securidaca_sylvestris,119,71,48,Alphahull-PointsKO-Adjacents,2629
Securidaca_volubilis,60,7,53,Points-PointsKO-Adjacents,499
Securinega_antsingyensis,8,1,7,Points-PointsKO-Adjacents,63
Securinega_capuronii,35,22,13,Alphahull-PointsKO-Adjacents,545
Securinega_durissima,35,19,16,Points-PointsKO-Adjacents,143
Securinega_perrieri,19,11,8,Points-PointsKO-Adjacents,119
Securinega_seyrigii,35,19,16,Points-PointsKO-Adjacents,212
Seemannaralia_gerrardii,20,8,12,Points-PointsKO-Adjacents,172
Seguieria_americana,389,285,104,Alphahull-PointsKO-Adjacents,14181
Seguieria_langsdorffii,402,339,63,Alphahull-PointsKO-Adjacents,9552
Seguieria_macrophylla,119,0,119,Points-PointsKO-Adjacents,961
Seguieria_paraguayensis,54,30,24,Alphahull-PointsKO-Adjacents,3307
Semaphyllanthe_intonsa,8,1,7,Points-PointsKO-Adjacents,55
Semecarpus_anacardium,7,0,7,Points-PointsKO-Adjacents,62
Semecarpus_atra,28,14,14,Points-PointsKO-Adjacents,135
Semecarpus_cassuvium,22,1,21,Points-PointsKO-Adjacents,151
Semecarpus_cuneiformis,39,9,30,Points-PointsKO-Adjacents,300
Oncocarpus_densiflorus,2,2,0,Points-PointsKO-Adjacents,17
Semecarpus_longifolius,22,7,15,Points-PointsKO-Adjacents,107
Oncocarpus_vitiensis,18,5,13,Points-PointsKO-Adjacents,103
Semialarium_mexicanum,547,471,76,Alphahull-PointsKO-Adjacents,7605
Semiliquidambar_cathayensis,2,2,0,Points-PointsKO-Adjacents,18
Semiliquidambar_caudata,NA,NA,NA,NA,NA
Semiliquidambar_chingii,2,2,0,Points-PointsKO-Adjacents,18
Senaea_coerulea,1,1,0,Points-PointsKO-Adjacents,9
Senaea_janeirensis,1,1,0,Points-PointsKO-Adjacents,9
Senecio_cobanensis,96,76,20,Alphahull-PointsKO-Adjacents,798
Senecio_elquiensis,1,1,0,Points-PointsKO-Adjacents,9
Senecio_scandens,412,0,412,Points-PointsKO-Adjacents,2308
Senecio_uspantanensis,0,0,0,NA,0
Senecio_yegua,28,11,17,Points-PointsKO-Adjacents,221
Senefeldera_testiculata,35,27,8,Alphahull-PointsKO-Adjacents,1083
Senefeldera_triandra,9,0,9,Points-PointsKO-Adjacents,77
Senefeldera_verticillata,243,193,50,Alphahull-PointsKO-Adjacents,3026
Senefelderopsis_chiribiquetensis,94,75,19,Alphahull-PointsKO-Adjacents,1937
Senefelderopsis_croizatii,26,13,13,Points-PointsKO-Adjacents,163
Senegalia_alemquerensis,11,1,10,Points-PointsKO-Adjacents,99
Senegalia_amazonica,23,4,19,Points-PointsKO-Adjacents,165
Senegalia_bahiensis,547,510,37,Alphahull-PointsKO-Adjacents,9593
Senegalia_berlandieri,468,425,43,Alphahull-PointsKO-Adjacents,6699
Senegalia_bonariensis,260,206,54,Alphahull-PointsKO-Adjacents,13833
Senegalia_caffra,290,228,62,Alphahull-PointsKO-Adjacents,10074
Senegalia_catechu,7,0,7,Points-PointsKO-Adjacents,63
Senegalia_crassifolia,45,36,9,Alphahull-PointsKO-Adjacents,271
Senegalia_etilis,37,22,15,Alphahull-PointsKO-Adjacents,983
Senegalia_feddeana,20,15,5,Points-PointsKO-Adjacents,163
Senegalia_ferruginea,0,0,0,NA,0
Senegalia_galpinii,46,14,32,Points-PointsKO-Adjacents,388
Senegalia_giganticarpa,58,32,26,Alphahull-PointsKO-Adjacents,527
Senegalia_gilliesii,141,102,39,Alphahull-PointsKO-Adjacents,7230
Senegalia_greggii,895,841,54,Alphahull-PointsKO-Adjacents,14911
Senegalia_hayesii,132,69,63,Alphahull-PointsKO-Adjacents,1449
Senegalia_interior,14,0,14,Points-PointsKO-Adjacents,103
Senegalia_intsia,0,0,0,NA,0
Senegalia_kallunkiae,29,15,14,Points-PointsKO-Adjacents,210
Senegalia_kelloggiana,10,6,4,Points-PointsKO-Adjacents,33
Senegalia_klugii,5,5,0,Points-PointsKO-Adjacents,45
Senegalia_laeta,136,74,62,Alphahull-PointsKO-Adjacents,3496
Senegalia_langsdorffii,347,313,34,Alphahull-PointsKO-Adjacents,9937
Senegalia_lasiophylla,43,30,13,Alphahull-PointsKO-Adjacents,999
Senegalia_loretensis,457,359,98,Alphahull-PointsKO-Adjacents,34600
Senegalia_lowei,18,4,14,Points-PointsKO-Adjacents,154
Senegalia_martii,80,42,38,Alphahull-PointsKO-Adjacents,2673
Senegalia_mirandae,7,3,4,Points-PointsKO-Adjacents,38
Senegalia_multipinnata,216,115,101,Alphahull-PointsKO-Adjacents,17382
Senegalia_muricata,31,11,20,Points-PointsKO-Adjacents,143
Senegalia_nigrescens,191,143,48,Alphahull-PointsKO-Adjacents,10484
Senegalia_paganuccii,122,101,21,Alphahull-PointsKO-Adjacents,5850
Senegalia_paraensis,22,0,22,Points-PointsKO-Adjacents,181
Senegalia_parviceps,82,38,44,Alphahull-PointsKO-Adjacents,2579
Senegalia_picachensis,50,35,15,Alphahull-PointsKO-Adjacents,568
Senegalia_polyacantha,846,701,145,Alphahull-PointsKO-Adjacents,40706
Senegalia_polyphylla,2698,2436,262,Alphahull-PointsKO-Adjacents,96239
Senegalia_praecox,214,176,38,Alphahull-PointsKO-Adjacents,12122
Senegalia_purpusii,27,0,27,Points-PointsKO-Adjacents,101
Senegalia_recurva,47,0,47,Points-PointsKO-Adjacents,369
Senegalia_reniformis,33,0,33,Points-PointsKO-Adjacents,69
Senegalia_rhytidocarpa,46,24,22,Alphahull-PointsKO-Adjacents,471
Senegalia_ricoae,4,4,0,Points-PointsKO-Adjacents,18
Senegalia_riograndensis,1,1,0,Points-PointsKO-Adjacents,9
Senegalia_rostrata,23,2,21,Points-PointsKO-Adjacents,207
Senegalia_rugata,24,1,23,Points-PointsKO-Adjacents,181
Senegalia_rurrenabaqueana,11,4,7,Points-PointsKO-Adjacents,71
Senegalia_santosii,9,1,8,Points-PointsKO-Adjacents,59
Senegalia_senegal,0,0,0,NA,0
Senegalia_tamarindifolia,101,96,5,Alphahull-PointsKO-Adjacents,39710
Senegalia_tenuifolia,1352,1,1351,Points-PointsKO-Adjacents,8578
Senegalia_trijuga,1,1,0,Points-PointsKO-Adjacents,9
Senegalia_tucumanensis,152,97,55,Alphahull-PointsKO-Adjacents,6378
Senegalia_visco,120,81,39,Alphahull-PointsKO-Adjacents,4881
Senegalia_westiana,9,0,9,Points-PointsKO-Adjacents,69
Senna_acuruensis,377,336,41,Alphahull-PointsKO-Adjacents,7685
Senna_affinis,242,201,41,Alphahull-PointsKO-Adjacents,4419
Senna_alata,972,766,206,Alphahull-PointsKO-Adjacents,84330
Senna_alexandrina,33,9,24,Points-PointsKO-Adjacents,278
Senna_angustisiliqua,20,14,6,Points-PointsKO-Adjacents,104
Senna_ankaranensis,5,5,0,Points-PointsKO-Adjacents,32
Senna_anthoxantha,23,9,14,Points-PointsKO-Adjacents,170
Senna_aristeguietae,14,0,14,Points-PointsKO-Adjacents,110
Senna_atomaria,1342,1128,214,Alphahull-PointsKO-Adjacents,17314
Senna_auriculata,9,0,9,Points-PointsKO-Adjacents,70
Senna_aversiflora,76,56,20,Alphahull-PointsKO-Adjacents,1266
Senna_aymara,27,10,17,Points-PointsKO-Adjacents,146
Senna_baccarinii,22,11,11,Points-PointsKO-Adjacents,166
Senna_bacillaris,812,670,142,Alphahull-PointsKO-Adjacents,42675
Senna_bicapsularis,127,60,67,Alphahull-PointsKO-Adjacents,4884
Senna_biglandularis,72,56,16,Alphahull-PointsKO-Adjacents,2193
Senna_birostris,146,85,61,Alphahull-PointsKO-Adjacents,5011
Senna_bosseri,6,3,3,Points-PointsKO-Adjacents,33
Senna_burkartiana,19,3,16,Points-PointsKO-Adjacents,150
Senna_cajamarcae,11,0,11,Points-PointsKO-Adjacents,72
Senna_cana,708,664,44,Alphahull-PointsKO-Adjacents,19183
Senna_cardiosperma,400,365,35,Alphahull-PointsKO-Adjacents,11211
Senna_caudata,29,13,16,Points-PointsKO-Adjacents,166
Senna_chapmanii,15,4,11,Points-PointsKO-Adjacents,79
Senna_chloroclada,89,68,21,Alphahull-PointsKO-Adjacents,2185
Senna_corymbosa,225,165,60,Alphahull-PointsKO-Adjacents,15480
Senna_costata,195,156,39,Alphahull-PointsKO-Adjacents,8702
Senna_cushina,6,0,6,Points-PointsKO-Adjacents,54
Senna_dariensis,194,163,31,Alphahull-PointsKO-Adjacents,2978
Senna_didymobotrya,1306,1221,85,Alphahull-PointsKO-Adjacents,20746
Senna_divaricata,2,2,0,Points-PointsKO-Adjacents,18
Senna_domingensis,2,1,1,Points-PointsKO-Adjacents,15
Senna_ellisiae,5,0,5,Points-PointsKO-Adjacents,44
Senna_foetidissima,141,114,27,Alphahull-PointsKO-Adjacents,1914
Senna_formosa,11,6,5,Points-PointsKO-Adjacents,46
Senna_fruticosa,365,285,80,Alphahull-PointsKO-Adjacents,8173
Senna_gardneri,168,0,168,Points-PointsKO-Adjacents,1071
Senna_garrettiana,9,1,8,Points-PointsKO-Adjacents,79
Senna_gaudichaudii,275,226,49,Alphahull-PointsKO-Adjacents,4143
Senna_georgica,264,175,89,Alphahull-PointsKO-Adjacents,18440
Senna_glutinosa,1512,1441,71,Alphahull-PointsKO-Adjacents,37692
Senna_guatemalensis,121,89,32,Alphahull-PointsKO-Adjacents,1320
Senna_hayesiana,580,491,89,Alphahull-PointsKO-Adjacents,10011
Senna_herzogii,68,47,21,Alphahull-PointsKO-Adjacents,983
Senna_holwayana,340,298,42,Alphahull-PointsKO-Adjacents,1784
Senna_huilana,1,1,0,Points-PointsKO-Adjacents,9
Senna_lactea,47,31,16,Alphahull-PointsKO-Adjacents,480
Senna_latifolia,183,108,75,Alphahull-PointsKO-Adjacents,10711
Senna_leandrii,94,78,16,Alphahull-PointsKO-Adjacents,1479
Senna_longiracemosa,6,0,6,Points-PointsKO-Adjacents,53
Senna_loretensis,21,8,13,Points-PointsKO-Adjacents,174
Senna_macranthera,1983,1788,195,Alphahull-PointsKO-Adjacents,32572
Senna_macrophylla,475,413,62,Alphahull-PointsKO-Adjacents,26524
Senna_mandonii,31,16,15,Points-PointsKO-Adjacents,224
Senna_meridionalis,34,25,9,Alphahull-PointsKO-Adjacents,88
Senna_mexicana,23,5,18,Points-PointsKO-Adjacents,142
Senna_mollissima,115,92,23,Alphahull-PointsKO-Adjacents,1053
Senna_morongii,95,72,23,Alphahull-PointsKO-Adjacents,5367
Senna_mucronifera,37,13,24,Points-PointsKO-Adjacents,285
Senna_multifoliolata,54,40,14,Alphahull-PointsKO-Adjacents,116
Senna_multiglandulosa,335,237,98,Alphahull-PointsKO-Adjacents,2503
Senna_multijuga,162,147,15,Alphahull-PointsKO-Adjacents,1345
Senna_mutisiana,27,14,13,Points-PointsKO-Adjacents,158
Senna_nicaraguensis,204,142,62,Alphahull-PointsKO-Adjacents,3402
Senna_nitida,23,15,8,Points-PointsKO-Adjacents,67
Senna_obliqua,35,16,19,Points-PointsKO-Adjacents,287
Senna_oxyphylla,84,51,33,Alphahull-PointsKO-Adjacents,2441
Senna_pallida,1222,1031,191,Alphahull-PointsKO-Adjacents,16017
Senna_papillosa,483,414,69,Alphahull-PointsKO-Adjacents,8120
Senna_pendula,1142,881,261,Alphahull-PointsKO-Adjacents,57250
Senna_peralteana,253,230,23,Alphahull-PointsKO-Adjacents,2102
Senna_perrieri,4,4,0,Points-PointsKO-Adjacents,30
Senna_petersiana,211,133,78,Alphahull-PointsKO-Adjacents,5724
Senna_pistaciifolia,99,63,36,Alphahull-PointsKO-Adjacents,1817
Senna_podocarpa,49,26,23,Alphahull-PointsKO-Adjacents,3546
Senna_polyantha,177,154,23,Alphahull-PointsKO-Adjacents,1504
Senna_polyphylla,32,1,31,Points-PointsKO-Adjacents,72
Senna_punoensis,24,11,13,Points-PointsKO-Adjacents,121
Senna_quinquangulata,444,310,134,Alphahull-PointsKO-Adjacents,22824
Senna_racemosa,585,502,83,Alphahull-PointsKO-Adjacents,5070
Senna_reticulata,1026,818,208,Alphahull-PointsKO-Adjacents,85566
Senna_robiniifolia,60,28,32,Alphahull-PointsKO-Adjacents,1160
Senna_rugosa,1083,968,115,Alphahull-PointsKO-Adjacents,36558
Senna_ruiziana,235,193,42,Alphahull-PointsKO-Adjacents,9158
Senna_saeri,11,0,11,Points-PointsKO-Adjacents,99
Senna_sandwithiana,14,6,8,Points-PointsKO-Adjacents,114
Senna_santanderensis,16,4,12,Points-PointsKO-Adjacents,125
Senna_scandens,6,0,6,Points-PointsKO-Adjacents,42
Senna_septemtrionalis,270,207,63,Alphahull-PointsKO-Adjacents,6043
Senna_siamea,6,1,5,Points-PointsKO-Adjacents,52
Senna_silvestris,1871,1734,137,Alphahull-PointsKO-Adjacents,119896
Senna_singueana,165,84,81,Alphahull-PointsKO-Adjacents,13292
Senna_skinneri,325,254,71,Alphahull-PointsKO-Adjacents,3236
Senna_smithiana,1,1,0,Points-PointsKO-Adjacents,9
Senna_sousana,9,0,9,Points-PointsKO-Adjacents,42
Senna_spectabilis,1500,1288,212,Alphahull-PointsKO-Adjacents,47641
Senna_spinescens,82,37,45,Alphahull-PointsKO-Adjacents,406
Senna_spinigera,8,1,7,Points-PointsKO-Adjacents,54
Senna_suarezensis,1,1,0,Points-PointsKO-Adjacents,9
Senna_sulfurea,2,1,1,Points-PointsKO-Adjacents,18
Senna_surattensis,92,35,57,Alphahull-PointsKO-Adjacents,1331
Senna_tapajozensis,80,39,41,Alphahull-PointsKO-Adjacents,5894
Senna_timoriensis,81,0,81,Points-PointsKO-Adjacents,506
Senna_tonduzii,39,25,14,Alphahull-PointsKO-Adjacents,188
Senna_trachypus,326,290,36,Alphahull-PointsKO-Adjacents,8698
Senna_trolliiflora,19,12,7,Points-PointsKO-Adjacents,108
Senna_uncata,1,1,0,Points-PointsKO-Adjacents,9
Senna_undulata,311,236,75,Alphahull-PointsKO-Adjacents,6201
Senna_uniflora,938,0,938,Points-PointsKO-Adjacents,3872
Senna_velutina,536,465,71,Alphahull-PointsKO-Adjacents,28638
Senna_versicolor,43,18,25,Points-PointsKO-Adjacents,304
Senna_viarum,54,24,30,Alphahull-PointsKO-Adjacents,191
Senna_viciifolia,21,13,8,Points-PointsKO-Adjacents,171
Senna_viguierella,67,52,15,Alphahull-PointsKO-Adjacents,940
Senna_viminea,8,0,8,Points-PointsKO-Adjacents,54
Senna_weddelliana,11,2,9,Points-PointsKO-Adjacents,63
Senna_williamsii,20,9,11,Points-PointsKO-Adjacents,95
Senna_wurdackii,11,6,5,Points-PointsKO-Adjacents,87
Seorsus_taxifolius,NA,NA,NA,NA,NA
Septotheca_tessmannii,9,1,8,Points-PointsKO-Adjacents,74
Sequoia_sempervirens,963,806,157,Alphahull-PointsKO-Adjacents,2479
Sequoiadendron_giganteum,180,157,23,Alphahull-PointsKO-Adjacents,720
Serenoa_repens,652,546,106,Alphahull-PointsKO-Adjacents,3927
Serianthes_calycina,5,4,1,Points-PointsKO-Adjacents,36
Serianthes_grandiflora,7,0,7,Points-PointsKO-Adjacents,49
Serianthes_hooglandii,32,16,16,Points-PointsKO-Adjacents,126
Serianthes_melanesica,0,0,0,NA,0
Serianthes_minahassae,47,18,29,Points-PointsKO-Adjacents,253
Serianthes_myriadenia,5,5,0,Points-PointsKO-Adjacents,26
Serianthes_nelsonii,1,0,1,Points-PointsKO-Adjacents,7
Serianthes_petitiana,1,1,0,Points-PointsKO-Adjacents,9
Serianthes_robinsonii,1,1,0,Points-PointsKO-Adjacents,9
Serianthes_rurutensis,1,1,0,Points-PointsKO-Adjacents,4
Sericanthe_andongensis,65,33,32,Alphahull-PointsKO-Adjacents,359
Sericanthe_auriculata,40,28,12,Alphahull-PointsKO-Adjacents,394
Sericanthe_burundensis,7,5,2,Points-PointsKO-Adjacents,27
Sericanthe_halleana,3,3,0,Points-PointsKO-Adjacents,25
Sericanthe_odoratissima,48,32,16,Alphahull-PointsKO-Adjacents,161
Sericanthe_pellegrinii,9,4,5,Points-PointsKO-Adjacents,66
Sericanthe_roseoides,7,3,4,Points-PointsKO-Adjacents,38
Sericanthe_testui,12,6,6,Points-PointsKO-Adjacents,92
Sericanthe_toupetou,8,1,7,Points-PointsKO-Adjacents,59
Serjania_paucidentata,210,109,101,Alphahull-PointsKO-Adjacents,6463
Serjania_polyphylla,63,35,28,Alphahull-PointsKO-Adjacents,390
Sersalisia_sericea,1430,1338,92,Alphahull-PointsKO-Adjacents,11947
Sersalisia_sessiliflora,15,10,5,Points-PointsKO-Adjacents,31
Sesamothamnus_busseanus,6,0,6,Points-PointsKO-Adjacents,45
Sesamothamnus_guerichii,7,3,4,Points-PointsKO-Adjacents,63
Sesamothamnus_lugardii,33,18,15,Points-PointsKO-Adjacents,285
Sesamothamnus_rivae,7,0,7,Points-PointsKO-Adjacents,48
Sesbania_bispinosa,53,12,41,Points-PointsKO-Adjacents,452
Sesbania_coerulescens,22,3,19,Points-PointsKO-Adjacents,176
Sesbania_drummondii,276,193,83,Alphahull-PointsKO-Adjacents,5023
Sesbania_dummeri,4,4,0,Points-PointsKO-Adjacents,36
Sesbania_exasperata,222,86,136,Alphahull-PointsKO-Adjacents,4969
Sesbania_formosa,264,224,40,Alphahull-PointsKO-Adjacents,6701
Sesbania_goetzei,14,3,11,Points-PointsKO-Adjacents,118
Sesbania_grandiflora,103,21,82,Alphahull-PointsKO-Adjacents,705
Sesbania_keniensis,16,10,6,Points-PointsKO-Adjacents,120
Sesbania_macrantha,113,68,45,Alphahull-PointsKO-Adjacents,9445
Sesbania_punicea,586,387,199,Alphahull-PointsKO-Adjacents,21391
Sesbania_sesban,458,301,157,Alphahull-PointsKO-Adjacents,28572
Sesbania_speciosa,22,13,9,Points-PointsKO-Adjacents,103
Sesbania_virgata,241,159,82,Alphahull-PointsKO-Adjacents,19966
Sessea_andina,7,3,4,Points-PointsKO-Adjacents,54
Sessea_brasiliensis,52,32,20,Alphahull-PointsKO-Adjacents,526
Sessea_colombiana,10,3,7,Points-PointsKO-Adjacents,57
Sessea_corymbiflora,68,42,26,Alphahull-PointsKO-Adjacents,1090
Sessea_crassivenosa,58,34,24,Alphahull-PointsKO-Adjacents,375
Sessea_dependens,37,12,25,Points-PointsKO-Adjacents,268
Sessea_herzogii,20,12,8,Points-PointsKO-Adjacents,95
Sessea_regnellii,109,0,109,Points-PointsKO-Adjacents,767
Sessea_sodiroi,9,3,6,Points-PointsKO-Adjacents,69
Sessea_stipulata,30,10,20,Points-PointsKO-Adjacents,244
Sextonia_pubescens,11,4,7,Points-PointsKO-Adjacents,80
Sextonia_rubra,145,99,46,Alphahull-PointsKO-Adjacents,10054
Shepherdia_argentea,630,548,82,Alphahull-PointsKO-Adjacents,35019
Sherbournia_amaraliocarpa,7,2,5,Points-PointsKO-Adjacents,57
Sherbournia_kiliotricha,4,4,0,Points-PointsKO-Adjacents,24
Shirakiopsis_aubrevillei,14,9,5,Points-PointsKO-Adjacents,100
Shirakiopsis_elliptica,280,176,104,Alphahull-PointsKO-Adjacents,11597
Shirakiopsis_indica,38,5,33,Points-PointsKO-Adjacents,287
Shirakiopsis_sanchezii,0,0,0,NA,0
Shirakiopsis_trilocularis,6,1,5,Points-PointsKO-Adjacents,44
Shirakiopsis_virgata,1,1,0,Points-PointsKO-Adjacents,9
Shorea_assamica,12,2,10,Points-PointsKO-Adjacents,80
Shorea_cuspidata,1,1,0,Points-PointsKO-Adjacents,9
Shorea_falcata,0,0,0,NA,0
Shorea_guiso,4,0,4,Points-PointsKO-Adjacents,35
Hopea_longiflora,4,0,4,Points-PointsKO-Adjacents,36
Hopea_macrophylla,12,3,9,Points-PointsKO-Adjacents,99
Richetia_coriacea,3,3,0,Points-PointsKO-Adjacents,27
Shorea_robusta,14,1,13,Points-PointsKO-Adjacents,114
Shorea_roxburghii,13,5,8,Points-PointsKO-Adjacents,91
Shorea_selanica,6,0,6,Points-PointsKO-Adjacents,44
Hopea_seminis,7,0,7,Points-PointsKO-Adjacents,57
Hopea_splendida,5,0,5,Points-PointsKO-Adjacents,45
Isoptera_sumatrana,1,0,1,Points-PointsKO-Adjacents,9
Shorea_trapezifolia,0,0,0,NA,0
Sibangea_arborescens,73,57,16,Alphahull-PointsKO-Adjacents,1766
Sibangea_pleioneura,9,5,4,Points-PointsKO-Adjacents,39
Sibangea_similis,38,29,9,Alphahull-PointsKO-Adjacents,421
Sibiraea_laevigata,13,0,13,Points-PointsKO-Adjacents,105
Sibiraea_tianschanica,0,0,0,NA,0
Sida_fallax,61,0,61,Points-PointsKO-Adjacents,192
Sideroxylon_acunae,3,3,0,Points-PointsKO-Adjacents,24
Sideroxylon_alachense,0,0,0,NA,0
Sideroxylon_altamiranoi,33,23,10,Alphahull-PointsKO-Adjacents,114
Sideroxylon_americanum,201,138,63,Alphahull-PointsKO-Adjacents,3300
Sideroxylon_anomalum,4,3,1,Points-PointsKO-Adjacents,36
Sideroxylon_beguei,19,6,13,Points-PointsKO-Adjacents,113
Sideroxylon_bequaertii,1,1,0,Points-PointsKO-Adjacents,9
Sideroxylon_betsimisarakum,14,7,7,Points-PointsKO-Adjacents,67
Sideroxylon_borbonicum,1,1,0,Points-PointsKO-Adjacents,9
Sideroxylon_boutonianum,0,0,0,NA,0
Sideroxylon_bullatum,3,3,0,Points-PointsKO-Adjacents,27
Sideroxylon_canariense,59,49,10,Alphahull-PointsKO-Adjacents,121
Sideroxylon_cantoniense,NA,NA,NA,NA,NA
Sideroxylon_capiri,531,448,83,Alphahull-PointsKO-Adjacents,9327
Sideroxylon_capuronii,14,0,14,Points-PointsKO-Adjacents,88
Sideroxylon_cartilagineum,47,22,25,Alphahull-PointsKO-Adjacents,591
Sideroxylon_celastrinum,384,262,122,Alphahull-PointsKO-Adjacents,13805
Sideroxylon_cinereum,0,0,0,NA,0
Sideroxylon_contrerasii,47,19,28,Points-PointsKO-Adjacents,271
Sideroxylon_cubense,58,40,18,Alphahull-PointsKO-Adjacents,337
Sideroxylon_dominicanum,3,3,0,Points-PointsKO-Adjacents,24
Sideroxylon_durifolium,3,2,1,Points-PointsKO-Adjacents,21
Sideroxylon_ekmanianum,3,3,0,Points-PointsKO-Adjacents,25
Sideroxylon_eucoriaceum,8,3,5,Points-PointsKO-Adjacents,63
Sideroxylon_eucuneifolium,4,4,0,Points-PointsKO-Adjacents,36
Sideroxylon_excavatum,1,1,0,Points-PointsKO-Adjacents,9
Sideroxylon_fimbriatum,3,3,0,Points-PointsKO-Adjacents,9
Sideroxylon_floribundum,16,6,10,Points-PointsKO-Adjacents,105
Sideroxylon_foetidissimum,305,0,305,Points-PointsKO-Adjacents,1604
Sideroxylon_galeatum,0,0,0,NA,0
Sideroxylon_gerrardianum,17,6,11,Points-PointsKO-Adjacents,96
Sideroxylon_grandiflorum,0,0,0,NA,0
Sideroxylon_hirtiantherum,3,3,0,Points-PointsKO-Adjacents,27
Sideroxylon_horridum,14,3,11,Points-PointsKO-Adjacents,100
Sideroxylon_ibarrae,6,3,3,Points-PointsKO-Adjacents,36
Sideroxylon_inerme,180,114,66,Alphahull-PointsKO-Adjacents,3218
Sideroxylon_jubilla,8,3,5,Points-PointsKO-Adjacents,51
Sideroxylon_lanuginosum,1612,1416,196,Alphahull-PointsKO-Adjacents,22938
Sideroxylon_leucophyllum,41,24,17,Alphahull-PointsKO-Adjacents,179
Sideroxylon_lycioides,291,222,69,Alphahull-PointsKO-Adjacents,11575
Sideroxylon_majus,2,2,0,Points-PointsKO-Adjacents,15
Sideroxylon_marginatum,1,1,0,Points-PointsKO-Adjacents,9
Sideroxylon_mascatense,41,12,29,Points-PointsKO-Adjacents,294
Sideroxylon_mirmulans,11,7,4,Points-PointsKO-Adjacents,22
Sideroxylon_moaense,2,2,0,Points-PointsKO-Adjacents,18
Sideroxylon_montanum,9,3,6,Points-PointsKO-Adjacents,43
Sideroxylon_nadeaudii,0,0,0,NA,0
Sideroxylon_nervosum,NA,NA,NA,NA,NA
Sideroxylon_obovatum,74,43,31,Alphahull-PointsKO-Adjacents,413
Sideroxylon_obtusifolium,1344,1109,235,Alphahull-PointsKO-Adjacents,48186
Sideroxylon_occidentale,71,51,20,Alphahull-PointsKO-Adjacents,1208
Sideroxylon_octosepalum,4,4,0,Points-PointsKO-Adjacents,30
Sideroxylon_palmeri,154,109,45,Alphahull-PointsKO-Adjacents,2122
Sideroxylon_peninsulare,21,6,15,Points-PointsKO-Adjacents,123
Sideroxylon_persimile,257,187,70,Alphahull-PointsKO-Adjacents,7795
Sideroxylon_polynesicum,9,1,8,Points-PointsKO-Adjacents,29
Sideroxylon_portoricense,248,177,71,Alphahull-PointsKO-Adjacents,2911
Sideroxylon_puberulum,1,0,1,Points-PointsKO-Adjacents,9
Sideroxylon_retinerve,3,3,0,Points-PointsKO-Adjacents,27
Sideroxylon_rotundifolium,4,4,0,Points-PointsKO-Adjacents,28
Sideroxylon_rubiginosum,3,2,1,Points-PointsKO-Adjacents,27
Sideroxylon_salicifolium,444,364,80,Alphahull-PointsKO-Adjacents,9052
Sideroxylon_saxorum,13,1,12,Points-PointsKO-Adjacents,94
Sideroxylon_socorrense,15,0,15,Points-PointsKO-Adjacents,17
Sideroxylon_stenospermum,85,59,26,Alphahull-PointsKO-Adjacents,862
Sideroxylon_stevensonii,12,7,5,Points-PointsKO-Adjacents,78
Sideroxylon_st-johnianum,0,0,0,NA,0
Sideroxylon_tambolokoko,3,3,0,Points-PointsKO-Adjacents,21
Sideroxylon_tenax,107,79,28,Alphahull-PointsKO-Adjacents,1376
Sideroxylon_tepicense,58,33,25,Alphahull-PointsKO-Adjacents,512
Sideroxylon_verruculosum,49,38,11,Alphahull-PointsKO-Adjacents,185
Sideroxylon_wightianum,33,17,16,Points-PointsKO-Adjacents,296
Simaba_cedron,696,544,152,Alphahull-PointsKO-Adjacents,67953
Simaba_docensis,3,2,1,Points-PointsKO-Adjacents,23
Simaba_ferruginea,140,84,56,Alphahull-PointsKO-Adjacents,7977
Simaba_floribunda,120,59,61,Alphahull-PointsKO-Adjacents,4175
Simaba_guianensis,326,241,85,Alphahull-PointsKO-Adjacents,31065
Simaba_insignis,20,0,20,Points-PointsKO-Adjacents,130
Simaba_morettii,2,2,0,Points-PointsKO-Adjacents,12
Simaba_obovata,68,42,26,Alphahull-PointsKO-Adjacents,3108
Simaba_orinocensis,430,346,84,Alphahull-PointsKO-Adjacents,56949
Simaba_paraensis,44,0,44,Points-PointsKO-Adjacents,345
Simaba_pohliana,9,1,8,Points-PointsKO-Adjacents,63
Simaba_polyphylla,66,35,31,Alphahull-PointsKO-Adjacents,769
Simarouba_amara,2186,2011,175,Alphahull-PointsKO-Adjacents,128486
Simarouba_glauca,343,278,65,Alphahull-PointsKO-Adjacents,5608
Quassia_laevis,2,2,0,Points-PointsKO-Adjacents,17
Simarouba_tulae,11,7,4,Points-PointsKO-Adjacents,64
Simarouba_versicolor,739,673,66,Alphahull-PointsKO-Adjacents,36714
Simira_aristeguietae,7,1,6,Points-PointsKO-Adjacents,63
Simira_cesariana,6,2,4,Points-PointsKO-Adjacents,30
Simira_cordifolia,161,122,39,Alphahull-PointsKO-Adjacents,6619
Simira_corumbensis,171,118,53,Alphahull-PointsKO-Adjacents,12818
Simira_ecuadorensis,46,0,46,Points-PointsKO-Adjacents,208
Simira_eliezeriana,8,3,5,Points-PointsKO-Adjacents,52
Simira_erythroxylon,9,1,8,Points-PointsKO-Adjacents,72
Simira_fragrans,7,2,5,Points-PointsKO-Adjacents,44
Simira_gardneriana,95,74,21,Alphahull-PointsKO-Adjacents,2847
Simira_glaziovii,103,72,31,Alphahull-PointsKO-Adjacents,3623
Simira_goudotii,1,1,0,Points-PointsKO-Adjacents,9
Simira_grazielae,23,4,19,Points-PointsKO-Adjacents,174
Simira_hadrantha,1,1,0,Points-PointsKO-Adjacents,9
Simira_hatschbachiorum,5,5,0,Points-PointsKO-Adjacents,29
Simira_hexandra,6,1,5,Points-PointsKO-Adjacents,45
Simira_hirsuta,11,7,4,Points-PointsKO-Adjacents,40
Simira_ignicola,2,2,0,Points-PointsKO-Adjacents,18
Simira_klugei,22,6,16,Points-PointsKO-Adjacents,167
Simira_lezamae,8,5,3,Points-PointsKO-Adjacents,57
Simira_longifolia,11,7,4,Points-PointsKO-Adjacents,67
Simira_macrocrater,61,34,27,Alphahull-PointsKO-Adjacents,1923
Simira_maxonii,122,97,25,Alphahull-PointsKO-Adjacents,855
Simira_mexicana,25,17,8,Points-PointsKO-Adjacents,159
Simira_mollis,2,2,0,Points-PointsKO-Adjacents,18
Simira_panamensis,9,1,8,Points-PointsKO-Adjacents,68
Simira_paraensis,8,0,8,Points-PointsKO-Adjacents,72
Simira_pikia,39,16,23,Points-PointsKO-Adjacents,304
Simira_podocarpa,14,1,13,Points-PointsKO-Adjacents,90
Simira_rhodoclada,31,15,16,Points-PointsKO-Adjacents,198
Simira_rubescens,488,401,87,Alphahull-PointsKO-Adjacents,60532
Simira_rubra,8,0,8,Points-PointsKO-Adjacents,68
Simira_salvadorensis,178,160,18,Alphahull-PointsKO-Adjacents,4385
Simira_sampaioana,169,118,51,Alphahull-PointsKO-Adjacents,8644
Simira_standleyi,4,4,0,Points-PointsKO-Adjacents,27
Simira_tinctoria,26,9,17,Points-PointsKO-Adjacents,213
Simira_viridiflora,52,37,15,Alphahull-PointsKO-Adjacents,517
Simira_walteri,2,2,0,Points-PointsKO-Adjacents,18
Simira_williamsii,12,0,12,Points-PointsKO-Adjacents,106
Simira_wurdackii,12,6,6,Points-PointsKO-Adjacents,104
Sinclairia_glabra,200,148,52,Alphahull-PointsKO-Adjacents,2274
Sindora_affinis,0,0,0,NA,0
Sindora_beccariana,5,0,5,Points-PointsKO-Adjacents,36
Sindora_bruggemanii,0,0,0,NA,0
Sindora_coriacea,6,2,4,Points-PointsKO-Adjacents,42
Sindora_echinocalyx,3,0,3,Points-PointsKO-Adjacents,26
Sindora_galedupa,2,2,0,Points-PointsKO-Adjacents,12
Sindora_glabra,4,4,0,Points-PointsKO-Adjacents,36
Sindora_inermis,0,0,0,NA,0
Sindora_irpicina,2,2,0,Points-PointsKO-Adjacents,17
Sindora_javanica,0,0,0,NA,0
Sindora_klaineana,40,31,9,Alphahull-PointsKO-Adjacents,226
Sindora_laotica,3,3,0,Points-PointsKO-Adjacents,27
Sindora_leiocarpa,5,1,4,Points-PointsKO-Adjacents,33
Sindora_siamensis,21,6,15,Points-PointsKO-Adjacents,164
Sindora_sumatrana,0,0,0,NA,0
Sindora_supa,2,2,0,Points-PointsKO-Adjacents,14
Sindora_tonkinensis,2,2,0,Points-PointsKO-Adjacents,18
Sindora_velutina,6,0,6,Points-PointsKO-Adjacents,54
Sindora_wallichii,6,0,6,Points-PointsKO-Adjacents,53
Sindoropsis_le-testui,62,53,9,Alphahull-PointsKO-Adjacents,750
Sinoadina_racemosa,83,37,46,Alphahull-PointsKO-Adjacents,4222
Sinojackia_henryi,2,2,0,Points-PointsKO-Adjacents,18
Sinojackia_rehderiana,4,3,1,Points-PointsKO-Adjacents,36
Sinojackia_sarcocarpa,NA,NA,NA,NA,NA
Sinojackia_xylocarpa,2,2,0,Points-PointsKO-Adjacents,18
Sinopanax_formosanus,65,57,8,Alphahull-PointsKO-Adjacents,135
Sinopodophyllum_hexandrum,83,51,32,Alphahull-PointsKO-Adjacents,3317
Sinopora_hongkongensis,0,0,0,NA,0
Sinosassafras_flavinervium,12,4,8,Points-PointsKO-Adjacents,90
Sinowilsonia_henryi,9,2,7,Points-PointsKO-Adjacents,81
Siparuna_aspera,565,502,63,Alphahull-PointsKO-Adjacents,9519
Siparuna_bifida,421,331,90,Alphahull-PointsKO-Adjacents,26677
Siparuna_brasiliensis,582,502,80,Alphahull-PointsKO-Adjacents,12954
Siparuna_calantha,8,0,8,Points-PointsKO-Adjacents,54
Siparuna_campii,2,2,0,Points-PointsKO-Adjacents,18
Siparuna_cascada,27,17,10,Points-PointsKO-Adjacents,157
Siparuna_cervicornis,230,0,230,Points-PointsKO-Adjacents,1514
Siparuna_conica,216,187,29,Alphahull-PointsKO-Adjacents,3356
Siparuna_cristata,435,359,76,Alphahull-PointsKO-Adjacents,34919
Siparuna_croatii,18,9,9,Points-PointsKO-Adjacents,131
Siparuna_cuspidata,611,506,105,Alphahull-PointsKO-Adjacents,37396
Siparuna_cymosa,68,30,38,Alphahull-PointsKO-Adjacents,349
Siparuna_decipiens,949,883,66,Alphahull-PointsKO-Adjacents,65124
Siparuna_echinata,217,192,25,Alphahull-PointsKO-Adjacents,1971
Siparuna_eggersii,37,27,10,Alphahull-PointsKO-Adjacents,572
Siparuna_ficoides,4,4,0,Points-PointsKO-Adjacents,30
Siparuna_gentryana,41,23,18,Alphahull-PointsKO-Adjacents,232
Siparuna_gesnerioides,419,366,53,Alphahull-PointsKO-Adjacents,3211
Siparuna_gigantotepala,45,33,12,Alphahull-PointsKO-Adjacents,247
Siparuna_glycycarpa,90,44,46,Alphahull-PointsKO-Adjacents,1262
Siparuna_grandiflora,487,405,82,Alphahull-PointsKO-Adjacents,15067
Siparuna_guajalitensis,20,13,7,Points-PointsKO-Adjacents,97
Siparuna_guianensis,4086,3868,218,Alphahull-PointsKO-Adjacents,138012
Siparuna_harlingii,88,61,27,Alphahull-PointsKO-Adjacents,666
Siparuna_krukovii,142,93,49,Alphahull-PointsKO-Adjacents,17729
Siparuna_laurifolia,206,168,38,Alphahull-PointsKO-Adjacents,2478
Siparuna_lepidota,217,191,26,Alphahull-PointsKO-Adjacents,2918
Siparuna_lozaniana,24,15,9,Points-PointsKO-Adjacents,166
Siparuna_macrotepala,139,123,16,Alphahull-PointsKO-Adjacents,1575
Siparuna_micrantha,50,16,34,Points-PointsKO-Adjacents,380
Siparuna_multiflora,31,23,8,Alphahull-PointsKO-Adjacents,324
Siparuna_muricata,175,139,36,Alphahull-PointsKO-Adjacents,2195
Siparuna_mutisii,25,13,12,Points-PointsKO-Adjacents,166
Siparuna_obstipa,65,40,25,Alphahull-PointsKO-Adjacents,1121
Siparuna_pachyantha,87,50,37,Alphahull-PointsKO-Adjacents,2210
Siparuna_palenquensis,13,8,5,Points-PointsKO-Adjacents,85
Siparuna_pauciflora,339,290,49,Alphahull-PointsKO-Adjacents,2003
Siparuna_petasiformis,7,0,7,Points-PointsKO-Adjacents,63
Siparuna_petiolaris,4,4,0,Points-PointsKO-Adjacents,36
Siparuna_pilosolepidota,57,46,11,Alphahull-PointsKO-Adjacents,255
Siparuna_poeppigii,252,150,102,Alphahull-PointsKO-Adjacents,10154
Siparuna_reginae,327,216,111,Alphahull-PointsKO-Adjacents,18166
Siparuna_sarmentosa,36,8,28,Points-PointsKO-Adjacents,261
Siparuna_schimpffii,45,26,19,Alphahull-PointsKO-Adjacents,970
Siparuna_sessiliflora,426,369,57,Alphahull-PointsKO-Adjacents,19486
Siparuna_stellulata,103,77,26,Alphahull-PointsKO-Adjacents,1181
Siparuna_subinodora,155,115,40,Alphahull-PointsKO-Adjacents,1455
Siparuna_thecaphora,1955,1796,159,Alphahull-PointsKO-Adjacents,37061
Siparuna_tomentosa,219,184,35,Alphahull-PointsKO-Adjacents,3136
Siparuna_vasqueziana,11,4,7,Points-PointsKO-Adjacents,70
Siphoneugena_crassifolia,143,0,143,Points-PointsKO-Adjacents,851
Siphoneugena_delicata,10,7,3,Points-PointsKO-Adjacents,57
Siphoneugena_densiflora,427,378,49,Alphahull-PointsKO-Adjacents,10526
Siphoneugena_dussii,389,287,102,Alphahull-PointsKO-Adjacents,18157
Siphoneugena_glabrata,1,1,0,Points-PointsKO-Adjacents,9
Siphoneugena_guilfoyleiana,14,0,14,Points-PointsKO-Adjacents,96
Siphoneugena_kiaerskoviana,54,41,13,Alphahull-PointsKO-Adjacents,1893
Siphoneugena_kuhlmannii,32,0,32,Points-PointsKO-Adjacents,190
Siphoneugena_minima,1,1,0,Points-PointsKO-Adjacents,9
Siphoneugena_occidentalis,110,73,37,Alphahull-PointsKO-Adjacents,1470
Siphoneugena_reitzii,234,0,234,Points-PointsKO-Adjacents,1323
Sisyrolepis_muricata,4,4,0,Points-PointsKO-Adjacents,36
Skimmia_arborescens,136,109,27,Alphahull-PointsKO-Adjacents,5340
Skimmia_multinervia,50,29,21,Alphahull-PointsKO-Adjacents,2148
Sladenia_celastrifolia,20,7,13,Points-PointsKO-Adjacents,178
Sladenia_integrifolia,NA,NA,NA,NA,NA
Sleumerodendron_austrocaledonicum,11,4,7,Points-PointsKO-Adjacents,62
Sloanea_aberrans,7,0,7,Points-PointsKO-Adjacents,44
Sloanea_ampla,51,36,15,Alphahull-PointsKO-Adjacents,194
Sloanea_amygdalina,24,15,9,Points-PointsKO-Adjacents,152
Sloanea_bathiei,3,3,0,Points-PointsKO-Adjacents,18
Sloanea_berteroana,45,25,20,Alphahull-PointsKO-Adjacents,237
Sloanea_bolivarensis,7,3,4,Points-PointsKO-Adjacents,54
Sloanea_brenesii,45,35,10,Alphahull-PointsKO-Adjacents,188
Sloanea_brevipes,36,5,31,Points-PointsKO-Adjacents,318
Sloanea_brevispina,49,23,26,Alphahull-PointsKO-Adjacents,985
Sloanea_calva,10,1,9,Points-PointsKO-Adjacents,62
Sloanea_caribaea,19,4,15,Points-PointsKO-Adjacents,148
Sloanea_carrenoi,4,4,0,Points-PointsKO-Adjacents,18
Sloanea_cataniapensis,3,3,0,Points-PointsKO-Adjacents,18
Sloanea_cavicola,7,3,4,Points-PointsKO-Adjacents,45
Sloanea_changii,3,3,0,Points-PointsKO-Adjacents,27
Sloanea_chingiana,4,4,0,Points-PointsKO-Adjacents,36
Sloanea_cordifolia,0,0,0,NA,0
Sloanea_crassifolia,19,9,10,Points-PointsKO-Adjacents,123
Sloanea_curatellifolia,4,4,0,Points-PointsKO-Adjacents,33
Sloanea_dasycarpa,191,163,28,Alphahull-PointsKO-Adjacents,392
Sloanea_davidsei,19,13,6,Points-PointsKO-Adjacents,128
Sloanea_dentata,13,5,8,Points-PointsKO-Adjacents,39
Sloanea_duckei,15,0,15,Points-PointsKO-Adjacents,129
Sloanea_durissima,55,23,32,Alphahull-PointsKO-Adjacents,980
Sloanea_echinocarpa,7,2,5,Points-PointsKO-Adjacents,63
Sloanea_eichleri,148,106,42,Alphahull-PointsKO-Adjacents,4829
Sloanea_erismoides,5,5,0,Points-PointsKO-Adjacents,44
Sloanea_faginea,97,82,15,Alphahull-PointsKO-Adjacents,443
Sloanea_filiformis,10,0,10,Points-PointsKO-Adjacents,75
Sloanea_floribunda,187,121,66,Alphahull-PointsKO-Adjacents,12654
Sloanea_fragrans,186,144,42,Alphahull-PointsKO-Adjacents,8741
Sloanea_froesii,5,5,0,Points-PointsKO-Adjacents,45
Sloanea_garcia-cossioi,19,14,5,Points-PointsKO-Adjacents,34
Sloanea_garckeana,568,427,141,Alphahull-PointsKO-Adjacents,43847
Sloanea_geniculata,14,9,5,Points-PointsKO-Adjacents,61
Sloanea_gentryi,3,3,0,Points-PointsKO-Adjacents,27
Sloanea_gracilis,35,18,17,Points-PointsKO-Adjacents,170
Sloanea_grandiflora,369,265,104,Alphahull-PointsKO-Adjacents,28603
Sloanea_grandis,27,2,25,Points-PointsKO-Adjacents,239
Sloanea_granulosa,16,3,13,Points-PointsKO-Adjacents,138
Sloanea_grossa,0,0,0,NA,0
Sloanea_guapilensis,12,5,7,Points-PointsKO-Adjacents,82
Sloanea_guianensis,1537,1343,194,Alphahull-PointsKO-Adjacents,115381
Sloanea_hainanensis,2,2,0,Points-PointsKO-Adjacents,18
Sloanea_hemsleyana,32,14,18,Points-PointsKO-Adjacents,287
Sloanea_hirsuta,548,488,60,Alphahull-PointsKO-Adjacents,11979
Sloanea_ilicifolia,16,7,9,Points-PointsKO-Adjacents,106
Sloanea_integrifolia,5,5,0,Points-PointsKO-Adjacents,45
Sloanea_jamaicensis,4,4,0,Points-PointsKO-Adjacents,24
Sloanea_kuhlmannii,6,0,6,Points-PointsKO-Adjacents,54
Sloanea_laevigata,16,9,7,Points-PointsKO-Adjacents,83
Sloanea_lanceolata,3,3,0,Points-PointsKO-Adjacents,27
Sloanea_larensis,2,2,0,Points-PointsKO-Adjacents,18
Sloanea_lasiocarpa,5,5,0,Points-PointsKO-Adjacents,36
Sloanea_lasiocoma,449,403,46,Alphahull-PointsKO-Adjacents,11038
Sloanea_latifolia,84,35,49,Alphahull-PointsKO-Adjacents,1290
Sloanea_laurifolia,216,123,93,Alphahull-PointsKO-Adjacents,20248
Sloanea_laxiflora,67,33,34,Alphahull-PointsKO-Adjacents,1534
Sloanea_leptocarpa,31,10,21,Points-PointsKO-Adjacents,279
Sloanea_longiaristata,15,8,7,Points-PointsKO-Adjacents,116
Sloanea_longisepala,10,4,6,Points-PointsKO-Adjacents,60
Sloanea_macrophylla,23,7,16,Points-PointsKO-Adjacents,191
Sloanea_medusula,71,59,12,Alphahull-PointsKO-Adjacents,821
Sloanea_megacarpa,4,4,0,Points-PointsKO-Adjacents,36
Sloanea_megaphylla,3,2,1,Points-PointsKO-Adjacents,24
Sloanea_meianthera,20,7,13,Points-PointsKO-Adjacents,137
Sloanea_merevariensis,6,0,6,Points-PointsKO-Adjacents,48
Sloanea_mollis,5,0,5,Points-PointsKO-Adjacents,45
Sloanea_multiflora,53,24,29,Alphahull-PointsKO-Adjacents,288
Sloanea_nitida,36,12,24,Points-PointsKO-Adjacents,288
Sloanea_obtusifolia,216,121,95,Alphahull-PointsKO-Adjacents,6765
Sloanea_parvifructa,11,2,9,Points-PointsKO-Adjacents,84
Sloanea_petenensis,39,21,18,Alphahull-PointsKO-Adjacents,191
Sloanea_pittieriana,5,5,0,Points-PointsKO-Adjacents,24
Sloanea_porphyrocarpa,51,15,36,Points-PointsKO-Adjacents,443
Sloanea_ptariana,8,1,7,Points-PointsKO-Adjacents,66
Sloanea_pubescens,242,134,108,Alphahull-PointsKO-Adjacents,29551
Sloanea_pubiflora,7,0,7,Points-PointsKO-Adjacents,54
Sloanea_retusa,54,33,21,Alphahull-PointsKO-Adjacents,1624
Sloanea_rhodantha,123,100,23,Alphahull-PointsKO-Adjacents,1958
Sloanea_robusta,142,78,64,Alphahull-PointsKO-Adjacents,11545
Sloanea_rufa,192,101,91,Alphahull-PointsKO-Adjacents,9382
Sloanea_schomburgkii,32,10,22,Points-PointsKO-Adjacents,255
Sloanea_shankii,1,1,0,Points-PointsKO-Adjacents,9
Sloanea_sigun,12,0,12,Points-PointsKO-Adjacents,93
Sloanea_sinemariensis,140,79,61,Alphahull-PointsKO-Adjacents,3816
Sloanea_sinensis,116,0,116,Points-PointsKO-Adjacents,1026
Sloanea_sipapoana,2,2,0,Points-PointsKO-Adjacents,18
Sloanea_spathulata,26,0,26,Points-PointsKO-Adjacents,216
Sloanea_sterculiacea,33,19,14,Points-PointsKO-Adjacents,189
Sloanea_steyermarkii,39,22,17,Alphahull-PointsKO-Adjacents,1590
Sloanea_stipitata,43,14,29,Points-PointsKO-Adjacents,350
Sloanea_subpsilocarpa,8,1,7,Points-PointsKO-Adjacents,67
Sloanea_subsessilis,2,2,0,Points-PointsKO-Adjacents,18
Sloanea_synandra,21,7,14,Points-PointsKO-Adjacents,146
Sloanea_terniflora,478,322,156,Alphahull-PointsKO-Adjacents,21498
Sloanea_tieghemi,40,19,21,Points-PointsKO-Adjacents,246
Sloanea_tomentosa,12,0,12,Points-PointsKO-Adjacents,108
Sloanea_trichosticha,4,4,0,Points-PointsKO-Adjacents,36
Sloanea_tuerckheimii,314,208,106,Alphahull-PointsKO-Adjacents,12474
Sloanea_uniflora,57,25,32,Alphahull-PointsKO-Adjacents,2254
Sloanea_venezuelana,8,1,7,Points-PointsKO-Adjacents,57
Sloanea_wurdackii,9,0,9,Points-PointsKO-Adjacents,75
Sloanea_xichouensis,1,1,0,Points-PointsKO-Adjacents,9
Sloanea_zuliaensis,110,1,109,Points-PointsKO-Adjacents,508
Smallanthus_fruticosus,43,25,18,Alphahull-PointsKO-Adjacents,310
Smallanthus_glabratus,4,4,0,Points-PointsKO-Adjacents,36
Smallanthus_jelskii,7,1,6,Points-PointsKO-Adjacents,63
Smallanthus_pyramidalis,126,94,32,Alphahull-PointsKO-Adjacents,1638
Smeathmannia_laevigata,61,41,20,Alphahull-PointsKO-Adjacents,2307
Smeathmannia_pubescens,161,112,49,Alphahull-PointsKO-Adjacents,4038
Smelophyllum_capense,11,6,5,Points-PointsKO-Adjacents,87
Smodingium_argutum,36,21,15,Alphahull-PointsKO-Adjacents,616
Socratea_exorrhiza,1651,1557,94,Alphahull-PointsKO-Adjacents,80335
Socratea_hecatonandra,5,1,4,Points-PointsKO-Adjacents,33
Socratea_rostrata,78,55,23,Alphahull-PointsKO-Adjacents,1610
Socratea_salazarii,133,110,23,Alphahull-PointsKO-Adjacents,6729
Solandra_grandiflora,82,17,65,Points-PointsKO-Adjacents,544
Solandra_longiflora,19,0,19,Points-PointsKO-Adjacents,140
Solanecio_mannii,115,55,60,Alphahull-PointsKO-Adjacents,1611
Solanum_abitaguense,110,93,17,Alphahull-PointsKO-Adjacents,1347
Solanum_abutiloides,114,80,34,Alphahull-PointsKO-Adjacents,1466
Solanum_acanthodes,158,81,77,Alphahull-PointsKO-Adjacents,3706
Solanum_accrescens,83,62,21,Alphahull-PointsKO-Adjacents,475
Solanum_actaeibotrys,43,21,22,Alphahull-PointsKO-Adjacents,403
Solanum_aculeastrum,145,93,52,Alphahull-PointsKO-Adjacents,5781
Solanum_acuminatum,81,60,21,Alphahull-PointsKO-Adjacents,940
Solanum_albidum,283,242,41,Alphahull-PointsKO-Adjacents,4315
Solanum_aligerum,465,392,73,Alphahull-PointsKO-Adjacents,5279
Solanum_altissimum,131,87,44,Alphahull-PointsKO-Adjacents,5339
Solanum_amblophyllum,14,0,14,Points-PointsKO-Adjacents,94
Solanum_anguivi,898,667,231,Alphahull-PointsKO-Adjacents,53936
Solanum_anisophyllum,180,150,30,Alphahull-PointsKO-Adjacents,3222
Solanum_aphyodendron,1014,865,149,Alphahull-PointsKO-Adjacents,18017
Solanum_appressum,36,19,17,Points-PointsKO-Adjacents,251
Solanum_arboreum,423,366,57,Alphahull-PointsKO-Adjacents,4582
Solanum_argenteum,220,165,55,Alphahull-PointsKO-Adjacents,4636
Solanum_argentinum,186,153,33,Alphahull-PointsKO-Adjacents,6477
Solanum_arundo,20,5,15,Points-PointsKO-Adjacents,152
Solanum_asperolanatum,638,574,64,Alphahull-PointsKO-Adjacents,6840
Solanum_aturense,569,476,93,Alphahull-PointsKO-Adjacents,9420
Solanum_bahamense,162,88,74,Alphahull-PointsKO-Adjacents,884
Solanum_barbeyanum,176,0,176,Points-PointsKO-Adjacents,990
Solanum_barbulatum,191,151,40,Alphahull-PointsKO-Adjacents,2101
Solanum_bellum,22,14,8,Points-PointsKO-Adjacents,157
Solanum_betaceum,100,0,100,Points-PointsKO-Adjacents,594
Solanum_bicolor,158,119,39,Alphahull-PointsKO-Adjacents,8908
Solanum_brevipedicellatum,56,42,14,Alphahull-PointsKO-Adjacents,354
Solanum_bullatum,316,0,316,Points-PointsKO-Adjacents,1716
Solanum_bumeliifolium,13,0,13,Points-PointsKO-Adjacents,66
Solanum_caavurana,569,451,118,Alphahull-PointsKO-Adjacents,17649
Solanum_cajanumense,51,29,22,Alphahull-PointsKO-Adjacents,567
Solanum_capillipes,1,1,0,Points-PointsKO-Adjacents,7
Solanum_capoerum,27,0,27,Points-PointsKO-Adjacents,154
Solanum_carautae,19,7,12,Points-PointsKO-Adjacents,101
Solanum_castaneum,47,23,24,Alphahull-PointsKO-Adjacents,421
Solanum_cernuum,247,0,247,Points-PointsKO-Adjacents,1555
Solanum_chalmersii,10,3,7,Points-PointsKO-Adjacents,60
Solanum_chrysasteroides,1,1,0,Points-PointsKO-Adjacents,9
Solanum_chrysotrichum,423,359,64,Alphahull-PointsKO-Adjacents,5044
Solanum_cinnamomeum,239,186,53,Alphahull-PointsKO-Adjacents,2277
Solanum_circinatum,443,357,86,Alphahull-PointsKO-Adjacents,8638
Solanum_clathratum,109,51,58,Alphahull-PointsKO-Adjacents,2257
Solanum_compressum,140,126,14,Alphahull-PointsKO-Adjacents,3143
Solanum_confine,48,0,48,Points-PointsKO-Adjacents,361
Solanum_conglobatum,85,47,38,Alphahull-PointsKO-Adjacents,2717
Solanum_cordovense,192,126,66,Alphahull-PointsKO-Adjacents,2929
Solanum_cormanthum,1,1,0,Points-PointsKO-Adjacents,9
Solanum_cornifolium,54,37,17,Alphahull-PointsKO-Adjacents,482
Solanum_corumbense,52,29,23,Alphahull-PointsKO-Adjacents,1429
Solanum_corymbiflorum,119,98,21,Alphahull-PointsKO-Adjacents,2286
Solanum_costatum,35,19,16,Points-PointsKO-Adjacents,194
Solanum_crinitipes,59,38,21,Alphahull-PointsKO-Adjacents,249
Solanum_crinitum,923,791,132,Alphahull-PointsKO-Adjacents,86955
Solanum_croatii,23,1,22,Points-PointsKO-Adjacents,110
Solanum_crotonifolium,40,29,11,Alphahull-PointsKO-Adjacents,773
Solanum_cucullatum,91,77,14,Alphahull-PointsKO-Adjacents,1122
Solanum_cutervanum,29,15,14,Points-PointsKO-Adjacents,193
Solanum_cyathophorum,92,74,18,Alphahull-PointsKO-Adjacents,2528
Solanum_cyclophyllum,36,9,27,Points-PointsKO-Adjacents,161
Solanum_decorum,47,23,24,Alphahull-PointsKO-Adjacents,647
Solanum_deflexiflorum,134,110,24,Alphahull-PointsKO-Adjacents,1722
Solanum_diploconos,259,213,46,Alphahull-PointsKO-Adjacents,3629
Solanum_diversifolium,50,18,32,Points-PointsKO-Adjacents,310
Solanum_dolosum,45,26,19,Alphahull-PointsKO-Adjacents,337
Solanum_donianum,27,1,26,Points-PointsKO-Adjacents,220
Solanum_echidnaeforme,20,0,20,Points-PointsKO-Adjacents,153
Solanum_endopogon,224,159,65,Alphahull-PointsKO-Adjacents,12257
Solanum_ensifolium,10,4,6,Points-PointsKO-Adjacents,54
Solanum_erianthum,176,0,176,Points-PointsKO-Adjacents,1121
Solanum_fallax,25,14,11,Points-PointsKO-Adjacents,173
Solanum_flexicaule,15,7,8,Points-PointsKO-Adjacents,115
Solanum_fosbergianum,9,4,5,Points-PointsKO-Adjacents,27
Solanum_gertii,19,0,19,Points-PointsKO-Adjacents,121
Solanum_giganteum,141,55,86,Alphahull-PointsKO-Adjacents,3680
Solanum_glomuliflorum,13,2,11,Points-PointsKO-Adjacents,96
Solanum_gomphodes,146,108,38,Alphahull-PointsKO-Adjacents,9804
Solanum_goniocaulon,21,12,9,Points-PointsKO-Adjacents,144
Solanum_goodspeedii,114,96,18,Alphahull-PointsKO-Adjacents,1444
Solanum_grandiflorum,171,135,36,Alphahull-PointsKO-Adjacents,4364
Solanum_granuloso-leprosum,759,646,113,Alphahull-PointsKO-Adjacents,21266
Solanum_hayesii,232,197,35,Alphahull-PointsKO-Adjacents,1788
Solanum_hazenii,592,478,114,Alphahull-PointsKO-Adjacents,10941
Solanum_heinianum,41,30,11,Alphahull-PointsKO-Adjacents,183
Solanum_hirtum,488,381,107,Alphahull-PointsKO-Adjacents,11447
Solanum_hypaleurotrichum,96,73,23,Alphahull-PointsKO-Adjacents,619
Solanum_hypermegethes,9,3,6,Points-PointsKO-Adjacents,65
Solanum_hyporhodium,4,4,0,Points-PointsKO-Adjacents,34
Solanum_iltisii,66,50,16,Alphahull-PointsKO-Adjacents,396
Solanum_incanum,151,62,89,Alphahull-PointsKO-Adjacents,9586
Solanum_incomptum,36,23,13,Alphahull-PointsKO-Adjacents,93
Solanum_inelegans,32,24,8,Alphahull-PointsKO-Adjacents,150
Solanum_jamaicense,695,510,185,Alphahull-PointsKO-Adjacents,20950
Solanum_johannae,9,1,8,Points-PointsKO-Adjacents,65
Solanum_kioniotrichum,55,33,22,Alphahull-PointsKO-Adjacents,3985
Solanum_kleinii,11,3,8,Points-PointsKO-Adjacents,64
Solanum_lacerdae,178,0,178,Points-PointsKO-Adjacents,965
Solanum_lanceolatum,950,818,132,Alphahull-PointsKO-Adjacents,7373
Solanum_lasiopodium,6,0,6,Points-PointsKO-Adjacents,47
Solanum_latiflorum,61,43,18,Alphahull-PointsKO-Adjacents,897
Solanum_lepidotum,548,446,102,Alphahull-PointsKO-Adjacents,14176
Solanum_leptostachys,87,67,20,Alphahull-PointsKO-Adjacents,2077
Solanum_leucocarpon,843,719,124,Alphahull-PointsKO-Adjacents,74096
Solanum_leucodendron,160,129,31,Alphahull-PointsKO-Adjacents,1731
Solanum_lindenii,101,70,31,Alphahull-PointsKO-Adjacents,1408
Solanum_luteoalbum,4,4,0,Points-PointsKO-Adjacents,29
Solanum_lycocarpum,912,810,102,Alphahull-PointsKO-Adjacents,32534
Solanum_malletii,40,21,19,Alphahull-PointsKO-Adjacents,496
Solanum_mapiricum,9,5,4,Points-PointsKO-Adjacents,64
Solanum_maternum,62,52,10,Alphahull-PointsKO-Adjacents,1255
Solanum_maturecalvans,284,233,51,Alphahull-PointsKO-Adjacents,4444
Solanum_mauritianum,3592,2850,742,Alphahull-PointsKO-Adjacents,27868
Solanum_melissarum,231,167,64,Alphahull-PointsKO-Adjacents,4846
Solanum_microleprodes,53,35,18,Alphahull-PointsKO-Adjacents,790
Solanum_myoxotrichum,30,16,14,Points-PointsKO-Adjacents,185
Solanum_nigricans,382,345,37,Alphahull-PointsKO-Adjacents,6516
Solanum_nitidum,110,77,33,Alphahull-PointsKO-Adjacents,2961
Solanum_nutans,294,229,65,Alphahull-PointsKO-Adjacents,3538
Solanum_obliquum,82,51,31,Alphahull-PointsKO-Adjacents,5302
Solanum_oblongifolium,289,244,45,Alphahull-PointsKO-Adjacents,2746
Solanum_occultum,104,80,24,Alphahull-PointsKO-Adjacents,8189
Solanum_ochrophyllum,50,27,23,Alphahull-PointsKO-Adjacents,199
Solanum_oocarpum,59,32,27,Alphahull-PointsKO-Adjacents,3037
Solanum_oppositifolium,447,385,62,Alphahull-PointsKO-Adjacents,39485
Solanum_ovalifolium,347,300,47,Alphahull-PointsKO-Adjacents,5310
Solanum_ovum-fringillae,11,0,11,Points-PointsKO-Adjacents,82
Solanum_oxyphyllum,52,25,27,Alphahull-PointsKO-Adjacents,1010
Solanum_pabstii,107,0,107,Points-PointsKO-Adjacents,772
Solanum_pachimatium,14,0,14,Points-PointsKO-Adjacents,111
Solanum_paniculatum,833,685,148,Alphahull-PointsKO-Adjacents,37744
Solanum_paralum,8,0,8,Points-PointsKO-Adjacents,54
Solanum_paranense,148,128,20,Alphahull-PointsKO-Adjacents,2419
Solanum_paucispinum,9,4,5,Points-PointsKO-Adjacents,66
Solanum_piluliferum,41,19,22,Points-PointsKO-Adjacents,283
Solanum_pinetorum,34,0,34,Points-PointsKO-Adjacents,237
Solanum_placitum,29,11,18,Points-PointsKO-Adjacents,195
Solanum_polygamum,9,7,2,Points-PointsKO-Adjacents,28
Solanum_proteanthum,132,82,50,Alphahull-PointsKO-Adjacents,8234
Solanum_pseudoquina,1093,0,1093,Points-PointsKO-Adjacents,5564
Solanum_pubigerum,25,16,9,Points-PointsKO-Adjacents,118
Solanum_quaesitum,59,31,28,Alphahull-PointsKO-Adjacents,2631
Solanum_quebradense,7,3,4,Points-PointsKO-Adjacents,54
Solanum_reitzii,79,64,15,Alphahull-PointsKO-Adjacents,1580
Solanum_riparium,333,255,78,Alphahull-PointsKO-Adjacents,7197
Solanum_ripense,41,18,23,Points-PointsKO-Adjacents,284
Solanum_robustifrons,123,0,123,Points-PointsKO-Adjacents,799
Solanum_rovirosanum,350,311,39,Alphahull-PointsKO-Adjacents,2202
Solanum_rudepannum,787,644,143,Alphahull-PointsKO-Adjacents,16237
Solanum_rufescens,325,277,48,Alphahull-PointsKO-Adjacents,3675
Solanum_rugosum,1053,841,212,Alphahull-PointsKO-Adjacents,72565
Solanum_ruizii,9,2,7,Points-PointsKO-Adjacents,66
Solanum_sambuciflorum,16,0,16,Points-PointsKO-Adjacents,96
Solanum_saponaceum,79,64,15,Alphahull-PointsKO-Adjacents,462
Solanum_saturatum,18,12,6,Points-PointsKO-Adjacents,77
Solanum_schlechtendalianum,1176,956,220,Alphahull-PointsKO-Adjacents,78359
Solanum_schliebenii,8,4,4,Points-PointsKO-Adjacents,51
Solanum_schumannianum,53,35,18,Alphahull-PointsKO-Adjacents,735
Solanum_scuticum,257,176,81,Alphahull-PointsKO-Adjacents,18924
Solanum_sellowianum,55,30,25,Alphahull-PointsKO-Adjacents,455
Solanum_semotum,59,0,59,Points-PointsKO-Adjacents,443
Solanum_sessile,521,459,62,Alphahull-PointsKO-Adjacents,18730
Solanum_sibundoyense,10,0,10,Points-PointsKO-Adjacents,53
Solanum_sooretamum,86,67,19,Alphahull-PointsKO-Adjacents,534
Solanum_stellatiglandulosum,26,13,13,Points-PointsKO-Adjacents,174
Solanum_stenophyllum,164,136,28,Alphahull-PointsKO-Adjacents,1292
Solanum_steyermarkii,26,4,22,Points-PointsKO-Adjacents,202
Solanum_stipulaceum,692,636,56,Alphahull-PointsKO-Adjacents,14710
Solanum_subinerme,625,462,163,Alphahull-PointsKO-Adjacents,47771
Solanum_superbum,8,1,7,Points-PointsKO-Adjacents,66
Solanum_swartzianum,844,729,115,Alphahull-PointsKO-Adjacents,9540
Solanum_sycocarpum,76,42,34,Alphahull-PointsKO-Adjacents,989
Solanum_sycophanta,224,186,38,Alphahull-PointsKO-Adjacents,4281
Solanum_symmetricum,227,183,44,Alphahull-PointsKO-Adjacents,5162
Solanum_tampicense,93,44,49,Alphahull-PointsKO-Adjacents,1679
Solanum_tegore,52,24,28,Alphahull-PointsKO-Adjacents,1439
Solanum_tenuisetosum,24,4,20,Points-PointsKO-Adjacents,190
Solanum_tettense,122,71,51,Alphahull-PointsKO-Adjacents,4822
Solanum_thelopodium,133,94,39,Alphahull-PointsKO-Adjacents,10068
Solanum_torvum,1628,1306,322,Alphahull-PointsKO-Adjacents,18638
Solanum_trachycyphum,164,124,40,Alphahull-PointsKO-Adjacents,2050
Solanum_trichoneuron,83,56,27,Alphahull-PointsKO-Adjacents,1170
Solanum_tricuspidatum,24,6,18,Points-PointsKO-Adjacents,147
Solanum_triste,5,4,1,Points-PointsKO-Adjacents,40
Solanum_umbellatum,893,714,179,Alphahull-PointsKO-Adjacents,19959
Solanum_urticans,36,27,9,Alphahull-PointsKO-Adjacents,241
Solanum_vacciniiflorum,81,70,11,Alphahull-PointsKO-Adjacents,149
Solanum_validinervium,12,4,8,Points-PointsKO-Adjacents,80
Solanum_variabile,604,538,66,Alphahull-PointsKO-Adjacents,8590
Solanum_velutissimum,58,40,18,Alphahull-PointsKO-Adjacents,290
Solanum_venosum,125,102,23,Alphahull-PointsKO-Adjacents,1264
Solanum_vestissimum,50,23,27,Alphahull-PointsKO-Adjacents,2125
Solanum_warmingii,38,19,19,Points-PointsKO-Adjacents,230
Solanum_whalenii,29,19,10,Points-PointsKO-Adjacents,156
Solanum_wrightii,37,25,12,Alphahull-PointsKO-Adjacents,947
Solanum_yanamonense,8,1,7,Points-PointsKO-Adjacents,63
Solmsia_calophylla,90,76,14,Alphahull-PointsKO-Adjacents,162
Sommera_arborescens,178,143,35,Alphahull-PointsKO-Adjacents,1408
Sommera_chiapensis,19,5,14,Points-PointsKO-Adjacents,130
Sommera_donnell-smithii,249,218,31,Alphahull-PointsKO-Adjacents,1458
Sommera_fusca,0,0,0,NA,0
Sommera_grandis,72,0,72,Points-PointsKO-Adjacents,328
Sommera_guatemalensis,14,8,6,Points-PointsKO-Adjacents,78
Sommera_montana,6,2,4,Points-PointsKO-Adjacents,54
Sommera_parva,5,5,0,Points-PointsKO-Adjacents,31
Sommera_purdiei,14,2,12,Points-PointsKO-Adjacents,97
Sommera_sabiceoides,125,85,40,Alphahull-PointsKO-Adjacents,5912
Sonchus_fruticosus,10,6,4,Points-PointsKO-Adjacents,20
Sonchus_pinnatus,3,3,0,Points-PointsKO-Adjacents,17
Sonneratia_alba,267,0,267,Points-PointsKO-Adjacents,1244
Sonneratia_apetala,3,2,1,Points-PointsKO-Adjacents,27
Sonneratia_caseolaris,86,28,58,Alphahull-PointsKO-Adjacents,700
Sonneratia_x_hainanensis,1,1,0,Points-PointsKO-Adjacents,9
Sonneratia_ovata,4,1,3,Points-PointsKO-Adjacents,21
Sophora_affinis,189,131,58,Alphahull-PointsKO-Adjacents,2333
Sophora_brachygyna,2,2,0,Points-PointsKO-Adjacents,18
Sophora_cassioides,18,8,10,Points-PointsKO-Adjacents,153
Sophora_chathamica,237,0,237,Points-PointsKO-Adjacents,545
Sophora_chrysophylla,82,68,14,Alphahull-PointsKO-Adjacents,175
Sophora_davidii,78,45,33,Alphahull-PointsKO-Adjacents,4170
Sophora_denudata,14,10,4,Points-PointsKO-Adjacents,27
Sophora_fernandeziana,1,1,0,Points-PointsKO-Adjacents,5
Sophora_flavescens,332,169,163,Alphahull-PointsKO-Adjacents,14137
Sophora_franchetiana,1,1,0,Points-PointsKO-Adjacents,9
Sophora_godleyi,83,68,15,Alphahull-PointsKO-Adjacents,234
Sophora_gypsophila,11,8,3,Points-PointsKO-Adjacents,50
Sophora_howinsula,14,8,6,Points-PointsKO-Adjacents,13
Sophora_inhambanensis,27,5,22,Points-PointsKO-Adjacents,159
Sophora_leachiana,9,7,2,Points-PointsKO-Adjacents,42
Sophora_macnabiana,0,0,0,NA,0
Sophora_mangarevaensis,1,1,0,Points-PointsKO-Adjacents,8
Sophora_masafuerana,1,1,0,Points-PointsKO-Adjacents,5
Sophora_microphylla,1192,1073,119,Alphahull-PointsKO-Adjacents,4205
Sophora_mollis,30,0,30,Points-PointsKO-Adjacents,223
Sophora_polyphylla,1,1,0,Points-PointsKO-Adjacents,6
Sophora_prazeri,39,14,25,Points-PointsKO-Adjacents,342
Sophora_raivavaeensis,0,0,0,NA,0
Sophora_rapaensis,2,2,0,Points-PointsKO-Adjacents,4
Sophora_rubriflora,1,1,0,Points-PointsKO-Adjacents,7
Sophora_saxicola,0,0,0,NA,0
Sophora_tetraptera,257,224,33,Alphahull-PointsKO-Adjacents,2053
Sophora_tomentosa,596,295,301,Alphahull-PointsKO-Adjacents,6331
Sophora_tonkinensis,20,12,8,Points-PointsKO-Adjacents,180
Sophora_toromiro,3,3,0,Points-PointsKO-Adjacents,16
Sophora_wightii,0,0,0,NA,0
Sophora_xanthoantha,NA,NA,NA,NA,NA
Sophora_yunnanensis,3,3,0,Points-PointsKO-Adjacents,27
Sorbopyrus_auricularis,5,0,5,Points-PointsKO-Adjacents,39
Sorbus_adamii,0,0,0,NA,0
Sorbus_admonitor,NA,NA,NA,NA,NA
Sorbus_albopilosa,NA,NA,NA,NA,NA
Sorbus_alnifolia,398,272,126,Alphahull-PointsKO-Adjacents,3701
Sorbus_americana,1040,923,117,Alphahull-PointsKO-Adjacents,29284
Sorbus_andreanszkyana,NA,NA,NA,NA,NA
Sorbus_anglica,54,36,18,Alphahull-PointsKO-Adjacents,273
Sorbus_aria,8674,7352,1322,Alphahull-PointsKO-Adjacents,32518
Sorbus_armeniaca,1,1,0,Points-PointsKO-Adjacents,9
Sorbus_aronioides,27,10,17,Points-PointsKO-Adjacents,205
Sorbus_arranensis,28,23,5,Alphahull-PointsKO-Adjacents,38
Sorbus_x_avonensis,NA,NA,NA,NA,NA
Sorbus_astateria,4,4,0,Points-PointsKO-Adjacents,36
Sorbus_aucuparia,24389,21814,2575,Alphahull-PointsKO-Adjacents,54940
Sorbus_austriaca,33,21,12,Alphahull-PointsKO-Adjacents,176
Sorbus_badensis,59,44,15,Alphahull-PointsKO-Adjacents,72
Sorbus_bakonyensis,0,0,0,NA,0
Sorbus_balatonica,NA,NA,NA,NA,NA
Sorbus_borosiana,0,0,0,NA,0
Sorbus_bristoliensis,7,1,6,Points-PointsKO-Adjacents,27
Sorbus_buekkensis,NA,NA,NA,NA,NA
Sorbus_buschiana,11,6,5,Points-PointsKO-Adjacents,51
Sorbus_caloneura,79,53,26,Alphahull-PointsKO-Adjacents,7435
Sorbus_cambrensis,1,1,0,Points-PointsKO-Adjacents,9
Sorbus_caucasica,5,1,4,Points-PointsKO-Adjacents,42
Sorbus_cheddarensis,NA,NA,NA,NA,NA
Sorbus_colchica,2,2,0,Points-PointsKO-Adjacents,9
Sorbus_commixta,422,358,64,Alphahull-PointsKO-Adjacents,3476
Sorbus_coronata,31,17,14,Points-PointsKO-Adjacents,245
Sorbus_corymbifera,46,13,33,Points-PointsKO-Adjacents,381
Sorbus_croceocarpa,126,44,82,Alphahull-PointsKO-Adjacents,1180
Sorbus_cuneifolia,3,3,0,Points-PointsKO-Adjacents,18
Sorbus_cuspidata,11,0,11,Points-PointsKO-Adjacents,74
Sorbus_danubialis,74,63,11,Alphahull-PointsKO-Adjacents,167
Sorbus_decipientiformis,NA,NA,NA,NA,NA
Sorbus_decora,487,380,107,Alphahull-PointsKO-Adjacents,36105
Sorbus_x_degenii,0,0,0,NA,0
Sorbus_devoniensis,2,2,0,Points-PointsKO-Adjacents,18
Sorbus_discolor,24,5,19,Points-PointsKO-Adjacents,215
Sorbus_domestica,5117,4546,571,Alphahull-PointsKO-Adjacents,26138
Sorbus_dominii,NA,NA,NA,NA,NA
Sorbus_dunnii,8,0,8,Points-PointsKO-Adjacents,72
Sorbus_eminens,20,8,12,Points-PointsKO-Adjacents,69
Sorbus_eminentiformis,3,2,1,Points-PointsKO-Adjacents,15
Sorbus_eminentoides,NA,NA,NA,NA,NA
Sorbus_epidendron,23,11,12,Points-PointsKO-Adjacents,164
Sorbus_esserteauiana,10,2,8,Points-PointsKO-Adjacents,81
Sorbus_eugenii-kelleri,0,0,0,NA,0
Sorbus_fedorovii,5,5,0,Points-PointsKO-Adjacents,24
Sorbus_ferruginea,9,1,8,Points-PointsKO-Adjacents,72
Sorbus_folgneri,86,61,25,Alphahull-PointsKO-Adjacents,9260
Sorbus_foliolosa,34,7,27,Points-PointsKO-Adjacents,258
Sorbus_franconica,55,40,15,Alphahull-PointsKO-Adjacents,284
Sorbus_futakiana,NA,NA,NA,NA,NA
Sorbus_gerecseensis,NA,NA,NA,NA,NA
Sorbus_globosa,5,5,0,Points-PointsKO-Adjacents,45
Sorbus_glomerulata,29,12,17,Points-PointsKO-Adjacents,204
Sorbus_graeca,447,378,69,Alphahull-PointsKO-Adjacents,1420
Sorbus_groenlandica,0,0,0,NA,0
Sorbus_guanxianensis,NA,NA,NA,NA,NA
Sorbus_hajastana,4,4,0,Points-PointsKO-Adjacents,24
Sorbus_helenae,10,2,8,Points-PointsKO-Adjacents,73
Sorbus_hemsleyi,50,23,27,Alphahull-PointsKO-Adjacents,3869
Sorbus_hibernica,4,3,1,Points-PointsKO-Adjacents,36
Sorbus_hungarica,NA,NA,NA,NA,NA
Sorbus_hybrida,1975,1607,368,Alphahull-PointsKO-Adjacents,14871
Sorbus_insignis,37,28,9,Alphahull-PointsKO-Adjacents,98
Sorbus_intermedia,16077,13801,2276,Alphahull-PointsKO-Adjacents,16357
Sorbus_joannis,NA,NA,NA,NA,NA
Sorbus_keissleri,39,18,21,Points-PointsKO-Adjacents,351
Sorbus_khasiana,0,0,0,NA,0
Sorbus_kiukiangensis,9,3,6,Points-PointsKO-Adjacents,81
Sorbus_klasterskyana,NA,NA,NA,NA,NA
Sorbus_kmetiana,NA,NA,NA,NA,NA
Sorbus_koehneana,86,57,29,Alphahull-PointsKO-Adjacents,5016
Sorbus_lancastriensis,8,5,3,Points-PointsKO-Adjacents,30
Sorbus_latifolia,321,262,59,Alphahull-PointsKO-Adjacents,2683
Sorbus_latissima,0,0,0,NA,0
Sorbus_leighensis,NA,NA,NA,NA,NA
Sorbus_leptophylla,14,11,3,Points-PointsKO-Adjacents,60
Sorbus_leyana,9,4,5,Points-PointsKO-Adjacents,34
Sorbus_luristanica,2,2,0,Points-PointsKO-Adjacents,18
Sorbus_macrantha,15,7,8,Points-PointsKO-Adjacents,120
Sorbus_magocsyana,NA,NA,NA,NA,NA
Sorbus_margaretae,NA,NA,NA,NA,NA
Sorbus_medogensis,0,0,0,NA,0
Sorbus_megalocarpa,21,5,16,Points-PointsKO-Adjacents,183
Sorbus_meliosmifolia,18,8,10,Points-PointsKO-Adjacents,161
Sorbus_microphylla,26,4,22,Points-PointsKO-Adjacents,188
Sorbus_muliensis,1,1,0,Points-PointsKO-Adjacents,9
Sorbus_minima,13,1,12,Points-PointsKO-Adjacents,25
Sorbus_monbeigii,20,11,9,Points-PointsKO-Adjacents,132
Sorbus_mougeotii,585,522,63,Alphahull-PointsKO-Adjacents,5454
Sorbus_obsoletidentata,0,0,0,NA,0
Sorbus_ochracea,33,22,11,Alphahull-PointsKO-Adjacents,843
Sorbus_oligodonta,48,33,15,Alphahull-PointsKO-Adjacents,975
Sorbus_pallescens,25,12,13,Points-PointsKO-Adjacents,199
Sorbus_pannonica,0,0,0,NA,0
Sorbus_parviloba,0,0,0,NA,0
Aria_paucinerva,NA,NA,NA,NA,NA
Sorbus_x_paxiana,NA,NA,NA,NA,NA
Sorbus_persica,3,3,0,Points-PointsKO-Adjacents,27
Sorbus_porrigentiformis,71,56,15,Alphahull-PointsKO-Adjacents,176
Sorbus_pseudobakonyensis,0,0,0,NA,0
Sorbus_pseudofennica,13,0,13,Points-PointsKO-Adjacents,29
Sorbus_pseudomeinichii,3,3,0,Points-PointsKO-Adjacents,12
Sorbus_x_pseudosemi-incisa,NA,NA,NA,NA,NA
Sorbus_x_pseudovertesensis,0,0,0,NA,0
Sorbus_randaiensis,49,38,11,Alphahull-PointsKO-Adjacents,124
Sorbus_redliana,NA,NA,NA,NA,NA
Sorbus_rehderiana,101,84,17,Alphahull-PointsKO-Adjacents,3848
Sorbus_rhamnoides,23,9,14,Points-PointsKO-Adjacents,188
Sorbus_rhombifolia,NA,NA,NA,NA,NA
Sorbus_roopiana,0,0,0,NA,0
Sorbus_rufopilosa,36,0,36,Points-PointsKO-Adjacents,312
Sorbus_rupicola,819,686,133,Alphahull-PointsKO-Adjacents,9398
Sorbus_rupicoloides,NA,NA,NA,NA,NA
Sorbus_salwinensis,2,2,0,Points-PointsKO-Adjacents,18
Sorbus_sargentiana,22,14,8,Points-PointsKO-Adjacents,154
Sorbus_saxicola,1,1,0,Points-PointsKO-Adjacents,9
Sorbus_scalaris,16,10,6,Points-PointsKO-Adjacents,119
Sorbus_scannelliana,1,1,0,Points-PointsKO-Adjacents,9
Sorbus_scopulina,1334,1216,118,Alphahull-PointsKO-Adjacents,34547
Sorbus_semi-incisa,0,0,0,NA,0
Sorbus_semipinnata,0,0,0,NA,0
Sorbus_simonkaiana,0,0,0,NA,0
Sorbus_sitchensis,604,0,604,Points-PointsKO-Adjacents,2442
Sorbus_subcuneata,1,1,0,Points-PointsKO-Adjacents,9
Sorbus_subdanubialis,NA,NA,NA,NA,NA
Sorbus_subfusca,18,7,11,Points-PointsKO-Adjacents,114
Sorbus_subochracea,NA,NA,NA,NA,NA
Sorbus_subpinnata,84,47,37,Alphahull-PointsKO-Adjacents,304
Sorbus_subsimilis,133,95,38,Alphahull-PointsKO-Adjacents,688
Sorbus_taurica,1,1,0,Points-PointsKO-Adjacents,8
Sorbus_tauricola,0,0,0,NA,0
Sorbus_thibetica,34,28,6,Alphahull-PointsKO-Adjacents,454
Sorbus_thomsonii,19,7,12,Points-PointsKO-Adjacents,156
Sorbus_tianschanica,4,4,0,Points-PointsKO-Adjacents,36
Sorbus_torminalis,13545,11992,1553,Alphahull-PointsKO-Adjacents,40820
Sorbus_tsinlingensis,0,0,0,NA,0
Sorbus_turcica,2,2,0,Points-PointsKO-Adjacents,17
Sorbus_turkestanica,0,0,0,NA,0
Sorbus_ursina,4,4,0,Points-PointsKO-Adjacents,36
Sorbus_velebitica,NA,NA,NA,NA,NA
Sorbus_velutina,11,6,5,Points-PointsKO-Adjacents,51
Sorbus_verrucosa,3,3,0,Points-PointsKO-Adjacents,27
Sorbus_x_vertesensis,0,0,0,NA,0
Sorbus_vexans,2,2,0,Points-PointsKO-Adjacents,18
Sorbus_vilmorinii,70,57,13,Alphahull-PointsKO-Adjacents,910
Sorbus_wallichii,9,0,9,Points-PointsKO-Adjacents,81
Sorbus_whiteana,4,1,3,Points-PointsKO-Adjacents,18
Sorbus_wilmottiana,5,0,5,Points-PointsKO-Adjacents,9
Sorbus_wilsoniana,35,12,23,Points-PointsKO-Adjacents,312
Sorbus_yuana,2,2,0,Points-PointsKO-Adjacents,18
Sorbus_zahlbruckneri,7,0,7,Points-PointsKO-Adjacents,63
Sorbus_zayuensis,NA,NA,NA,NA,NA
Sorbus_zertovae,NA,NA,NA,NA,NA
Sorindeia_africana,134,86,48,Alphahull-PointsKO-Adjacents,6220
Sorindeia_albiflora,NA,NA,NA,NA,NA
Sorindeia_batekeensis,2,2,0,Points-PointsKO-Adjacents,18
Sorindeia_calantha,17,10,7,Points-PointsKO-Adjacents,80
Sorindeia_collina,5,5,0,Points-PointsKO-Adjacents,45
Sorindeia_grandifolia,304,256,48,Alphahull-PointsKO-Adjacents,4372
Sorindeia_juglandifolia,234,158,76,Alphahull-PointsKO-Adjacents,5701
Sorindeia_katangensis,1,1,0,Points-PointsKO-Adjacents,9
Sorindeia_madagascariensis,268,210,58,Alphahull-PointsKO-Adjacents,7040
Sorindeia_oxyandra,4,4,0,Points-PointsKO-Adjacents,18
Sorindeia_submontana,6,0,6,Points-PointsKO-Adjacents,54
Sorindeia_undulata,0,0,0,NA,0
Sorindeia_winkleri,87,70,17,Alphahull-PointsKO-Adjacents,2273
Sorocea_affinis,261,224,37,Alphahull-PointsKO-Adjacents,2000
Sorocea_bonplandii,1243,1136,107,Alphahull-PointsKO-Adjacents,22243
Sorocea_briquetii,293,253,40,Alphahull-PointsKO-Adjacents,8272
Sorocea_duckei,105,47,58,Alphahull-PointsKO-Adjacents,5916
Sorocea_ganevii,6,2,4,Points-PointsKO-Adjacents,40
Sorocea_guilleminiana,1010,876,134,Alphahull-PointsKO-Adjacents,68136
Sorocea_hilarii,428,337,91,Alphahull-PointsKO-Adjacents,4542
Sorocea_jaramilloi,23,14,9,Points-PointsKO-Adjacents,158
Sorocea_muriculata,607,0,607,Points-PointsKO-Adjacents,4203
Sorocea_pubivena,643,559,84,Alphahull-PointsKO-Adjacents,32225
Sorocea_racemosa,47,23,24,Alphahull-PointsKO-Adjacents,597
Sorocea_ruminata,30,22,8,Alphahull-PointsKO-Adjacents,317
Sorocea_sarcocarpa,34,23,11,Alphahull-PointsKO-Adjacents,434
Sorocea_sprucei,361,272,89,Alphahull-PointsKO-Adjacents,15706
Sorocea_steinbachii,391,337,54,Alphahull-PointsKO-Adjacents,18756
Sorocea_trophoides,296,239,57,Alphahull-PointsKO-Adjacents,2613
Souroubea_corallina,67,26,41,Alphahull-PointsKO-Adjacents,4845
Soyauxia_floribunda,79,58,21,Alphahull-PointsKO-Adjacents,1351
Soyauxia_gabonensis,51,38,13,Alphahull-PointsKO-Adjacents,783
Soyauxia_grandifolia,48,24,24,Alphahull-PointsKO-Adjacents,360
Soyauxia_talbotii,7,1,6,Points-PointsKO-Adjacents,63
Soyauxia_velutina,19,8,11,Points-PointsKO-Adjacents,134
Soymida_febrifuga,3,3,0,Points-PointsKO-Adjacents,27
Spachea_correae,45,31,14,Alphahull-PointsKO-Adjacents,365
Spachea_elegans,63,33,30,Alphahull-PointsKO-Adjacents,2326
Spachea_herbert-smithii,10,5,5,Points-PointsKO-Adjacents,75
Spachea_membranacea,9,3,6,Points-PointsKO-Adjacents,39
Spachea_tricarpa,32,0,32,Points-PointsKO-Adjacents,208
Sparattanthelium_acreanum,19,0,19,Points-PointsKO-Adjacents,162
Sparattanthelium_amazonum,239,159,80,Alphahull-PointsKO-Adjacents,8995
Sparattanthelium_borororum,53,12,41,Points-PointsKO-Adjacents,445
Sparattanthelium_botocudorum,239,160,79,Alphahull-PointsKO-Adjacents,2137
Sparattanthelium_tupinambazum,69,31,38,Alphahull-PointsKO-Adjacents,741
Sparattosperma_catingae,27,15,12,Points-PointsKO-Adjacents,212
Sparattosperma_leucanthum,634,498,136,Alphahull-PointsKO-Adjacents,27568
Sparrmannia_africana,39,22,17,Alphahull-PointsKO-Adjacents,177
Sparrmannia_discolor,23,16,7,Points-PointsKO-Adjacents,106
Sparrmannia_ricinocarpa,12,1,11,Points-PointsKO-Adjacents,95
Spathandra_blakeoides,98,64,34,Alphahull-PointsKO-Adjacents,2502
Spathelia_excelsa,9,0,9,Points-PointsKO-Adjacents,81
Spathelia_terminalioides,15,3,12,Points-PointsKO-Adjacents,110
Spathelia_ulei,56,36,20,Alphahull-PointsKO-Adjacents,1513
Spathiostemon_javensis,69,24,45,Alphahull-PointsKO-Adjacents,491
Spathiostemon_moniliformis,0,0,0,NA,0
Spathodea_campanulata,261,184,77,Alphahull-PointsKO-Adjacents,11499
Spatholobus_parviflorus,36,2,34,Points-PointsKO-Adjacents,294
Spatholobus_viridis,8,2,6,Points-PointsKO-Adjacents,63
Spermacoce_confusa,0,0,0,NA,0
Sphaerantia_chartacea,12,8,4,Points-PointsKO-Adjacents,27
Sphaerantia_discolor,21,15,6,Points-PointsKO-Adjacents,73
Sphaerocoryne_affinis,3,2,1,Points-PointsKO-Adjacents,24
Sphaerocoryne_gracilis,65,32,33,Alphahull-PointsKO-Adjacents,1076
Sphalmium_racemosum,45,39,6,Alphahull-PointsKO-Adjacents,33
Sphenostemon_lobosporus,107,91,16,Alphahull-PointsKO-Adjacents,256
Nouhuysia_papuana,0,0,0,NA,0
Idenburgia_pauciflora,2,2,0,Points-PointsKO-Adjacents,12
Sphinctanthus_acutilobus,4,4,0,Points-PointsKO-Adjacents,36
Sphinctanthus_hasslerianus,8,1,7,Points-PointsKO-Adjacents,69
Sphinctanthus_maculatus,120,0,120,Points-PointsKO-Adjacents,934
Sphinctanthus_microphyllus,25,12,13,Points-PointsKO-Adjacents,186
Sphinctanthus_polycarpus,6,1,5,Points-PointsKO-Adjacents,54
Sphinctanthus_striiflorus,42,13,29,Points-PointsKO-Adjacents,328
Sphingiphila_tetramera,2,2,0,Points-PointsKO-Adjacents,18
Sphyranthera_airyshawii,0,0,0,NA,0
Sphyranthera_lutescens,0,0,0,NA,0
Spigelia_anthelmia,685,460,225,Alphahull-PointsKO-Adjacents,18938
Spiniluma_discolor,3,3,0,Points-PointsKO-Adjacents,9
Spiraea_bella,31,11,20,Points-PointsKO-Adjacents,177
Spiraea_canescens,61,25,36,Alphahull-PointsKO-Adjacents,501
Spiraea_cantoniensis,38,2,36,Points-PointsKO-Adjacents,314
Spiraea_media,387,0,387,Points-PointsKO-Adjacents,2745
Spiraea_purpurea,8,2,6,Points-PointsKO-Adjacents,54
Acsmithia_collina,10,4,6,Points-PointsKO-Adjacents,59
Acsmithia_davidsonii,60,52,8,Alphahull-PointsKO-Adjacents,83
Acsmithia_integrifolia,8,0,8,Points-PointsKO-Adjacents,52
Acsmithia_meridionalis,13,9,4,Points-PointsKO-Adjacents,26
Acsmithia_parvifolia,8,3,5,Points-PointsKO-Adjacents,48
Acsmithia_pulleana,9,0,9,Points-PointsKO-Adjacents,66
Acsmithia_reticulata,10,0,10,Points-PointsKO-Adjacents,64
Spiranthera_guianensis,22,0,22,Points-PointsKO-Adjacents,186
Spiranthera_parviflora,76,37,39,Alphahull-PointsKO-Adjacents,2392
Spirospermum_penduliflorum,34,14,20,Points-PointsKO-Adjacents,229
Spirostachys_africana,168,117,51,Alphahull-PointsKO-Adjacents,5326
Spirostachys_venenifera,3,3,0,Points-PointsKO-Adjacents,27
Spirotecoma_apiculata,11,6,5,Points-PointsKO-Adjacents,76
Spirotecoma_holguinensis,5,5,0,Points-PointsKO-Adjacents,36
Spirotecoma_rubriflora,20,11,9,Points-PointsKO-Adjacents,166
Spirotecoma_spiralis,7,1,6,Points-PointsKO-Adjacents,44
Spirotheca_awadendron,15,6,9,Points-PointsKO-Adjacents,93
Spirotheca_mahechae,2,2,0,Points-PointsKO-Adjacents,18
Spirotheca_michaeli,5,5,0,Points-PointsKO-Adjacents,44
Spirotheca_rivieri,131,89,42,Alphahull-PointsKO-Adjacents,2009
Spirotheca_rosea,228,166,62,Alphahull-PointsKO-Adjacents,4955
Spirotropis_longifolia,26,13,13,Points-PointsKO-Adjacents,183
Spondianthus_preussii,138,74,64,Alphahull-PointsKO-Adjacents,2517
Spondias_dulcis,7,0,7,Points-PointsKO-Adjacents,51
Spondias_lakonensis,19,3,16,Points-PointsKO-Adjacents,171
Spondias_macrocarpa,105,56,49,Alphahull-PointsKO-Adjacents,3566
Spondias_mombin,1895,1611,284,Alphahull-PointsKO-Adjacents,133449
Spondias_pinnata,4,4,0,Points-PointsKO-Adjacents,33
Spondias_purpurea,1010,836,174,Alphahull-PointsKO-Adjacents,17769
Spondias_radlkoferi,347,291,56,Alphahull-PointsKO-Adjacents,8043
Spondias_tefyi,15,8,7,Points-PointsKO-Adjacents,58
Spondias_testudinis,36,0,36,Points-PointsKO-Adjacents,283
Spondias_tuberosa,720,0,720,Points-PointsKO-Adjacents,4249
Spondias_venosa,27,10,17,Points-PointsKO-Adjacents,220
Spondias_venulosa,184,136,48,Alphahull-PointsKO-Adjacents,5911
Spongiosperma_cataractarum,14,4,10,Points-PointsKO-Adjacents,105
Spongiosperma_grandiflorum,63,40,23,Alphahull-PointsKO-Adjacents,1874
Spongiosperma_longilobum,14,7,7,Points-PointsKO-Adjacents,96
Spongiosperma_macrophyllum,36,22,14,Alphahull-PointsKO-Adjacents,1437
Spongiosperma_oleifolium,8,0,8,Points-PointsKO-Adjacents,30
Spongiosperma_riparium,7,1,6,Points-PointsKO-Adjacents,63
Squamopappus_skutchii,29,18,11,Points-PointsKO-Adjacents,116
Stachyandra_imberbis,1,1,0,Points-PointsKO-Adjacents,9
Stachyandra_merana,7,2,5,Points-PointsKO-Adjacents,24
Stachyandra_rufibarbis,6,0,6,Points-PointsKO-Adjacents,33
Stachyandra_viticifolia,4,4,0,Points-PointsKO-Adjacents,23
Stachyarrhena_acuminata,46,16,30,Points-PointsKO-Adjacents,366
Stachyarrhena_acutiloba,3,3,0,Points-PointsKO-Adjacents,27
Stachyarrhena_duckei,20,0,20,Points-PointsKO-Adjacents,161
Stachyarrhena_grandifolia,NA,NA,NA,NA,NA
Stachyarrhena_harleyi,38,15,23,Points-PointsKO-Adjacents,195
Stachyarrhena_heterochroa,25,21,4,Alphahull-PointsKO-Adjacents,99
Stachyarrhena_oellgardii,NA,NA,NA,NA,NA
Stachyarrhena_penduliflora,149,104,45,Alphahull-PointsKO-Adjacents,11545
Stachyarrhena_reticulata,25,17,8,Points-PointsKO-Adjacents,174
Stachyarrhena_revoluta,NA,NA,NA,NA,NA
Stachyarrhena_spicata,126,72,54,Alphahull-PointsKO-Adjacents,12115
Stachyothyrsus_stapfiana,30,21,9,Alphahull-PointsKO-Adjacents,643
Stachyothyrsus_staudtii,29,15,14,Points-PointsKO-Adjacents,193
Stachytarpheta_orubica,15,6,9,Points-PointsKO-Adjacents,78
Stachytarpheta_piranii,3,3,0,Points-PointsKO-Adjacents,23
Stachyurus_cordatulus,18,14,4,Points-PointsKO-Adjacents,62
Stachyurus_himalaicus,165,137,28,Alphahull-PointsKO-Adjacents,7839
Stachyurus_obovatus,14,7,7,Points-PointsKO-Adjacents,101
Stadmania_acuminata,5,1,4,Points-PointsKO-Adjacents,35
Stadmania_excelsa,2,2,0,Points-PointsKO-Adjacents,18
Stadmania_glauca,4,4,0,Points-PointsKO-Adjacents,36
Stadmania_leandrii,9,4,5,Points-PointsKO-Adjacents,41
Stadmania_oppositifolia,4,4,0,Points-PointsKO-Adjacents,34
Stadmania_serrulata,6,0,6,Points-PointsKO-Adjacents,36
Stahlia_monosperma,12,6,6,Points-PointsKO-Adjacents,47
Stanmarkia_medialis,6,2,4,Points-PointsKO-Adjacents,47
Stanmarkia_spectabilis,3,3,0,Points-PointsKO-Adjacents,23
Staphylea_bolanderi,94,81,13,Alphahull-PointsKO-Adjacents,179
Staphylea_bumalda,561,411,150,Alphahull-PointsKO-Adjacents,3758
Staphylea_campanulata,0,0,0,NA,0
Staphylea_forrestii,4,4,0,Points-PointsKO-Adjacents,36
Staphylea_holocarpa,36,14,22,Points-PointsKO-Adjacents,323
Staphylea_pinnata,481,321,160,Alphahull-PointsKO-Adjacents,14957
Staphylea_shweliensis,0,0,0,NA,0
Staphylea_trifolia,1717,1232,485,Alphahull-PointsKO-Adjacents,32645
Staphylea_yuanjiangensis,NA,NA,NA,NA,NA
Staudtia_kamerunensis,221,191,30,Alphahull-PointsKO-Adjacents,6453
Stauranthus_perforatus,61,41,20,Alphahull-PointsKO-Adjacents,293
Steganotaenia_araliacea,228,132,96,Alphahull-PointsKO-Adjacents,9667
Steganotaenia_commiphoroides,3,3,0,Points-PointsKO-Adjacents,27
Steinbachiella_leptoclada,17,12,5,Points-PointsKO-Adjacents,120
Steiractinia_helianthoides,29,17,12,Points-PointsKO-Adjacents,188
Steiractinia_rusbyana,2,2,0,Points-PointsKO-Adjacents,9
Stelechocarpus_burahol,7,0,7,Points-PointsKO-Adjacents,61
Stelechocarpus_cauliflorus,10,1,9,Points-PointsKO-Adjacents,90
Stemonocoleus_micranthus,54,31,23,Alphahull-PointsKO-Adjacents,1967
Vateria_acuminata,0,0,0,NA,0
Vateria_affinis,NA,NA,NA,NA,NA
Vateria_canaliculata,NA,NA,NA,NA,NA
Monoporandra_cordifolia,0,0,0,NA,0
Monoporandra_elegans,0,0,0,NA,0
Vateria_gardneri,NA,NA,NA,NA,NA
Vateria_lanceolata,NA,NA,NA,NA,NA
Monoporandra_lancifolia,0,0,0,NA,0
Vateria_moonii,NA,NA,NA,NA,NA
Vateria_petiolaris,NA,NA,NA,NA,NA
Vateria_reticulata,NA,NA,NA,NA,NA
Vateria_ceylanica,NA,NA,NA,NA,NA
Stemonurus_ammui,38,0,38,Points-PointsKO-Adjacents,110
Stemonurus_apicalis,1,0,1,Points-PointsKO-Adjacents,9
Stemonurus_celebicus,0,0,0,NA,0
Stemonurus_corrugatus,NA,NA,NA,NA,NA
Stemonurus_dichrocarpus,0,0,0,NA,0
Stemonurus_gitingensis,1,1,0,Points-PointsKO-Adjacents,8
Stemonurus_grandifolius,5,0,5,Points-PointsKO-Adjacents,45
Stemonurus_malaccensis,7,0,7,Points-PointsKO-Adjacents,63
Stemonurus_monticola,8,2,6,Points-PointsKO-Adjacents,46
Stemonurus_perobtusus,0,0,0,NA,0
Stemonurus_scorpioides,8,3,5,Points-PointsKO-Adjacents,72
Stemonurus_secundiflorus,5,0,5,Points-PointsKO-Adjacents,45
Stemonurus_umbellatus,23,0,23,Points-PointsKO-Adjacents,137
Stenanona_carrillensis,3,3,0,Points-PointsKO-Adjacents,22
Stenanona_cauliflora,2,2,0,Points-PointsKO-Adjacents,18
Stenanona_columbiensis,1,1,0,Points-PointsKO-Adjacents,9
Stenanona_costaricensis,53,44,9,Alphahull-PointsKO-Adjacents,270
Stenanona_flagelliflora,3,3,0,Points-PointsKO-Adjacents,21
Stenanona_hondurensis,5,5,0,Points-PointsKO-Adjacents,30
Stenanona_humilis,9,0,9,Points-PointsKO-Adjacents,48
Stenanona_migueliana,2,2,0,Points-PointsKO-Adjacents,18
Stenanona_monticola,2,2,0,Points-PointsKO-Adjacents,18
Stenanona_narinensis,1,1,0,Points-PointsKO-Adjacents,9
Stenanona_panamensis,12,9,3,Points-PointsKO-Adjacents,30
Stenanona_stenopetala,14,9,5,Points-PointsKO-Adjacents,90
Stenanona_tuberculata,4,4,0,Points-PointsKO-Adjacents,24
Stenanona_tubiflora,5,5,0,Points-PointsKO-Adjacents,29
Stenocarpus_dumbeensis,3,3,0,Points-PointsKO-Adjacents,17
Stenocarpus_sinuatus,469,311,158,Alphahull-PointsKO-Adjacents,1167
Stenocereus_alamosensis,94,64,30,Alphahull-PointsKO-Adjacents,814
Stenocereus_beneckei,38,31,7,Alphahull-PointsKO-Adjacents,166
Stenocereus_chacalapensis,6,3,3,Points-PointsKO-Adjacents,24
Stenocereus_chrysocarpus,15,10,5,Points-PointsKO-Adjacents,84
Stenocereus_eichlamii,3,1,2,Points-PointsKO-Adjacents,21
Stenocereus_fimbriatus,9,1,8,Points-PointsKO-Adjacents,44
Stenocereus_fricii,13,5,8,Points-PointsKO-Adjacents,68
Stenocereus_griseus,136,86,50,Alphahull-PointsKO-Adjacents,2727
Stenocereus_gummosus,233,210,23,Alphahull-PointsKO-Adjacents,1751
Stenocereus_kerberi,20,6,14,Points-PointsKO-Adjacents,106
Stenocereus_laevigatus,107,84,23,Alphahull-PointsKO-Adjacents,612
Stenocereus_martinezii,7,2,5,Points-PointsKO-Adjacents,35
Stenocereus_montanus,31,15,16,Points-PointsKO-Adjacents,214
Stenocereus_pruinosus,184,151,33,Alphahull-PointsKO-Adjacents,3072
Stenocereus_queretaroensis,107,96,11,Alphahull-PointsKO-Adjacents,2129
Stenocereus_standleyi,20,1,19,Points-PointsKO-Adjacents,103
Stenocereus_stellatus,129,115,14,Alphahull-PointsKO-Adjacents,544
Stenocereus_thurberi,312,282,30,Alphahull-PointsKO-Adjacents,3847
Stenocereus_treleasei,23,0,23,Points-PointsKO-Adjacents,91
Stenopadus_andicola,4,4,0,Points-PointsKO-Adjacents,23
Stenopadus_chimantensis,13,7,6,Points-PointsKO-Adjacents,45
Stenopadus_colombianus,7,2,5,Points-PointsKO-Adjacents,48
Stenopadus_connellii,35,0,35,Points-PointsKO-Adjacents,154
Stenopadus_cucullatus,9,4,5,Points-PointsKO-Adjacents,25
Stenopadus_huachamacari,6,0,6,Points-PointsKO-Adjacents,39
Stenopadus_kunhardtii,9,6,3,Points-PointsKO-Adjacents,38
Stenopadus_obconicus,5,5,0,Points-PointsKO-Adjacents,24
Stenopadus_sericeus,3,3,0,Points-PointsKO-Adjacents,27
Stenopadus_talaumifolius,101,81,20,Alphahull-PointsKO-Adjacents,2174
Stenosepala_hirsuta,55,47,8,Alphahull-PointsKO-Adjacents,929
Stenostegia_congesta,30,24,6,Alphahull-PointsKO-Adjacents,33
Stenostomum_abbreviatum,6,3,3,Points-PointsKO-Adjacents,23
Stenostomum_acreanum,184,101,83,Alphahull-PointsKO-Adjacents,6313
Stenostomum_acutatum,34,16,18,Points-PointsKO-Adjacents,116
Stenostomum_albobrunneum,0,0,0,NA,0
Stenostomum_apiculatum,6,0,6,Points-PointsKO-Adjacents,53
Stenostomum_aristatum,0,0,0,NA,0
Stenostomum_aromaticum,9,7,2,Points-PointsKO-Adjacents,15
Stenostomum_baracoense,NA,NA,NA,NA,NA
Stenostomum_cahosianum,1,1,0,Points-PointsKO-Adjacents,9
Stenostomum_coriaceum,2,2,0,Points-PointsKO-Adjacents,10
Stenostomum_cuspidatum,NA,NA,NA,NA,NA
Stenostomum_darienense,2,2,0,Points-PointsKO-Adjacents,17
Stenostomum_densiflorum,1,1,0,Points-PointsKO-Adjacents,7
Stenostomum_ekmanii,0,0,0,NA,0
Stenostomum_ellipticum,3,3,0,Points-PointsKO-Adjacents,23
Stenostomum_granulatum,3,3,0,Points-PointsKO-Adjacents,26
Stenostomum_guianensis,0,0,0,NA,0
Stenostomum_heteroneurum,4,4,0,Points-PointsKO-Adjacents,21
Stenostomum_involucratum,8,4,4,Points-PointsKO-Adjacents,41
Stenostomum_jamaicense,2,2,0,Points-PointsKO-Adjacents,18
Stenostomum_lucidum,99,57,42,Alphahull-PointsKO-Adjacents,1722
Stenostomum_minutifolium,NA,NA,NA,NA,NA
Stenostomum_mucronatum,1,1,0,Points-PointsKO-Adjacents,9
Stenostomum_multinerve,4,4,0,Points-PointsKO-Adjacents,14
Stenostomum_nipense,NA,NA,NA,NA,NA
Stenostomum_obtusifolium,7,3,4,Points-PointsKO-Adjacents,33
Stenostomum_occidentale,0,0,0,NA,0
Stenostomum_oliganthum,5,5,0,Points-PointsKO-Adjacents,32
Stenostomum_orbiculare,1,1,0,Points-PointsKO-Adjacents,9
Stenostomum_pedicellare,NA,NA,NA,NA,NA
Stenostomum_pitonianum,0,0,0,NA,0
Stenostomum_portoricense,4,3,1,Points-PointsKO-Adjacents,21
Stenostomum_radiatum,3,3,0,Points-PointsKO-Adjacents,26
Stenostomum_resinosum,30,13,17,Points-PointsKO-Adjacents,181
Stenostomum_reticulare,1,1,0,Points-PointsKO-Adjacents,9
Stenostomum_rotundatum,1,1,0,Points-PointsKO-Adjacents,8
Stenostomum_scrobiculatum,4,4,0,Points-PointsKO-Adjacents,30
Stenostomum_shaferi,18,10,8,Points-PointsKO-Adjacents,56
Stenostomum_sintenisii,5,5,0,Points-PointsKO-Adjacents,37
Stenostomum_tomentosum,1,1,0,Points-PointsKO-Adjacents,9
Stenostomum_turrialbanum,34,23,11,Alphahull-PointsKO-Adjacents,170
Stenostomum_urbanianum,5,5,0,Points-PointsKO-Adjacents,44
Stephanodaphne_cremostachya,16,13,3,Points-PointsKO-Adjacents,20
Stephanodaphne_cuspidata,12,5,7,Points-PointsKO-Adjacents,42
Stephanodaphne_geminata,61,47,14,Alphahull-PointsKO-Adjacents,938
Stephanodaphne_humbertii,3,3,0,Points-PointsKO-Adjacents,27
Stephanodaphne_pedicellata,7,2,5,Points-PointsKO-Adjacents,43
Stephanodaphne_perrieri,2,2,0,Points-PointsKO-Adjacents,14
Stephanodaphne_pilosa,41,27,14,Alphahull-PointsKO-Adjacents,148
Stephanodaphne_schatzii,8,4,4,Points-PointsKO-Adjacents,33
Stephanopodium_angulatum,12,7,5,Points-PointsKO-Adjacents,63
Stephanopodium_aptotum,4,3,1,Points-PointsKO-Adjacents,12
Stephanopodium_blanchetianum,99,77,22,Alphahull-PointsKO-Adjacents,798
Stephanopodium_costaricense,54,46,8,Alphahull-PointsKO-Adjacents,260
Stephanopodium_cuspidatum,8,2,6,Points-PointsKO-Adjacents,68
Stephanopodium_engleri,24,15,9,Points-PointsKO-Adjacents,170
Stephanopodium_estrellense,25,14,11,Points-PointsKO-Adjacents,148
Stephanopodium_gentryi,16,4,12,Points-PointsKO-Adjacents,107
Stephanopodium_longipedicellatum,7,1,6,Points-PointsKO-Adjacents,56
Stephanopodium_magnifolium,9,6,3,Points-PointsKO-Adjacents,32
Stephanopodium_organense,20,9,11,Points-PointsKO-Adjacents,122
Stephanopodium_peruvianum,46,22,24,Alphahull-PointsKO-Adjacents,2209
Stephanopodium_sessile,9,2,7,Points-PointsKO-Adjacents,59
Stephanostegia_capuronii,32,16,16,Points-PointsKO-Adjacents,142
Stephanostegia_hildebrandtii,91,57,34,Alphahull-PointsKO-Adjacents,498
Sterculia_abbreviata,4,4,0,Points-PointsKO-Adjacents,36
Sterculia_aerisperma,25,10,15,Points-PointsKO-Adjacents,148
Sterculia_africana,113,50,63,Alphahull-PointsKO-Adjacents,1755
Sterculia_albidiflora,6,1,5,Points-PointsKO-Adjacents,54
Sterculia_alexandri,9,1,8,Points-PointsKO-Adjacents,61
Sterculia_allenii,14,8,6,Points-PointsKO-Adjacents,38
Sterculia_amazonica,7,0,7,Points-PointsKO-Adjacents,59
Sterculia_apeibophylla,99,63,36,Alphahull-PointsKO-Adjacents,9695
Sterculia_apetala,937,737,200,Alphahull-PointsKO-Adjacents,44768
Sterculia_appendiculata,19,4,15,Points-PointsKO-Adjacents,152
Sterculia_brevissima,2,2,0,Points-PointsKO-Adjacents,18
Sterculia_caribaea,19,13,6,Points-PointsKO-Adjacents,30
Sterculia_ceramica,4,4,0,Points-PointsKO-Adjacents,31
Sterculia_chicomendesii,33,0,33,Points-PointsKO-Adjacents,290
Sterculia_colombiana,159,136,23,Alphahull-PointsKO-Adjacents,6396
Sterculia_corrugata,6,3,3,Points-PointsKO-Adjacents,32
Sterculia_costaricana,46,38,8,Alphahull-PointsKO-Adjacents,224
Sterculia_curiosa,111,79,32,Alphahull-PointsKO-Adjacents,2864
Sterculia_dawei,40,21,19,Alphahull-PointsKO-Adjacents,272
Sterculia_duckei,19,5,14,Points-PointsKO-Adjacents,159
Sterculia_euosma,17,0,17,Points-PointsKO-Adjacents,153
Sterculia_excelsa,177,112,65,Alphahull-PointsKO-Adjacents,23910
Sterculia_foetida,14,0,14,Points-PointsKO-Adjacents,110
Sterculia_frondosa,201,145,56,Alphahull-PointsKO-Adjacents,13093
Sterculia_gilva,3,0,3,Points-PointsKO-Adjacents,27
Sterculia_guangxiensis,NA,NA,NA,NA,NA
Sterculia_guapayensis,28,8,20,Points-PointsKO-Adjacents,233
Sterculia_guianensis,8,4,4,Points-PointsKO-Adjacents,67
Sterculia_hainanensis,7,2,5,Points-PointsKO-Adjacents,63
Sterculia_henryi,5,4,1,Points-PointsKO-Adjacents,45
Sterculia_hymenocalyx,5,5,0,Points-PointsKO-Adjacents,45
Sterculia_impressinervis,NA,NA,NA,NA,NA
Sterculia_kayae,44,17,27,Points-PointsKO-Adjacents,344
Sterculia_khasiana,NA,NA,NA,NA,NA
Sterculia_killipiana,28,13,15,Points-PointsKO-Adjacents,208
Sterculia_kingtungensis,1,1,0,Points-PointsKO-Adjacents,9
Sterculia_lanceifolia,9,1,8,Points-PointsKO-Adjacents,81
Sterculia_lanceolata,122,83,39,Alphahull-PointsKO-Adjacents,6360
Sterculia_lisae,10,0,10,Points-PointsKO-Adjacents,65
Sterculia_mexicana,85,0,85,Points-PointsKO-Adjacents,341
Sterculia_mhosya,1,1,0,Points-PointsKO-Adjacents,9
Sterculia_micrantha,1,1,0,Points-PointsKO-Adjacents,9
Sterculia_monosperma,5,0,5,Points-PointsKO-Adjacents,42
Sterculia_multiovula,10,1,9,Points-PointsKO-Adjacents,64
Sterculia_murex,23,11,12,Points-PointsKO-Adjacents,167
Sterculia_oblonga,97,66,31,Alphahull-PointsKO-Adjacents,2759
Sterculia_parviflora,4,0,4,Points-PointsKO-Adjacents,27
Sterculia_pendula,8,1,7,Points-PointsKO-Adjacents,72
Sterculia_peruviana,46,23,23,Alphahull-PointsKO-Adjacents,762
Sterculia_pexa,17,6,11,Points-PointsKO-Adjacents,153
Sterculia_principis,35,11,24,Points-PointsKO-Adjacents,300
Sterculia_pruriens,410,326,84,Alphahull-PointsKO-Adjacents,49405
Sterculia_purpurea,1,1,0,Points-PointsKO-Adjacents,9
Sterculia_quinqueloba,58,27,31,Alphahull-PointsKO-Adjacents,2720
Sterculia_rebeccae,49,22,27,Alphahull-PointsKO-Adjacents,658
Sterculia_recordiana,94,71,23,Alphahull-PointsKO-Adjacents,722
Sterculia_rhinopetala,37,16,21,Points-PointsKO-Adjacents,276
Sterculia_rigidifolia,5,5,0,Points-PointsKO-Adjacents,45
Sterculia_rogersii,82,67,15,Alphahull-PointsKO-Adjacents,2390
Sterculia_rugosa,48,22,26,Alphahull-PointsKO-Adjacents,539
Sterculia_schliebenii,17,9,8,Points-PointsKO-Adjacents,78
Sterculia_setigera,672,623,49,Alphahull-PointsKO-Adjacents,8326
Sterculia_simaoensis,1,1,0,Points-PointsKO-Adjacents,9
Sterculia_steyermarkii,9,1,8,Points-PointsKO-Adjacents,72
Sterculia_stipulifera,32,3,29,Points-PointsKO-Adjacents,286
Sterculia_striata,720,652,68,Alphahull-PointsKO-Adjacents,38176
Sterculia_subnobilis,NA,NA,NA,NA,NA
Sterculia_subviolacea,8,0,8,Points-PointsKO-Adjacents,72
Sterculia_tavia,38,18,20,Points-PointsKO-Adjacents,224
Sterculia_tessmannii,215,187,28,Alphahull-PointsKO-Adjacents,8782
Sterculia_tonkinensis,33,13,20,Points-PointsKO-Adjacents,277
Sterculia_tragacantha,542,471,71,Alphahull-PointsKO-Adjacents,9969
Sterculia_urens,5,5,0,Points-PointsKO-Adjacents,45
Sterculia_villifera,24,17,7,Points-PointsKO-Adjacents,181
Sterculia_villosa,7,0,7,Points-PointsKO-Adjacents,60
Sterculia_yuanjiangensis,NA,NA,NA,NA,NA
Stereocaryum_neocaledonicum,NA,NA,NA,NA,NA
Stereocaryum_ovigerum,21,10,11,Points-PointsKO-Adjacents,130
Stereocaryum_rubiginosum,23,16,7,Points-PointsKO-Adjacents,59
Stereospermum_angustifolium,2,2,0,Points-PointsKO-Adjacents,18
Stereospermum_annamense,0,0,0,NA,0
Stereospermum_arcuatum,7,2,5,Points-PointsKO-Adjacents,58
Stereospermum_boivini,5,5,0,Points-PointsKO-Adjacents,32
Stereospermum_chelonoides,5,0,5,Points-PointsKO-Adjacents,45
Stereospermum_cylindricum,2,2,0,Points-PointsKO-Adjacents,18
Stereospermum_euphorioides,103,87,16,Alphahull-PointsKO-Adjacents,2458
Stereospermum_fimbriatum,4,4,0,Points-PointsKO-Adjacents,36
Stereospermum_harmsianum,25,9,16,Points-PointsKO-Adjacents,224
Stereospermum_hildebrandtii,14,7,7,Points-PointsKO-Adjacents,78
Stereospermum_kunthianum,699,583,116,Alphahull-PointsKO-Adjacents,16365
Stereospermum_longiflorum,16,9,7,Points-PointsKO-Adjacents,72
Stereospermum_nematocarpum,48,38,10,Alphahull-PointsKO-Adjacents,426
Stereospermum_neuranthum,6,1,5,Points-PointsKO-Adjacents,54
Stereospermum_rhoifolium,1,1,0,Points-PointsKO-Adjacents,9
Stereospermum_strigilosum,6,1,5,Points-PointsKO-Adjacents,54
Stereospermum_tetragonum,26,7,19,Points-PointsKO-Adjacents,228
Stereospermum_tomentosum,2,2,0,Points-PointsKO-Adjacents,18
Stereospermum_undatum,26,15,11,Points-PointsKO-Adjacents,148
Stereospermum_variabile,21,12,9,Points-PointsKO-Adjacents,167
Stereospermum_zenkeri,3,0,3,Points-PointsKO-Adjacents,18
Sterigmapetalum_chrysophyllum,3,3,0,Points-PointsKO-Adjacents,27
Sterigmapetalum_colombianum,23,7,16,Points-PointsKO-Adjacents,184
Sterigmapetalum_exappendiculatum,8,2,6,Points-PointsKO-Adjacents,64
Sterigmapetalum_guianense,58,36,22,Alphahull-PointsKO-Adjacents,2178
Sterigmapetalum_heterodoxum,3,3,0,Points-PointsKO-Adjacents,27
Sterigmapetalum_obovatum,198,143,55,Alphahull-PointsKO-Adjacents,25370
Sterigmapetalum_resinosum,6,1,5,Points-PointsKO-Adjacents,48
Sterigmapetalum_tachirense,2,2,0,Points-PointsKO-Adjacents,15
Steriphoma_ellipticum,26,9,17,Points-PointsKO-Adjacents,196
Steriphoma_paradoxum,39,14,25,Points-PointsKO-Adjacents,263
Steriphoma_peruvianum,13,6,7,Points-PointsKO-Adjacents,113
Steriphoma_urbanii,2,2,0,Points-PointsKO-Adjacents,18
Stetsonia_coryne,47,30,17,Alphahull-PointsKO-Adjacents,3287
Stevensia_aculeolata,NA,NA,NA,NA,NA
Stevensia_buxifolia,8,2,6,Points-PointsKO-Adjacents,50
Stevensia_ebracteata,4,3,1,Points-PointsKO-Adjacents,33
Stevensia_ekmaniana,1,1,0,Points-PointsKO-Adjacents,9
Stevensia_grandiflora,5,5,0,Points-PointsKO-Adjacents,36
Stevensia_hotteana,1,1,0,Points-PointsKO-Adjacents,9
Stevensia_minutifolia,5,5,0,Points-PointsKO-Adjacents,26
Stevensia_ovatifolia,3,3,0,Points-PointsKO-Adjacents,16
Stevensia_samanensis,1,1,0,Points-PointsKO-Adjacents,9
Stewartia_calcicola,3,3,0,Points-PointsKO-Adjacents,27
Stewartia_cordifolia,7,2,5,Points-PointsKO-Adjacents,63
Stewartia_crassifolia,5,2,3,Points-PointsKO-Adjacents,45
Stewartia_laotica,1,1,0,Points-PointsKO-Adjacents,9
Stewartia_malacodendron,138,104,34,Alphahull-PointsKO-Adjacents,4582
Stewartia_medogensis,NA,NA,NA,NA,NA
Stewartia_monadelpha,89,63,26,Alphahull-PointsKO-Adjacents,320
Stewartia_obovata,1,1,0,Points-PointsKO-Adjacents,9
Stewartia_ovata,130,92,38,Alphahull-PointsKO-Adjacents,1773
Stewartia_pteropetiolata,12,6,6,Points-PointsKO-Adjacents,102
Stewartia_rostrata,6,1,5,Points-PointsKO-Adjacents,50
Stewartia_rubiginosa,1,1,0,Points-PointsKO-Adjacents,9
Stewartia_sichuanensis,NA,NA,NA,NA,NA
Stewartia_sinensis,34,10,24,Points-PointsKO-Adjacents,302
Stewartia_sinii,4,4,0,Points-PointsKO-Adjacents,36
Stewartia_villosa,15,4,11,Points-PointsKO-Adjacents,135
Stifftia_chrysantha,73,44,29,Alphahull-PointsKO-Adjacents,582
Stifftia_fruticosa,21,10,11,Points-PointsKO-Adjacents,119
Stifftia_parviflora,38,18,20,Points-PointsKO-Adjacents,276
Stillingia_acutifolia,65,48,17,Alphahull-PointsKO-Adjacents,439
Stillingia_bodenbenderi,8,0,8,Points-PointsKO-Adjacents,60
Stillingia_lineata,5,4,1,Points-PointsKO-Adjacents,32
Stillingia_oppositifolia,42,26,16,Alphahull-PointsKO-Adjacents,527
Stillingia_sylvatica,688,589,99,Alphahull-PointsKO-Adjacents,16163
Stillingia_tenella,35,0,35,Points-PointsKO-Adjacents,232
Stillingia_trapezoidea,97,77,20,Alphahull-PointsKO-Adjacents,4521
Stillingia_uleana,86,59,27,Alphahull-PointsKO-Adjacents,1312
Stilpnophyllum_grandifolium,16,8,8,Points-PointsKO-Adjacents,84
Stilpnophyllum_oellgaardii,28,19,9,Points-PointsKO-Adjacents,99
Stilpnophyllum_revolutum,6,1,5,Points-PointsKO-Adjacents,44
Stirtonanthus_taylorianus,3,3,0,Points-PointsKO-Adjacents,21
Stockwellia_quadrifida,24,17,7,Points-PointsKO-Adjacents,37
Stomatochaeta_cylindrica,6,1,5,Points-PointsKO-Adjacents,24
Stomatochaeta_steyermarkii,3,3,0,Points-PointsKO-Adjacents,21
Storckiella_australiensis,28,21,7,Alphahull-PointsKO-Adjacents,53
Storckiella_vitiensis,1,1,0,Points-PointsKO-Adjacents,9
Storthocalyx_pancheri,27,18,9,Points-PointsKO-Adjacents,67
Stranvaesia_amphidoxa,65,47,18,Alphahull-PointsKO-Adjacents,4967
Stranvaesia_nussia,8,2,6,Points-PointsKO-Adjacents,66
Stranvaesia_oblanceolata,8,0,8,Points-PointsKO-Adjacents,72
Stranvaesia_tomentosa,4,3,1,Points-PointsKO-Adjacents,36
Strasburgeria_robusta,26,21,5,Alphahull-PointsKO-Adjacents,40
Streblorrhiza_speciosa,1,1,0,Points-PointsKO-Adjacents,3
Streblus_anthropophagorum,17,4,13,Points-PointsKO-Adjacents,73
Streblus_asper,63,10,53,Points-PointsKO-Adjacents,524
Streblus_dimepate,153,130,23,Alphahull-PointsKO-Adjacents,1568
Sloetia_elongata,17,2,15,Points-PointsKO-Adjacents,114
Streblus_ilicifolius,46,13,33,Points-PointsKO-Adjacents,335
Streblus_indicus,9,1,8,Points-PointsKO-Adjacents,81
Streblus_macrophyllus,14,0,14,Points-PointsKO-Adjacents,116
Streblus_mauritianus,60,38,22,Alphahull-PointsKO-Adjacents,834
Phyllochlamys_spinosa,20,1,19,Points-PointsKO-Adjacents,158
Streblus_pendulinus,1224,1093,131,Alphahull-PointsKO-Adjacents,2773
Streblus_smithii,8,0,8,Points-PointsKO-Adjacents,30
Streblus_taxoides,14,0,14,Points-PointsKO-Adjacents,114
Streblus_usambarensis,95,49,46,Alphahull-PointsKO-Adjacents,2993
Streblus_zeylanicus,1,1,0,Points-PointsKO-Adjacents,9
Strempeliopsis_arborea,2,2,0,Points-PointsKO-Adjacents,12
Strephonema_mannii,49,36,13,Alphahull-PointsKO-Adjacents,1155
Strephonema_sericeum,48,0,48,Points-PointsKO-Adjacents,303
Strobocalyx_arborea,127,0,127,Points-PointsKO-Adjacents,900
Strobocalyx_bockiana,19,8,11,Points-PointsKO-Adjacents,167
Strobocalyx_solanifolia,39,15,24,Points-PointsKO-Adjacents,334
Strombosia_ceylanica,11,0,11,Points-PointsKO-Adjacents,92
Strombosia_fleuryana,6,0,6,Points-PointsKO-Adjacents,37
Strombosia_glaucescens,34,13,21,Points-PointsKO-Adjacents,177
Strombosia_gossweileri,4,4,0,Points-PointsKO-Adjacents,30
Strombosia_grandifolia,217,170,47,Alphahull-PointsKO-Adjacents,13359
Strombosia_nigropunctata,21,6,15,Points-PointsKO-Adjacents,138
Strombosia_pustulata,247,180,67,Alphahull-PointsKO-Adjacents,6602
Strombosia_scheffleri,183,141,42,Alphahull-PointsKO-Adjacents,3941
Strombosia_zenkeri,23,13,10,Points-PointsKO-Adjacents,178
Strombosiopsis_nana,3,3,0,Points-PointsKO-Adjacents,26
Strombosiopsis_sereinii,9,3,6,Points-PointsKO-Adjacents,61
Strombosiopsis_tetrandra,407,371,36,Alphahull-PointsKO-Adjacents,11613
Strophanthus_boivinii,97,70,27,Alphahull-PointsKO-Adjacents,1924
Strophanthus_congoensis,7,0,7,Points-PointsKO-Adjacents,61
Strophanthus_eminii,53,33,20,Alphahull-PointsKO-Adjacents,1053
Strophanthus_gratus,111,63,48,Alphahull-PointsKO-Adjacents,5201
Strophanthus_hispidus,232,163,69,Alphahull-PointsKO-Adjacents,7287
Strophanthus_kombe,23,7,16,Points-PointsKO-Adjacents,183
Strophanthus_petersianus,28,9,19,Points-PointsKO-Adjacents,224
Strophanthus_preussii,178,104,74,Alphahull-PointsKO-Adjacents,5393
Strophanthus_speciosus,38,22,16,Alphahull-PointsKO-Adjacents,879
Strophanthus_welwitschii,110,73,37,Alphahull-PointsKO-Adjacents,4223
Strophioblachia_fimbricalyx,21,7,14,Points-PointsKO-Adjacents,139
Strumpfia_maritima,54,19,35,Points-PointsKO-Adjacents,250
Strychnopsis_thouarsii,53,34,19,Alphahull-PointsKO-Adjacents,825
Strychnos_angolensis,73,45,28,Alphahull-PointsKO-Adjacents,2811
Strychnos_axillaris,113,0,113,Points-PointsKO-Adjacents,786
Strychnos_bifurcata,3,3,0,Points-PointsKO-Adjacents,27
Strychnos_brasiliensis,873,775,98,Alphahull-PointsKO-Adjacents,15065
Strychnos_chlorantha,46,36,10,Alphahull-PointsKO-Adjacents,331
Strychnos_chromatoxylon,3,3,0,Points-PointsKO-Adjacents,27
Strychnos_cocculoides,117,49,68,Alphahull-PointsKO-Adjacents,8105
Strychnos_colombiensis,37,18,19,Points-PointsKO-Adjacents,221
Strychnos_croatii,33,25,8,Alphahull-PointsKO-Adjacents,478
Strychnos_decussata,142,74,68,Alphahull-PointsKO-Adjacents,1923
Strychnos_elaeocarpa,26,18,8,Points-PointsKO-Adjacents,131
Strychnos_erichsonii,91,37,54,Alphahull-PointsKO-Adjacents,1747
Strychnos_fendleri,60,38,22,Alphahull-PointsKO-Adjacents,2444
Strychnos_glabra,33,4,29,Points-PointsKO-Adjacents,276
Strychnos_henningsii,135,61,74,Alphahull-PointsKO-Adjacents,1498
Strychnos_innocua,335,251,84,Alphahull-PointsKO-Adjacents,8898
Strychnos_jobertiana,70,25,45,Alphahull-PointsKO-Adjacents,2990
Strychnos_lucida,1343,1279,64,Alphahull-PointsKO-Adjacents,8716
Strychnos_madagascariensis,218,150,68,Alphahull-PointsKO-Adjacents,2858
Strychnos_mattogrossensis,85,21,64,Alphahull-PointsKO-Adjacents,702
Strychnos_melastomatoides,6,6,0,Points-PointsKO-Adjacents,48
Strychnos_mellodora,7,2,5,Points-PointsKO-Adjacents,57
Strychnos_millepunctata,19,13,6,Points-PointsKO-Adjacents,100
Strychnos_mitis,21,6,15,Points-PointsKO-Adjacents,127
Strychnos_myrtoides,5,5,0,Points-PointsKO-Adjacents,42
Strychnos_nux-blanda,9,0,9,Points-PointsKO-Adjacents,75
Strychnos_nux-vomica,17,1,16,Points-PointsKO-Adjacents,126
Strychnos_panurensis,176,106,70,Alphahull-PointsKO-Adjacents,9743
Strychnos_parvifolia,131,54,77,Alphahull-PointsKO-Adjacents,5533
Strychnos_potatorum,5,0,5,Points-PointsKO-Adjacents,45
Strychnos_pseudoquina,543,492,51,Alphahull-PointsKO-Adjacents,22647
Strychnos_pungens,57,33,24,Alphahull-PointsKO-Adjacents,687
Strychnos_ramentifera,36,9,27,Points-PointsKO-Adjacents,278
Strychnos_rondeletioides,127,70,57,Alphahull-PointsKO-Adjacents,8303
Strychnos_rubiginosa,105,64,41,Alphahull-PointsKO-Adjacents,1932
Strychnos_solerederi,16,0,16,Points-PointsKO-Adjacents,138
Strychnos_solimoesana,20,3,17,Points-PointsKO-Adjacents,170
Strychnos_spinosa,871,715,156,Alphahull-PointsKO-Adjacents,20545
Strychnos_staudtii,48,40,8,Alphahull-PointsKO-Adjacents,626
Strychnos_tarapotensis,101,1,100,Points-PointsKO-Adjacents,682
Strychnos_ternata,20,12,8,Points-PointsKO-Adjacents,126
Strychnos_tseasnum,6,3,3,Points-PointsKO-Adjacents,39
Strychnos_usambarensis,150,79,71,Alphahull-PointsKO-Adjacents,6239
Strychnos_variabilis,26,13,13,Points-PointsKO-Adjacents,140
Strychnos_wallichiana,6,0,6,Points-PointsKO-Adjacents,48
Strychnos_xylophylla,7,2,5,Points-PointsKO-Adjacents,36
Stryphnodendron_adstringens,723,641,82,Alphahull-PointsKO-Adjacents,25927
Stryphnodendron_coriaceum,203,171,32,Alphahull-PointsKO-Adjacents,9520
Stryphnodendron_duckeanum,41,24,17,Alphahull-PointsKO-Adjacents,789
Stryphnodendron_fissuratum,18,4,14,Points-PointsKO-Adjacents,147
Stryphnodendron_flammatum,2,2,0,Points-PointsKO-Adjacents,18
Stryphnodendron_foreroi,35,12,23,Points-PointsKO-Adjacents,264
Stryphnodendron_guianense,338,249,89,Alphahull-PointsKO-Adjacents,51150
Stryphnodendron_levelii,4,4,0,Points-PointsKO-Adjacents,30
Stryphnodendron_microstachyum,159,79,80,Alphahull-PointsKO-Adjacents,3340
Stryphnodendron_moricolor,4,1,3,Points-PointsKO-Adjacents,27
Stryphnodendron_obovatum,202,147,55,Alphahull-PointsKO-Adjacents,10381
Stryphnodendron_occhionianum,23,4,19,Points-PointsKO-Adjacents,185
Stryphnodendron_paniculatum,45,16,29,Points-PointsKO-Adjacents,366
Stryphnodendron_polyphyllum,385,322,63,Alphahull-PointsKO-Adjacents,19698
Stryphnodendron_polystachyum,111,58,53,Alphahull-PointsKO-Adjacents,8142
Stryphnodendron_porcatum,44,36,8,Alphahull-PointsKO-Adjacents,458
Stryphnodendron_pulcherrimum,708,584,124,Alphahull-PointsKO-Adjacents,60410
Stryphnodendron_racemiferum,45,29,16,Alphahull-PointsKO-Adjacents,283
Stryphnodendron_roseiflorum,36,21,15,Alphahull-PointsKO-Adjacents,586
Stryphnodendron_rotundifolium,496,430,66,Alphahull-PointsKO-Adjacents,33537
Stuhlmannia_moavi,19,0,19,Points-PointsKO-Adjacents,136
Styloceras_brokawii,69,0,69,Points-PointsKO-Adjacents,298
Styloceras_columnare,12,6,6,Points-PointsKO-Adjacents,51
Styloceras_connatum,11,5,6,Points-PointsKO-Adjacents,71
Styloceras_kunthianum,3,3,0,Points-PointsKO-Adjacents,25
Styloceras_laurifolium,51,25,26,Alphahull-PointsKO-Adjacents,518
Styloceras_penninervium,6,1,5,Points-PointsKO-Adjacents,45
Stylogyne_aguarunana,3,3,0,Points-PointsKO-Adjacents,23
Stylogyne_ardisioides,229,191,38,Alphahull-PointsKO-Adjacents,11664
Stylogyne_atra,58,25,33,Alphahull-PointsKO-Adjacents,5900
Stylogyne_bracteolata,14,7,7,Points-PointsKO-Adjacents,84
Stylogyne_canaliculata,6,0,6,Points-PointsKO-Adjacents,43
Stylogyne_darienensis,1,1,0,Points-PointsKO-Adjacents,9
Stylogyne_glomeruliflora,16,11,5,Points-PointsKO-Adjacents,45
Stylogyne_hayesii,21,7,14,Points-PointsKO-Adjacents,166
Stylogyne_incognita,9,2,7,Points-PointsKO-Adjacents,55
Stylogyne_lasseri,16,4,12,Points-PointsKO-Adjacents,127
Stylogyne_lateriflora,18,8,10,Points-PointsKO-Adjacents,75
Stylogyne_laxiflora,30,17,13,Points-PointsKO-Adjacents,214
Stylogyne_longifolia,147,78,69,Alphahull-PointsKO-Adjacents,6769
Stylogyne_micrantha,334,260,74,Alphahull-PointsKO-Adjacents,21242
Stylogyne_nigricans,28,6,22,Points-PointsKO-Adjacents,249
Stylogyne_orinocensis,332,277,55,Alphahull-PointsKO-Adjacents,30762
Stylogyne_serpentina,96,62,34,Alphahull-PointsKO-Adjacents,5517
Stylogyne_turbacensis,448,369,79,Alphahull-PointsKO-Adjacents,11643
Leucopogon_abnormis,7,1,6,Points-PointsKO-Adjacents,48
Leucopogon_dammarifolius,18,12,6,Points-PointsKO-Adjacents,80
Leucopogon_malayanus,26,0,26,Points-PointsKO-Adjacents,106
Leucopogon_pancheri,117,117,0,Alphahull,5517
Styphelia_tameiameiae,94,0,94,Points-PointsKO-Adjacents,221
Styphnolobium_burseroides,12,7,5,Points-PointsKO-Adjacents,68
Styphnolobium_caudatum,6,0,6,Points-PointsKO-Adjacents,39
Styphnolobium_conzattii,4,0,4,Points-PointsKO-Adjacents,33
Styphnolobium_japonicum,20,6,14,Points-PointsKO-Adjacents,147
Styphnolobium_monteviridis,12,9,3,Points-PointsKO-Adjacents,30
Styphnolobium_parviflorum,7,0,7,Points-PointsKO-Adjacents,36
Styphnolobium_protantherum,5,0,5,Points-PointsKO-Adjacents,19
Styphnolobium_sporadicum,14,2,12,Points-PointsKO-Adjacents,114
Styrax_acuminatus,149,104,45,Alphahull-PointsKO-Adjacents,3296
Styrax_agrestis,48,8,40,Points-PointsKO-Adjacents,346
Styrax_americanus,570,457,113,Alphahull-PointsKO-Adjacents,14179
Styrax_argenteus,587,497,90,Alphahull-PointsKO-Adjacents,8031
Styrax_argentifolius,5,5,0,Points-PointsKO-Adjacents,45
Styrax_aureus,51,0,51,Points-PointsKO-Adjacents,224
Styrax_benzoides,6,0,6,Points-PointsKO-Adjacents,54
Styrax_benzoin,5,1,4,Points-PointsKO-Adjacents,45
Styrax_bicolor,12,1,11,Points-PointsKO-Adjacents,95
Styrax_calvescens,16,5,11,Points-PointsKO-Adjacents,140
Styrax_camporum,881,798,83,Alphahull-PointsKO-Adjacents,30940
Styrax_chinensis,5,5,0,Points-PointsKO-Adjacents,45
Styrax_chrysocalyx,2,2,0,Points-PointsKO-Adjacents,12
Styrax_chrysocarpus,1,1,0,Points-PointsKO-Adjacents,9
Styrax_confusus,134,97,37,Alphahull-PointsKO-Adjacents,6698
Styrax_conterminus,19,1,18,Points-PointsKO-Adjacents,111
Styrax_dasyanthus,68,34,34,Alphahull-PointsKO-Adjacents,3557
Styrax_davillifolius,17,8,9,Points-PointsKO-Adjacents,133
Styrax_duidae,2,2,0,Points-PointsKO-Adjacents,18
Styrax_ferrugineus,624,538,86,Alphahull-PointsKO-Adjacents,25896
Styrax_formosanus,315,257,58,Alphahull-PointsKO-Adjacents,491
Styrax_foveolaria,37,21,16,Alphahull-PointsKO-Adjacents,155
Styrax_glaber,44,12,32,Points-PointsKO-Adjacents,316
Styrax_glabratus,108,51,57,Alphahull-PointsKO-Adjacents,2045
Styrax_glabrescens,397,336,61,Alphahull-PointsKO-Adjacents,4791
Styrax_grandiflorus,146,66,80,Alphahull-PointsKO-Adjacents,2125
Styrax_grandifolius,418,336,82,Alphahull-PointsKO-Adjacents,12916
Styrax_griseus,52,29,23,Alphahull-PointsKO-Adjacents,2644
Styrax_guanayanus,5,1,4,Points-PointsKO-Adjacents,41
Styrax_guyanensis,288,224,64,Alphahull-PointsKO-Adjacents,45656
Styrax_hainanensis,3,2,1,Points-PointsKO-Adjacents,18
Styrax_hemsleyanus,19,5,14,Points-PointsKO-Adjacents,168
Styrax_huanus,19,4,15,Points-PointsKO-Adjacents,168
Styrax_hypargyreus,4,4,0,Points-PointsKO-Adjacents,36
Styrax_hypochryseus,0,0,0,NA,0
Styrax_incarnatus,4,4,0,Points-PointsKO-Adjacents,32
Styrax_japonicus,1014,673,341,Alphahull-PointsKO-Adjacents,17062
Styrax_lanceolatus,8,3,5,Points-PointsKO-Adjacents,53
Styrax_lancifolius,12,0,12,Points-PointsKO-Adjacents,93
Styrax_latifolius,166,130,36,Alphahull-PointsKO-Adjacents,4027
Styrax_leprosus,592,0,592,Points-PointsKO-Adjacents,3855
Styrax_longipedicellatus,6,0,6,Points-PointsKO-Adjacents,39
Styrax_macranthus,33,21,12,Alphahull-PointsKO-Adjacents,1250
Styrax_macrocalyx,16,10,6,Points-PointsKO-Adjacents,95
Styrax_macrocarpus,2,2,0,Points-PointsKO-Adjacents,18
Styrax_macrophyllus,19,1,18,Points-PointsKO-Adjacents,171
Styrax_magnus,30,0,30,Points-PointsKO-Adjacents,99
Styrax_martii,187,155,32,Alphahull-PointsKO-Adjacents,4120
Styrax_microphyllus,2,2,0,Points-PointsKO-Adjacents,18
Styrax_neblinae,6,2,4,Points-PointsKO-Adjacents,37
Styrax_nicaraguensis,20,12,8,Points-PointsKO-Adjacents,84
Styrax_nunezii,23,15,8,Points-PointsKO-Adjacents,91
Styrax_obassis,172,130,42,Alphahull-PointsKO-Adjacents,1382
Styrax_oblongus,9,1,8,Points-PointsKO-Adjacents,65
Styrax_odoratissimus,55,33,22,Alphahull-PointsKO-Adjacents,1598
Styrax_officinalis,529,454,75,Alphahull-PointsKO-Adjacents,673
Styrax_omuk,2,2,0,Points-PointsKO-Adjacents,18
Styrax_pallidus,39,6,33,Points-PointsKO-Adjacents,293
Styrax_panamensis,2,2,0,Points-PointsKO-Adjacents,15
Styrax_pavonii,137,104,33,Alphahull-PointsKO-Adjacents,2599
Styrax_pedicellatus,58,41,17,Alphahull-PointsKO-Adjacents,293
Styrax_pentlandianus,74,43,31,Alphahull-PointsKO-Adjacents,517
Styrax_perkinsiae,45,27,18,Alphahull-PointsKO-Adjacents,1828
Styrax_peruvianus,9,0,9,Points-PointsKO-Adjacents,72
Styrax_platanifolius,42,29,13,Alphahull-PointsKO-Adjacents,618
Styrax_pohlii,378,0,378,Points-PointsKO-Adjacents,2738
Styrax_portoricensis,4,1,3,Points-PointsKO-Adjacents,27
Styrax_radians,28,13,15,Points-PointsKO-Adjacents,141
Styrax_roseus,44,27,17,Alphahull-PointsKO-Adjacents,2256
Styrax_rugosus,2,2,0,Points-PointsKO-Adjacents,18
Styrax_schultzei,5,5,0,Points-PointsKO-Adjacents,36
Styrax_serrulatus,16,0,16,Points-PointsKO-Adjacents,140
Styrax_sieberi,145,83,62,Alphahull-PointsKO-Adjacents,8714
Styrax_steyermarkii,8,0,8,Points-PointsKO-Adjacents,47
Styrax_subargenteus,14,1,13,Points-PointsKO-Adjacents,89
Styrax_suberifolius,357,291,66,Alphahull-PointsKO-Adjacents,5818
Styrax_supaii,3,3,0,Points-PointsKO-Adjacents,27
Styrax_tomentosus,8,1,7,Points-PointsKO-Adjacents,66
Styrax_tonkinensis,61,39,22,Alphahull-PointsKO-Adjacents,4300
Styrax_trichocalyx,39,22,17,Alphahull-PointsKO-Adjacents,1416
Styrax_vilcabambae,17,10,7,Points-PointsKO-Adjacents,82
Styrax_warscewiczii,201,153,48,Alphahull-PointsKO-Adjacents,1241
Styrax_yutajensis,3,3,0,Points-PointsKO-Adjacents,15
Suberanthus_brachycarpus,18,4,14,Points-PointsKO-Adjacents,144
Suberanthus_hincheanus,2,2,0,Points-PointsKO-Adjacents,18
Suberanthus_pungens,1,1,0,Points-PointsKO-Adjacents,9
Sumbaviopsis_albicans,20,5,15,Points-PointsKO-Adjacents,160
Sundacarpus_amarus,221,144,77,Alphahull-PointsKO-Adjacents,2479
Suregada_adenophora,73,53,20,Alphahull-PointsKO-Adjacents,171
Suregada_aequorea,38,26,12,Alphahull-PointsKO-Adjacents,86
Suregada_africana,47,26,21,Alphahull-PointsKO-Adjacents,1019
Suregada_boiviniana,129,103,26,Alphahull-PointsKO-Adjacents,2342
Suregada_bracteata,5,5,0,Points-PointsKO-Adjacents,26
Suregada_calcicola,0,0,0,NA,0
Suregada_capuronii,16,6,10,Points-PointsKO-Adjacents,107
Suregada_celastroides,4,4,0,Points-PointsKO-Adjacents,36
Suregada_decidua,33,21,12,Alphahull-PointsKO-Adjacents,260
Suregada_eucleoides,20,11,9,Points-PointsKO-Adjacents,72
Suregada_gaultheriifolia,7,0,7,Points-PointsKO-Adjacents,54
Suregada_glomerulata,117,50,67,Alphahull-PointsKO-Adjacents,635
Suregada_grandiflora,1,1,0,Points-PointsKO-Adjacents,8
Suregada_humbertii,1,1,0,Points-PointsKO-Adjacents,9
Suregada_ivorensis,3,3,0,Points-PointsKO-Adjacents,27
Suregada_lanceolata,5,5,0,Points-PointsKO-Adjacents,45
Suregada_laurina,12,9,3,Points-PointsKO-Adjacents,35
Suregada_lithoxyla,15,8,7,Points-PointsKO-Adjacents,58
Suregada_multiflora,28,3,25,Points-PointsKO-Adjacents,231
Suregada_nigricaulis,7,4,3,Points-PointsKO-Adjacents,23
Suregada_perrieri,4,4,0,Points-PointsKO-Adjacents,27
Suregada_procera,22,4,18,Points-PointsKO-Adjacents,178
Suregada_zanzibariensis,85,55,30,Alphahull-PointsKO-Adjacents,708
Suriana_maritima,366,0,366,Points-PointsKO-Adjacents,1574
Swartzia_acreana,66,43,23,Alphahull-PointsKO-Adjacents,3755
Swartzia_acutifolia,228,179,49,Alphahull-PointsKO-Adjacents,8621
Swartzia_alato-sericea,9,1,8,Points-PointsKO-Adjacents,81
Swartzia_alternifoliolata,10,5,5,Points-PointsKO-Adjacents,52
Swartzia_amazonica,6,1,5,Points-PointsKO-Adjacents,36
Swartzia_amplifolia,112,75,37,Alphahull-PointsKO-Adjacents,1800
Swartzia_amshoffiana,19,13,6,Points-PointsKO-Adjacents,126
Swartzia_angustifoliola,7,3,4,Points-PointsKO-Adjacents,57
Swartzia_anomala,93,68,25,Alphahull-PointsKO-Adjacents,2126
Swartzia_apetala,816,718,98,Alphahull-PointsKO-Adjacents,12630
Swartzia_apiculata,17,11,6,Points-PointsKO-Adjacents,95
Swartzia_aptera,22,1,21,Points-PointsKO-Adjacents,151
Swartzia_arborescens,858,775,83,Alphahull-PointsKO-Adjacents,65436
Swartzia_argentea,145,112,33,Alphahull-PointsKO-Adjacents,4911
Swartzia_arumateuana,106,46,60,Alphahull-PointsKO-Adjacents,6797
Swartzia_auriculata,190,140,50,Alphahull-PointsKO-Adjacents,13386
Swartzia_aymardii,2,2,0,Points-PointsKO-Adjacents,12
Swartzia_bahiensis,44,34,10,Alphahull-PointsKO-Adjacents,155
Swartzia_bannia,13,5,8,Points-PointsKO-Adjacents,92
Swartzia_benthamiana,230,186,44,Alphahull-PointsKO-Adjacents,17128
Swartzia_bombycina,30,23,7,Alphahull-PointsKO-Adjacents,135
Swartzia_brachyrachis,283,208,75,Alphahull-PointsKO-Adjacents,23730
Swartzia_buntingii,13,5,8,Points-PointsKO-Adjacents,106
Swartzia_cabrerae,4,4,0,Points-PointsKO-Adjacents,30
Swartzia_calva,23,8,15,Points-PointsKO-Adjacents,207
Swartzia_canescens,14,7,7,Points-PointsKO-Adjacents,121
Swartzia_capixabensis,6,0,6,Points-PointsKO-Adjacents,47
Swartzia_cardiosperma,180,137,43,Alphahull-PointsKO-Adjacents,7635
Swartzia_caribaea,9,3,6,Points-PointsKO-Adjacents,24
Swartzia_caudata,31,21,10,Alphahull-PointsKO-Adjacents,441
Swartzia_colombiana,26,15,11,Points-PointsKO-Adjacents,187
Swartzia_conferta,108,81,27,Alphahull-PointsKO-Adjacents,6235
Swartzia_coriaceifolia,2,2,0,Points-PointsKO-Adjacents,18
Swartzia_corrugata,56,33,23,Alphahull-PointsKO-Adjacents,745
Swartzia_costaricensis,70,59,11,Alphahull-PointsKO-Adjacents,384
Swartzia_costata,8,0,8,Points-PointsKO-Adjacents,56
Swartzia_cowanii,3,3,0,Points-PointsKO-Adjacents,21
Swartzia_cubensis,330,296,34,Alphahull-PointsKO-Adjacents,2466
Swartzia_cupavenensis,41,32,9,Alphahull-PointsKO-Adjacents,640
Swartzia_curranii,2,2,0,Points-PointsKO-Adjacents,16
Swartzia_cuspidata,173,132,41,Alphahull-PointsKO-Adjacents,10148
Swartzia_davisii,1,1,0,Points-PointsKO-Adjacents,9
Swartzia_dipetala,72,30,42,Alphahull-PointsKO-Adjacents,484
Swartzia_discocarpa,23,4,19,Points-PointsKO-Adjacents,194
Swartzia_dolichopoda,8,0,8,Points-PointsKO-Adjacents,54
Swartzia_duckei,19,9,10,Points-PointsKO-Adjacents,155
Swartzia_emarginata,36,0,36,Points-PointsKO-Adjacents,252
Swartzia_eriocarpa,10,5,5,Points-PointsKO-Adjacents,83
Swartzia_fanshawei,1,1,0,Points-PointsKO-Adjacents,9
Swartzia_fimbriata,2,2,0,Points-PointsKO-Adjacents,18
Swartzia_flaemingii,367,290,77,Alphahull-PointsKO-Adjacents,20015
Swartzia_floribunda,28,21,7,Alphahull-PointsKO-Adjacents,227
Swartzia_foliolosa,1,1,0,Points-PointsKO-Adjacents,9
Swartzia_fraterna,2,2,0,Points-PointsKO-Adjacents,18
Swartzia_froesii,6,0,6,Points-PointsKO-Adjacents,54
Swartzia_gigantea,2,2,0,Points-PointsKO-Adjacents,18
Swartzia_glabrata,51,14,37,Points-PointsKO-Adjacents,372
Swartzia_glazioviana,22,7,15,Points-PointsKO-Adjacents,65
Swartzia_gracilis,43,25,18,Alphahull-PointsKO-Adjacents,1761
Swartzia_grandifolia,206,163,43,Alphahull-PointsKO-Adjacents,13665
Swartzia_guatemalensis,149,128,21,Alphahull-PointsKO-Adjacents,1529
Swartzia_guianensis,24,9,15,Points-PointsKO-Adjacents,187
Swartzia_haughtii,60,49,11,Alphahull-PointsKO-Adjacents,1035
Swartzia_hostmannii,7,4,3,Points-PointsKO-Adjacents,63
Swartzia_huallagae,1,1,0,Points-PointsKO-Adjacents,9
Swartzia_humboldtiana,NA,NA,NA,NA,NA
Swartzia_ingaefolia,2,2,0,Points-PointsKO-Adjacents,18
Swartzia_ingens,13,6,7,Points-PointsKO-Adjacents,93
Swartzia_ingifolia,82,60,22,Alphahull-PointsKO-Adjacents,1893
Swartzia_iniridensis,5,2,3,Points-PointsKO-Adjacents,45
Swartzia_jenmanii,6,2,4,Points-PointsKO-Adjacents,48
Swartzia_jimenezii,0,0,0,NA,0
Swartzia_jororii,87,59,28,Alphahull-PointsKO-Adjacents,2704
Swartzia_juruana,3,3,0,Points-PointsKO-Adjacents,27
Swartzia_kaieteurensis,13,8,5,Points-PointsKO-Adjacents,60
Swartzia_katawa,13,5,8,Points-PointsKO-Adjacents,63
Swartzia_klugii,104,70,34,Alphahull-PointsKO-Adjacents,2547
Swartzia_krukovii,14,0,14,Points-PointsKO-Adjacents,119
Swartzia_laevicarpa,285,238,47,Alphahull-PointsKO-Adjacents,21911
Swartzia_lamellata,26,16,10,Points-PointsKO-Adjacents,146
Swartzia_langsdorffii,93,58,35,Alphahull-PointsKO-Adjacents,1306
Swartzia_latifolia,57,0,57,Points-PointsKO-Adjacents,405
Swartzia_laurifolia,189,127,62,Alphahull-PointsKO-Adjacents,23349
Swartzia_laxiflora,112,66,46,Alphahull-PointsKO-Adjacents,8609
Swartzia_leblondii,7,3,4,Points-PointsKO-Adjacents,52
Swartzia_leiocalycina,12,9,3,Points-PointsKO-Adjacents,75
Swartzia_leiogyne,4,4,0,Points-PointsKO-Adjacents,36
Swartzia_leptopetala,334,265,69,Alphahull-PointsKO-Adjacents,26180
Swartzia_littlei,11,7,4,Points-PointsKO-Adjacents,69
Swartzia_longicarpa,8,2,6,Points-PointsKO-Adjacents,66
Swartzia_longipedicellata,2,2,0,Points-PointsKO-Adjacents,18
Swartzia_longistipitata,39,0,39,Points-PointsKO-Adjacents,208
Swartzia_lucida,68,44,24,Alphahull-PointsKO-Adjacents,941
Swartzia_macrocarpa,54,1,53,Points-PointsKO-Adjacents,374
Swartzia_macrophylla,54,46,8,Alphahull-PointsKO-Adjacents,1044
Swartzia_macrosema,40,25,15,Alphahull-PointsKO-Adjacents,308
Swartzia_macrostachya,429,364,65,Alphahull-PointsKO-Adjacents,19923
Swartzia_magdalenae,5,5,0,Points-PointsKO-Adjacents,45
Swartzia_maguirei,13,6,7,Points-PointsKO-Adjacents,84
Swartzia_manausensis,32,24,8,Alphahull-PointsKO-Adjacents,168
Swartzia_mangabalensis,5,5,0,Points-PointsKO-Adjacents,45
Swartzia_maquenqueana,5,5,0,Points-PointsKO-Adjacents,12
Swartzia_martii,24,14,10,Points-PointsKO-Adjacents,171
Swartzia_mexicana,7,2,5,Points-PointsKO-Adjacents,38
Swartzia_micrantha,15,4,11,Points-PointsKO-Adjacents,106
Swartzia_microcarpa,21,7,14,Points-PointsKO-Adjacents,175
Swartzia_monachiana,2,2,0,Points-PointsKO-Adjacents,18
Swartzia_mucronifera,7,1,6,Points-PointsKO-Adjacents,50
Swartzia_mutisii,1,1,0,Points-PointsKO-Adjacents,9
Swartzia_myrtifolia,537,435,102,Alphahull-PointsKO-Adjacents,13785
Swartzia_nuda,5,4,1,Points-PointsKO-Adjacents,38
Swartzia_oblanceolata,62,33,29,Alphahull-PointsKO-Adjacents,3434
Swartzia_oblata,160,0,160,Points-PointsKO-Adjacents,1051
Swartzia_oblonga,2,2,0,Points-PointsKO-Adjacents,18
Swartzia_obscura,78,45,33,Alphahull-PointsKO-Adjacents,2524
Swartzia_oedipus,11,0,11,Points-PointsKO-Adjacents,73
Swartzia_oraria,63,42,21,Alphahull-PointsKO-Adjacents,2335
Swartzia_oriximinaensis,5,5,0,Points-PointsKO-Adjacents,43
Swartzia_pachyphylla,2,2,0,Points-PointsKO-Adjacents,18
Swartzia_palustris,12,0,12,Points-PointsKO-Adjacents,49
Swartzia_panacoco,266,224,42,Alphahull-PointsKO-Adjacents,15030
Swartzia_panamensis,94,73,21,Alphahull-PointsKO-Adjacents,712
Swartzia_parvifolia,14,4,10,Points-PointsKO-Adjacents,91
Swartzia_parvipetala,186,134,52,Alphahull-PointsKO-Adjacents,11918
Swartzia_pendula,163,136,27,Alphahull-PointsKO-Adjacents,7312
Swartzia_pernitida,2,2,0,Points-PointsKO-Adjacents,18
Swartzia_peruviana,29,11,18,Points-PointsKO-Adjacents,249
Swartzia_phaneroptera,25,16,9,Points-PointsKO-Adjacents,147
Swartzia_piarensis,9,2,7,Points-PointsKO-Adjacents,72
Swartzia_pickelii,148,113,35,Alphahull-PointsKO-Adjacents,707
Swartzia_picramnioides,15,11,4,Points-PointsKO-Adjacents,57
Swartzia_picta,39,19,20,Points-PointsKO-Adjacents,284
Swartzia_pilulifera,77,57,20,Alphahull-PointsKO-Adjacents,1186
Swartzia_pinheiroana,8,0,8,Points-PointsKO-Adjacents,38
Swartzia_pinnata,35,12,23,Points-PointsKO-Adjacents,229
Swartzia_pittieri,63,43,20,Alphahull-PointsKO-Adjacents,2991
Swartzia_polita,160,98,62,Alphahull-PointsKO-Adjacents,6416
Swartzia_polyphylla,576,514,62,Alphahull-PointsKO-Adjacents,36214
Swartzia_prolata,5,5,0,Points-PointsKO-Adjacents,36
Swartzia_racemosa,145,100,45,Alphahull-PointsKO-Adjacents,3891
Swartzia_recurva,199,1,198,Points-PointsKO-Adjacents,1328
Swartzia_rediviva,1,1,0,Points-PointsKO-Adjacents,9
Swartzia_remiger,19,12,7,Points-PointsKO-Adjacents,131
Swartzia_reticulata,80,54,26,Alphahull-PointsKO-Adjacents,854
Swartzia_riedelii,35,19,16,Points-PointsKO-Adjacents,203
Swartzia_robiniifolia,17,10,7,Points-PointsKO-Adjacents,123
Swartzia_roraimae,6,0,6,Points-PointsKO-Adjacents,52
Swartzia_rosea,54,0,54,Points-PointsKO-Adjacents,402
Swartzia_schomburgkii,208,164,44,Alphahull-PointsKO-Adjacents,14788
Swartzia_schunkei,15,11,4,Points-PointsKO-Adjacents,98
Swartzia_sericea,193,154,39,Alphahull-PointsKO-Adjacents,6414
Swartzia_simplex,1296,1111,185,Alphahull-PointsKO-Adjacents,26685
Swartzia_steyermarkii,9,0,9,Points-PointsKO-Adjacents,81
Swartzia_stipellata,2,2,0,Points-PointsKO-Adjacents,18
Swartzia_submarginata,136,97,39,Alphahull-PointsKO-Adjacents,7219
Swartzia_sumorum,10,7,3,Points-PointsKO-Adjacents,88
Swartzia_tessmannii,124,69,55,Alphahull-PointsKO-Adjacents,4784
Swartzia_tillettii,6,0,6,Points-PointsKO-Adjacents,35
Swartzia_tomentifera,44,26,18,Alphahull-PointsKO-Adjacents,465
Swartzia_trianae,101,83,18,Alphahull-PointsKO-Adjacents,1840
Swartzia_trinitensis,6,1,5,Points-PointsKO-Adjacents,46
Swartzia_triptera,6,1,5,Points-PointsKO-Adjacents,41
Swartzia_ulei,59,41,18,Alphahull-PointsKO-Adjacents,661
Swartzia_vaupesiana,36,12,24,Points-PointsKO-Adjacents,284
Swartzia_velutina,11,8,3,Points-PointsKO-Adjacents,68
Swartzia_wurdackii,4,4,0,Points-PointsKO-Adjacents,30
Swartzia_xanthopetala,28,15,13,Points-PointsKO-Adjacents,172
Swartzia_zeledonensis,21,13,8,Points-PointsKO-Adjacents,74
Sweetia_fruticosa,504,428,76,Alphahull-PointsKO-Adjacents,31651
Swietenia_humilis,369,290,79,Alphahull-PointsKO-Adjacents,6544
Swietenia_macrophylla,424,317,107,Alphahull-PointsKO-Adjacents,13258
Swietenia_mahagoni,43,14,29,Points-PointsKO-Adjacents,289
Swinglea_glutinosa,0,0,0,NA,0
Syagrus_amara,9,3,6,Points-PointsKO-Adjacents,25
Syagrus_botryophora,107,79,28,Alphahull-PointsKO-Adjacents,1310
Syagrus_campylospatha,21,14,7,Points-PointsKO-Adjacents,138
Syagrus_cearensis,38,22,16,Alphahull-PointsKO-Adjacents,1459
Syagrus_cocoides,171,135,36,Alphahull-PointsKO-Adjacents,19427
Syagrus_comosa,340,298,42,Alphahull-PointsKO-Adjacents,20686
Syagrus_coronata,296,258,38,Alphahull-PointsKO-Adjacents,7062
Syagrus_deflexa,13,9,4,Points-PointsKO-Adjacents,54
Syagrus_flexuosa,463,409,54,Alphahull-PointsKO-Adjacents,23341
Syagrus_glaucescens,54,47,7,Alphahull-PointsKO-Adjacents,197
Syagrus_inajai,100,68,32,Alphahull-PointsKO-Adjacents,10694
Syagrus_kellyana,4,4,0,Points-PointsKO-Adjacents,17
Syagrus_lorenzoniorum,10,4,6,Points-PointsKO-Adjacents,73
Syagrus_macrocarpa,32,16,16,Points-PointsKO-Adjacents,230
Syagrus_microphylla,36,31,5,Alphahull-PointsKO-Adjacents,363
Syagrus_oleracea,367,315,52,Alphahull-PointsKO-Adjacents,16748
Syagrus_orinocensis,109,87,22,Alphahull-PointsKO-Adjacents,5612
Syagrus_picrophylla,22,9,13,Points-PointsKO-Adjacents,131
Syagrus_pseudococos,78,0,78,Points-PointsKO-Adjacents,404
Syagrus_romanzoffiana,1134,1037,97,Alphahull-PointsKO-Adjacents,25149
Syagrus_ruschiana,34,26,8,Alphahull-PointsKO-Adjacents,235
Syagrus_sancona,169,112,57,Alphahull-PointsKO-Adjacents,10727
Syagrus_schizophylla,98,52,46,Alphahull-PointsKO-Adjacents,520
Syagrus_smithii,48,16,32,Points-PointsKO-Adjacents,378
Syagrus_stenopetala,3,3,0,Points-PointsKO-Adjacents,27
Syagrus_stratincola,8,3,5,Points-PointsKO-Adjacents,66
Syagrus_vagans,40,28,12,Alphahull-PointsKO-Adjacents,587
Syagrus_vermicularis,14,0,14,Points-PointsKO-Adjacents,122
Syagrus_weddelliana,6,2,4,Points-PointsKO-Adjacents,38
Syagrus_yungasensis,0,0,0,NA,0
Sycopsis_sinensis,84,52,32,Alphahull-PointsKO-Adjacents,466
Sylvichadsia_grandidieri,9,2,7,Points-PointsKO-Adjacents,72
Sylvichadsia_grandifolia,20,10,10,Points-PointsKO-Adjacents,117
Symbolanthus_aureus,1,1,0,Points-PointsKO-Adjacents,9
Symbolanthus_australis,8,4,4,Points-PointsKO-Adjacents,45
Symbolanthus_brittonianus,12,3,9,Points-PointsKO-Adjacents,82
Symmeria_paniculata,141,97,44,Alphahull-PointsKO-Adjacents,6016
Sympetalandra_borneensis,6,1,5,Points-PointsKO-Adjacents,49
Sympetalandra_densiflora,0,0,0,NA,0
Sympetalandra_hildebrandii,NA,NA,NA,NA,NA
Sympetalandra_schmutzii,0,0,0,NA,0
Sympetalandra_unijuga,7,0,7,Points-PointsKO-Adjacents,56
Symphonia_eugenioides,9,0,9,Points-PointsKO-Adjacents,67
Symphonia_fasciculata,35,16,19,Points-PointsKO-Adjacents,171
Symphonia_globulifera,2662,2363,299,Alphahull-PointsKO-Adjacents,94322
Symphonia_gymnoclada,44,28,16,Alphahull-PointsKO-Adjacents,488
Symphonia_lepidocarpa,7,3,4,Points-PointsKO-Adjacents,22
Symphonia_linearis,13,1,12,Points-PointsKO-Adjacents,91
Symphonia_louvelii,69,48,21,Alphahull-PointsKO-Adjacents,925
Symphonia_microphylla,50,32,18,Alphahull-PointsKO-Adjacents,287
Symphonia_nectarifera,18,5,13,Points-PointsKO-Adjacents,142
Symphonia_oligantha,6,1,5,Points-PointsKO-Adjacents,38
Symphonia_pauciflora,91,68,23,Alphahull-PointsKO-Adjacents,815
Symphonia_sessiliflora,7,1,6,Points-PointsKO-Adjacents,56
Symphonia_tanalensis,36,18,18,Points-PointsKO-Adjacents,162
Symphonia_urophylla,104,85,19,Alphahull-PointsKO-Adjacents,963
Symphonia_verrucosa,20,4,16,Points-PointsKO-Adjacents,133
Symphyopappus_lymansmithii,82,61,21,Alphahull-PointsKO-Adjacents,1894
Symplococarpon_flavifolium,13,0,13,Points-PointsKO-Adjacents,100
Symplococarpon_purpusii,223,167,56,Alphahull-PointsKO-Adjacents,3340
Symplocos_abietorum,2,2,0,Points-PointsKO-Adjacents,18
Symplocos_adenophylla,152,71,81,Alphahull-PointsKO-Adjacents,11262
Symplocos_adenopus,46,24,22,Alphahull-PointsKO-Adjacents,3277
Symplocos_altissima,2,2,0,Points-PointsKO-Adjacents,18
Symplocos_amplifolia,1,1,0,Points-PointsKO-Adjacents,9
Symplocos_ampulliformis,47,40,7,Alphahull-PointsKO-Adjacents,82
Symplocos_angulata,6,2,4,Points-PointsKO-Adjacents,33
Symplocos_anomala,341,266,75,Alphahull-PointsKO-Adjacents,17109
Symplocos_arechea,67,35,32,Alphahull-PointsKO-Adjacents,845
Symplocos_atlantica,1,0,1,Points-PointsKO-Adjacents,7
Symplocos_austin-smithii,164,147,17,Alphahull-PointsKO-Adjacents,466
Symplocos_austrosinensis,9,2,7,Points-PointsKO-Adjacents,81
Symplocos_badia,2,2,0,Points-PointsKO-Adjacents,18
Symplocos_baehnii,11,3,8,Points-PointsKO-Adjacents,84
Symplocos_baeuerlenii,100,91,9,Alphahull-PointsKO-Adjacents,47
Symplocos_bidana,32,24,8,Alphahull-PointsKO-Adjacents,140
Symplocos_blancae,2,2,0,Points-PointsKO-Adjacents,18
Symplocos_bogotensis,49,13,36,Points-PointsKO-Adjacents,338
Symplocos_breedlovei,51,43,8,Alphahull-PointsKO-Adjacents,154
Symplocos_caerulescens,11,3,8,Points-PointsKO-Adjacents,56
Symplocos_candelabrum,83,52,31,Alphahull-PointsKO-Adjacents,780
Symplocos_canescens,17,7,10,Points-PointsKO-Adjacents,106
Symplocos_carmencitae,4,4,0,Points-PointsKO-Adjacents,30
Symplocos_celastrinea,360,305,55,Alphahull-PointsKO-Adjacents,11936
Symplocos_cernua,2,2,0,Points-PointsKO-Adjacents,18
Symplocos_chimantensis,1,1,0,Points-PointsKO-Adjacents,9
Symplocos_chloroleuca,0,0,0,NA,0
Symplocos_citrea,273,246,27,Alphahull-PointsKO-Adjacents,2063
Symplocos_clethrifolia,8,2,6,Points-PointsKO-Adjacents,54
Symplocos_coccinea,96,71,25,Alphahull-PointsKO-Adjacents,417
Symplocos_cochinchinensis,1441,1149,292,Alphahull-PointsKO-Adjacents,28546
Symplocos_congesta,200,157,43,Alphahull-PointsKO-Adjacents,4907
Symplocos_coriacea,27,14,13,Points-PointsKO-Adjacents,126
Symplocos_corymboclados,78,59,19,Alphahull-PointsKO-Adjacents,518
Symplocos_costaricana,69,57,12,Alphahull-PointsKO-Adjacents,154
Symplocos_crassilimba,9,1,8,Points-PointsKO-Adjacents,66
Symplocos_crassiramifera,19,17,2,Points-PointsKO-Adjacents,22
Symplocos_culminicola,2,2,0,Points-PointsKO-Adjacents,18
Symplocos_cyanocarpa,74,66,8,Alphahull-PointsKO-Adjacents,65
Symplocos_dasyphylla,3,3,0,Points-PointsKO-Adjacents,27
Symplocos_debilis,21,16,5,Points-PointsKO-Adjacents,93
Symplocos_dolichotricha,15,5,10,Points-PointsKO-Adjacents,135
Symplocos_dryophila,75,2,73,Points-PointsKO-Adjacents,319
Symplocos_ecuadorensis,11,3,8,Points-PointsKO-Adjacents,86
Symplocos_elliptica,7,2,5,Points-PointsKO-Adjacents,44
Symplocos_excelsa,19,10,9,Points-PointsKO-Adjacents,96
Symplocos_falcata,119,101,18,Alphahull-PointsKO-Adjacents,2208
Eurya_japonica,706,376,330,Alphahull-PointsKO-Adjacents,4582
Symplocos_fimbriata,47,33,14,Alphahull-PointsKO-Adjacents,156
Symplocos_flosfragrans,30,18,12,Points-PointsKO-Adjacents,182
Symplocos_flos-pilosa,NA,NA,NA,NA,NA
Symplocos_fukienensis,1,1,0,Points-PointsKO-Adjacents,9
Symplocos_fuliginosa,17,5,12,Points-PointsKO-Adjacents,136
Symplocos_glabarrima,10,0,10,Points-PointsKO-Adjacents,72
Symplocos_glandulifera,10,1,9,Points-PointsKO-Adjacents,90
Symplocos_glauca,264,179,85,Alphahull-PointsKO-Adjacents,1955
Symplocos_glaziovii,6,1,5,Points-PointsKO-Adjacents,36
Symplocos_globosa,2,2,0,Points-PointsKO-Adjacents,18
Symplocos_globulifera,2,2,0,Points-PointsKO-Adjacents,18
Symplocos_glomerata,100,0,100,Points-PointsKO-Adjacents,714
Symplocos_groffii,30,13,17,Points-PointsKO-Adjacents,270
Symplocos_guianensis,177,106,71,Alphahull-PointsKO-Adjacents,8206
Symplocos_hainanensis,2,2,0,Points-PointsKO-Adjacents,18
Symplocos_harroldii,51,39,12,Alphahull-PointsKO-Adjacents,178
Symplocos_hartwegii,34,0,34,Points-PointsKO-Adjacents,161
Symplocos_heishanensis,110,80,30,Alphahull-PointsKO-Adjacents,1927
Symplocos_henschelii,22,10,12,Points-PointsKO-Adjacents,180
Symplocos_hiemalis,8,1,7,Points-PointsKO-Adjacents,48
Symplocos_hookeri,16,0,16,Points-PointsKO-Adjacents,144
Symplocos_incrassata,17,0,17,Points-PointsKO-Adjacents,83
Symplocos_insignis,40,28,12,Alphahull-PointsKO-Adjacents,254
Symplocos_itatiaiae,47,27,20,Alphahull-PointsKO-Adjacents,293
Symplocos_johnsonii,28,16,12,Points-PointsKO-Adjacents,117
Symplocos_junghuhnii,0,0,0,NA,0
Symplocos_jurgensenii,31,12,19,Points-PointsKO-Adjacents,221
Symplocos_lanata,5,2,3,Points-PointsKO-Adjacents,21
Symplocos_lancifolia,422,320,102,Alphahull-PointsKO-Adjacents,13267
Symplocos_lasseri,3,3,0,Points-PointsKO-Adjacents,24
Symplocos_laxiflora,98,0,98,Points-PointsKO-Adjacents,635
Symplocos_lehmannii,9,4,5,Points-PointsKO-Adjacents,66
Symplocos_limoncillo,257,209,48,Alphahull-PointsKO-Adjacents,2439
Symplocos_longipes,28,13,15,Points-PointsKO-Adjacents,115
Symplocos_lucida,61,26,35,Alphahull-PointsKO-Adjacents,450
Symplocos_lugubris,18,14,4,Points-PointsKO-Adjacents,65
Symplocos_mapiriensis,61,49,12,Alphahull-PointsKO-Adjacents,149
Symplocos_martinicensis,75,31,44,Alphahull-PointsKO-Adjacents,551
Symplocos_matudae,77,53,24,Alphahull-PointsKO-Adjacents,1373
Symplocos_melanochroa,9,1,8,Points-PointsKO-Adjacents,72
Symplocos_mezii,4,4,0,Points-PointsKO-Adjacents,36
Symplocos_micrantha,8,4,4,Points-PointsKO-Adjacents,35
Symplocos_microstyla,6,3,3,Points-PointsKO-Adjacents,21
Symplocos_molinae,4,4,0,Points-PointsKO-Adjacents,36
Symplocos_morii,9,3,6,Points-PointsKO-Adjacents,60
Symplocos_mucronata,28,18,10,Points-PointsKO-Adjacents,239
Symplocos_nana,23,5,18,Points-PointsKO-Adjacents,152
Symplocos_naniflora,22,14,8,Points-PointsKO-Adjacents,104
Symplocos_neblinae,9,0,9,Points-PointsKO-Adjacents,21
Symplocos_neei,20,13,7,Points-PointsKO-Adjacents,98
Symplocos_neocaledonica,9,1,8,Points-PointsKO-Adjacents,51
Symplocos_nitens,439,358,81,Alphahull-PointsKO-Adjacents,31576
Symplocos_nitidiflora,69,44,25,Alphahull-PointsKO-Adjacents,757
Symplocos_nivalis,4,4,0,Points-PointsKO-Adjacents,36
Symplocos_nuda,34,16,18,Points-PointsKO-Adjacents,265
Symplocos_oreophila,8,3,5,Points-PointsKO-Adjacents,49
Symplocos_organensis,9,8,1,Points-PointsKO-Adjacents,50
Symplocos_ovatilobata,3,3,0,Points-PointsKO-Adjacents,25
Symplocos_panamensis,66,51,15,Alphahull-PointsKO-Adjacents,583
Symplocos_paniculata,505,0,505,Points-PointsKO-Adjacents,3310
Symplocos_patazensis,2,2,0,Points-PointsKO-Adjacents,18
Symplocos_paucistaminea,118,99,19,Alphahull-PointsKO-Adjacents,289
Symplocos_pendula,16,5,11,Points-PointsKO-Adjacents,120
Symplocos_pentandra,152,0,152,Points-PointsKO-Adjacents,1033
Symplocos_peruviana,10,3,7,Points-PointsKO-Adjacents,62
Symplocos_phaeoneura,14,11,3,Points-PointsKO-Adjacents,73
Symplocos_pilosa,1,1,0,Points-PointsKO-Adjacents,9
Symplocos_platyphylla,36,19,17,Points-PointsKO-Adjacents,268
Symplocos_pluribracteata,1,1,0,Points-PointsKO-Adjacents,9
Symplocos_poilanei,11,4,7,Points-PointsKO-Adjacents,90
Symplocos_povedae,14,8,6,Points-PointsKO-Adjacents,44
Symplocos_psiloclada,18,8,10,Points-PointsKO-Adjacents,152
Symplocos_pubescens,313,265,48,Alphahull-PointsKO-Adjacents,12424
Symplocos_pycnantha,128,100,28,Alphahull-PointsKO-Adjacents,1852
Symplocos_pycnophylla,29,8,21,Points-PointsKO-Adjacents,200
Symplocos_pyrifolia,6,0,6,Points-PointsKO-Adjacents,54
Symplocos_quitensis,117,75,42,Alphahull-PointsKO-Adjacents,951
Symplocos_racemosa,84,38,46,Alphahull-PointsKO-Adjacents,3592
Symplocos_ramosissima,120,84,36,Alphahull-PointsKO-Adjacents,8732
Symplocos_reflexa,15,3,12,Points-PointsKO-Adjacents,131
Symplocos_retusa,9,2,7,Points-PointsKO-Adjacents,50
Symplocos_revoluta,75,51,24,Alphahull-PointsKO-Adjacents,1537
Symplocos_rhamnifolia,70,43,27,Alphahull-PointsKO-Adjacents,610
Symplocos_rhomboidea,15,14,1,Points-PointsKO-Adjacents,35
Symplocos_rigidissima,44,23,21,Alphahull-PointsKO-Adjacents,2037
Symplocos_rimbachii,4,4,0,Points-PointsKO-Adjacents,36
Symplocos_rizzinii,2,2,0,Points-PointsKO-Adjacents,18
Symplocos_robinfosteri,7,3,4,Points-PointsKO-Adjacents,52
Symplocos_robusta,4,4,0,Points-PointsKO-Adjacents,34
Symplocos_sandemanii,6,1,5,Points-PointsKO-Adjacents,54
Symplocos_scabra,8,0,8,Points-PointsKO-Adjacents,68
Symplocos_serrulata,135,112,23,Alphahull-PointsKO-Adjacents,990
Symplocos_spectabilis,0,0,0,NA,0
Symplocos_spruceana,7,2,5,Points-PointsKO-Adjacents,61
Symplocos_stawellii,373,300,73,Alphahull-PointsKO-Adjacents,1535
Symplocos_stellaris,224,169,55,Alphahull-PointsKO-Adjacents,9016
Symplocos_suaveolens,3,3,0,Points-PointsKO-Adjacents,27
Symplocos_subandina,10,5,5,Points-PointsKO-Adjacents,67
Symplocos_subcuneata,65,46,19,Alphahull-PointsKO-Adjacents,936
Symplocos_sulcata,11,5,6,Points-PointsKO-Adjacents,90
Symplocos_sumuntia,633,0,633,Points-PointsKO-Adjacents,2727
Symplocos_tacanensis,3,3,0,Points-PointsKO-Adjacents,27
Symplocos_tenuifolia,295,255,40,Alphahull-PointsKO-Adjacents,3411
Symplocos_tetrandra,230,0,230,Points-PointsKO-Adjacents,1576
Symplocos_theiformis,116,102,14,Alphahull-PointsKO-Adjacents,727
Symplocos_thwaitesii,496,420,76,Alphahull-PointsKO-Adjacents,2131
Symplocos_tinctoria,997,870,127,Alphahull-PointsKO-Adjacents,11655
Symplocos_tribracteolata,31,21,10,Alphahull-PointsKO-Adjacents,63
Symplocos_truncata,0,0,0,NA,0
Symplocos_ulei,10,7,3,Points-PointsKO-Adjacents,67
Symplocos_ulotricha,2,2,0,Points-PointsKO-Adjacents,18
Symplocos_umbellata,1,1,0,Points-PointsKO-Adjacents,9
Symplocos_uniflora,489,426,63,Alphahull-PointsKO-Adjacents,9909
Symplocos_vatteri,6,2,4,Points-PointsKO-Adjacents,54
Symplocos_viridissima,31,11,20,Points-PointsKO-Adjacents,208
Symplocos_wikstroemiifolia,74,45,29,Alphahull-PointsKO-Adjacents,1774
Symplocos_xylopyrena,44,29,15,Alphahull-PointsKO-Adjacents,201
Symplocos_yangchunensis,NA,NA,NA,NA,NA
Symplocos_yapacanensis,1,1,0,Points-PointsKO-Adjacents,9
Synapsis_ilicifolia,1,1,0,Points-PointsKO-Adjacents,9
Syncarpia_glomulifera,4427,3955,472,Alphahull-PointsKO-Adjacents,4404
Syncarpia_hillii,70,59,11,Alphahull-PointsKO-Adjacents,122
Syncarpia_verecunda,44,34,10,Alphahull-PointsKO-Adjacents,139
Syncolostemon_flabellifolius,0,0,0,NA,0
Syndiclis_anlungensis,NA,NA,NA,NA,NA
Syndiclis_chinensis,4,4,0,Points-PointsKO-Adjacents,36
Syndiclis_fooningensis,1,1,0,Points-PointsKO-Adjacents,9
Syndiclis_furfuracea,NA,NA,NA,NA,NA
Syndiclis_lotungensis,1,1,0,Points-PointsKO-Adjacents,9
Syndiclis_marlipoensis,2,2,0,Points-PointsKO-Adjacents,18
Syndiclis_pingbienensis,NA,NA,NA,NA,NA
Syndiclis_sichourensis,1,1,0,Points-PointsKO-Adjacents,9
Syndyophyllum_excelsum,4,4,0,Points-PointsKO-Adjacents,32
Syndyophyllum_occidentale,3,3,0,Points-PointsKO-Adjacents,27
Synechanthus_fibrosus,112,87,25,Alphahull-PointsKO-Adjacents,916
Synechanthus_warscewiczianus,455,410,45,Alphahull-PointsKO-Adjacents,3347
Synima_cordieri,23,6,17,Points-PointsKO-Adjacents,158
Synoum_glandulosum,3487,3287,200,Alphahull-PointsKO-Adjacents,2450
Synsepalum_afzelii,54,26,28,Alphahull-PointsKO-Adjacents,1380
Synsepalum_aubrevillei,14,10,4,Points-PointsKO-Adjacents,95
Synsepalum_batesii,0,0,0,NA,0
Synsepalum_bequaertii,5,5,0,Points-PointsKO-Adjacents,45
Synsepalum_brenanii,2,2,0,Points-PointsKO-Adjacents,15
Synsepalum_brevipes,248,147,101,Alphahull-PointsKO-Adjacents,12083
Synsepalum_cerasiferum,46,17,29,Points-PointsKO-Adjacents,300
Synsepalum_congolense,6,5,1,Points-PointsKO-Adjacents,48
Synsepalum_dulcificum,272,230,42,Alphahull-PointsKO-Adjacents,3527
Synsepalum_fleuryanum,17,13,4,Points-PointsKO-Adjacents,93
Synsepalum_gabonense,4,4,0,Points-PointsKO-Adjacents,36
Synsepalum_glycydorum,1,1,0,Points-PointsKO-Adjacents,9
Synsepalum_kassneri,0,0,0,NA,0
Synsepalum_laurentii,9,0,9,Points-PointsKO-Adjacents,75
Synsepalum_letouzei,7,1,6,Points-PointsKO-Adjacents,62
Synsepalum_muelleri,11,6,5,Points-PointsKO-Adjacents,54
Synsepalum_nyangense,3,3,0,Points-PointsKO-Adjacents,24
Synsepalum_ogouense,1,1,0,Points-PointsKO-Adjacents,9
Synsepalum_passargei,61,29,32,Alphahull-PointsKO-Adjacents,355
Synsepalum_pobeguinianum,31,17,14,Points-PointsKO-Adjacents,229
Synsepalum_revolutum,16,3,13,Points-PointsKO-Adjacents,132
Synsepalum_seretii,15,0,15,Points-PointsKO-Adjacents,112
Synsepalum_stipulatum,112,77,35,Alphahull-PointsKO-Adjacents,2802
Synsepalum_subcordatum,34,16,18,Points-PointsKO-Adjacents,195
Synsepalum_subverticillatum,9,2,7,Points-PointsKO-Adjacents,53
Synsepalum_tsounkpe,7,1,6,Points-PointsKO-Adjacents,43
Synsepalum_ulugurense,6,1,5,Points-PointsKO-Adjacents,54
Synsepalum_zenkeri,4,4,0,Points-PointsKO-Adjacents,36
Syringa_emodi,15,0,15,Points-PointsKO-Adjacents,132
Syringa_komarowii,20,6,14,Points-PointsKO-Adjacents,178
Syringa_oblata,38,14,24,Points-PointsKO-Adjacents,340
Syringa_pinetorum,6,1,5,Points-PointsKO-Adjacents,54
Syringa_reticulata,187,101,86,Alphahull-PointsKO-Adjacents,3809
Syringa_tomentella,86,0,86,Points-PointsKO-Adjacents,656
Syringa_villosa,8,3,5,Points-PointsKO-Adjacents,57
Syringa_vulgaris,98,72,26,Alphahull-PointsKO-Adjacents,1870
Systemonodaphne_geminiflora,36,14,22,Points-PointsKO-Adjacents,282
Syzygium_abbreviatum,1,1,0,Points-PointsKO-Adjacents,9
Syzygium_aborense,0,0,0,NA,0
Syzygium_abortivum,1,1,0,Points-PointsKO-Adjacents,9
Syzygium_abulugense,0,0,0,NA,0
Syzygium_aciculinum,0,0,0,NA,0
Syzygium_acre,9,6,3,Points-PointsKO-Adjacents,19
Syzygium_acrophilum,0,0,0,NA,0
Syzygium_acuminatissimum,139,59,80,Alphahull-PointsKO-Adjacents,1784
Syzygium_acuminatum,0,0,0,NA,0
Syzygium_acutangulum,34,16,18,Points-PointsKO-Adjacents,175
Syzygium_acutatum,0,0,0,NA,0
Syzygium_adelphicum,51,36,15,Alphahull-PointsKO-Adjacents,329
Syzygium_adenophyllum,2,1,1,Points-PointsKO-Adjacents,18
Syzygium_aegiceroides,0,0,0,NA,0
Syzygium_aemulum,0,0,0,NA,0
Syzygium_aeoranthum,4,4,0,Points-PointsKO-Adjacents,32
Syzygium_affine,0,0,0,NA,0
Syzygium_aggregatum,30,22,8,Alphahull-PointsKO-Adjacents,85
Syzygium_aksornae,NA,NA,NA,NA,NA
Syzygium_alatoramulum,38,0,38,Points-PointsKO-Adjacents,88
Syzygium_alatum,61,42,19,Alphahull-PointsKO-Adjacents,535
Syzygium_albayense,1,1,0,Points-PointsKO-Adjacents,9
Syzygium_albiflorum,4,0,4,Points-PointsKO-Adjacents,24
Syzygium_album,NA,NA,NA,NA,NA
Syzygium_alliiligneum,53,42,11,Alphahull-PointsKO-Adjacents,107
Syzygium_alternifolium,0,0,0,NA,0
Syzygium_alubo,0,0,0,NA,0
Syzygium_alutaceum,0,0,0,NA,0
Syzygium_alvarezii,1,1,0,Points-PointsKO-Adjacents,9
Syzygium_amicorum,3,3,0,Points-PointsKO-Adjacents,16
Syzygium_amieuense,8,0,8,Points-PointsKO-Adjacents,48
Syzygium_amphoraecarpus,NA,NA,NA,NA,NA
Syzygium_amplexicaule,0,0,0,NA,0
Syzygium_ampliflorum,1,0,1,Points-PointsKO-Adjacents,9
Syzygium_amplifolium,4,4,0,Points-PointsKO-Adjacents,25
Syzygium_amplum,32,17,15,Points-PointsKO-Adjacents,183
Syzygium_ampullarium,2,2,0,Points-PointsKO-Adjacents,14
Syzygium_anacardiifolium,0,0,0,NA,0
Syzygium_andamanicum,0,0,0,NA,0
Syzygium_aneityense,5,0,5,Points-PointsKO-Adjacents,32
Syzygium_angkae,1,1,0,Points-PointsKO-Adjacents,9
Syzygium_angophoroides,757,693,64,Alphahull-PointsKO-Adjacents,8604
Syzygium_angulare,0,0,0,NA,0
Syzygium_angulatum,0,0,0,NA,0
Syzygium_anisopetalum,0,0,0,NA,0
Syzygium_anisosepalum,0,0,0,NA,0
Syzygium_anomalum,1,1,0,Points-PointsKO-Adjacents,9
Syzygium_anthicoides,0,0,0,NA,0
Syzygium_anthicum,0,0,0,NA,0
Syzygium_antisepticum,14,1,13,Points-PointsKO-Adjacents,120
Syzygium_antonianum,0,0,0,NA,0
Syzygium_aoupinianum,2,2,0,Points-PointsKO-Adjacents,12
Syzygium_apetiolatum,4,4,0,Points-PointsKO-Adjacents,16
Syzygium_apiarii,1,1,0,Points-PointsKO-Adjacents,9
Syzygium_apodophyllum,93,77,16,Alphahull-PointsKO-Adjacents,234
Syzygium_apodum,0,0,0,NA,0
Syzygium_apoense,1,1,0,Points-PointsKO-Adjacents,9
Syzygium_aqueum,89,56,33,Alphahull-PointsKO-Adjacents,2166
Syzygium_araiocladum,4,4,0,Points-PointsKO-Adjacents,36
Syzygium_arboreum,25,11,14,Points-PointsKO-Adjacents,90
Syzygium_arcanum,0,0,0,NA,0
Syzygium_arcuatinervium,1,1,0,Points-PointsKO-Adjacents,5
Syzygium_arenitense,18,13,5,Points-PointsKO-Adjacents,55
Syzygium_argyrocalyx,4,4,0,Points-PointsKO-Adjacents,26
Syzygium_argyropedicum,29,23,6,Alphahull-PointsKO-Adjacents,73
Syzygium_armstrongii,203,187,16,Alphahull-PointsKO-Adjacents,1211
Syzygium_aromaticum,11,4,7,Points-PointsKO-Adjacents,59
Syzygium_assamicum,0,0,0,NA,0
Syzygium_assimile,2,1,1,Points-PointsKO-Adjacents,18
Syzygium_astronioides,0,0,0,NA,0
Syzygium_attenuatum,13,3,10,Points-PointsKO-Adjacents,87
Syzygium_attopeuense,1,1,0,Points-PointsKO-Adjacents,7
Syzygium_aurantiacum,3,3,0,Points-PointsKO-Adjacents,16
Syzygium_auriculatum,13,4,9,Points-PointsKO-Adjacents,26
Syzygium_australe,1126,971,155,Alphahull-PointsKO-Adjacents,4286
Syzygium_austrocaledonicum,51,37,14,Alphahull-PointsKO-Adjacents,167
Syzygium_austrosinense,17,5,12,Points-PointsKO-Adjacents,153
Syzygium_austroyunnanense,NA,NA,NA,NA,NA
Syzygium_avene,0,0,0,NA,0
Syzygium_badescens,0,0,0,NA,0
Syzygium_badium,0,0,0,NA,0
Syzygium_baeuerlenii,5,5,0,Points-PointsKO-Adjacents,36
Syzygium_bakoense,0,0,0,NA,0
Syzygium_baladense,22,13,9,Points-PointsKO-Adjacents,101
Syzygium_balansae,12,4,8,Points-PointsKO-Adjacents,45
Syzygium_balerense,0,0,0,NA,0
Syzygium_balfourii,0,0,0,NA,0
Syzygium_balsameum,6,0,6,Points-PointsKO-Adjacents,54
Syzygium_bamagense,81,65,16,Alphahull-PointsKO-Adjacents,436
Syzygium_bankense,11,2,9,Points-PointsKO-Adjacents,76
Syzygium_banksii,78,58,20,Alphahull-PointsKO-Adjacents,313
Syzygium_baramense,3,0,3,Points-PointsKO-Adjacents,18
Syzygium_barnesii,1,1,0,Points-PointsKO-Adjacents,9
Syzygium_barringtonioides,2,2,0,Points-PointsKO-Adjacents,18
Syzygium_bartonii,1,1,0,Points-PointsKO-Adjacents,9
Syzygium_bataanense,1,1,0,Points-PointsKO-Adjacents,9
Syzygium_beccarii,2,1,1,Points-PointsKO-Adjacents,18
Syzygium_beddomei,1,1,0,Points-PointsKO-Adjacents,9
Syzygium_benguellense,2,2,0,Points-PointsKO-Adjacents,18
Syzygium_benguetense,0,0,0,NA,0
Syzygium_benjaminum,39,23,16,Alphahull-PointsKO-Adjacents,347
Syzygium_bernardoi,0,0,0,NA,0
Syzygium_bernieri,99,72,27,Alphahull-PointsKO-Adjacents,1606
Syzygium_bicolor,7,3,4,Points-PointsKO-Adjacents,39
Syzygium_bicostatum,0,0,0,NA,0
Syzygium_bijouxii,0,0,0,NA,0
Syzygium_blumei,0,0,0,NA,0
Syzygium_boerlagei,0,0,0,NA,0
Syzygium_boisianum,1,1,0,Points-PointsKO-Adjacents,9
Syzygium_boonjee,45,38,7,Alphahull-PointsKO-Adjacents,50
Syzygium_borbonicum,0,0,0,NA,0
Syzygium_bordenii,0,0,0,NA,0
Syzygium_borneense,7,0,7,Points-PointsKO-Adjacents,57
Syzygium_bourdillonii,0,0,0,NA,0
Syzygium_brachyanthelium,0,0,0,NA,0
Syzygium_brachybotryum,0,0,0,NA,0
Syzygium_brachycalyx,3,3,0,Points-PointsKO-Adjacents,17
Syzygium_brachypodum,0,0,0,NA,0
Syzygium_brachyrachis,2,0,2,Points-PointsKO-Adjacents,18
Syzygium_brachythyrsum,2,2,0,Points-PointsKO-Adjacents,18
Syzygium_brackenridgei,2,2,0,Points-PointsKO-Adjacents,12
Syzygium_branderhorstii,56,30,26,Alphahull-PointsKO-Adjacents,387
Syzygium_brevicymum,0,0,0,NA,0
Syzygium_brevifolium,1,1,0,Points-PointsKO-Adjacents,9
Syzygium_brevioperculatum,3,3,0,Points-PointsKO-Adjacents,22
Syzygium_brevipes,2,2,0,Points-PointsKO-Adjacents,17
Syzygium_brongniartii,17,6,11,Points-PointsKO-Adjacents,88
Syzygium_brousmichei,0,0,0,NA,0
Syzygium_bubengense,0,0,0,NA,0
Syzygium_buettnerianum,102,0,102,Points-PointsKO-Adjacents,415
Syzygium_bujangii,0,0,0,NA,0
Syzygium_bullockii,14,6,8,Points-PointsKO-Adjacents,117
Syzygium_bungadinnia,41,32,9,Alphahull-PointsKO-Adjacents,224
Syzygium_burepense,3,3,0,Points-PointsKO-Adjacents,13
Syzygium_burkillianum,1,1,0,Points-PointsKO-Adjacents,9
Syzygium_busuense,3,3,0,Points-PointsKO-Adjacents,27
Syzygium_buxifolioideum,1,1,0,Points-PointsKO-Adjacents,9
Syzygium_buxifolium,396,318,78,Alphahull-PointsKO-Adjacents,9156
Syzygium_cacuminis,0,0,0,NA,0
Syzygium_cagayanense,0,0,0,NA,0
Syzygium_calcicola,0,0,0,NA,0
Syzygium_calleryanum,0,0,0,NA,0
Syzygium_callianthum,6,0,6,Points-PointsKO-Adjacents,29
Syzygium_calophyllifolium,1,0,1,Points-PointsKO-Adjacents,9
Syzygium_calubcob,4,4,0,Points-PointsKO-Adjacents,23
Syzygium_calyptrocalyx,0,0,0,NA,0
Syzygium_cameronum,0,0,0,NA,0
Syzygium_camptodromum,0,0,0,NA,0
Syzygium_camptophyllum,0,0,0,NA,0
Syzygium_candelabriforme,0,0,0,NA,0
Syzygium_canicortex,80,69,11,Alphahull-PointsKO-Adjacents,261
Syzygium_capillaceum,7,0,7,Points-PointsKO-Adjacents,39
Syzygium_capitatum,0,0,0,NA,0
Syzygium_capituliferum,2,2,0,Points-PointsKO-Adjacents,16
Syzygium_capoasense,1,1,0,Points-PointsKO-Adjacents,9
Syzygium_cardiophyllum,0,0,0,NA,0
Syzygium_caroli,0,0,0,NA,0
Syzygium_carolinense,5,4,1,Points-PointsKO-Adjacents,12
Syzygium_carrii,1,1,0,Points-PointsKO-Adjacents,9
Syzygium_cartilagineum,2,2,0,Points-PointsKO-Adjacents,6
Syzygium_caryophyllatum,2,1,1,Points-PointsKO-Adjacents,18
Syzygium_caryophylliflorum,0,0,0,NA,0
Syzygium_caryophylloides,0,0,0,NA,0
Syzygium_casiguranense,1,1,0,Points-PointsKO-Adjacents,9
Syzygium_castaneum,5,2,3,Points-PointsKO-Adjacents,36
Syzygium_caudatilimbum,13,6,7,Points-PointsKO-Adjacents,98
Syzygium_caudatum,4,1,3,Points-PointsKO-Adjacents,21
Syzygium_cauliflorum,2,2,0,Points-PointsKO-Adjacents,17
Syzygium_cavitense,0,0,0,NA,0
Syzygium_cephalophorum,0,0,0,NA,0
Syzygium_chaii,0,0,0,NA,0
Syzygium_championii,22,0,22,Points-PointsKO-Adjacents,198
Syzygium_chavaran,0,0,0,NA,0
Syzygium_chloranthum,7,0,7,Points-PointsKO-Adjacents,63
Syzygium_chloroleucum,1,1,0,Points-PointsKO-Adjacents,9
Syzygium_christmannii,0,0,0,NA,0
Syzygium_christophersenii,1,1,0,Points-PointsKO-Adjacents,8
Syzygium_chunianum,5,0,5,Points-PointsKO-Adjacents,36
Syzygium_ciliatosetosum,0,0,0,NA,0
Syzygium_cinctum,1,1,0,Points-PointsKO-Adjacents,8
Syzygium_cinnamomeum,1,1,0,Points-PointsKO-Adjacents,9
Syzygium_cladopterum,7,1,6,Points-PointsKO-Adjacents,39
Syzygium_clavellatum,1,1,0,Points-PointsKO-Adjacents,9
Syzygium_claviflorum,319,243,76,Alphahull-PointsKO-Adjacents,2763
Syzygium_cleistocalyx,0,0,0,NA,0
Syzygium_clementis,0,0,0,NA,0
Syzygium_clusiifolium,13,0,13,Points-PointsKO-Adjacents,74
Syzygium_coalitum,12,7,5,Points-PointsKO-Adjacents,59
Syzygium_coccineum,28,18,10,Points-PointsKO-Adjacents,76
Syzygium_combretiflorum,NA,NA,NA,NA,NA
Syzygium_commersonii,1,1,0,Points-PointsKO-Adjacents,9
Syzygium_conceptionis,9,6,3,Points-PointsKO-Adjacents,55
Syzygium_concinnum,1,1,0,Points-PointsKO-Adjacents,9
Syzygium_condensatum,24,18,6,Points-PointsKO-Adjacents,64
Syzygium_confertiflorum,1,1,0,Points-PointsKO-Adjacents,9
Syzygium_confertum,3,0,3,Points-PointsKO-Adjacents,27
Syzygium_confusum,0,0,0,NA,0
Syzygium_congestum,0,0,0,NA,0
Syzygium_conglobatum,1,1,0,Points-PointsKO-Adjacents,9
Syzygium_conglomeratum,1,0,1,Points-PointsKO-Adjacents,9
Syzygium_congolense,39,10,29,Points-PointsKO-Adjacents,260
Syzygium_conicum,NA,NA,NA,NA,NA
Syzygium_consanguineum,0,0,0,NA,0
Syzygium_consimile,0,0,0,NA,0
Syzygium_conspersipunctatum,3,3,0,Points-PointsKO-Adjacents,27
Syzygium_contractum,0,0,0,NA,0
Syzygium_copelandii,0,0,0,NA,0
Syzygium_cordatilimbum,0,0,0,NA,0
Syzygium_cordatum,300,204,96,Alphahull-PointsKO-Adjacents,17622
Syzygium_cordemoyi,0,0,0,NA,0
Syzygium_cordifoliatum,0,0,0,NA,0
Syzygium_cordifolium,1,1,0,Points-PointsKO-Adjacents,9
Syzygium_cormiflorum,240,213,27,Alphahull-PointsKO-Adjacents,666
Syzygium_cornifolium,0,0,0,NA,0
Syzygium_cornuflorum,0,0,0,NA,0
Syzygium_corticopapyraceum,0,0,0,NA,0
Syzygium_corticosum,0,0,0,NA,0
Syzygium_corymbosum,0,0,0,NA,0
Syzygium_corynanthum,199,178,21,Alphahull-PointsKO-Adjacents,712
Syzygium_corynocarpum,7,2,5,Points-PointsKO-Adjacents,44
Syzygium_costulatum,0,0,0,NA,0
Syzygium_courtallense,0,0,0,NA,0
Syzygium_craibii,0,0,0,NA,0
Syzygium_crassibracteatum,0,0,0,NA,0
Syzygium_crassiflorum,0,0,0,NA,0
Syzygium_crassilimbum,0,0,0,NA,0
Syzygium_crassipes,0,0,0,NA,0
Syzygium_crassissimum,0,0,0,NA,0
Syzygium_creaghii,2,2,0,Points-PointsKO-Adjacents,18
Syzygium_crebrinerve,272,251,21,Alphahull-PointsKO-Adjacents,666
Syzygium_cruriflorum,NA,NA,NA,NA,NA
Syzygium_crypteronioides,0,0,0,NA,0
Syzygium_cumini,363,123,240,Alphahull-PointsKO-Adjacents,12675
Syzygium_cuneatum,0,0,0,NA,0
Syzygium_cuneiforme,1,0,1,Points-PointsKO-Adjacents,9
Syzygium_curranii,0,0,0,NA,0
Syzygium_curtiflorum,0,0,0,NA,0
Syzygium_curtisii,2,2,0,Points-PointsKO-Adjacents,16
Syzygium_curvistylum,2,2,0,Points-PointsKO-Adjacents,18
Syzygium_cuttingii,0,0,0,NA,0
Syzygium_cyanophyllum,NA,NA,NA,NA,NA
Syzygium_cylindricum,0,0,0,NA,0
Syzygium_cymosum,2,2,0,Points-PointsKO-Adjacents,15
Syzygium_cyrtophylloides,0,0,0,NA,0
Syzygium_danguyanum,21,0,21,Points-PointsKO-Adjacents,119
Syzygium_dansiei,11,9,2,Points-PointsKO-Adjacents,22
Syzygium_daphne,1,1,0,Points-PointsKO-Adjacents,9
Syzygium_dasyphyllum,1,1,0,Points-PointsKO-Adjacents,9
Syzygium_davaoense,0,0,0,NA,0
Syzygium_dealbatum,4,4,0,Points-PointsKO-Adjacents,13
Syzygium_decipiens,19,0,19,Points-PointsKO-Adjacents,110
Syzygium_decoriflorum,0,0,0,NA,0
Syzygium_decussatum,2,2,0,Points-PointsKO-Adjacents,16
Syzygium_delicatulum,1,1,0,Points-PointsKO-Adjacents,9
Syzygium_dempoense,1,1,0,Points-PointsKO-Adjacents,9
Syzygium_densiflorum,2,1,1,Points-PointsKO-Adjacents,18
Syzygium_densinervium,8,3,5,Points-PointsKO-Adjacents,26
Syzygium_deplanchei,43,29,14,Alphahull-PointsKO-Adjacents,133
Syzygium_dictyoneurum,0,0,0,NA,0
Syzygium_dielsianum,NA,NA,NA,NA,NA
Syzygium_diffusiflorum,0,0,0,NA,0
Syzygium_diffusum,1,1,0,Points-PointsKO-Adjacents,5
Syzygium_diospyrifolium,3,3,0,Points-PointsKO-Adjacents,27
Syzygium_discophorum,0,0,0,NA,0
Syzygium_dispansum,1,1,0,Points-PointsKO-Adjacents,9
Syzygium_divaricatum,73,63,10,Alphahull-PointsKO-Adjacents,110
Syzygium_dolichophyllum,8,4,4,Points-PointsKO-Adjacents,45
Syzygium_dolichorhynchum,NA,NA,NA,NA,NA
Syzygium_dolichostylum,NA,NA,NA,NA,NA
Syzygium_dubium,0,0,0,NA,0
Syzygium_duplomarginatum,1,1,0,Points-PointsKO-Adjacents,9
Syzygium_dupontii,0,0,0,NA,0
Syzygium_durifolium,1,1,0,Points-PointsKO-Adjacents,9
Syzygium_durum,0,0,0,NA,0
Syzygium_duthieanum,2,1,1,Points-PointsKO-Adjacents,18
Syzygium_dyerianum,1,1,0,Points-PointsKO-Adjacents,9
Syzygium_ebaloii,0,0,0,NA,0
Syzygium_ecostulatum,0,0,0,NA,0
Syzygium_effusum,163,129,34,Alphahull-PointsKO-Adjacents,2778
Syzygium_elliptifolium,0,0,0,NA,0
Syzygium_elliptilimbum,3,1,2,Points-PointsKO-Adjacents,18
Syzygium_elopurae,1,1,0,Points-PointsKO-Adjacents,9
Syzygium_embelioides,NA,NA,NA,NA,NA
Syzygium_emirnense,253,218,35,Alphahull-PointsKO-Adjacents,2359
Syzygium_endophloium,119,0,119,Points-PointsKO-Adjacents,278
Syzygium_erythranthum,1,0,1,Points-PointsKO-Adjacents,9
Syzygium_erythrocalyx,36,29,7,Alphahull-PointsKO-Adjacents,92
Syzygium_erythrodoxum,73,57,16,Alphahull-PointsKO-Adjacents,108
Syzygium_erythropetalum,19,8,11,Points-PointsKO-Adjacents,90
Syzygium_escritorii,0,0,0,NA,0
Syzygium_eucalyptoides,1092,1037,55,Alphahull-PointsKO-Adjacents,9447
Syzygium_eugeniiforme,0,0,0,NA,0
Syzygium_eugenioides,0,0,0,NA,0
Syzygium_euonymifolium,8,3,5,Points-PointsKO-Adjacents,72
Syzygium_euphlebium,54,49,5,Alphahull-PointsKO-Adjacents,24
Syzygium_evenulosum,0,0,0,NA,0
Syzygium_everettii,2,2,0,Points-PointsKO-Adjacents,18
Syzygium_eximiiflorum,0,0,0,NA,0
Syzygium_faciflorum,0,0,0,NA,0
Syzygium_fastigiatum,39,13,26,Points-PointsKO-Adjacents,291
Syzygium_fenicis,0,0,0,NA,0
Syzygium_fergusonii,0,0,0,NA,0
Syzygium_fibrosum,213,163,50,Alphahull-PointsKO-Adjacents,1008
Syzygium_fijiense,0,0,0,NA,0
Syzygium_filiflorum,3,3,0,Points-PointsKO-Adjacents,16
Syzygium_filiforme,2,1,1,Points-PointsKO-Adjacents,18
Syzygium_filipes,0,0,0,NA,0
Syzygium_finisterrae,0,0,0,NA,0
Syzygium_fischeri,NA,NA,NA,NA,NA
Syzygium_flagrimonte,1,1,0,Points-PointsKO-Adjacents,9
Syzygium_flavescens,8,2,6,Points-PointsKO-Adjacents,36
Syzygium_flavidum,0,0,0,NA,0
Syzygium_floribundum,208,161,47,Alphahull-PointsKO-Adjacents,1047
Syzygium_flosculiferum,1,1,0,Points-PointsKO-Adjacents,9
Syzygium_fluvicola,0,0,0,NA,0
Syzygium_formosanum,166,151,15,Alphahull-PointsKO-Adjacents,298
Syzygium_formosum,4,4,0,Points-PointsKO-Adjacents,36
Syzygium_forrestii,4,2,2,Points-PointsKO-Adjacents,36
Syzygium_forte,436,384,52,Alphahull-PointsKO-Adjacents,3104
Syzygium_fossiramulosum,0,0,0,NA,0
Syzygium_foxworthianum,0,0,0,NA,0
Syzygium_foxworthyi,1,1,0,Points-PointsKO-Adjacents,9
Syzygium_francisii,268,234,34,Alphahull-PointsKO-Adjacents,904
Syzygium_fraternum,NA,NA,NA,NA,NA
Syzygium_fratris,8,5,3,Points-PointsKO-Adjacents,15
Syzygium_frutescens,35,22,13,Alphahull-PointsKO-Adjacents,103
Syzygium_fullagarii,16,9,7,Points-PointsKO-Adjacents,5
Syzygium_fulvotomentosum,0,0,0,NA,0
Syzygium_furfuraceum,65,51,14,Alphahull-PointsKO-Adjacents,910
Syzygium_fuscescens,1,1,0,Points-PointsKO-Adjacents,9
Syzygium_fusticuliferum,0,0,0,NA,0
Syzygium_gageanum,0,0,0,NA,0
Syzygium_ganophyllum,1,1,0,Points-PointsKO-Adjacents,9
Syzygium_garciae,0,0,0,NA,0
Syzygium_garciniifolium,1,1,0,Points-PointsKO-Adjacents,9
Syzygium_garcinioides,0,0,0,NA,0
Syzygium_gardneri,0,0,0,NA,0
Syzygium_georgeae,NA,NA,NA,NA,NA
Syzygium_germainii,1,1,0,Points-PointsKO-Adjacents,9
Syzygium_gerrardii,54,33,21,Alphahull-PointsKO-Adjacents,837
Syzygium_gigantifolium,0,0,0,NA,0
Syzygium_gillespiei,1,1,0,Points-PointsKO-Adjacents,3
Syzygium_gilletii,9,1,8,Points-PointsKO-Adjacents,69
Syzygium_giorgii,17,0,17,Points-PointsKO-Adjacents,144
Syzygium_gitingense,0,0,0,NA,0
Syzygium_gjellerupii,0,0,0,NA,0
Syzygium_glabratum,4,0,4,Points-PointsKO-Adjacents,27
Syzygium_gladiatum,0,0,0,NA,0
Syzygium_glanduligerum,2,0,2,Points-PointsKO-Adjacents,18
Syzygium_glaucissimum,NA,NA,NA,NA,NA
Syzygium_glaucum,2,2,0,Points-PointsKO-Adjacents,18
Syzygium_glenum,9,4,5,Points-PointsKO-Adjacents,22
Syzygium_globiflorum,12,3,9,Points-PointsKO-Adjacents,99
Syzygium_globosum,0,0,0,NA,0
Syzygium_glomeratum,2,2,0,Points-PointsKO-Adjacents,14
Syzygium_glomerulatum,0,0,0,NA,0
Syzygium_glomeruliferum,0,0,0,NA,0
Syzygium_gonatanthum,27,15,12,Points-PointsKO-Adjacents,136
Syzygium_goniocalyx,7,0,7,Points-PointsKO-Adjacents,39
Syzygium_goniopterum,11,4,7,Points-PointsKO-Adjacents,73
Syzygium_gonshanense,NA,NA,NA,NA,NA
Syzygium_goodenovii,0,0,0,NA,0
Syzygium_gracilipaniculum,0,0,0,NA,0
Syzygium_gracilipes,8,0,8,Points-PointsKO-Adjacents,50
Syzygium_graeffei,NA,NA,NA,NA,NA
Syzygium_graeme-andersoniae,0,0,0,NA,0
Syzygium_grande,13,1,12,Points-PointsKO-Adjacents,83
Syzygium_graveolens,63,49,14,Alphahull-PointsKO-Adjacents,200
Syzygium_grayi,1,1,0,Points-PointsKO-Adjacents,9
Syzygium_grevesianum,1,1,0,Points-PointsKO-Adjacents,9
Syzygium_griffithii,2,1,1,Points-PointsKO-Adjacents,12
Syzygium_griseum,1,1,0,Points-PointsKO-Adjacents,9
Syzygium_guangxiense,NA,NA,NA,NA,NA
Syzygium_guehoi,0,0,0,NA,0
Syzygium_guillauminii,9,2,7,Points-PointsKO-Adjacents,46
Syzygium_guineense,969,800,169,Alphahull-PointsKO-Adjacents,65922
Syzygium_gustavioides,119,112,7,Alphahull-PointsKO-Adjacents,595
Syzygium_gyrostemoneum,NA,NA,NA,NA,NA
Syzygium_hainanense,3,3,0,Points-PointsKO-Adjacents,27
Syzygium_halophilum,0,0,0,NA,0
Syzygium_hancei,47,25,22,Alphahull-PointsKO-Adjacents,2549
Syzygium_handelii,4,4,0,Points-PointsKO-Adjacents,36
Syzygium_haniffii,0,0,0,NA,0
Syzygium_harmandii,1,1,0,Points-PointsKO-Adjacents,9
Syzygium_havilandii,1,1,0,Points-PointsKO-Adjacents,9
Syzygium_hebephyllum,0,0,0,NA,0
Syzygium_hedraiophyllum,70,61,9,Alphahull-PointsKO-Adjacents,96
Syzygium_helferi,3,3,0,Points-PointsKO-Adjacents,27
Syzygium_heloanthum,NA,NA,NA,NA,NA
Syzygium_hemilamprum,397,331,66,Alphahull-PointsKO-Adjacents,1478
Syzygium_hemisphericum,1,0,1,Points-PointsKO-Adjacents,9
Syzygium_hemsleyanum,2,2,0,Points-PointsKO-Adjacents,18
Syzygium_hendersonii,0,0,0,NA,0
Syzygium_heterobotrys,2,2,0,Points-PointsKO-Adjacents,18
Syzygium_hirtum,16,6,10,Points-PointsKO-Adjacents,104
Syzygium_hodgkinsoniae,264,250,14,Alphahull-PointsKO-Adjacents,189
Syzygium_homichlophilum,7,2,5,Points-PointsKO-Adjacents,21
Syzygium_hoseanum,1,1,0,Points-PointsKO-Adjacents,9
Syzygium_houttuynii,3,3,0,Points-PointsKO-Adjacents,21
Syzygium_houttuyniifolia,NA,NA,NA,NA,NA
Syzygium_howii,2,2,0,Points-PointsKO-Adjacents,18
Syzygium_hughcumingii,1,1,0,Points-PointsKO-Adjacents,9
Syzygium_hulletianum,0,0,0,NA,0
Syzygium_humblotii,1,1,0,Points-PointsKO-Adjacents,7
Syzygium_hutchinsonii,0,0,0,NA,0
Syzygium_hylochare,15,6,9,Points-PointsKO-Adjacents,84
Syzygium_hylophilum,84,58,26,Alphahull-PointsKO-Adjacents,2005
Syzygium_hypsipetes,0,0,0,NA,0
Syzygium_idrisii,0,0,0,NA,0
Syzygium_iliasii,0,0,0,NA,0
Syzygium_ilocanum,0,0,0,NA,0
Syzygium_imitans,3,3,0,Points-PointsKO-Adjacents,27
Syzygium_imperiale,0,0,0,NA,0
Syzygium_inasense,0,0,0,NA,0
Syzygium_incarnatum,5,0,5,Points-PointsKO-Adjacents,32
Syzygium_incrassatum,1,1,0,Points-PointsKO-Adjacents,6
Syzygium_infrarubiginosum,NA,NA,NA,NA,NA
Syzygium_ingens,220,205,15,Alphahull-PointsKO-Adjacents,457
Syzygium_inophylloides,20,10,10,Points-PointsKO-Adjacents,72
Syzygium_inophyllum,1,1,0,Points-PointsKO-Adjacents,9
Syzygium_inopinatum,0,0,0,NA,0
Syzygium_insulare,12,0,12,Points-PointsKO-Adjacents,64
Syzygium_intumescens,1,1,0,Points-PointsKO-Adjacents,9
Syzygium_isabelense,0,0,0,NA,0
Syzygium_iteophyllum,9,1,8,Points-PointsKO-Adjacents,37
Syzygium_iwahigense,0,0,0,NA,0
Syzygium_ixoroides,2,2,0,Points-PointsKO-Adjacents,18
Syzygium_jaffrei,3,3,0,Points-PointsKO-Adjacents,19
Syzygium_jaheri,0,0,0,NA,0
Syzygium_jainii,NA,NA,NA,NA,NA
Syzygium_jambos,222,0,222,Points-PointsKO-Adjacents,1299
Syzygium_jasminifolium,1,1,0,Points-PointsKO-Adjacents,9
Syzygium_jienfunicum,0,0,0,NA,0
Syzygium_johnsonii,214,181,33,Alphahull-PointsKO-Adjacents,620
Syzygium_kabaense,1,1,0,Points-PointsKO-Adjacents,9
Syzygium_kajewskii,5,5,0,Points-PointsKO-Adjacents,33
Syzygium_kalahiense,1,1,0,Points-PointsKO-Adjacents,9
Syzygium_kanarense,NA,NA,NA,NA,NA
Syzygium_kanneliyensis,NA,NA,NA,NA,NA
Syzygium_karimatense,0,0,0,NA,0
Syzygium_kemamanense,0,0,0,NA,0
Syzygium_keroanthum,NA,NA,NA,NA,NA
Syzygium_kerrii,0,0,0,NA,0
Syzygium_kerstingii,3,3,0,Points-PointsKO-Adjacents,21
Syzygium_keysseri,2,2,0,Points-PointsKO-Adjacents,9
Syzygium_khaoyaiense,0,0,0,NA,0
Syzygium_khasianum,0,0,0,NA,0
Syzygium_khoonmengianum,0,0,0,NA,0
Syzygium_kiahii,0,0,0,NA,0
Syzygium_kiauense,4,4,0,Points-PointsKO-Adjacents,27
Syzygium_kietanum,1,1,0,Points-PointsKO-Adjacents,7
Syzygium_kinabaluense,3,2,1,Points-PointsKO-Adjacents,18
Syzygium_klampok,0,0,0,NA,0
Syzygium_klossii,0,0,0,NA,0
Syzygium_koghianum,15,7,8,Points-PointsKO-Adjacents,80
Syzygium_koniamboense,4,4,0,Points-PointsKO-Adjacents,36
Syzygium_koordersianum,2,1,1,Points-PointsKO-Adjacents,18
Syzygium_korthalsianum,0,0,0,NA,0
Syzygium_koumacense,4,4,0,Points-PointsKO-Adjacents,22
Syzygium_kudatense,0,0,0,NA,0
Syzygium_kunstleri,1,0,1,Points-PointsKO-Adjacents,9
Syzygium_kuranda,115,0,115,Points-PointsKO-Adjacents,215
Syzygium_kurzii,0,0,0,NA,0
Syzygium_kusukusuense,61,53,8,Alphahull-PointsKO-Adjacents,52
Syzygium_kwangtungense,8,2,6,Points-PointsKO-Adjacents,72
Syzygium_legatii,16,10,6,Points-PointsKO-Adjacents,135
Syzygium_lacustre,0,0,0,NA,0
Syzygium_laetum,2,0,2,Points-PointsKO-Adjacents,18
Syzygium_lagerstmemioides,0,0,0,NA,0
Syzygium_lakshnakarae,0,0,0,NA,0
Syzygium_lambirense,0,0,0,NA,0
Syzygium_lamii,0,0,0,NA,0
Syzygium_lamprophyllum,0,0,0,NA,0
Syzygium_lanceolarium,0,0,0,NA,0
Syzygium_lanceolatum,0,0,0,NA,0
Syzygium_lancilimbum,0,0,0,NA,0
Syzygium_laqueatum,15,1,14,Points-PointsKO-Adjacents,85
Syzygium_lasianthifolium,NA,NA,NA,NA,NA
Syzygium_lateriflorum,33,18,15,Points-PointsKO-Adjacents,143
Syzygium_latifolium,1,1,0,Points-PointsKO-Adjacents,9
Syzygium_laurifolium,0,0,0,NA,0
Syzygium_laxiflorum,1,0,1,Points-PointsKO-Adjacents,9
Syzygium_lecardii,16,7,9,Points-PointsKO-Adjacents,73
Syzygium_lehuntii,0,0,0,NA,0
Syzygium_lenbrassii,3,3,0,Points-PointsKO-Adjacents,12
Syzygium_leonhardii,2,2,0,Points-PointsKO-Adjacents,18
Syzygium_leptoneurum,8,3,5,Points-PointsKO-Adjacents,42
Syzygium_leptophlebium,1,1,0,Points-PointsKO-Adjacents,8
Syzygium_leptopodium,43,32,11,Alphahull-PointsKO-Adjacents,220
Syzygium_leptostemon,20,5,15,Points-PointsKO-Adjacents,145
Syzygium_leucanthum,0,0,0,NA,0
Syzygium_leucocladum,0,0,0,NA,0
Syzygium_leucoxylon,10,2,8,Points-PointsKO-Adjacents,73
Syzygium_levinei,21,6,15,Points-PointsKO-Adjacents,178
Syzygium_lewisii,NA,NA,NA,NA,NA
Syzygium_leytense,0,0,0,NA,0
Syzygium_lifuanum,15,8,7,Points-PointsKO-Adjacents,76
Syzygium_lineatum,12,1,11,Points-PointsKO-Adjacents,105
Syzygium_linocieroideum,0,0,0,NA,0
Syzygium_littorale,1,1,0,Points-PointsKO-Adjacents,9
Syzygium_llanosii,0,0,0,NA,0
Syzygium_loiseleurioides,3,3,0,Points-PointsKO-Adjacents,27
Syzygium_longifolium,14,5,9,Points-PointsKO-Adjacents,77
Syzygium_longipedicellatum,0,0,0,NA,0
Syzygium_longipes,60,40,20,Alphahull-PointsKO-Adjacents,1877
Syzygium_longissimum,0,0,0,NA,0
Syzygium_longistylum,0,0,0,NA,0
Syzygium_lorentzianum,11,5,6,Points-PointsKO-Adjacents,36
Syzygium_lorofolium,1,1,0,Points-PointsKO-Adjacents,9
Syzygium_luehmannii,310,265,45,Alphahull-PointsKO-Adjacents,960
Syzygium_lugubre,5,5,0,Points-PointsKO-Adjacents,21
Syzygium_lunduense,1,1,0,Points-PointsKO-Adjacents,9
Syzygium_luteum,0,0,0,NA,0
Syzygium_luzonense,1,1,0,Points-PointsKO-Adjacents,9
Syzygium_macgregorii,0,0,0,NA,0
Syzygium_macilwraithianum,23,17,6,Points-PointsKO-Adjacents,48
Syzygium_mackinnonianum,28,0,28,Points-PointsKO-Adjacents,62
Syzygium_macranthum,77,61,16,Alphahull-PointsKO-Adjacents,195
Syzygium_macrocalyx,3,3,0,Points-PointsKO-Adjacents,18
Syzygium_macromyrtus,0,0,0,NA,0
Syzygium_madangense,2,2,0,Points-PointsKO-Adjacents,12
Syzygium_magnoliifolium,1,1,0,Points-PointsKO-Adjacents,9
Syzygium_maingayi,0,0,0,NA,0
Syzygium_mainitense,1,1,0,Points-PointsKO-Adjacents,9
Syzygium_maire,285,249,36,Alphahull-PointsKO-Adjacents,1333
Syzygium_makul,1,1,0,Points-PointsKO-Adjacents,9
Syzygium_malabaricum,0,0,0,NA,0
Syzygium_malaccense,113,77,36,Alphahull-PointsKO-Adjacents,2854
Syzygium_malagsam,0,0,0,NA,0
Syzygium_mamillatum,0,0,0,NA,0
Syzygium_mananquil,2,2,0,Points-PointsKO-Adjacents,17
Syzygium_manii,1,0,1,Points-PointsKO-Adjacents,9
Syzygium_marginatum,NA,NA,NA,NA,NA
Syzygium_martelinoi,0,0,0,NA,0
Syzygium_masukuense,11,2,9,Points-PointsKO-Adjacents,96
Syzygium_mauritianum,0,0,0,NA,0
Syzygium_mauritsii,0,0,0,NA,0
Syzygium_medium,1,1,0,Points-PointsKO-Adjacents,9
Syzygium_megalanthum,1,1,0,Points-PointsKO-Adjacents,8
Syzygium_megalospermum,12,2,10,Points-PointsKO-Adjacents,84
Syzygium_megistophyllum,7,1,6,Points-PointsKO-Adjacents,39
Syzygium_melanophilum,NA,NA,NA,NA,NA
Syzygium_melanostictum,0,0,0,NA,0
Syzygium_melliodorum,0,0,0,NA,0
Syzygium_meorianum,4,4,0,Points-PointsKO-Adjacents,18
Syzygium_merokense,1,1,0,Points-PointsKO-Adjacents,9
Syzygium_merrittianum,0,0,0,NA,0
Syzygium_micans,3,3,0,Points-PointsKO-Adjacents,24
Syzygium_micklethwaitii,32,25,7,Alphahull-PointsKO-Adjacents,361
Syzygium_micrandrum,1,1,0,Points-PointsKO-Adjacents,9
Syzygium_micranthum,0,0,0,NA,0
Syzygium_microcymum,0,0,0,NA,0
Syzygium_microphyllum,0,0,0,NA,0
Syzygium_micropodum,41,13,28,Points-PointsKO-Adjacents,228
Syzygium_millsii,1,1,0,Points-PointsKO-Adjacents,9
Syzygium_mimicum,0,0,0,NA,0
Syzygium_mindorense,0,0,0,NA,0
Syzygium_minus,NA,NA,NA,NA,NA
Syzygium_minutiflorum,0,0,0,NA,0
Syzygium_minutuliflorum,308,277,31,Alphahull-PointsKO-Adjacents,1728
Syzygium_mirabile,0,0,0,NA,0
Syzygium_mirandae,0,0,0,NA,0
Syzygium_mishmiense,0,0,0,NA,0
Syzygium_monetarium,0,0,0,NA,0
Syzygium_monimioides,10,7,3,Points-PointsKO-Adjacents,18
Syzygium_monospermum,27,19,8,Points-PointsKO-Adjacents,56
Syzygium_monticola,0,0,0,NA,0
Syzygium_montis-adam,NA,NA,NA,NA,NA
Syzygium_moorei,263,0,263,Points-PointsKO-Adjacents,91
Syzygium_mouanum,33,18,15,Points-PointsKO-Adjacents,143
Syzygium_moultonii,0,0,0,NA,0
Syzygium_muelleri,2,0,2,Points-PointsKO-Adjacents,18
Syzygium_multibracteolatum,0,0,0,NA,0
Syzygium_multiglandulosum,0,0,0,NA,0
Syzygium_multinerve,1,1,0,Points-PointsKO-Adjacents,9
Syzygium_multipetalum,54,40,14,Alphahull-PointsKO-Adjacents,97
Syzygium_multipuncticulatum,0,0,0,NA,0
Syzygium_mundagam,0,0,0,NA,0
Syzygium_munronii,1,1,0,Points-PointsKO-Adjacents,9
Syzygium_myhendrae,1,1,0,Points-PointsKO-Adjacents,9
Syzygium_myriadenum,7,0,7,Points-PointsKO-Adjacents,57
Syzygium_myrianthum,0,0,0,NA,0
Syzygium_myrsinifolium,8,0,8,Points-PointsKO-Adjacents,63
Syzygium_myrtifolium,1,1,0,Points-PointsKO-Adjacents,9
Syzygium_myrtilloides,1,1,0,Points-PointsKO-Adjacents,9
Syzygium_myrtillus,0,0,0,NA,0
Syzygium_myrtoides,1,1,0,Points-PointsKO-Adjacents,9
Syzygium_naiadum,8,3,5,Points-PointsKO-Adjacents,38
Syzygium_nandarivatense,0,0,0,NA,0
Syzygium_nanpingense,NA,NA,NA,NA,NA
Syzygium_napiforme,2,0,2,Points-PointsKO-Adjacents,18
Syzygium_neesianum,0,0,0,NA,0
Syzygium_nemorale,17,2,15,Points-PointsKO-Adjacents,102
Syzygium_neocaledonicum,29,19,10,Points-PointsKO-Adjacents,101
Syzygium_neriifolium,0,0,0,NA,0
Syzygium_nervosum,335,266,69,Alphahull-PointsKO-Adjacents,4297
Syzygium_neurocalyx,4,4,0,Points-PointsKO-Adjacents,18
Syzygium_neurophyllum,NA,NA,NA,NA,NA
Syzygium_ngadimanianum,0,0,0,NA,0
Syzygium_nicobaricum,0,0,0,NA,0
Syzygium_nidie,3,3,0,Points-PointsKO-Adjacents,15
Syzygium_nigrans,0,0,0,NA,0
Syzygium_nigricans,3,1,2,Points-PointsKO-Adjacents,27
Syzygium_nigropunctatum,0,0,0,NA,0
Syzygium_nitens,0,0,0,NA,0
Syzygium_nitidulum,0,0,0,NA,0
Syzygium_nitidum,2,2,0,Points-PointsKO-Adjacents,11
Syzygium_nitrasirirakii,NA,NA,NA,NA,NA
Syzygium_nomoa,7,1,6,Points-PointsKO-Adjacents,47
Syzygium_normanbiensc,7,3,4,Points-PointsKO-Adjacents,32
Syzygium_novoguineense,0,0,0,NA,0
Syzygium_nummularium,0,0,0,NA,0
Syzygium_nutans,26,11,15,Points-PointsKO-Adjacents,164
Syzygium_oblanceolatum,4,4,0,Points-PointsKO-Adjacents,36
Syzygium_oblancilimbum,1,1,0,Points-PointsKO-Adjacents,9
Syzygium_oblatum,7,0,7,Points-PointsKO-Adjacents,50
Syzygium_obliquinervium,0,0,0,NA,0
Syzygium_oblongifolium,0,0,0,NA,0
Syzygium_occidentale,0,0,0,NA,0
Syzygium_occlusum,0,0,0,NA,0
Syzygium_odoardoi,0,0,0,NA,0
Syzygium_odoratum,7,2,5,Points-PointsKO-Adjacents,63
Syzygium_oleosum,1033,927,106,Alphahull-PointsKO-Adjacents,2678
Syzygium_oligadelphum,1,1,0,Points-PointsKO-Adjacents,9
Syzygium_oliganthum,1,1,0,Points-PointsKO-Adjacents,9
Syzygium_oligomyrum,4,1,3,Points-PointsKO-Adjacents,36
Syzygium_onesimum,4,4,0,Points-PointsKO-Adjacents,26
Syzygium_onivense,9,4,5,Points-PointsKO-Adjacents,24
Syzygium_orites,0,0,0,NA,0
Syzygium_orthoneurum,NA,NA,NA,NA,NA
Syzygium_ovale,NA,NA,NA,NA,NA
Syzygium_ovalifolium,1,1,0,Points-PointsKO-Adjacents,9
Syzygium_owariense,123,84,39,Alphahull-PointsKO-Adjacents,1305
Syzygium_oxyphyllum,0,0,0,NA,0
Syzygium_pachyanthum,0,0,0,NA,0
Syzygium_pachycladum,22,13,9,Points-PointsKO-Adjacents,125
Syzygium_pachyphyllum,3,3,0,Points-PointsKO-Adjacents,18
Syzygium_pachyrrachis,0,0,0,NA,0
Syzygium_pachysarcum,1,1,0,Points-PointsKO-Adjacents,9
Syzygium_pachysepalum,1,1,0,Points-PointsKO-Adjacents,9
Syzygium_pahangense,0,0,0,NA,0
Syzygium_palauense,0,0,0,NA,0
Syzygium_palawanense,2,2,0,Points-PointsKO-Adjacents,18
Syzygium_palghatense,0,0,0,NA,0
Syzygium_pallens,6,3,3,Points-PointsKO-Adjacents,36
Syzygium_pallidilimbum,0,0,0,NA,0
Syzygium_pallidulum,0,0,0,NA,0
Syzygium_pallidum,0,0,0,NA,0
Syzygium_paludosum,NA,NA,NA,NA,NA
Syzygium_panayense,0,0,0,NA,0
Syzygium_pancheri,64,49,15,Alphahull-PointsKO-Adjacents,189
Syzygium_panduriforme,0,0,0,NA,0
Syzygium_paniculatum,277,182,95,Alphahull-PointsKO-Adjacents,791
Syzygium_paniense,16,8,8,Points-PointsKO-Adjacents,51
Syzygium_panzeri,1,1,0,Points-PointsKO-Adjacents,9
Syzygium_papillosum,1,1,0,Points-PointsKO-Adjacents,9
Syzygium_papyraceum,78,68,10,Alphahull-PointsKO-Adjacents,154
Syzygium_paradoxum,0,0,0,NA,0
Syzygium_paraiense,2,1,1,Points-PointsKO-Adjacents,18
Syzygium_parameswaranii,NA,NA,NA,NA,NA
Syzygium_parkeri,42,23,19,Alphahull-PointsKO-Adjacents,201
Syzygium_parvifolium,8,3,5,Points-PointsKO-Adjacents,56
Syzygium_parvulum,8,5,3,Points-PointsKO-Adjacents,42
Syzygium_pascasioii,0,0,0,NA,0
Syzygium_patens,0,0,0,NA,0
Syzygium_patentinerve,1,1,0,Points-PointsKO-Adjacents,9
Syzygium_paucipunctatum,0,0,0,NA,0
Syzygium_paucivenium,8,5,3,Points-PointsKO-Adjacents,16
Syzygium_pauper,0,0,0,NA,0
Syzygium_peekelii,NA,NA,NA,NA,NA
Syzygium_pellucidum,0,0,0,NA,0
Syzygium_penasii,0,0,0,NA,0
Syzygium_pendens,0,0,0,NA,0
Syzygium_pendulinum,0,0,0,NA,0
Syzygium_penibukanense,1,1,0,Points-PointsKO-Adjacents,9
Syzygium_pennelii,3,3,0,Points-PointsKO-Adjacents,22
Syzygium_peregrinum,1,0,1,Points-PointsKO-Adjacents,9
Syzygium_pergamaceum,17,5,12,Points-PointsKO-Adjacents,93
Syzygium_pergamentaceum,0,0,0,NA,0
Syzygium_periyarensis,NA,NA,NA,NA,NA
Syzygium_perryae,0,0,0,NA,0
Syzygium_perspicuinervium,1,1,0,Points-PointsKO-Adjacents,9
Syzygium_petakense,0,0,0,NA,0
Syzygium_petraeum,0,0,0,NA,0
Syzygium_petrophilum,1,1,0,Points-PointsKO-Adjacents,9
Syzygium_phacelanthum,NA,NA,NA,NA,NA
Syzygium_phaeophyllum,1,1,0,Points-PointsKO-Adjacents,9
Syzygium_phaeostictum,7,0,7,Points-PointsKO-Adjacents,42
Syzygium_phanerophlebium,0,0,0,NA,0
Syzygium_phengklaii,0,0,0,NA,0
Syzygium_philippinense,1,1,0,Points-PointsKO-Adjacents,9
Syzygium_phillyreifolium,21,8,13,Points-PointsKO-Adjacents,123
Syzygium_phryganodes,0,0,0,NA,0
Syzygium_pierrei,2,2,0,Points-PointsKO-Adjacents,18
Syzygium_pilgerianum,NA,NA,NA,NA,NA
Syzygium_piluliferum,0,0,0,NA,0
Syzygium_platycarpum,1,1,0,Points-PointsKO-Adjacents,9
Syzygium_platypodum,5,5,0,Points-PointsKO-Adjacents,36
Syzygium_plumbeum,0,0,0,NA,0
Syzygium_plumeum,19,9,10,Points-PointsKO-Adjacents,87
Syzygium_pluviatile,6,0,6,Points-PointsKO-Adjacents,27
Syzygium_polisense,0,0,0,NA,0
Syzygium_politum,2,2,0,Points-PointsKO-Adjacents,12
Syzygium_polyanthum,12,1,11,Points-PointsKO-Adjacents,96
Syzygium_polycephaloides,6,1,5,Points-PointsKO-Adjacents,43
Syzygium_polycephalum,3,3,0,Points-PointsKO-Adjacents,21
Syzygium_polypetaloideum,7,0,7,Points-PointsKO-Adjacents,63
Syzygium_polypetalum,0,0,0,NA,0
Syzygium_polyphlebium,NA,NA,NA,NA,NA
Syzygium_pondoense,8,1,7,Points-PointsKO-Adjacents,41
Syzygium_pontianakense,0,0,0,NA,0
Syzygium_populifolium,0,0,0,NA,0
Syzygium_porphyranthum,0,0,0,NA,0
Syzygium_porphyrocarpum,24,8,16,Points-PointsKO-Adjacents,110
Syzygium_potamicum,NA,NA,NA,NA,NA
Syzygium_poyanum,5,5,0,Points-PointsKO-Adjacents,20
Syzygium_praecox,1,1,0,Points-PointsKO-Adjacents,9
Syzygium_praestantilimbum,NA,NA,NA,NA,NA
Syzygium_praestigiosum,NA,NA,NA,NA,NA
Syzygium_praetermissum,0,0,0,NA,0
Syzygium_praineanum,1,1,0,Points-PointsKO-Adjacents,9
Syzygium_prasiniflorum,1,0,1,Points-PointsKO-Adjacents,9
Syzygium_pringlei,14,9,5,Points-PointsKO-Adjacents,55
Syzygium_propinquum,6,3,3,Points-PointsKO-Adjacents,35
Syzygium_pseudocalcicola,0,0,0,NA,0
Syzygium_pseudoclaviflorum,0,0,0,NA,0
Syzygium_pseudofastigiatum,43,31,12,Alphahull-PointsKO-Adjacents,91
Syzygium_pseudolaetum,0,0,0,NA,0
Syzygium_pseudomalaccense,1,1,0,Points-PointsKO-Adjacents,8
Syzygium_pseudomolle,1,0,1,Points-PointsKO-Adjacents,9
Syzygium_pseudopinnatum,7,3,4,Points-PointsKO-Adjacents,47
Syzygium_pterocalyx,6,0,6,Points-PointsKO-Adjacents,35
Syzygium_pterocarpum,NA,NA,NA,NA,NA
Syzygium_pterophorum,1,0,1,Points-PointsKO-Adjacents,9
Syzygium_pteropodum,9,1,8,Points-PointsKO-Adjacents,59
Syzygium_puberulum,47,26,21,Alphahull-PointsKO-Adjacents,247
Syzygium_pulaiense,NA,NA,NA,NA,NA
Syzygium_pulgarense,0,0,0,NA,0
Syzygium_pullei,0,0,0,NA,0
Syzygium_punctilimbum,5,0,5,Points-PointsKO-Adjacents,36
Syzygium_purpureum,0,0,0,NA,0
Syzygium_purpuricarpum,1,1,0,Points-PointsKO-Adjacents,9
Syzygium_purpuriflorum,0,0,0,NA,0
Syzygium_pustulatum,3,1,2,Points-PointsKO-Adjacents,21
Syzygium_putii,0,0,0,NA,0
Syzygium_pycnanthum,22,3,19,Points-PointsKO-Adjacents,165
Syzygium_pyrifolium,2,2,0,Points-PointsKO-Adjacents,9
Syzygium_pyriforme,6,1,5,Points-PointsKO-Adjacents,50
Syzygium_pyrocarpum,13,4,9,Points-PointsKO-Adjacents,40
Syzygium_pyrrophloeum,NA,NA,NA,NA,NA
Syzygium_quadrangulare,22,7,15,Points-PointsKO-Adjacents,71
Syzygium_quadrangulatum,0,0,0,NA,0
Syzygium_quadratum,1,1,0,Points-PointsKO-Adjacents,9
Syzygium_quadrialatum,0,0,0,NA,0
Syzygium_quadribracteatum,0,0,0,NA,0
Syzygium_quadricostatum,NA,NA,NA,NA,NA
Syzygium_racemosum,10,1,9,Points-PointsKO-Adjacents,84
Syzygium_rama-varmae,0,0,0,NA,0
Syzygium_rambutyense,1,1,0,Points-PointsKO-Adjacents,8
Syzygium_ramiflorum,1,1,0,Points-PointsKO-Adjacents,9
Syzygium_ramilepis,9,5,4,Points-PointsKO-Adjacents,26
Syzygium_ramosii,0,0,0,NA,0
Syzygium_ramosissimum,1,0,1,Points-PointsKO-Adjacents,9
Syzygium_rampans,0,0,0,NA,0
Syzygium_randianum,0,0,0,NA,0
Syzygium_rechingeri,0,0,0,NA,0
Syzygium_recurvovenosum,1,1,0,Points-PointsKO-Adjacents,8
Syzygium_refertum,0,0,0,NA,0
Syzygium_rehderianum,31,15,16,Points-PointsKO-Adjacents,279
Syzygium_rejangense,2,2,0,Points-PointsKO-Adjacents,18
Syzygium_remotifolium,1,0,1,Points-PointsKO-Adjacents,9
Syzygium_resa,130,113,17,Alphahull-PointsKO-Adjacents,584
Syzygium_reticulatum,0,0,0,NA,0
Syzygium_retinervium,0,0,0,NA,0
Syzygium_revolutum,2,2,0,Points-PointsKO-Adjacents,18
Syzygium_rhizophorum,NA,NA,NA,NA,NA
Syzygium_rhomboideum,0,0,0,NA,0
Syzygium_rhopalanthum,50,43,7,Alphahull-PointsKO-Adjacents,69
Syzygium_richardsonianum,34,14,20,Points-PointsKO-Adjacents,181
Syzygium_richii,4,2,2,Points-PointsKO-Adjacents,29
Syzygium_ridleyi,2,0,2,Points-PointsKO-Adjacents,12
Syzygium_ridsdalei,2,2,0,Points-PointsKO-Adjacents,18
Syzygium_rigens,0,0,0,NA,0
Syzygium_rigidifolium,0,0,0,NA,0
Syzygium_riparium,NA,NA,NA,NA,NA
Syzygium_ripicola,3,3,0,Points-PointsKO-Adjacents,27
Syzygium_rizalense,0,0,0,NA,0
Syzygium_robbinsii,4,4,0,Points-PointsKO-Adjacents,33
Syzygium_robertii,0,0,0,NA,0
Syzygium_robinsonii,0,0,0,NA,0
Syzygium_robustum,0,0,0,NA,0
Syzygium_rockii,0,0,0,NA,0
Syzygium_roemeri,4,4,0,Points-PointsKO-Adjacents,36
Syzygium_rolfei,0,0,0,NA,0
Syzygium_rosaceum,5,5,0,Points-PointsKO-Adjacents,33
Syzygium_rosenbluthii,2,2,0,Points-PointsKO-Adjacents,18
Syzygium_roseomarginatum,0,0,0,NA,0
Syzygium_roseum,2,2,0,Points-PointsKO-Adjacents,18
Syzygium_rostadonis,0,0,0,NA,0
Syzygium_rostratum,0,0,0,NA,0
Syzygium_rosulentum,3,0,3,Points-PointsKO-Adjacents,21
Syzygium_rotundifolium,3,3,0,Points-PointsKO-Adjacents,27
Syzygium_rowlandii,45,16,29,Points-PointsKO-Adjacents,290
Syzygium_rubens,0,0,0,NA,0
Syzygium_rubescens,1,1,0,Points-PointsKO-Adjacents,9
Syzygium_rubicundum,2,2,0,Points-PointsKO-Adjacents,18
Syzygium_rubrimolle,10,7,3,Points-PointsKO-Adjacents,37
Syzygium_rubropunctatum,1,1,0,Points-PointsKO-Adjacents,9
Syzygium_rubropurpureum,0,0,0,NA,0
Syzygium_rubrovenium,0,0,0,NA,0
Syzygium_rugosum,0,0,0,NA,0
Syzygium_rumphii,0,0,0,NA,0
Syzygium_rysopodum,3,3,0,Points-PointsKO-Adjacents,27
Syzygium_sabangense,4,4,0,Points-PointsKO-Adjacents,30
Syzygium_sakalavarum,51,32,19,Alphahull-PointsKO-Adjacents,1319
Syzygium_salicifolium,1,0,1,Points-PointsKO-Adjacents,9
Syzygium_saliciforme,2,2,0,Points-PointsKO-Adjacents,18
Syzygium_salicinum,6,1,5,Points-PointsKO-Adjacents,44
Syzygium_salictoides,1,1,0,Points-PointsKO-Adjacents,9
Syzygium_salignum,0,0,0,NA,0
Syzygium_salomonense,0,0,0,NA,0
Syzygium_salpinganthum,1,1,0,Points-PointsKO-Adjacents,9
Syzygium_salwinense,4,4,0,Points-PointsKO-Adjacents,36
Syzygium_samarangense,50,0,50,Points-PointsKO-Adjacents,279
Syzygium_sambiranense,0,0,0,NA,0
Syzygium_sambogense,5,5,0,Points-PointsKO-Adjacents,21
Syzygium_samoense,3,3,0,Points-PointsKO-Adjacents,19
Syzygium_sandwicense,11,7,4,Points-PointsKO-Adjacents,45
Syzygium_santosii,0,0,0,NA,0
Syzygium_sarmentosum,5,5,0,Points-PointsKO-Adjacents,10
Syzygium_savaiiense,8,3,5,Points-PointsKO-Adjacents,25
Syzygium_saxatile,NA,NA,NA,NA,NA
Syzygium_sayeri,114,88,26,Alphahull-PointsKO-Adjacents,323
Syzygium_scalarinerve,0,0,0,NA,0
Syzygium_schlechteri,NA,NA,NA,NA,NA
Syzygium_schlechterianum,5,5,0,Points-PointsKO-Adjacents,27
Syzygium_schmidii,0,0,0,NA,0
Syzygium_schumannianum,8,1,7,Points-PointsKO-Adjacents,59
Syzygium_schwenckii,NA,NA,NA,NA,NA
Syzygium_sclerophyllum,1,0,1,Points-PointsKO-Adjacents,9
Syzygium_scolopophyllum,NA,NA,NA,NA,NA
Syzygium_scortechinii,7,1,6,Points-PointsKO-Adjacents,60
Syzygium_scytophyllum,0,0,0,NA,0
Syzygium_seemannianum,2,2,0,Points-PointsKO-Adjacents,12
Syzygium_seemannii,0,0,0,NA,0
Syzygium_selukaifolium,0,0,0,NA,0
Syzygium_sessililimbum,0,0,0,NA,0
Syzygium_setosum,2,1,1,Points-PointsKO-Adjacents,18
Syzygium_sexangulatum,4,3,1,Points-PointsKO-Adjacents,27
Syzygium_siamense,4,0,4,Points-PointsKO-Adjacents,34
Syzygium_sichuanense,NA,NA,NA,NA,NA
Syzygium_siderocola,0,0,0,NA,0
Syzygium_silamense,0,0,0,NA,0
Syzygium_simile,7,3,4,Points-PointsKO-Adjacents,31
Syzygium_simillimum,0,0,0,NA,0
Syzygium_singaporense,2,1,1,Points-PointsKO-Adjacents,18
Syzygium_skiophilum,1,1,0,Points-PointsKO-Adjacents,9
Syzygium_slootenii,0,0,0,NA,0
Syzygium_smalianum,0,0,0,NA,0
Syzygium_smithii,4764,4384,380,Alphahull-PointsKO-Adjacents,6118
Syzygium_soepadmoi,NA,NA,NA,NA,NA
Syzygium_sogerense,4,4,0,Points-PointsKO-Adjacents,21
Syzygium_sorongense,2,2,0,Points-PointsKO-Adjacents,18
Syzygium_spathulatum,0,0,0,NA,0
Syzygium_speciosissimum,0,0,0,NA,0
Syzygium_spectabile,0,0,0,NA,0
Syzygium_splendens,0,0,0,NA,0
Syzygium_squamatum,0,0,0,NA,0
Syzygium_squamiferum,0,0,0,NA,0
Syzygium_sriganesanii,0,0,0,NA,0
Syzygium_stapfianum,0,0,0,NA,0
Syzygium_staudtii,105,70,35,Alphahull-PointsKO-Adjacents,2221
Syzygium_steenisii,4,3,1,Points-PointsKO-Adjacents,36
Syzygium_stelechanthum,3,3,0,Points-PointsKO-Adjacents,12
Syzygium_stenocladum,1,1,0,Points-PointsKO-Adjacents,9
Syzygium_stenurum,0,0,0,NA,0
Syzygium_sterrophyllum,8,1,7,Points-PointsKO-Adjacents,72
Syzygium_stipitatum,0,0,0,NA,0
Syzygium_stipulare,3,3,0,Points-PointsKO-Adjacents,23
Syzygium_stocksii,0,0,0,NA,0
Syzygium_striatulum,0,0,0,NA,0
Syzygium_subalatum,70,50,20,Alphahull-PointsKO-Adjacents,1061
Syzygium_subamplexicaule,1,1,0,Points-PointsKO-Adjacents,9
Syzygium_subcapitulatum,0,0,0,NA,0
Syzygium_subcaudatum,1,1,0,Points-PointsKO-Adjacents,9
Syzygium_subcorymbosum,50,0,50,Points-PointsKO-Adjacents,213
Syzygium_subcrenatum,2,2,0,Points-PointsKO-Adjacents,9
Syzygium_subdecussatum,3,3,0,Points-PointsKO-Adjacents,21
Syzygium_subfalcatum,0,0,0,NA,0
Syzygium_subfoetidum,0,0,0,NA,0
Syzygium_subglobosum,2,2,0,Points-PointsKO-Adjacents,9
Syzygium_subhorizontale,0,0,0,NA,0
Syzygium_subisense,0,0,0,NA,0
Syzygium_subnodosum,NA,NA,NA,NA,NA
Syzygium_suborbiculare,789,724,65,Alphahull-PointsKO-Adjacents,5208
Syzygium_subscandens,NA,NA,NA,NA,NA
Syzygium_subsessile,0,0,0,NA,0
Syzygium_subsessiliflorum,0,0,0,NA,0
Syzygium_subsessilifolium,1,0,1,Points-PointsKO-Adjacents,9
Syzygium_subsimile,0,0,0,NA,0
Syzygium_subtile,0,0,0,NA,0
Syzygium_sulcistylum,0,0,0,NA,0
Syzygium_sulitii,0,0,0,NA,0
Syzygium_sulphuratum,0,0,0,NA,0
Syzygium_surigaense,0,0,0,NA,0
Syzygium_suringarianum,0,0,0,NA,0
Syzygium_swettenhamianum,1,1,0,Points-PointsKO-Adjacents,9
Syzygium_sylvicola,13,1,12,Points-PointsKO-Adjacents,67
Syzygium_symingtonianum,1,1,0,Points-PointsKO-Adjacents,9
Syzygium_synaptoneurum,0,0,0,NA,0
Syzygium_syzygioides,10,1,9,Points-PointsKO-Adjacents,81
Syzygium_szemaoense,10,0,10,Points-PointsKO-Adjacents,90
Syzygium_taeniatum,12,3,9,Points-PointsKO-Adjacents,64
Syzygium_tahanense,0,0,0,NA,0
Syzygium_taipingense,0,0,0,NA,0
Syzygium_taiwanicum,4,4,0,Points-PointsKO-Adjacents,6
Syzygium_tapiaka,2,2,0,Points-PointsKO-Adjacents,18
Syzygium_tawahense,5,0,5,Points-PointsKO-Adjacents,39
Syzygium_tayabense,0,0,0,NA,0
Syzygium_taytayense,1,1,0,Points-PointsKO-Adjacents,8
Syzygium_tchambaense,1,1,0,Points-PointsKO-Adjacents,9
Syzygium_tectum,0,0,0,NA,0
Syzygium_tekuense,0,0,0,NA,0
Syzygium_tenellum,NA,NA,NA,NA,NA
Syzygium_tenuicaudatum,0,0,0,NA,0
Syzygium_tenuiflorum,4,4,0,Points-PointsKO-Adjacents,27
Syzygium_tenuifolium,0,0,0,NA,0
Syzygium_tenuilimbum,NA,NA,NA,NA,NA
Syzygium_tenuipes,0,0,0,NA,0
Syzygium_tenuirame,0,0,0,NA,0
Syzygium_tenuirhachis,NA,NA,NA,NA,NA
Syzygium_tephrodes,6,0,6,Points-PointsKO-Adjacents,45
Syzygium_teretiflorum,NA,NA,NA,NA,NA
Syzygium_tesselatum,NA,NA,NA,NA,NA
Syzygium_tetragonum,25,8,17,Points-PointsKO-Adjacents,217
Syzygium_tetrapleurum,0,0,0,NA,0
Syzygium_tetrapterum,3,2,1,Points-PointsKO-Adjacents,18
Syzygium_thalassicum,0,0,0,NA,0
Syzygium_thompsonii,1,0,1,Points-PointsKO-Adjacents,8
Syzygium_thomsenii,0,0,0,NA,0
Syzygium_thorelii,0,0,0,NA,0
Syzygium_thornei,11,4,7,Points-PointsKO-Adjacents,60
Syzygium_thumra,2,2,0,Points-PointsKO-Adjacents,18
Syzygium_tierneyanum,553,0,553,Points-PointsKO-Adjacents,1539
Syzygium_timorianum,NA,NA,NA,NA,NA
Syzygium_tiumanense,1,1,0,Points-PointsKO-Adjacents,6
Syzygium_toddalioides,0,0,0,NA,0
Syzygium_tolypanthum,NA,NA,NA,NA,NA
Syzygium_toninense,29,19,10,Points-PointsKO-Adjacents,101
Syzygium_tonkinense,3,3,0,Points-PointsKO-Adjacents,27
Syzygium_tontoutaense,2,2,0,Points-PointsKO-Adjacents,17
Syzygium_toppingii,0,0,0,NA,0
Syzygium_torricellianum,0,0,0,NA,0
Syzygium_trachyanthum,24,7,17,Points-PointsKO-Adjacents,112
Syzygium_trachyphloium,97,86,11,Alphahull-PointsKO-Adjacents,154
Syzygium_travancoricum,0,0,0,NA,0
Syzygium_treubii,0,0,0,NA,0
Syzygium_trianthum,0,0,0,NA,0
Syzygium_trichotomum,2,2,0,Points-PointsKO-Adjacents,12
Syzygium_tricolor,NA,NA,NA,NA,NA
Syzygium_tripetalum,26,14,12,Points-PointsKO-Adjacents,90
Syzygium_triphlebium,6,3,3,Points-PointsKO-Adjacents,43
Syzygium_triphyllum,0,0,0,NA,0
Syzygium_tripinnatum,5,5,0,Points-PointsKO-Adjacents,6
Syzygium_triplinervium,NA,NA,NA,NA,NA
Syzygium_triste,0,0,0,NA,0
Syzygium_trivene,64,43,21,Alphahull-PointsKO-Adjacents,824
Syzygium_tsoongii,7,0,7,Points-PointsKO-Adjacents,57
Syzygium_tubiflorum,NA,NA,NA,NA,NA
Syzygium_tula,0,0,0,NA,0
Syzygium_turbinatum,0,0,0,NA,0
Syzygium_tympananthum,5,4,1,Points-PointsKO-Adjacents,37
Syzygium_ultramaficum,0,0,0,NA,0
Syzygium_umbellatum,NA,NA,NA,NA,NA
Syzygium_umbilicatum,1,1,0,Points-PointsKO-Adjacents,9
Syzygium_umbrosum,0,0,0,NA,0
Syzygium_uniflorum,1,1,0,Points-PointsKO-Adjacents,9
Syzygium_unipunctatum,111,0,111,Points-PointsKO-Adjacents,237
Syzygium_urceolatum,15,0,15,Points-PointsKO-Adjacents,115
Syzygium_urdanetense,0,0,0,NA,0
Syzygium_urophyllum,1,1,0,Points-PointsKO-Adjacents,9
Syzygium_utilis,0,0,0,NA,0
Syzygium_valdecoriaceum,NA,NA,NA,NA,NA
Syzygium_valdepunctatum,0,0,0,NA,0
Syzygium_valdevenosum,5,0,5,Points-PointsKO-Adjacents,43
Syzygium_valentissimum,NA,NA,NA,NA,NA
Syzygium_validinerve,2,2,0,Points-PointsKO-Adjacents,9
Syzygium_validum,NA,NA,NA,NA,NA
Syzygium_vanderwateri,NA,NA,NA,NA,NA
Syzygium_variabile,35,24,11,Alphahull-PointsKO-Adjacents,148
Syzygium_variifolium,0,0,0,NA,0
Syzygium_variolosum,3,2,1,Points-PointsKO-Adjacents,27
Syzygium_vaughanii,0,0,0,NA,0
Syzygium_vaupelii,0,0,0,NA,0
Syzygium_veillonii,0,0,0,NA,0
Syzygium_velae,14,8,6,Points-PointsKO-Adjacents,19
Syzygium_velutinum,1,1,0,Points-PointsKO-Adjacents,6
Syzygium_venosum,1,0,1,Points-PointsKO-Adjacents,9
Syzygium_venustum,0,0,0,NA,0
Syzygium_verniciflorum,9,1,8,Points-PointsKO-Adjacents,52
Syzygium_vernicosum,2,2,0,Points-PointsKO-Adjacents,18
Syzygium_vernonioides,0,0,0,NA,0
Syzygium_verrucosum,7,2,5,Points-PointsKO-Adjacents,47
Syzygium_versteegii,36,12,24,Points-PointsKO-Adjacents,221
Syzygium_vestitum,1,1,0,Points-PointsKO-Adjacents,9
Syzygium_viburnoides,3,3,0,Points-PointsKO-Adjacents,16
Syzygium_vidalianum,1,1,0,Points-PointsKO-Adjacents,9
Syzygium_villamilii,4,4,0,Points-PointsKO-Adjacents,33
Syzygium_villiferum,1,1,0,Points-PointsKO-Adjacents,9
Syzygium_virescens,0,0,0,NA,0
Syzygium_virotii,7,5,2,Points-PointsKO-Adjacents,19
Syzygium_vismioides,0,0,0,NA,0
Syzygium_vrieseanum,0,0,0,NA,0
Syzygium_vulcanicum,0,0,0,NA,0
Syzygium_wagapense,26,11,15,Points-PointsKO-Adjacents,127
Syzygium_waikaiunense,2,2,0,Points-PointsKO-Adjacents,8
Syzygium_walkeri,0,0,0,NA,0
Syzygium_warburgii,3,3,0,Points-PointsKO-Adjacents,27
Syzygium_waterhousei,7,0,7,Points-PointsKO-Adjacents,55
Syzygium_watsonianum,0,0,0,NA,0
Syzygium_watutense,1,1,0,Points-PointsKO-Adjacents,9
Syzygium_wenshanense,NA,NA,NA,NA,NA
Syzygium_wenzelii,0,0,0,NA,0
Syzygium_wesa,127,110,17,Alphahull-PointsKO-Adjacents,258
Syzygium_whitfordii,0,0,0,NA,0
Syzygium_williamsii,0,0,0,NA,0
Syzygium_wilsonii,108,0,108,Points-PointsKO-Adjacents,260
Syzygium_winckelii,0,0,0,NA,0
Syzygium_winitii,0,0,0,NA,0
Syzygium_wolfii,0,0,0,NA,0
Syzygium_wollastonii,1,1,0,Points-PointsKO-Adjacents,9
Syzygium_womersleyi,47,25,22,Alphahull-PointsKO-Adjacents,431
Syzygium_wrayi,0,0,0,NA,0
Syzygium_wrightii,1,1,0,Points-PointsKO-Adjacents,6
Syzygium_xanthophyllum,0,0,0,NA,0
Syzygium_xanthostemifolium,1,1,0,Points-PointsKO-Adjacents,9
Syzygium_xerampelinum,38,30,8,Alphahull-PointsKO-Adjacents,53
Syzygium_xiphophyllum,0,0,0,NA,0
Syzygium_xizangense,NA,NA,NA,NA,NA
Syzygium_xylopiaceum,6,0,6,Points-PointsKO-Adjacents,42
Syzygium_yunnanense,2,2,0,Points-PointsKO-Adjacents,18
Syzygium_zamboangense,0,0,0,NA,0
Syzygium_zeylanicum,3,0,3,Points-PointsKO-Adjacents,27
Syzygium_zhenghei,47,35,12,Alphahull-PointsKO-Adjacents,292
Syzygium_zimmermannii,1,0,1,Points-PointsKO-Adjacents,9
Syzygium_zollingerianum,1,0,1,Points-PointsKO-Adjacents,9
Tabebuia_acrophylla,32,24,8,Alphahull-PointsKO-Adjacents,242
Tabebuia_angustata,21,7,14,Points-PointsKO-Adjacents,155
Tabebuia_arimaoensis,2,2,0,Points-PointsKO-Adjacents,18
Tabebuia_aurea,1279,1159,120,Alphahull-PointsKO-Adjacents,53704
Tabebuia_bahamensis,18,3,15,Points-PointsKO-Adjacents,72
Tabebuia_berteroi,83,67,16,Alphahull-PointsKO-Adjacents,736
Tabebuia_bibracteolata,6,3,3,Points-PointsKO-Adjacents,30
Tabebuia_brooksiana,8,4,4,Points-PointsKO-Adjacents,72
Tabebuia_buchii,2,2,0,Points-PointsKO-Adjacents,10
Tabebuia_bullata,13,10,3,Points-PointsKO-Adjacents,60
Tabebuia_calcicola,14,5,9,Points-PointsKO-Adjacents,117
Tabebuia_cassinoides,108,1,107,Points-PointsKO-Adjacents,599
Tabebuia_conferta,4,4,0,Points-PointsKO-Adjacents,21
Tabebuia_crispiflora,6,2,4,Points-PointsKO-Adjacents,32
Tabebuia_densifolia,10,6,4,Points-PointsKO-Adjacents,74
Tabebuia_dubia,15,9,6,Points-PointsKO-Adjacents,67
Tabebuia_elegans,6,1,5,Points-PointsKO-Adjacents,33
Tabebuia_elliptica,145,94,51,Alphahull-PointsKO-Adjacents,1012
Tabebuia_elongata,0,0,0,NA,0
Tabebuia_fluviatilis,123,69,54,Alphahull-PointsKO-Adjacents,5087
Tabebuia_gemmiflora,19,0,19,Points-PointsKO-Adjacents,165
Tabebuia_haemantha,57,46,11,Alphahull-PointsKO-Adjacents,74
Tabebuia_heterophylla,221,0,221,Points-PointsKO-Adjacents,908
Tabebuia_hypoleuca,15,6,9,Points-PointsKO-Adjacents,83
Tabebuia_inaequipes,2,2,0,Points-PointsKO-Adjacents,18
Tabebuia_insignis,673,565,108,Alphahull-PointsKO-Adjacents,57671
Tabebuia_jackiana,1,1,0,Points-PointsKO-Adjacents,9
Tabebuia_karsoana,5,4,1,Points-PointsKO-Adjacents,20
Tabebuia_lepidota,17,4,13,Points-PointsKO-Adjacents,118
Tabebuia_leptoneura,23,11,12,Points-PointsKO-Adjacents,156
Tabebuia_linearis,5,5,0,Points-PointsKO-Adjacents,35
Tabebuia_maxonii,3,3,0,Points-PointsKO-Adjacents,14
Tabebuia_microphylla,21,11,10,Points-PointsKO-Adjacents,114
Tabebuia_moaensis,13,7,6,Points-PointsKO-Adjacents,51
Tabebuia_multinervis,1,1,0,Points-PointsKO-Adjacents,9
Tabebuia_myrtifolia,40,19,21,Points-PointsKO-Adjacents,206
Tabebuia_nodosa,95,66,29,Alphahull-PointsKO-Adjacents,5778
Tabebuia_obovata,17,5,12,Points-PointsKO-Adjacents,128
Tabebuia_obtusifolia,108,62,46,Alphahull-PointsKO-Adjacents,2466
Tabebuia_ophiolithica,4,4,0,Points-PointsKO-Adjacents,35
Tabebuia_orinocensis,42,35,7,Alphahull-PointsKO-Adjacents,410
Tabebuia_ovatifolia,0,0,0,NA,0
Tabebuia_pallida,18,10,8,Points-PointsKO-Adjacents,67
Tabebuia_palustris,63,37,26,Alphahull-PointsKO-Adjacents,398
Tabebuia_paniculata,4,3,1,Points-PointsKO-Adjacents,18
Tabebuia_pilosa,38,24,14,Alphahull-PointsKO-Adjacents,204
Tabebuia_pinetorum,2,2,0,Points-PointsKO-Adjacents,12
Tabebuia_platyantha,10,5,5,Points-PointsKO-Adjacents,62
Tabebuia_polymorpha,4,4,0,Points-PointsKO-Adjacents,26
Tabebuia_pulverulenta,5,5,0,Points-PointsKO-Adjacents,18
Tabebuia_reticulata,27,17,10,Points-PointsKO-Adjacents,195
Tabebuia_revoluta,8,4,4,Points-PointsKO-Adjacents,22
Tabebuia_ricardii,5,4,1,Points-PointsKO-Adjacents,28
Tabebuia_rigida,21,16,5,Points-PointsKO-Adjacents,38
Tabebuia_rosea,1081,974,107,Alphahull-PointsKO-Adjacents,29809
Tabebuia_roseoalba,767,659,108,Alphahull-PointsKO-Adjacents,42856
Tabebuia_sauvallei,8,1,7,Points-PointsKO-Adjacents,35
Tabebuia_schumanniana,29,26,3,Alphahull-PointsKO-Adjacents,43
Tabebuia_shaferi,8,2,6,Points-PointsKO-Adjacents,45
Tabebuia_stenocalyx,102,52,50,Alphahull-PointsKO-Adjacents,1103
Tabebuia_striata,9,3,6,Points-PointsKO-Adjacents,55
Tabebuia_trachycarpa,29,12,17,Points-PointsKO-Adjacents,194
Tabebuia_vinosa,14,8,6,Points-PointsKO-Adjacents,62
Tabebuia_zanonii,2,2,0,Points-PointsKO-Adjacents,12
Tabernaemontana_africana,196,159,37,Alphahull-PointsKO-Adjacents,5249
Tabernaemontana_alba,952,823,129,Alphahull-PointsKO-Adjacents,9289
Tabernaemontana_allenii,1,1,0,Points-PointsKO-Adjacents,9
Tabernaemontana_alternifolia,5,1,4,Points-PointsKO-Adjacents,45
Tabernaemontana_amplifolia,64,48,16,Alphahull-PointsKO-Adjacents,490
Tabernaemontana_amygdalifolia,692,0,692,Points-PointsKO-Adjacents,3333
Tabernaemontana_angulata,188,132,56,Alphahull-PointsKO-Adjacents,15655
Tabernaemontana_antheonycta,1,1,0,Points-PointsKO-Adjacents,9
Tabernaemontana_apoda,0,0,0,NA,0
Tabernaemontana_arborea,252,200,52,Alphahull-PointsKO-Adjacents,5163
Tabernaemontana_attenuata,36,15,21,Points-PointsKO-Adjacents,275
Tabernaemontana_aurantiaca,59,31,28,Alphahull-PointsKO-Adjacents,1067
Tabernaemontana_bovina,39,16,23,Points-PointsKO-Adjacents,274
Tabernaemontana_brachyantha,57,43,14,Alphahull-PointsKO-Adjacents,2227
Tabernaemontana_brasiliensis,6,0,6,Points-PointsKO-Adjacents,45
Tabernaemontana_bufalina,26,3,23,Points-PointsKO-Adjacents,195
Tabernaemontana_calcarea,79,64,15,Alphahull-PointsKO-Adjacents,570
Tabernaemontana_capuronii,4,4,0,Points-PointsKO-Adjacents,8
Tabernaemontana_catharinensis,1167,0,1167,Points-PointsKO-Adjacents,6549
Tabernaemontana_cerea,39,23,16,Alphahull-PointsKO-Adjacents,1085
Tabernaemontana_cerifera,23,11,12,Points-PointsKO-Adjacents,108
Tabernaemontana_ciliata,120,95,25,Alphahull-PointsKO-Adjacents,1537
Tabernaemontana_citrifolia,186,124,62,Alphahull-PointsKO-Adjacents,1359
Tabernaemontana_coffeoides,353,312,41,Alphahull-PointsKO-Adjacents,5416
Tabernaemontana_columbiensis,75,55,20,Alphahull-PointsKO-Adjacents,1306
Tabernaemontana_contorta,27,15,12,Points-PointsKO-Adjacents,152
Tabernaemontana_cordata,2,1,1,Points-PointsKO-Adjacents,18
Tabernaemontana_coriacea,120,64,56,Alphahull-PointsKO-Adjacents,6516
Tabernaemontana_corymbosa,41,11,30,Points-PointsKO-Adjacents,348
Tabernaemontana_crassa,245,191,54,Alphahull-PointsKO-Adjacents,6497
Tabernaemontana_crassifolia,32,18,14,Points-PointsKO-Adjacents,193
Tabernaemontana_cumata,6,1,5,Points-PointsKO-Adjacents,52
Tabernaemontana_cuspidata,40,18,22,Points-PointsKO-Adjacents,328
Tabernaemontana_cymosa,376,291,85,Alphahull-PointsKO-Adjacents,18376
Tabernaemontana_debrayi,10,0,10,Points-PointsKO-Adjacents,53
Tabernaemontana_dichotoma,1,0,1,Points-PointsKO-Adjacents,7
Tabernaemontana_disticha,88,64,24,Alphahull-PointsKO-Adjacents,1898
Tabernaemontana_divaricata,29,4,25,Points-PointsKO-Adjacents,261
Tabernaemontana_donnell-smithii,378,332,46,Alphahull-PointsKO-Adjacents,8720
Tabernaemontana_elegans,84,47,37,Alphahull-PointsKO-Adjacents,2285
Tabernaemontana_eubracteata,42,23,19,Alphahull-PointsKO-Adjacents,369
Tabernaemontana_eusepala,42,27,15,Alphahull-PointsKO-Adjacents,290
Tabernaemontana_eusepaloides,15,6,9,Points-PointsKO-Adjacents,93
Tabernaemontana_flavicans,431,287,144,Alphahull-PointsKO-Adjacents,25196
Tabernaemontana_gamblei,1,0,1,Points-PointsKO-Adjacents,9
Tabernaemontana_grandiflora,703,585,118,Alphahull-PointsKO-Adjacents,17689
Tabernaemontana_granulosa,1,1,0,Points-PointsKO-Adjacents,9
Tabernaemontana_hannae,3,3,0,Points-PointsKO-Adjacents,18
Tabernaemontana_heterophylla,715,615,100,Alphahull-PointsKO-Adjacents,63994
Tabernaemontana_humblotii,28,15,13,Points-PointsKO-Adjacents,148
Tabernaemontana_hystrix,422,360,62,Alphahull-PointsKO-Adjacents,9129
Tabernaemontana_laeta,439,0,439,Points-PointsKO-Adjacents,2555
Tabernaemontana_lagenaria,27,13,14,Points-PointsKO-Adjacents,234
Tabernaemontana_laurifolia,5,5,0,Points-PointsKO-Adjacents,32
Tabernaemontana_leeuwenbergiana,8,3,5,Points-PointsKO-Adjacents,49
Tabernaemontana_letestui,52,38,14,Alphahull-PointsKO-Adjacents,946
Tabernaemontana_linkii,157,104,53,Alphahull-PointsKO-Adjacents,11532
Tabernaemontana_litoralis,277,200,77,Alphahull-PointsKO-Adjacents,5206
Tabernaemontana_longipes,358,64,294,Alphahull-PointsKO-Adjacents,2739
Tabernaemontana_lorifera,39,23,16,Alphahull-PointsKO-Adjacents,956
Tabernaemontana_macrocalyx,357,285,72,Alphahull-PointsKO-Adjacents,32578
Tabernaemontana_macrocarpa,53,26,27,Alphahull-PointsKO-Adjacents,4301
Tabernaemontana_markgrafiana,202,0,202,Points-PointsKO-Adjacents,1416
Tabernaemontana_maxima,57,22,35,Alphahull-PointsKO-Adjacents,1271
Tabernaemontana_mocquerysi,56,37,19,Alphahull-PointsKO-Adjacents,620
Tabernaemontana_muricata,35,1,34,Points-PointsKO-Adjacents,242
Tabernaemontana_ochroleuca,1,1,0,Points-PointsKO-Adjacents,9
Tabernaemontana_odoratissima,18,9,9,Points-PointsKO-Adjacents,138
Tabernaemontana_oppositifolia,16,9,7,Points-PointsKO-Adjacents,68
Tabernaemontana_ovalifolia,1,1,0,Points-PointsKO-Adjacents,9
Tabernaemontana_pachysiphon,164,111,53,Alphahull-PointsKO-Adjacents,3954
Tabernaemontana_palustris,27,17,10,Points-PointsKO-Adjacents,149
Tabernaemontana_panamensis,132,112,20,Alphahull-PointsKO-Adjacents,1635
Tabernaemontana_pandacaqui,1770,1564,206,Alphahull-PointsKO-Adjacents,10516
Tabernaemontana_pauciflora,43,18,25,Points-PointsKO-Adjacents,352
Tabernaemontana_pauli,49,42,7,Alphahull-PointsKO-Adjacents,69
Tabernaemontana_peduncularis,16,3,13,Points-PointsKO-Adjacents,138
Tabernaemontana_penduliflora,81,50,31,Alphahull-PointsKO-Adjacents,2360
Tabernaemontana_persicariifolia,4,3,1,Points-PointsKO-Adjacents,25
Tabernaemontana_phymata,54,39,15,Alphahull-PointsKO-Adjacents,335
Tabernaemontana_polyneura,1,1,0,Points-PointsKO-Adjacents,9
Tabernaemontana_remota,4,4,0,Points-PointsKO-Adjacents,23
Tabernaemontana_retusa,85,56,29,Alphahull-PointsKO-Adjacents,1120
Tabernaemontana_robinsonii,186,155,31,Alphahull-PointsKO-Adjacents,1176
Tabernaemontana_rupicola,216,177,39,Alphahull-PointsKO-Adjacents,13992
Tabernaemontana_salomonensis,0,0,0,NA,0
Tabernaemontana_salzmannii,190,0,190,Points-PointsKO-Adjacents,1008
Tabernaemontana_sambiranensis,9,7,2,Points-PointsKO-Adjacents,50
Tabernaemontana_sananho,738,658,80,Alphahull-PointsKO-Adjacents,48714
Tabernaemontana_sessilifolia,44,26,18,Alphahull-PointsKO-Adjacents,450
Tabernaemontana_siphilitica,776,681,95,Alphahull-PointsKO-Adjacents,86144
Tabernaemontana_solanifolia,171,132,39,Alphahull-PointsKO-Adjacents,6769
Tabernaemontana_sphaerocarpa,15,4,11,Points-PointsKO-Adjacents,124
Tabernaemontana_stapfiana,67,40,27,Alphahull-PointsKO-Adjacents,899
Tabernaemontana_stellata,18,9,9,Points-PointsKO-Adjacents,98
Tabernaemontana_stenosiphon,7,3,4,Points-PointsKO-Adjacents,20
Tabernaemontana_thurstonii,0,0,0,NA,0
Tabernaemontana_tomentosa,197,162,35,Alphahull-PointsKO-Adjacents,2005
Tabernaemontana_undulata,728,616,112,Alphahull-PointsKO-Adjacents,35300
Tabernaemontana_vanheurckii,109,75,34,Alphahull-PointsKO-Adjacents,6539
Tabernaemontana_ventricosa,97,45,52,Alphahull-PointsKO-Adjacents,1415
Tabernaemontana_wullschlaegelii,7,2,5,Points-PointsKO-Adjacents,50
Tabernanthe_iboga,139,99,40,Alphahull-PointsKO-Adjacents,8851
Tacarcuna_amanoifolia,9,1,8,Points-PointsKO-Adjacents,81
Tacarcuna_gentryi,8,2,6,Points-PointsKO-Adjacents,37
Tacarcuna_tachirensis,2,2,0,Points-PointsKO-Adjacents,18
Tachia_grandiflora,13,5,8,Points-PointsKO-Adjacents,111
Tachia_grandifolia,59,41,18,Alphahull-PointsKO-Adjacents,2576
Tachia_occidentalis,127,94,33,Alphahull-PointsKO-Adjacents,4784
Tachia_parviflora,106,70,36,Alphahull-PointsKO-Adjacents,854
Tachia_siwertii,1,1,0,Points-PointsKO-Adjacents,9
Tachia_smithii,2,2,0,Points-PointsKO-Adjacents,18
Tachigali_alba,130,65,65,Alphahull-PointsKO-Adjacents,18817
Tachigali_albiflora,28,15,13,Points-PointsKO-Adjacents,213
Tachigali_amplifolia,21,0,21,Points-PointsKO-Adjacents,121
Tachigali_argyrophylla,4,4,0,Points-PointsKO-Adjacents,36
Tachigali_aurea,717,659,58,Alphahull-PointsKO-Adjacents,30456
Tachigali_barnebyi,10,0,10,Points-PointsKO-Adjacents,83
Tachigali_beaurepairei,8,5,3,Points-PointsKO-Adjacents,51
Tachigali_bicornuta,12,4,8,Points-PointsKO-Adjacents,90
Tachigali_bracteosa,97,50,47,Alphahull-PointsKO-Adjacents,6068
Tachigali_candelabrum,4,4,0,Points-PointsKO-Adjacents,36
Tachigali_catingae,5,5,0,Points-PointsKO-Adjacents,39
Tachigali_cavipes,69,0,69,Points-PointsKO-Adjacents,550
Tachigali_chrysaloides,64,31,33,Alphahull-PointsKO-Adjacents,3980
Tachigali_chrysophylla,159,93,66,Alphahull-PointsKO-Adjacents,18017
Tachigali_colombiana,9,1,8,Points-PointsKO-Adjacents,48
Tachigali_costaricensis,40,29,11,Alphahull-PointsKO-Adjacents,142
Tachigali_davidsei,32,22,10,Alphahull-PointsKO-Adjacents,594
Tachigali_densiflora,242,189,53,Alphahull-PointsKO-Adjacents,3343
Tachigali_denudata,145,112,33,Alphahull-PointsKO-Adjacents,1178
Tachigali_duckei,23,0,23,Points-PointsKO-Adjacents,161
Tachigali_dwyeri,5,5,0,Points-PointsKO-Adjacents,45
Tachigali_eriopetala,30,13,17,Points-PointsKO-Adjacents,232
Tachigali_formicarum,46,27,19,Alphahull-PointsKO-Adjacents,2799
Tachigali_friburgensis,36,26,10,Alphahull-PointsKO-Adjacents,568
Tachigali_fusca,5,5,0,Points-PointsKO-Adjacents,36
Tachigali_glauca,164,117,47,Alphahull-PointsKO-Adjacents,22503
Tachigali_goeldiana,39,16,23,Points-PointsKO-Adjacents,299
Tachigali_grandistipulata,5,5,0,Points-PointsKO-Adjacents,39
Tachigali_guianensis,445,347,98,Alphahull-PointsKO-Adjacents,42447
Tachigali_hypoleuca,63,38,25,Alphahull-PointsKO-Adjacents,1594
Tachigali_inconspicua,30,19,11,Points-PointsKO-Adjacents,219
Tachigali_leiocalyx,8,3,5,Points-PointsKO-Adjacents,41
Tachigali_longiflora,10,0,10,Points-PointsKO-Adjacents,77
Tachigali_macbridei,55,30,25,Alphahull-PointsKO-Adjacents,5636
Tachigali_macropetala,29,0,29,Points-PointsKO-Adjacents,222
Tachigali_macrostachya,16,3,13,Points-PointsKO-Adjacents,140
Tachigali_melanocarpa,43,24,19,Alphahull-PointsKO-Adjacents,678
Tachigali_melinonii,46,19,27,Points-PointsKO-Adjacents,340
Tachigali_micrantha,3,3,0,Points-PointsKO-Adjacents,26
Tachigali_micropetala,47,14,33,Points-PointsKO-Adjacents,354
Tachigali_multijuga,25,9,16,Points-PointsKO-Adjacents,175
Tachigali_odoratissima,118,92,26,Alphahull-PointsKO-Adjacents,3287
Tachigali_paniculata,899,811,88,Alphahull-PointsKO-Adjacents,81007
Tachigali_paraensis,91,42,49,Alphahull-PointsKO-Adjacents,4584
Tachigali_paratyensis,132,86,46,Alphahull-PointsKO-Adjacents,2707
Tachigali_peruviana,13,1,12,Points-PointsKO-Adjacents,117
Tachigali_physophora,68,43,25,Alphahull-PointsKO-Adjacents,3711
Tachigali_pilgeriana,68,45,23,Alphahull-PointsKO-Adjacents,1603
Tachigali_pimichinensis,3,3,0,Points-PointsKO-Adjacents,27
Tachigali_plumbea,40,19,21,Points-PointsKO-Adjacents,270
Tachigali_poeppigiana,54,14,40,Points-PointsKO-Adjacents,440
Tachigali_prancei,17,4,13,Points-PointsKO-Adjacents,132
Tachigali_ptychophysca,24,9,15,Points-PointsKO-Adjacents,180
Tachigali_pubiflora,35,22,13,Alphahull-PointsKO-Adjacents,324
Tachigali_richardiana,8,0,8,Points-PointsKO-Adjacents,57
Tachigali_rigida,55,37,18,Alphahull-PointsKO-Adjacents,1944
Tachigali_rubiginosa,490,433,57,Alphahull-PointsKO-Adjacents,22561
Tachigali_rugosa,283,243,40,Alphahull-PointsKO-Adjacents,5972
Tachigali_schultesiana,2,2,0,Points-PointsKO-Adjacents,18
Tachigali_setifera,137,92,45,Alphahull-PointsKO-Adjacents,9198
Tachigali_subvelutina,761,703,58,Alphahull-PointsKO-Adjacents,25099
Tachigali_tinctoria,109,59,50,Alphahull-PointsKO-Adjacents,3713
Tachigali_urbaniana,19,0,19,Points-PointsKO-Adjacents,144
Tachigali_venusta,58,25,33,Alphahull-PointsKO-Adjacents,5646
Tachigali_versicolor,30,23,7,Alphahull-PointsKO-Adjacents,80
Tachigali_vulgaris,697,631,66,Alphahull-PointsKO-Adjacents,48860
Tahina_spectabilis,4,4,0,Points-PointsKO-Adjacents,25
Taiwania_cryptomerioides,63,38,25,Alphahull-PointsKO-Adjacents,321
Takhtajania_perrieri,11,9,2,Points-PointsKO-Adjacents,38
Talbotiella_batesii,9,3,6,Points-PointsKO-Adjacents,75
Talbotiella_eketensis,3,3,0,Points-PointsKO-Adjacents,21
Talbotiella_gentii,52,44,8,Alphahull-PointsKO-Adjacents,220
Talipariti_archboldianum,32,16,16,Points-PointsKO-Adjacents,180
Talipariti_borneense,2,2,0,Points-PointsKO-Adjacents,18
Talipariti_bowersiae,0,0,0,NA,0
Talipariti_ellipticifolium,13,6,7,Points-PointsKO-Adjacents,65
Talipariti_glabrum,3,3,0,Points-PointsKO-Adjacents,4
Talipariti_simile,0,0,0,NA,0
Talipariti_tiliaceum,1303,775,528,Alphahull-PointsKO-Adjacents,26849
Talisia_acutifolia,44,23,21,Alphahull-PointsKO-Adjacents,567
Talisia_angustifolia,51,24,27,Alphahull-PointsKO-Adjacents,2664
Talisia_bullata,4,4,0,Points-PointsKO-Adjacents,36
Talisia_carinata,104,65,39,Alphahull-PointsKO-Adjacents,2113
Talisia_caudata,5,2,3,Points-PointsKO-Adjacents,38
Talisia_cerasina,521,384,137,Alphahull-PointsKO-Adjacents,42915
Talisia_chartacea,8,4,4,Points-PointsKO-Adjacents,72
Talisia_clathrata,50,24,26,Alphahull-PointsKO-Adjacents,1753
Talisia_coriacea,34,5,29,Points-PointsKO-Adjacents,270
Talisia_croatii,72,33,39,Alphahull-PointsKO-Adjacents,1164
Talisia_cupularis,95,51,44,Alphahull-PointsKO-Adjacents,1061
Talisia_dasyclada,27,10,17,Points-PointsKO-Adjacents,234
Talisia_douradensis,3,3,0,Points-PointsKO-Adjacents,27
Talisia_equatoriensis,14,5,9,Points-PointsKO-Adjacents,90
Talisia_esculenta,840,725,115,Alphahull-PointsKO-Adjacents,41112
Talisia_eximia,6,1,5,Points-PointsKO-Adjacents,34
Talisia_firma,84,57,27,Alphahull-PointsKO-Adjacents,3158
Talisia_floresii,74,0,74,Points-PointsKO-Adjacents,393
Talisia_furfuracea,14,9,5,Points-PointsKO-Adjacents,93
Talisia_ghilleana,17,10,7,Points-PointsKO-Adjacents,105
Talisia_granulosa,2,2,0,Points-PointsKO-Adjacents,12
Talisia_guianensis,58,0,58,Points-PointsKO-Adjacents,435
Talisia_hemidasya,51,29,22,Alphahull-PointsKO-Adjacents,1988
Talisia_hexaphylla,220,162,58,Alphahull-PointsKO-Adjacents,10700
Talisia_japurensis,39,13,26,Points-PointsKO-Adjacents,320
Talisia_laevigata,3,3,0,Points-PointsKO-Adjacents,21
Talisia_lanata,1,1,0,Points-PointsKO-Adjacents,9
Talisia_longifolia,104,63,41,Alphahull-PointsKO-Adjacents,6496
Talisia_macrophylla,205,140,65,Alphahull-PointsKO-Adjacents,19217
Talisia_marleneana,62,40,22,Alphahull-PointsKO-Adjacents,3702
Talisia_megaphylla,66,0,66,Points-PointsKO-Adjacents,551
Talisia_microphylla,27,4,23,Points-PointsKO-Adjacents,206
Talisia_mollis,135,88,47,Alphahull-PointsKO-Adjacents,10174
Talisia_morii,6,0,6,Points-PointsKO-Adjacents,47
Talisia_nervosa,199,143,56,Alphahull-PointsKO-Adjacents,3174
Talisia_obovata,39,0,39,Points-PointsKO-Adjacents,309
Talisia_pachycarpa,36,15,21,Points-PointsKO-Adjacents,303
Talisia_parviflora,7,2,5,Points-PointsKO-Adjacents,63
Talisia_pinnata,6,1,5,Points-PointsKO-Adjacents,54
Talisia_praealta,33,21,12,Alphahull-PointsKO-Adjacents,486
Talisia_princeps,51,19,32,Points-PointsKO-Adjacents,349
Talisia_retusa,189,108,81,Alphahull-PointsKO-Adjacents,16203
Talisia_setigera,21,14,7,Points-PointsKO-Adjacents,143
Talisia_simaboides,7,3,4,Points-PointsKO-Adjacents,39
Talisia_squarrosa,13,5,8,Points-PointsKO-Adjacents,86
Talisia_stricta,17,11,6,Points-PointsKO-Adjacents,89
Talisia_subalbens,29,19,10,Points-PointsKO-Adjacents,145
Talisia_sylvatica,98,63,35,Alphahull-PointsKO-Adjacents,2145
Talisia_velutina,2,2,0,Points-PointsKO-Adjacents,18
Talisia_veraluciana,21,4,17,Points-PointsKO-Adjacents,153
Tamania_chardonii,20,13,7,Points-PointsKO-Adjacents,74
Tamarindus_indica,1209,1015,194,Alphahull-PointsKO-Adjacents,30226
Tamarix_africana,1467,1185,282,Alphahull-PointsKO-Adjacents,10596
Tamarix_amplexicaulis,8,0,8,Points-PointsKO-Adjacents,63
Tamarix_androssowii,2,1,1,Points-PointsKO-Adjacents,18
Tamarix_aphylla,586,378,208,Alphahull-PointsKO-Adjacents,19132
Tamarix_aralensis,4,4,0,Points-PointsKO-Adjacents,30
Tamarix_arborea,8,0,8,Points-PointsKO-Adjacents,69
Tamarix_arceuthoides,20,1,19,Points-PointsKO-Adjacents,165
Tamarix_aucheriana,7,0,7,Points-PointsKO-Adjacents,57
Tamarix_austromongolica,NA,NA,NA,NA,NA
Tamarix_boveana,189,124,65,Alphahull-PointsKO-Adjacents,1215
Tamarix_canariensis,2013,1576,437,Alphahull-PointsKO-Adjacents,4995
Tamarix_chinensis,671,479,192,Alphahull-PointsKO-Adjacents,28603
Tamarix_dalmatica,9,0,9,Points-PointsKO-Adjacents,56
Tamarix_dioica,9,0,9,Points-PointsKO-Adjacents,81
Tamarix_elongata,0,0,0,NA,0
Tamarix_gallica,1337,1031,306,Alphahull-PointsKO-Adjacents,15125
Tamarix_gracilis,5,5,0,Points-PointsKO-Adjacents,30
Tamarix_hampeana,28,9,19,Points-PointsKO-Adjacents,190
Tamarix_hispida,4,4,0,Points-PointsKO-Adjacents,36
Tamarix_hohenackeri,19,4,15,Points-PointsKO-Adjacents,145
Tamarix_indica,2,1,1,Points-PointsKO-Adjacents,18
Tamarix_karelinii,0,0,0,NA,0
Tamarix_kotschyi,8,2,6,Points-PointsKO-Adjacents,72
Tamarix_laxa,7,0,7,Points-PointsKO-Adjacents,63
Tamarix_leptostachya,0,0,0,NA,0
Tamarix_mascatensis,18,4,14,Points-PointsKO-Adjacents,114
Tamarix_meyeri,11,0,11,Points-PointsKO-Adjacents,99
Tamarix_parviflora,375,228,147,Alphahull-PointsKO-Adjacents,17125
Tamarix_passerinoides,5,5,0,Points-PointsKO-Adjacents,45
Tamarix_ramosissima,1829,1514,315,Alphahull-PointsKO-Adjacents,58167
Tamarix_salina,0,0,0,NA,0
Tamarix_senegalensis,22,9,13,Points-PointsKO-Adjacents,174
Tamarix_smyrnensis,6,1,5,Points-PointsKO-Adjacents,45
Tamarix_stricta,2,2,0,Points-PointsKO-Adjacents,18
Tamarix_szovitsiana,0,0,0,NA,0
Tamarix_taklamakanensis,NA,NA,NA,NA,NA
Tamarix_tetragyna,96,76,20,Alphahull-PointsKO-Adjacents,392
Tamarix_tetrandra,52,29,23,Alphahull-PointsKO-Adjacents,1082
Tamarix_usneoides,30,13,17,Points-PointsKO-Adjacents,243
Tambourissa_bathiei,0,0,0,NA,0
Tambourissa_beanjadensis,4,3,1,Points-PointsKO-Adjacents,36
Tambourissa_bosseri,9,3,6,Points-PointsKO-Adjacents,73
Tambourissa_capuronii,13,5,8,Points-PointsKO-Adjacents,82
Tambourissa_castri-delphinii,28,9,19,Points-PointsKO-Adjacents,124
Tambourissa_cocottensis,0,0,0,NA,0
Tambourissa_crassa,0,0,0,NA,0
Tambourissa_decaryana,3,3,0,Points-PointsKO-Adjacents,24
Tambourissa_dorrii,3,3,0,Points-PointsKO-Adjacents,23
Tambourissa_floricostata,2,2,0,Points-PointsKO-Adjacents,18
Tambourissa_gracilis,2,2,0,Points-PointsKO-Adjacents,16
Tambourissa_hildebrandtii,34,17,17,Points-PointsKO-Adjacents,235
Tambourissa_humbertii,6,0,6,Points-PointsKO-Adjacents,43
Tambourissa_madagascariensis,17,0,17,Points-PointsKO-Adjacents,112
Tambourissa_mandrarensis,6,3,3,Points-PointsKO-Adjacents,28
Tambourissa_manongarivensis,8,3,5,Points-PointsKO-Adjacents,36
Tambourissa_masoalensis,11,8,3,Points-PointsKO-Adjacents,42
Tambourissa_nicolliae,14,2,12,Points-PointsKO-Adjacents,91
Tambourissa_nitida,1,1,0,Points-PointsKO-Adjacents,9
Tambourissa_nosybensis,0,0,0,NA,0
Tambourissa_parvifolia,14,7,7,Points-PointsKO-Adjacents,93
Tambourissa_pedicellata,0,0,0,NA,0
Tambourissa_perrieri,14,9,5,Points-PointsKO-Adjacents,106
Tambourissa_purpurea,211,188,23,Alphahull-PointsKO-Adjacents,3025
Tambourissa_quadrifida,2,1,1,Points-PointsKO-Adjacents,16
Tambourissa_rakotozafyi,8,5,3,Points-PointsKO-Adjacents,35
Tambourissa_religiosa,48,34,14,Alphahull-PointsKO-Adjacents,523
Tambourissa_sieberi,0,0,0,NA,0
Tambourissa_tetragona,0,0,0,NA,0
Tambourissa_thouvenotii,62,40,22,Alphahull-PointsKO-Adjacents,392
Tambourissa_trichophylla,30,17,13,Points-PointsKO-Adjacents,162
Tambourissa_uapacifolia,20,7,13,Points-PointsKO-Adjacents,99
Tamilnadia_uliginosa,14,0,14,Points-PointsKO-Adjacents,123
Tammsia_anomala,14,7,7,Points-PointsKO-Adjacents,94
Tannodia_cordifolia,17,7,10,Points-PointsKO-Adjacents,87
Tannodia_grandiflora,12,7,5,Points-PointsKO-Adjacents,52
Tannodia_nitida,1,1,0,Points-PointsKO-Adjacents,9
Tannodia_obovata,3,3,0,Points-PointsKO-Adjacents,27
Tannodia_pennivenia,6,2,4,Points-PointsKO-Adjacents,29
Tannodia_perrieri,67,47,20,Alphahull-PointsKO-Adjacents,360
Tannodia_swynnertonii,9,3,6,Points-PointsKO-Adjacents,56
Tannodia_tenuifolia,32,14,18,Points-PointsKO-Adjacents,214
Taonabo_japonica,76,0,76,Points-PointsKO-Adjacents,480
Tapeinosperma_divaricatum,0,0,0,NA,0
Tapeinosperma_multiflorum,0,0,0,NA,0
Tapeinosperma_pseudojambosa,126,90,36,Alphahull-PointsKO-Adjacents,533
Tapiphyllum_velutinum,9,2,7,Points-PointsKO-Adjacents,71
Tapirira_bethanniana,5,3,2,Points-PointsKO-Adjacents,27
Tapirira_chimalapana,15,11,4,Points-PointsKO-Adjacents,29
Tapirira_guianensis,5639,5344,295,Alphahull-PointsKO-Adjacents,143992
Tapirira_lepidota,18,11,7,Points-PointsKO-Adjacents,56
Tapirira_mexicana,266,220,46,Alphahull-PointsKO-Adjacents,3613
Tapirira_obtusa,878,732,146,Alphahull-PointsKO-Adjacents,73428
Tapirira_pilosa,2,2,0,Points-PointsKO-Adjacents,12
Tapirira_retusa,137,93,44,Alphahull-PointsKO-Adjacents,8114
Tapirira_rubrinervis,6,0,6,Points-PointsKO-Adjacents,44
Tapiscia_sinensis,44,18,26,Points-PointsKO-Adjacents,395
Tapiscia_yunnanensis,9,0,9,Points-PointsKO-Adjacents,72
Tapoides_villamilii,1,1,0,Points-PointsKO-Adjacents,9
Tapura_acreana,42,27,15,Alphahull-PointsKO-Adjacents,2977
Tapura_africana,59,49,10,Alphahull-PointsKO-Adjacents,1033
Tapura_amazonica,666,586,80,Alphahull-PointsKO-Adjacents,60551
Tapura_bouquetiana,34,28,6,Alphahull-PointsKO-Adjacents,499
Tapura_bullata,4,4,0,Points-PointsKO-Adjacents,33
Tapura_capitulifera,50,25,25,Alphahull-PointsKO-Adjacents,1645
Tapura_carinata,9,4,5,Points-PointsKO-Adjacents,48
Tapura_colombiana,34,23,11,Alphahull-PointsKO-Adjacents,868
Tapura_coriacea,73,52,21,Alphahull-PointsKO-Adjacents,2118
Tapura_costata,5,5,0,Points-PointsKO-Adjacents,33
Tapura_cubensis,20,4,16,Points-PointsKO-Adjacents,147
Tapura_ferreyrae,2,2,0,Points-PointsKO-Adjacents,18
Tapura_fischeri,101,55,46,Alphahull-PointsKO-Adjacents,1584
Tapura_follii,6,0,6,Points-PointsKO-Adjacents,41
Tapura_guianensis,537,452,85,Alphahull-PointsKO-Adjacents,39472
Tapura_haitiensis,3,3,0,Points-PointsKO-Adjacents,12
Tapura_juruana,211,161,50,Alphahull-PointsKO-Adjacents,16329
Tapura_lanceolata,26,18,8,Points-PointsKO-Adjacents,131
Tapura_latifolia,15,0,15,Points-PointsKO-Adjacents,40
Tapura_le-testui,3,3,0,Points-PointsKO-Adjacents,27
Tapura_magnifolia,4,4,0,Points-PointsKO-Adjacents,36
Tapura_neglecta,2,2,0,Points-PointsKO-Adjacents,18
Tapura_orbicularis,1,1,0,Points-PointsKO-Adjacents,9
Tapura_panamensis,2,2,0,Points-PointsKO-Adjacents,18
Tapura_peruviana,160,137,23,Alphahull-PointsKO-Adjacents,5737
Tapura_singularis,28,0,28,Points-PointsKO-Adjacents,218
Tapura_tchoutoi,4,4,0,Points-PointsKO-Adjacents,23
Tapura_tessmannii,3,3,0,Points-PointsKO-Adjacents,27
Taralea_cordata,169,135,34,Alphahull-PointsKO-Adjacents,12635
Taralea_crassifolia,79,56,23,Alphahull-PointsKO-Adjacents,3468
Taralea_nudipes,98,53,45,Alphahull-PointsKO-Adjacents,2768
Taralea_oppositifolia,437,372,65,Alphahull-PointsKO-Adjacents,29544
Taralea_phaeophylla,1,1,0,Points-PointsKO-Adjacents,9
Taralea_reticulata,11,5,6,Points-PointsKO-Adjacents,93
Tarchonanthus_camphoratus,244,181,63,Alphahull-PointsKO-Adjacents,14607
Tarchonanthus_littoralis,82,0,82,Points-PointsKO-Adjacents,461
Tarchonanthus_minor,101,78,23,Alphahull-PointsKO-Adjacents,5073
Tarchonanthus_obovatus,68,44,24,Alphahull-PointsKO-Adjacents,3271
Tarchonanthus_parvicapitulatus,48,25,23,Alphahull-PointsKO-Adjacents,1909
Tarchonanthus_trilobus,62,0,62,Points-PointsKO-Adjacents,523
Tarenna_adangensis,3,3,0,Points-PointsKO-Adjacents,26
Tarenna_adpressa,0,0,0,NA,0
Tarenna_agumbensis,0,0,0,NA,0
Tarenna_annamensis,NA,NA,NA,NA,NA
Tarenna_arborescens,3,3,0,Points-PointsKO-Adjacents,27
Tarenna_asiatica,27,16,11,Points-PointsKO-Adjacents,80
Tarenna_campaniflora,0,0,0,NA,0
Tarenna_capuroniana,44,36,8,Alphahull-PointsKO-Adjacents,286
Tarenna_ciliolata,0,0,0,NA,0
Tarenna_cinerea,0,0,0,NA,0
Tarenna_citrina,1,1,0,Points-PointsKO-Adjacents,9
Tarenna_compactiflora,NA,NA,NA,NA,NA
Tarenna_conferta,124,73,51,Alphahull-PointsKO-Adjacents,7884
Tarenna_confusa,1,1,0,Points-PointsKO-Adjacents,9
Tarenna_costata,1,1,0,Points-PointsKO-Adjacents,9
Tarenna_cumingiana,21,0,21,Points-PointsKO-Adjacents,179
Tarenna_dallachiana,525,473,52,Alphahull-PointsKO-Adjacents,3278
Tarenna_depauperata,31,14,17,Points-PointsKO-Adjacents,275
Tarenna_disperma,0,0,0,NA,0
Tarenna_flava,0,0,0,NA,0
Tarenna_foonchewii,NA,NA,NA,NA,NA
Tarenna_fragrans,22,3,19,Points-PointsKO-Adjacents,106
Tarenna_funebris,25,3,22,Points-PointsKO-Adjacents,198
Tarenna_gibbsiae,7,2,5,Points-PointsKO-Adjacents,35
Tarenna_gracilipes,130,104,26,Alphahull-PointsKO-Adjacents,387
Tarenna_gracilis,48,29,19,Alphahull-PointsKO-Adjacents,1169
Tarenna_grandiflora,111,94,17,Alphahull-PointsKO-Adjacents,1737
Tarenna_grevei,62,41,21,Alphahull-PointsKO-Adjacents,652
Tarenna_harmandiana,0,0,0,NA,0
Tarenna_helferi,0,0,0,NA,0
Tarenna_hirsuta,NA,NA,NA,NA,NA
Tarenna_hispidula,NA,NA,NA,NA,NA
Tarenna_hoaensis,4,4,0,Points-PointsKO-Adjacents,36
Tarenna_hutchinsonii,6,1,5,Points-PointsKO-Adjacents,54
Tarenna_inops,12,7,5,Points-PointsKO-Adjacents,56
Tarenna_jolinonii,38,31,7,Alphahull-PointsKO-Adjacents,579
Tarenna_joskei,0,0,0,NA,0
Tarenna_kivuensis,6,2,4,Points-PointsKO-Adjacents,36
Tarenna_lancilimba,15,3,12,Points-PointsKO-Adjacents,122
Tarenna_lasiorhachis,107,82,25,Alphahull-PointsKO-Adjacents,3727
Tarenna_longipedicellata,8,0,8,Points-PointsKO-Adjacents,66
Tarenna_luhomeroensis,6,2,4,Points-PointsKO-Adjacents,35
Tarenna_luteola,53,36,17,Alphahull-PointsKO-Adjacents,1790
Tarenna_macroptera,3,3,0,Points-PointsKO-Adjacents,27
Tarenna_mollis,6,1,5,Points-PointsKO-Adjacents,45
Tarenna_mollissima,84,63,21,Alphahull-PointsKO-Adjacents,4487
Tarenna_monosperma,0,0,0,NA,0
Tarenna_monticola,56,45,11,Alphahull-PointsKO-Adjacents,167
Tarenna_mussaendoides,0,0,0,NA,0
Tarenna_nilagirica,0,0,0,NA,0
Tarenna_nilotica,20,4,16,Points-PointsKO-Adjacents,169
Tarenna_nitidula,99,81,18,Alphahull-PointsKO-Adjacents,1892
Tarenna_nitiduloides,10,6,4,Points-PointsKO-Adjacents,17
Tarenna_pallidula,353,311,42,Alphahull-PointsKO-Adjacents,23898
Tarenna_pavettoides,317,213,104,Alphahull-PointsKO-Adjacents,20361
Tarenna_pembensis,0,0,0,NA,0
Tarenna_pentamera,216,194,22,Alphahull-PointsKO-Adjacents,2460
Tarenna_petitii,22,5,17,Points-PointsKO-Adjacents,167
Tarenna_pilosa,NA,NA,NA,NA,NA
Tarenna_polysperma,3,3,0,Points-PointsKO-Adjacents,27
Tarenna_precidantenna,78,55,23,Alphahull-PointsKO-Adjacents,2350
Tarenna_principensis,2,2,0,Points-PointsKO-Adjacents,7
Tarenna_puberula,NA,NA,NA,NA,NA
Tarenna_pubinervis,9,0,9,Points-PointsKO-Adjacents,81
Tarenna_pulchra,4,4,0,Points-PointsKO-Adjacents,36
Tarenna_quadrangularis,10,5,5,Points-PointsKO-Adjacents,29
Tarenna_quocensis,0,0,0,NA,0
Tarenna_rwandensis,8,3,5,Points-PointsKO-Adjacents,52
Tarenna_sakae,NA,NA,NA,NA,NA
Tarenna_sambucina,59,19,40,Points-PointsKO-Adjacents,263
Tarenna_sechellensis,1,1,0,Points-PointsKO-Adjacents,6
Tarenna_seemanniana,0,0,0,NA,0
Tarenna_spiranthera,86,63,23,Alphahull-PointsKO-Adjacents,728
Tarenna_stellulata,1,1,0,Points-PointsKO-Adjacents,9
Tarenna_sumatrensis,1,1,0,Points-PointsKO-Adjacents,9
Tarenna_thomasii,38,17,21,Points-PointsKO-Adjacents,312
Tarenna_thouarsiana,129,100,29,Alphahull-PointsKO-Adjacents,1094
Tarenna_tsangii,5,5,0,Points-PointsKO-Adjacents,45
Tarenna_valida,NA,NA,NA,NA,NA
Tarenna_vignei,143,114,29,Alphahull-PointsKO-Adjacents,2216
Tarenna_wangii,2,2,0,Points-PointsKO-Adjacents,18
Tarenna_weberifolia,0,0,0,NA,0
Tarenna_winkleri,1,0,1,Points-PointsKO-Adjacents,9
Tarenna_yunnanensis,1,1,0,Points-PointsKO-Adjacents,9
Tarennoidea_wallichii,62,27,35,Alphahull-PointsKO-Adjacents,2292
Tarrietia_utilis,78,56,22,Alphahull-PointsKO-Adjacents,1045
Tasmannia_piperita,400,324,76,Alphahull-PointsKO-Adjacents,2649
Taxandria_juniperina,129,0,129,Points-PointsKO-Adjacents,368
Taxandria_linearifolia,397,357,40,Alphahull-PointsKO-Adjacents,1394
Taxodium_distichum,4094,3638,456,Alphahull-PointsKO-Adjacents,29744
Taxus_baccata,16016,12109,3907,Alphahull-PointsKO-Adjacents,61046
Taxus_brevifolia,1197,1106,91,Alphahull-PointsKO-Adjacents,12479
Taxus_canadensis,1218,1002,216,Alphahull-PointsKO-Adjacents,37564
Taxus_cuspidata,210,118,92,Alphahull-PointsKO-Adjacents,3680
Taxus_floridana,18,0,18,Points-PointsKO-Adjacents,78
Taxus_globosa,148,118,30,Alphahull-PointsKO-Adjacents,1214
Taxus_wallichiana,148,88,60,Alphahull-PointsKO-Adjacents,3744
Teclea_carpopunctifera,3,3,0,Points-PointsKO-Adjacents,21
Teclea_crenulata,NA,NA,NA,NA,NA
Teclea_engleriana,1,1,0,Points-PointsKO-Adjacents,9
Teclea_natalensis,50,25,25,Alphahull-PointsKO-Adjacents,808
Tecoma_capensis,350,151,199,Alphahull-PointsKO-Adjacents,4805
Tecoma_castanifolia,26,14,12,Points-PointsKO-Adjacents,176
Tecoma_fulva,115,72,43,Alphahull-PointsKO-Adjacents,3704
Tecoma_nyassae,48,22,26,Alphahull-PointsKO-Adjacents,660
Tecoma_stans,2772,2238,534,Alphahull-PointsKO-Adjacents,45209
Tecoma_tenuiflora,100,81,19,Alphahull-PointsKO-Adjacents,1259
Tecomella_undulata,10,0,10,Points-PointsKO-Adjacents,88
Tectiphiala_ferox,NA,NA,NA,NA,NA
Tectona_grandis,16,2,14,Points-PointsKO-Adjacents,144
Tectona_hamiltoniana,1,1,0,Points-PointsKO-Adjacents,9
Tectona_philippinensis,2,2,0,Points-PointsKO-Adjacents,16
Teijsmanniodendron_ahernianum,48,15,33,Points-PointsKO-Adjacents,311
Teijsmanniodendron_bintuluense,5,5,0,Points-PointsKO-Adjacents,42
Teijsmanniodendron_bogoriense,93,40,53,Alphahull-PointsKO-Adjacents,2545
Teijsmanniodendron_bullatum,7,1,6,Points-PointsKO-Adjacents,51
Teijsmanniodendron_coriaceum,48,24,24,Alphahull-PointsKO-Adjacents,908
Teijsmanniodendron_glabrum,17,7,10,Points-PointsKO-Adjacents,118
Teijsmanniodendron_havilandii,3,3,0,Points-PointsKO-Adjacents,18
Teijsmanniodendron_hollrungii,69,18,51,Points-PointsKO-Adjacents,525
Teijsmanniodendron_holophyllum,67,43,24,Alphahull-PointsKO-Adjacents,3319
Teijsmanniodendron_latiffii,1,1,0,Points-PointsKO-Adjacents,9
Teijsmanniodendron_obscurinerve,3,3,0,Points-PointsKO-Adjacents,12
Teijsmanniodendron_pteropodum,61,26,35,Alphahull-PointsKO-Adjacents,1805
Teijsmanniodendron_punctatum,3,3,0,Points-PointsKO-Adjacents,21
Teijsmanniodendron_renageorgeae,NA,NA,NA,NA,NA
Teijsmanniodendron_sarawakanum,32,19,13,Points-PointsKO-Adjacents,214
Teijsmanniodendron_scaberrimum,4,4,0,Points-PointsKO-Adjacents,36
Teijsmanniodendron_simplicifolium,34,21,13,Alphahull-PointsKO-Adjacents,1013
Teijsmanniodendron_simplicioides,8,4,4,Points-PointsKO-Adjacents,63
Teijsmanniodendron_sinclairii,13,4,9,Points-PointsKO-Adjacents,110
Teijsmanniodendron_smilacifolium,11,4,7,Points-PointsKO-Adjacents,99
Teijsmanniodendron_subspicatum,24,10,14,Points-PointsKO-Adjacents,195
Teijsmanniodendron_unifoliolatum,30,11,19,Points-PointsKO-Adjacents,250
Teijsmanniodendron_zainudinii,3,3,0,Points-PointsKO-Adjacents,25
Telanthophora_arborescens,0,0,0,NA,0
Telanthophora_grandifolia,496,427,69,Alphahull-PointsKO-Adjacents,4647
Telanthophora_standleyi,23,10,13,Points-PointsKO-Adjacents,105
Temnocalyx_nodulosa,5,5,0,Points-PointsKO-Adjacents,36
Tephrosia_aequilata,75,45,30,Alphahull-PointsKO-Adjacents,1160
Tephrosia_phylloxylon,15,10,5,Points-PointsKO-Adjacents,61
Tephrosia_praecana,4,4,0,Points-PointsKO-Adjacents,23
Tephrosia_pungens,39,29,10,Alphahull-PointsKO-Adjacents,303
Tephrosia_sinapou,198,90,108,Alphahull-PointsKO-Adjacents,6971
Tephrosia_vogelii,206,112,94,Alphahull-PointsKO-Adjacents,11050
Tephrothamnus_paradoxus,17,11,6,Points-PointsKO-Adjacents,58
Tepuianthus_aracensis,12,7,5,Points-PointsKO-Adjacents,39
Tepuianthus_colombianus,8,2,6,Points-PointsKO-Adjacents,72
Tepuianthus_sarisarinamensis,14,6,8,Points-PointsKO-Adjacents,79
Tepuianthus_savannensis,36,22,14,Alphahull-PointsKO-Adjacents,149
Tepuianthus_yapacanensis,3,3,0,Points-PointsKO-Adjacents,15
Terminalia_actinophylla,185,149,36,Alphahull-PointsKO-Adjacents,8413
Terminalia_acuminata,19,0,19,Points-PointsKO-Adjacents,90
Terminalia_amazonia,1122,959,163,Alphahull-PointsKO-Adjacents,51447
Terminalia_arbuscula,3,2,1,Points-PointsKO-Adjacents,25
Terminalia_argentea,1094,1013,81,Alphahull-PointsKO-Adjacents,34385
Terminalia_arjuna,5,0,5,Points-PointsKO-Adjacents,45
Terminalia_australis,223,188,35,Alphahull-PointsKO-Adjacents,7767
Terminalia_avicennioides,542,498,44,Alphahull-PointsKO-Adjacents,7166
Terminalia_belini,6,3,3,Points-PointsKO-Adjacents,24
Terminalia_bellirica,18,1,17,Points-PointsKO-Adjacents,136
Terminalia_bialata,23,0,23,Points-PointsKO-Adjacents,153
Terminalia_boivinii,91,61,30,Alphahull-PointsKO-Adjacents,2077
Terminalia_brachystemma,26,6,20,Points-PointsKO-Adjacents,214
Terminalia_brevipes,3,3,0,Points-PointsKO-Adjacents,27
Terminalia_brownii,80,42,38,Alphahull-PointsKO-Adjacents,1840
Terminalia_bucidoides,56,39,17,Alphahull-PointsKO-Adjacents,426
Terminalia_calcicola,22,10,12,Points-PointsKO-Adjacents,122
Terminalia_calophylla,8,3,5,Points-PointsKO-Adjacents,56
Terminalia_carolinensis,2,2,0,Points-PointsKO-Adjacents,11
Terminalia_catappa,1498,889,609,Alphahull-PointsKO-Adjacents,40840
Terminalia_cephalota,1,1,0,Points-PointsKO-Adjacents,7
Terminalia_chebula,28,6,22,Points-PointsKO-Adjacents,245
Terminalia_chicharronia,32,11,21,Points-PointsKO-Adjacents,249
Terminalia_citrina,10,0,10,Points-PointsKO-Adjacents,81
Terminalia_comintana,0,0,0,NA,0
Terminalia_crenata,11,0,11,Points-PointsKO-Adjacents,45
Terminalia_crenulata,0,0,0,NA,0
Terminalia_crispialata,50,32,18,Alphahull-PointsKO-Adjacents,2179
Terminalia_dichotoma,221,123,98,Alphahull-PointsKO-Adjacents,19448
Terminalia_disjuncta,8,5,3,Points-PointsKO-Adjacents,32
Terminalia_diversipilosa,4,4,0,Points-PointsKO-Adjacents,32
Terminalia_edulis,0,0,0,NA,0
Terminalia_eichleriana,79,63,16,Alphahull-PointsKO-Adjacents,3058
Terminalia_erici-rosenii,2,2,0,Points-PointsKO-Adjacents,18
Terminalia_eriostachya,7,0,7,Points-PointsKO-Adjacents,57
Terminalia_exsculpta,5,5,0,Points-PointsKO-Adjacents,34
Terminalia_fagifolia,832,775,57,Alphahull-PointsKO-Adjacents,25309
Terminalia_fatraea,78,39,39,Alphahull-PointsKO-Adjacents,3051
Terminalia_franchetii,33,13,20,Points-PointsKO-Adjacents,291
Terminalia_glabrescens,999,908,91,Alphahull-PointsKO-Adjacents,39495
Terminalia_glaucescens,475,432,43,Alphahull-PointsKO-Adjacents,7620
Terminalia_gracilipes,12,3,9,Points-PointsKO-Adjacents,80
Terminalia_guaiquinimae,16,10,6,Points-PointsKO-Adjacents,91
Terminalia_ivorensis,94,70,24,Alphahull-PointsKO-Adjacents,5057
Terminalia_januarensis,119,80,39,Alphahull-PointsKO-Adjacents,2637
Terminalia_kaiseriana,17,7,10,Points-PointsKO-Adjacents,102
Terminalia_kilimandscharica,48,40,8,Alphahull-PointsKO-Adjacents,946
Terminalia_kuhlmannii,9,0,9,Points-PointsKO-Adjacents,54
Terminalia_laxiflora,346,295,51,Alphahull-PointsKO-Adjacents,9258
Terminalia_leandriana,14,3,11,Points-PointsKO-Adjacents,88
Terminalia_lucida,160,99,61,Alphahull-PointsKO-Adjacents,11175
Terminalia_macroptera,222,182,40,Alphahull-PointsKO-Adjacents,8010
Terminalia_macrostachya,118,84,34,Alphahull-PointsKO-Adjacents,2096
Terminalia_mameluco,92,56,36,Alphahull-PointsKO-Adjacents,1258
Terminalia_mantaly,51,28,23,Alphahull-PointsKO-Adjacents,1064
Terminalia_mollis,142,83,59,Alphahull-PointsKO-Adjacents,4979
Terminalia_muelleri,278,213,65,Alphahull-PointsKO-Adjacents,1585
Terminalia_myriocarpa,22,1,21,Points-PointsKO-Adjacents,178
Terminalia_neotaliala,51,29,22,Alphahull-PointsKO-Adjacents,887
Terminalia_nigrovenulosa,21,5,16,Points-PointsKO-Adjacents,165
Terminalia_oblonga,617,509,108,Alphahull-PointsKO-Adjacents,24061
Terminalia_ombrophila,20,11,9,Points-PointsKO-Adjacents,138
Terminalia_orbicularis,8,1,7,Points-PointsKO-Adjacents,57
Terminalia_parvula,0,0,0,NA,0
Terminalia_perrieri,18,11,7,Points-PointsKO-Adjacents,86
Terminalia_phanerophlebia,39,30,9,Alphahull-PointsKO-Adjacents,469
Terminalia_polyantha,0,0,0,NA,0
Terminalia_polycarpa,7,1,6,Points-PointsKO-Adjacents,54
Terminalia_procera,75,11,64,Points-PointsKO-Adjacents,441
Terminalia_prunioides,216,153,63,Alphahull-PointsKO-Adjacents,6792
Terminalia_quintalata,53,35,18,Alphahull-PointsKO-Adjacents,1362
Terminalia_ramatuella,40,27,13,Alphahull-PointsKO-Adjacents,636
Terminalia_randii,13,2,11,Points-PointsKO-Adjacents,101
Terminalia_reitzii,12,4,8,Points-PointsKO-Adjacents,91
Terminalia_sambesiaca,8,0,8,Points-PointsKO-Adjacents,70
Terminalia_samoensis,2,2,0,Points-PointsKO-Adjacents,9
Terminalia_scutifera,8,1,7,Points-PointsKO-Adjacents,52
Terminalia_sericea,294,244,50,Alphahull-PointsKO-Adjacents,15905
Terminalia_seyrigii,97,77,20,Alphahull-PointsKO-Adjacents,1433
Terminalia_spinosa,11,5,6,Points-PointsKO-Adjacents,73
Terminalia_stuhlmannii,11,1,10,Points-PointsKO-Adjacents,69
Terminalia_subserrata,4,4,0,Points-PointsKO-Adjacents,33
Terminalia_sulcata,9,6,3,Points-PointsKO-Adjacents,31
Terminalia_superba,1338,1278,60,Alphahull-PointsKO-Adjacents,7871
Terminalia_tanibouca,1,1,0,Points-PointsKO-Adjacents,9
Terminalia_tetrandra,13,0,13,Points-PointsKO-Adjacents,51
Terminalia_trichopoda,5,4,1,Points-PointsKO-Adjacents,39
Terminalia_triflora,398,333,65,Alphahull-PointsKO-Adjacents,19218
Terminalia_tropophylla,26,10,16,Points-PointsKO-Adjacents,164
Terminalia_uleana,3,3,0,Points-PointsKO-Adjacents,25
Terminalia_ulexoides,35,23,12,Alphahull-PointsKO-Adjacents,461
Terminalia_urschii,6,0,6,Points-PointsKO-Adjacents,37
Terminalia_valverdeae,34,23,11,Alphahull-PointsKO-Adjacents,139
Terminalia_vermae,NA,NA,NA,NA,NA
Terminalia_virens,62,46,16,Alphahull-PointsKO-Adjacents,1631
Terminalia_yapacana,24,13,11,Points-PointsKO-Adjacents,143
Terminthia_paniculata,3,3,0,Points-PointsKO-Adjacents,27
Ternstroemia_acrodantha,3,3,0,Points-PointsKO-Adjacents,27
Ternstroemia_africana,10,2,8,Points-PointsKO-Adjacents,64
Ternstroemia_alnifolia,104,82,22,Alphahull-PointsKO-Adjacents,1538
Ternstroemia_aracae,7,3,4,Points-PointsKO-Adjacents,27
Ternstroemia_asymmetrica,80,56,24,Alphahull-PointsKO-Adjacents,949
Ternstroemia_biangulipes,11,7,4,Points-PointsKO-Adjacents,46
Ternstroemia_brachypoda,7,1,6,Points-PointsKO-Adjacents,48
Ternstroemia_brasiliensis,492,401,91,Alphahull-PointsKO-Adjacents,11656
Ternstroemia_browniana,8,2,6,Points-PointsKO-Adjacents,63
Ternstroemia_camelliifolia,11,2,9,Points-PointsKO-Adjacents,77
Ternstroemia_campinicola,26,13,13,Points-PointsKO-Adjacents,176
Ternstroemia_candolleana,107,53,54,Alphahull-PointsKO-Adjacents,2302
Garcinia_cherryi,65,41,24,Alphahull-PointsKO-Adjacents,289
Ternstroemia_circumscissilis,36,22,14,Alphahull-PointsKO-Adjacents,129
Ternstroemia_cleistogama,10,5,5,Points-PointsKO-Adjacents,40
Ternstroemia_clusiifolia,6,1,5,Points-PointsKO-Adjacents,45
Ternstroemia_conicocarpa,5,5,0,Points-PointsKO-Adjacents,45
Ternstroemia_cuneifolia,28,14,14,Points-PointsKO-Adjacents,201
Ternstroemia_delicatula,27,1,26,Points-PointsKO-Adjacents,237
Ternstroemia_dentisepala,32,19,13,Points-PointsKO-Adjacents,106
Ternstroemia_evenia,1,1,0,Points-PointsKO-Adjacents,9
Ternstroemia_fragrans,45,13,32,Points-PointsKO-Adjacents,279
Ternstroemia_gleasoniana,1,1,0,Points-PointsKO-Adjacents,9
Ternstroemia_globiflora,7,2,5,Points-PointsKO-Adjacents,54
Ternstroemia_grandiosa,2,2,0,Points-PointsKO-Adjacents,18
Ternstroemia_gymnanthera,70,0,70,Points-PointsKO-Adjacents,499
Ternstroemia_hainanensis,3,3,0,Points-PointsKO-Adjacents,27
Ternstroemia_heptasepala,5,0,5,Points-PointsKO-Adjacents,18
Ternstroemia_huasteca,68,59,9,Alphahull-PointsKO-Adjacents,172
Ternstroemia_insignis,3,3,0,Points-PointsKO-Adjacents,27
Ternstroemia_jelskii,46,28,18,Alphahull-PointsKO-Adjacents,1258
Ternstroemia_killipiana,5,5,0,Points-PointsKO-Adjacents,33
Ternstroemia_klugiana,23,1,22,Points-PointsKO-Adjacents,135
Ternstroemia_kwangtungensis,22,6,16,Points-PointsKO-Adjacents,177
Ternstroemia_laevigata,15,0,15,Points-PointsKO-Adjacents,126
Ternstroemia_landae,1,1,0,Points-PointsKO-Adjacents,9
Ternstroemia_lehmannii,40,25,15,Alphahull-PointsKO-Adjacents,487
Ternstroemia_lineata,454,402,52,Alphahull-PointsKO-Adjacents,6001
Ternstroemia_luquillensis,5,0,5,Points-PointsKO-Adjacents,31
Ternstroemia_luteoflora,76,53,23,Alphahull-PointsKO-Adjacents,2956
Ternstroemia_macrocarpa,38,27,11,Alphahull-PointsKO-Adjacents,838
Ternstroemia_maguirei,5,5,0,Points-PointsKO-Adjacents,33
Ternstroemia_maltbyi,9,6,3,Points-PointsKO-Adjacents,27
Ternstroemia_meridionalis,154,133,21,Alphahull-PointsKO-Adjacents,2380
Ternstroemia_microphylla,1,1,0,Points-PointsKO-Adjacents,9
Ternstroemia_multiovulata,44,36,8,Alphahull-PointsKO-Adjacents,80
Ternstroemia_mutisiana,3,3,0,Points-PointsKO-Adjacents,24
Ternstroemia_nitida,35,22,13,Alphahull-PointsKO-Adjacents,2270
Ternstroemia_oocarpa,242,210,32,Alphahull-PointsKO-Adjacents,1391
Ternstroemia_pachytrocha,8,4,4,Points-PointsKO-Adjacents,43
Ternstroemia_peduncularis,38,25,13,Alphahull-PointsKO-Adjacents,393
Ternstroemia_penduliflora,9,4,5,Points-PointsKO-Adjacents,61
Ternstroemia_polyandra,15,8,7,Points-PointsKO-Adjacents,81
Ternstroemia_polypetala,15,8,7,Points-PointsKO-Adjacents,75
Ternstroemia_punctata,59,31,28,Alphahull-PointsKO-Adjacents,2960
Ternstroemia_schomburgkiana,8,3,5,Points-PointsKO-Adjacents,72
Ternstroemia_sichuanensis,1,1,0,Points-PointsKO-Adjacents,9
Ternstroemia_simaoensis,5,5,0,Points-PointsKO-Adjacents,45
Ternstroemia_stahlii,16,11,5,Points-PointsKO-Adjacents,49
Ternstroemia_standleyana,12,6,6,Points-PointsKO-Adjacents,53
Ternstroemia_steyermarkii,3,3,0,Points-PointsKO-Adjacents,27
Ternstroemia_subserrata,31,21,10,Alphahull-PointsKO-Adjacents,198
Ternstroemia_subsessilis,1,1,0,Points-PointsKO-Adjacents,9
Ternstroemia_sylvatica,48,40,8,Alphahull-PointsKO-Adjacents,935
Ternstroemia_tepezapote,836,763,73,Alphahull-PointsKO-Adjacents,8585
Ternstroemia_urophora,22,10,12,Points-PointsKO-Adjacents,135
Ternstroemia_verticillata,20,5,15,Points-PointsKO-Adjacents,149
Ternstroemia_yunnanensis,5,4,1,Points-PointsKO-Adjacents,45
Terua_vallicola,1,1,0,Points-PointsKO-Adjacents,9
Tessaria_fastigiata,70,52,18,Alphahull-PointsKO-Adjacents,1655
Tessaria_integrifolia,567,444,123,Alphahull-PointsKO-Adjacents,43287
Tessmannia_africana,73,55,18,Alphahull-PointsKO-Adjacents,2558
Tessmannia_anomala,67,38,29,Alphahull-PointsKO-Adjacents,2506
Tessmannia_burttii,7,1,6,Points-PointsKO-Adjacents,48
Tessmannia_copallifera,1,1,0,Points-PointsKO-Adjacents,9
Tessmannia_dawei,5,5,0,Points-PointsKO-Adjacents,30
Tessmannia_densiflora,8,5,3,Points-PointsKO-Adjacents,37
Tessmannia_dewildemaniana,19,8,11,Points-PointsKO-Adjacents,141
Tessmannia_lescrauwaetii,29,16,13,Points-PointsKO-Adjacents,219
Tessmannia_martiniana,7,2,5,Points-PointsKO-Adjacents,54
Tessmannia_yangambiensis,2,2,0,Points-PointsKO-Adjacents,12
Tessmannianthus_calcaratus,14,9,5,Points-PointsKO-Adjacents,90
Tessmannianthus_carinatus,2,2,0,Points-PointsKO-Adjacents,14
Tessmannianthus_cenepensis,9,2,7,Points-PointsKO-Adjacents,81
Tessmannianthus_cereifolius,3,3,0,Points-PointsKO-Adjacents,18
Tessmannianthus_gordonii,3,3,0,Points-PointsKO-Adjacents,21
Tessmannianthus_heterostemon,44,30,14,Alphahull-PointsKO-Adjacents,1516
Tessmannianthus_quadridomius,11,7,4,Points-PointsKO-Adjacents,80
Testulea_gabonensis,29,19,10,Points-PointsKO-Adjacents,220
Tetraberlinia_baregarum,1,1,0,Points-PointsKO-Adjacents,9
Tetraberlinia_bifoliolata,242,223,19,Alphahull-PointsKO-Adjacents,3616
Tetraberlinia_korupensis,15,12,3,Points-PointsKO-Adjacents,32
Tetraberlinia_longiracemosa,24,17,7,Points-PointsKO-Adjacents,139
Tetraberlinia_moreliana,49,31,18,Alphahull-PointsKO-Adjacents,521
Tetraberlinia_polyphylla,20,11,9,Points-PointsKO-Adjacents,159
Tetraberlinia_tubmaniana,33,27,6,Alphahull-PointsKO-Adjacents,265
Tetracentron_sinense,68,43,25,Alphahull-PointsKO-Adjacents,3191
Tetracera_affinis,16,4,12,Points-PointsKO-Adjacents,122
Tetracera_boiviniana,93,64,29,Alphahull-PointsKO-Adjacents,569
Tetracera_eriantha,3,3,0,Points-PointsKO-Adjacents,27
Tetracera_parviflora,120,78,42,Alphahull-PointsKO-Adjacents,4358
Tetrachyron_orizabaensis,40,25,15,Alphahull-PointsKO-Adjacents,289
Tetraclinis_articulata,189,126,63,Alphahull-PointsKO-Adjacents,1935
Melicope_tetrandra,0,0,0,NA,0
Tetradenia_bainesii,5,5,0,Points-PointsKO-Adjacents,45
Tetradenia_brevispicata,43,24,19,Alphahull-PointsKO-Adjacents,800
Tetradenia_multiflora,2,2,0,Points-PointsKO-Adjacents,18
Tetradenia_riparia,76,42,34,Alphahull-PointsKO-Adjacents,1950
Tetradenia_urticifolia,13,1,12,Points-PointsKO-Adjacents,99
Tetradium_austrosinense,1,1,0,Points-PointsKO-Adjacents,9
Tetradium_calcicolum,0,0,0,NA,0
Tetradium_daniellii,48,19,29,Points-PointsKO-Adjacents,429
Tetradium_fraxinifolium,36,0,36,Points-PointsKO-Adjacents,162
Tetradium_glabrifolium,196,129,67,Alphahull-PointsKO-Adjacents,4304
Tetradium_ruticarpum,152,118,34,Alphahull-PointsKO-Adjacents,15130
Tetradium_sambucinum,0,0,0,NA,0
Tetragastris_altissima,740,652,88,Alphahull-PointsKO-Adjacents,63356
Tetragastris_balsamifera,64,46,18,Alphahull-PointsKO-Adjacents,551
Tetragastris_breviacuminata,7,3,4,Points-PointsKO-Adjacents,21
Tetragastris_catuaba,51,33,18,Alphahull-PointsKO-Adjacents,251
Tetragastris_hostmannii,58,38,20,Alphahull-PointsKO-Adjacents,2370
Tetragastris_mucronata,26,9,17,Points-PointsKO-Adjacents,206
Tetragastris_occhionii,59,38,21,Alphahull-PointsKO-Adjacents,209
Tetragastris_panamensis,1142,1012,130,Alphahull-PointsKO-Adjacents,74664
Tetragastris_varians,15,11,4,Points-PointsKO-Adjacents,82
Tetrameles_nudiflora,60,27,33,Alphahull-PointsKO-Adjacents,897
Tetrameranthus_duckei,29,16,13,Points-PointsKO-Adjacents,131
Tetrameranthus_globulifer,7,2,5,Points-PointsKO-Adjacents,39
Tetrameranthus_laomae,54,26,28,Alphahull-PointsKO-Adjacents,642
Tetrameranthus_pachycarpus,14,9,5,Points-PointsKO-Adjacents,78
Tetrameranthus_umbellatus,17,3,14,Points-PointsKO-Adjacents,121
Tetranthera_angulata,8,1,7,Points-PointsKO-Adjacents,60
Tetrapanax_papyrifer,86,42,44,Alphahull-PointsKO-Adjacents,3506
Tetrapleura_chevalieri,18,9,9,Points-PointsKO-Adjacents,154
Tetrapleura_tetraptera,297,225,72,Alphahull-PointsKO-Adjacents,7033
Tetrapterocarpon_geayi,97,78,19,Alphahull-PointsKO-Adjacents,1591
Tetrapterocarpon_septentrionalis,19,10,9,Points-PointsKO-Adjacents,92
Tetrapterys_aristeguietae,1,1,0,Points-PointsKO-Adjacents,9
Tetrapterys_citrifolia,0,0,0,NA,0
Tetrapterys_styloptera,242,0,242,Points-PointsKO-Adjacents,1587
Tetrasida_chachapoyensis,11,8,3,Points-PointsKO-Adjacents,64
Tetrastylidium_grandifolium,182,0,182,Points-PointsKO-Adjacents,1071
Tetrastylidium_peruvianum,86,0,86,Points-PointsKO-Adjacents,466
Tetrataxis_salicifolia,0,0,0,NA,0
Tetrathylacium_johansenii,86,55,31,Alphahull-PointsKO-Adjacents,720
Tetrathylacium_macrophyllum,644,591,53,Alphahull-PointsKO-Adjacents,19982
Tetrazygia_angustifolia,45,14,31,Points-PointsKO-Adjacents,262
Tetrazygia_bicolor,114,71,43,Alphahull-PointsKO-Adjacents,1747
Tetrazygia_biflora,10,8,2,Points-PointsKO-Adjacents,45
Tetrazygia_crotonifolia,55,46,9,Alphahull-PointsKO-Adjacents,172
Tetrazygia_discolor,26,12,14,Points-PointsKO-Adjacents,80
Tetrazygia_eleagnoides,47,27,20,Alphahull-PointsKO-Adjacents,166
Tetrazygia_urbanii,21,16,5,Points-PointsKO-Adjacents,63
Tetrazygia_urceolata,3,3,0,Points-PointsKO-Adjacents,18
Tetrazygiopsis_brachycentra,7,3,4,Points-PointsKO-Adjacents,62
Tetrazygiopsis_cordata,2,2,0,Points-PointsKO-Adjacents,9
Tetrazygiopsis_ekmanii,1,1,0,Points-PointsKO-Adjacents,8
Tetrazygiopsis_longicollis,19,13,6,Points-PointsKO-Adjacents,99
Tetrorchidium_andinum,144,105,39,Alphahull-PointsKO-Adjacents,2512
Tetrorchidium_brevifolium,17,9,8,Points-PointsKO-Adjacents,48
Tetrorchidium_bulbipilosum,9,4,5,Points-PointsKO-Adjacents,62
Tetrorchidium_costaricense,27,18,9,Points-PointsKO-Adjacents,100
Tetrorchidium_didymostemon,325,253,72,Alphahull-PointsKO-Adjacents,8755
Tetrorchidium_duckei,2,2,0,Points-PointsKO-Adjacents,18
Tetrorchidium_dusenii,28,8,20,Points-PointsKO-Adjacents,237
Tetrorchidium_euryphyllum,153,122,31,Alphahull-PointsKO-Adjacents,969
Tetrorchidium_hirsutum,7,3,4,Points-PointsKO-Adjacents,42
Tetrorchidium_jamaicense,2,1,1,Points-PointsKO-Adjacents,14
Tetrorchidium_macrophyllum,282,245,37,Alphahull-PointsKO-Adjacents,6499
Tetrorchidium_microphyllum,2,1,1,Points-PointsKO-Adjacents,16
Tetrorchidium_ochroleucum,49,36,13,Alphahull-PointsKO-Adjacents,563
Tetrorchidium_popayanense,9,1,8,Points-PointsKO-Adjacents,67
Tetrorchidium_robledoanum,34,22,12,Alphahull-PointsKO-Adjacents,175
Tetrorchidium_rotundatum,102,79,23,Alphahull-PointsKO-Adjacents,2690
Tetrorchidium_rubrivenium,729,595,134,Alphahull-PointsKO-Adjacents,23613
Tetrorchidium_ulugurense,5,5,0,Points-PointsKO-Adjacents,15
Thailentadopsis_tenuis,9,2,7,Points-PointsKO-Adjacents,81
Thaleropia_hypargyrea,0,0,0,NA,0
Thaleropia_iteophylla,3,3,0,Points-PointsKO-Adjacents,14
Thaleropia_queenslandica,41,0,41,Points-PointsKO-Adjacents,75
Thecacoris_cometia,72,43,29,Alphahull-PointsKO-Adjacents,631
Thecacoris_grandifolia,9,4,5,Points-PointsKO-Adjacents,55
Thecacoris_humbertii,3,3,0,Points-PointsKO-Adjacents,26
Thecacoris_leptobotrya,72,55,17,Alphahull-PointsKO-Adjacents,1407
Thecacoris_lucida,50,25,25,Alphahull-PointsKO-Adjacents,1184
Thecacoris_madagascariensis,83,61,22,Alphahull-PointsKO-Adjacents,753
Thecacoris_perrieri,86,61,25,Alphahull-PointsKO-Adjacents,697
Thecacoris_trichogyne,59,33,26,Alphahull-PointsKO-Adjacents,1446
Themistoclesia_hirsuta,0,0,0,NA,0
Theobroma_angustifolium,78,63,15,Alphahull-PointsKO-Adjacents,722
Theobroma_bernoullii,66,47,19,Alphahull-PointsKO-Adjacents,475
Theobroma_bicolor,188,108,80,Alphahull-PointsKO-Adjacents,11350
Theobroma_cacao,456,347,109,Alphahull-PointsKO-Adjacents,12859
Theobroma_canumanense,6,0,6,Points-PointsKO-Adjacents,54
Theobroma_cirmolinae,6,1,5,Points-PointsKO-Adjacents,54
Theobroma_duckei,2,2,0,Points-PointsKO-Adjacents,18
Theobroma_gileri,23,13,10,Points-PointsKO-Adjacents,116
Theobroma_glaucum,76,58,18,Alphahull-PointsKO-Adjacents,3902
Theobroma_grandiflorum,146,76,70,Alphahull-PointsKO-Adjacents,17311
Theobroma_hylaeum,8,2,6,Points-PointsKO-Adjacents,60
Theobroma_mammosum,34,25,9,Alphahull-PointsKO-Adjacents,293
Theobroma_microcarpum,116,73,43,Alphahull-PointsKO-Adjacents,15164
Theobroma_nemorale,8,0,8,Points-PointsKO-Adjacents,61
Theobroma_obovatum,136,104,32,Alphahull-PointsKO-Adjacents,10778
Theobroma_simiarum,44,33,11,Alphahull-PointsKO-Adjacents,517
Theobroma_sinuosum,4,4,0,Points-PointsKO-Adjacents,35
Theobroma_speciosum,478,421,57,Alphahull-PointsKO-Adjacents,36909
Theobroma_subincanum,861,794,67,Alphahull-PointsKO-Adjacents,55293
Theobroma_velutinum,33,0,33,Points-PointsKO-Adjacents,258
Thespesia_acutiloba,30,23,7,Alphahull-PointsKO-Adjacents,290
Thespesia_danis,23,9,14,Points-PointsKO-Adjacents,171
Thespesia_grandiflora,23,14,9,Points-PointsKO-Adjacents,92
Thespesia_gummiflua,18,11,7,Points-PointsKO-Adjacents,51
Thespesia_lampas,36,4,32,Points-PointsKO-Adjacents,281
Thespesia_populnea,321,125,196,Alphahull-PointsKO-Adjacents,4674
Thespesia_populneoides,342,254,88,Alphahull-PointsKO-Adjacents,7765
Thespesia_trilobata,3,3,0,Points-PointsKO-Adjacents,27
Thevetia_ahouai,921,783,138,Alphahull-PointsKO-Adjacents,14308
Thibaudia_floribunda,312,265,47,Alphahull-PointsKO-Adjacents,3302
Thilachium_africanum,53,22,31,Alphahull-PointsKO-Adjacents,2430
Thilachium_densiflorum,10,5,5,Points-PointsKO-Adjacents,71
Thilachium_humbertii,2,2,0,Points-PointsKO-Adjacents,18
Thilachium_laurifolium,16,9,7,Points-PointsKO-Adjacents,81
Thilachium_monophyllum,13,0,13,Points-PointsKO-Adjacents,99
Thilachium_pouponii,13,7,6,Points-PointsKO-Adjacents,94
Thilachium_seyrigii,16,11,5,Points-PointsKO-Adjacents,106
Thilachium_thomasii,18,11,7,Points-PointsKO-Adjacents,128
Thinouia_ventricosa,8,0,8,Points-PointsKO-Adjacents,56
Thiollierea_kaalaensis,2,2,0,Points-PointsKO-Adjacents,8
Thiollierea_lenormandii,4,4,0,Points-PointsKO-Adjacents,21
Thiollierea_macrophylla,10,5,5,Points-PointsKO-Adjacents,65
Thiollierea_pachyphylla,4,4,0,Points-PointsKO-Adjacents,17
Thiollierea_rigaultii,1,1,0,Points-PointsKO-Adjacents,9
Thogsennia_lindeniana,2,2,0,Points-PointsKO-Adjacents,17
Thomandersia_congolana,69,39,30,Alphahull-PointsKO-Adjacents,635
Thomandersia_hensii,297,255,42,Alphahull-PointsKO-Adjacents,16568
Thouinia_acuminata,29,18,11,Points-PointsKO-Adjacents,142
Thouinia_paucidentata,310,270,40,Alphahull-PointsKO-Adjacents,2806
Thouinia_portoricensis,44,30,14,Alphahull-PointsKO-Adjacents,102
Thouinia_serrata,138,98,40,Alphahull-PointsKO-Adjacents,2670
Thouinia_striata,45,33,12,Alphahull-PointsKO-Adjacents,92
Thouinia_velutina,7,1,6,Points-PointsKO-Adjacents,47
Thouinia_villosa,191,154,37,Alphahull-PointsKO-Adjacents,4594
Thouinidium_decandrum,400,332,68,Alphahull-PointsKO-Adjacents,6322
Thouinia_pinnata,4,4,0,Points-PointsKO-Adjacents,28
Thouinia_pulverulenta,1,1,0,Points-PointsKO-Adjacents,6
Thrinax_excelsa,5,5,0,Points-PointsKO-Adjacents,45
Thrinax_parviflora,12,6,6,Points-PointsKO-Adjacents,61
Thrinax_radiata,226,0,226,Points-PointsKO-Adjacents,791
Thuja_koraiensis,12,5,7,Points-PointsKO-Adjacents,65
Thuja_occidentalis,7287,6872,415,Alphahull-PointsKO-Adjacents,40345
Thuja_plicata,4051,3777,274,Alphahull-PointsKO-Adjacents,14495
Thuja_standishii,176,139,37,Alphahull-PointsKO-Adjacents,1346
Thuja_sutchuenensis,1,1,0,Points-PointsKO-Adjacents,9
Thujopsis_dolabrata,109,78,31,Alphahull-PointsKO-Adjacents,1495
Thyrsanthera_suborbicularis,3,3,0,Points-PointsKO-Adjacents,27
Thyrsodium_bolivianum,36,18,18,Points-PointsKO-Adjacents,292
Thyrsodium_guianense,61,42,19,Alphahull-PointsKO-Adjacents,1573
Thyrsodium_herrerense,13,4,9,Points-PointsKO-Adjacents,90
Thyrsodium_puberulum,42,28,14,Alphahull-PointsKO-Adjacents,2036
Thyrsodium_rondonianum,85,62,23,Alphahull-PointsKO-Adjacents,7490
Thyrsodium_spruceanum,738,582,156,Alphahull-PointsKO-Adjacents,40795
Thysanostemon_fanshawei,4,3,1,Points-PointsKO-Adjacents,36
Tibouchina_andreana,34,23,11,Alphahull-PointsKO-Adjacents,202
Tibouchina_aspera,400,284,116,Alphahull-PointsKO-Adjacents,20971
Tibouchina_barnebyana,88,80,8,Alphahull-PointsKO-Adjacents,528
Tibouchina_bipenicillata,121,82,39,Alphahull-PointsKO-Adjacents,2487
Tibouchina_boudetii,19,12,7,Points-PointsKO-Adjacents,103
Tibouchina_candolleana,401,352,49,Alphahull-PointsKO-Adjacents,9728
Tibouchina_canescens,71,54,17,Alphahull-PointsKO-Adjacents,701
Tibouchina_ciliaris,89,70,19,Alphahull-PointsKO-Adjacents,1309
Tibouchina_clavata,101,68,33,Alphahull-PointsKO-Adjacents,573
Tibouchina_cryptadena,15,2,13,Points-PointsKO-Adjacents,110
Tibouchina_dusenii,30,15,15,Points-PointsKO-Adjacents,206
Tibouchina_estrellensis,342,0,342,Points-PointsKO-Adjacents,1704
Tibouchina_fissinervia,316,278,38,Alphahull-PointsKO-Adjacents,5785
Tibouchina_francavillana,76,48,28,Alphahull-PointsKO-Adjacents,1333
Tibouchina_gleasoniana,28,18,10,Points-PointsKO-Adjacents,115
Tibouchina_granulosa,172,101,71,Alphahull-PointsKO-Adjacents,4317
Tibouchina_grossa,374,348,26,Alphahull-PointsKO-Adjacents,2585
Tibouchina_inopinata,49,34,15,Alphahull-PointsKO-Adjacents,84
Tibouchina_kuhlmannii,10,0,10,Points-PointsKO-Adjacents,59
Tibouchina_lepidota,600,538,62,Alphahull-PointsKO-Adjacents,4504
Tibouchina_lindeniana,72,54,18,Alphahull-PointsKO-Adjacents,1450
Tibouchina_longifolia,1034,873,161,Alphahull-PointsKO-Adjacents,20746
Tibouchina_mollis,289,262,27,Alphahull-PointsKO-Adjacents,2504
Tibouchina_mutabilis,112,76,36,Alphahull-PointsKO-Adjacents,1430
Tibouchina_ochypetala,127,100,27,Alphahull-PointsKO-Adjacents,2427
Tibouchina_paleacea,16,6,10,Points-PointsKO-Adjacents,138
Tibouchina_papyrus,41,29,12,Alphahull-PointsKO-Adjacents,513
Tibouchina_pogonanthera,32,1,31,Points-PointsKO-Adjacents,242
Tibouchina_pulchra,323,271,52,Alphahull-PointsKO-Adjacents,2245
Tibouchina_regnellii,75,59,16,Alphahull-PointsKO-Adjacents,631
Tibouchina_reitzii,107,90,17,Alphahull-PointsKO-Adjacents,585
Tibouchina_rhynchantherifolia,4,4,0,Points-PointsKO-Adjacents,36
Tibouchina_rigidula,28,17,11,Points-PointsKO-Adjacents,199
Tibouchina_sellowiana,477,424,53,Alphahull-PointsKO-Adjacents,6292
Tibouchina_solmsii,3,3,0,Points-PointsKO-Adjacents,27
Tibouchina_stenocarpa,779,662,117,Alphahull-PointsKO-Adjacents,28602
Tibouchina_velutina,64,44,20,Alphahull-PointsKO-Adjacents,848
Tibouchinopsis_mirabilis,10,6,4,Points-PointsKO-Adjacents,29
Ticodendron_incognitum,47,0,47,Points-PointsKO-Adjacents,187
Ticorea_longiflora,58,29,29,Alphahull-PointsKO-Adjacents,4286
Ticorea_tubiflora,127,73,54,Alphahull-PointsKO-Adjacents,17086
Tieghemella_africana,49,31,18,Alphahull-PointsKO-Adjacents,1089
Tieghemella_heckelii,30,16,14,Points-PointsKO-Adjacents,210
Tilesia_baccata,529,404,125,Alphahull-PointsKO-Adjacents,39084
Tilia_amurensis,257,0,257,Points-PointsKO-Adjacents,1321
Tilia_begoniifolia,1,1,0,Points-PointsKO-Adjacents,9
Tilia_callidonta,3,3,0,Points-PointsKO-Adjacents,27
Tilia_chinensis,49,28,21,Alphahull-PointsKO-Adjacents,1544
Tilia_chingiana,10,3,7,Points-PointsKO-Adjacents,86
Tilia_cordata,40382,35296,5086,Alphahull-PointsKO-Adjacents,70102
Tilia_dasystyla,9,3,6,Points-PointsKO-Adjacents,60
Tilia_endochrysea,32,17,15,Points-PointsKO-Adjacents,288
Tilia_henryana,9,0,9,Points-PointsKO-Adjacents,81
Tilia_japonica,362,296,66,Alphahull-PointsKO-Adjacents,2766
Tilia_jiaodongensis,NA,NA,NA,NA,NA
Tilia_kueichouensis,3,3,0,Points-PointsKO-Adjacents,27
Tilia_likiangensis,2,2,0,Points-PointsKO-Adjacents,18
Tilia_mandshurica,15,2,13,Points-PointsKO-Adjacents,129
Tilia_membranacea,3,3,0,Points-PointsKO-Adjacents,27
Tilia_miqueliana,47,11,36,Points-PointsKO-Adjacents,305
Tilia_mongolica,16,0,16,Points-PointsKO-Adjacents,144
Tilia_nobilis,8,5,3,Points-PointsKO-Adjacents,72
Tilia_oliveri,27,13,14,Points-PointsKO-Adjacents,243
Tilia_paucicostata,37,12,25,Points-PointsKO-Adjacents,330
Tilia_platyphyllos,17684,14280,3404,Alphahull-PointsKO-Adjacents,42433
Tilia_rubra,5,0,5,Points-PointsKO-Adjacents,45
Tilia_tomentosa,118,64,54,Alphahull-PointsKO-Adjacents,5629
Tilia_tuan,53,26,27,Alphahull-PointsKO-Adjacents,4129
Timonius_akunensis,2,2,0,Points-PointsKO-Adjacents,9
Timonius_albus,0,0,0,NA,0
Timonius_amboinicus,3,3,0,Points-PointsKO-Adjacents,21
Timonius_amungwiwanensis,1,1,0,Points-PointsKO-Adjacents,9
Timonius_appendiculatus,1,1,0,Points-PointsKO-Adjacents,9
Timonius_arboreus,10,3,7,Points-PointsKO-Adjacents,28
Timonius_argenteus,2,2,0,Points-PointsKO-Adjacents,18
Timonius_avenis,19,0,19,Points-PointsKO-Adjacents,145
Timonius_belensis,47,0,47,Points-PointsKO-Adjacents,318
Timonius_billitonensis,0,0,0,NA,0
Timonius_bismarckensis,9,2,7,Points-PointsKO-Adjacents,56
Timonius_bogoriensis,NA,NA,NA,NA,NA
Timonius_borneensis,16,6,10,Points-PointsKO-Adjacents,138
Timonius_bougainvillensis,0,0,0,NA,0
Timonius_bracteatus,1,1,0,Points-PointsKO-Adjacents,9
Timonius_bracteoides,0,0,0,NA,0
Timonius_branderhorstii,4,4,0,Points-PointsKO-Adjacents,36
Timonius_carii,4,4,0,Points-PointsKO-Adjacents,21
Timonius_carstensensis,2,2,0,Points-PointsKO-Adjacents,18
Timonius_celebicus,4,4,0,Points-PointsKO-Adjacents,27
Timonius_clathratus,9,4,5,Points-PointsKO-Adjacents,47
Timonius_clementis,0,0,0,NA,0
Timonius_corneri,2,2,0,Points-PointsKO-Adjacents,9
Timonius_corymbosus,1,1,0,Points-PointsKO-Adjacents,7
Timonius_cryptophlebus,1,1,0,Points-PointsKO-Adjacents,9
Timonius_decipiens,3,3,0,Points-PointsKO-Adjacents,26
Timonius_diffusus,1,1,0,Points-PointsKO-Adjacents,9
Timonius_dolichophyllus,6,0,6,Points-PointsKO-Adjacents,50
Timonius_elegans,0,0,0,NA,0
Timonius_esherianus,1,0,1,Points-PointsKO-Adjacents,9
Timonius_ferrugineus,0,0,0,NA,0
Timonius_finlaysonianus,0,0,0,NA,0
Timonius_flavescens,56,27,29,Alphahull-PointsKO-Adjacents,494
Timonius_glabrior,NA,NA,NA,NA,NA
Timonius_grandifolius,7,0,7,Points-PointsKO-Adjacents,53
Timonius_hentyi,0,0,0,NA,0
Timonius_heptamerus,1,1,0,Points-PointsKO-Adjacents,9
Timonius_hydrangeifolius,0,0,0,NA,0
Timonius_imitans,1,1,0,Points-PointsKO-Adjacents,9
Timonius_klossii,1,1,0,Points-PointsKO-Adjacents,9
Timonius_koikokoensis,3,3,0,Points-PointsKO-Adjacents,25
Timonius_koordersii,7,0,7,Points-PointsKO-Adjacents,43
Timonius_korrensis,0,0,0,NA,0
Timonius_kostermansii,0,0,0,NA,0
Timonius_lageniferus,5,5,0,Points-PointsKO-Adjacents,26
Timonius_lamii,0,0,0,NA,0
Timonius_lasianthoides,12,4,8,Points-PointsKO-Adjacents,108
Timonius_laxus,0,0,0,NA,0
Timonius_ledermannii,3,2,1,Points-PointsKO-Adjacents,12
Timonius_leptocalyx,0,0,0,NA,0
Timonius_longifolius,2,2,0,Points-PointsKO-Adjacents,18
Timonius_longitubus,9,1,8,Points-PointsKO-Adjacents,60
Timonius_matangensis,NA,NA,NA,NA,NA
Timonius_meridionalis,5,5,0,Points-PointsKO-Adjacents,35
Timonius_merokensis,1,1,0,Points-PointsKO-Adjacents,9
Timonius_minahassae,16,5,11,Points-PointsKO-Adjacents,104
Timonius_modestus,6,2,4,Points-PointsKO-Adjacents,48
Timonius_mollis,0,0,0,NA,0
Timonius_moluccanus,1,1,0,Points-PointsKO-Adjacents,8
Timonius_morobensis,5,5,0,Points-PointsKO-Adjacents,30
Timonius_neobritannicus,8,2,6,Points-PointsKO-Adjacents,33
Timonius_nitens,4,4,0,Points-PointsKO-Adjacents,36
Timonius_oblongus,2,2,0,Points-PointsKO-Adjacents,18
Timonius_oreophilus,1,1,0,Points-PointsKO-Adjacents,9
Timonius_ovalis,0,0,0,NA,0
Timonius_pachyphyllus,0,0,0,NA,0
Timonius_papuanus,1,1,0,Points-PointsKO-Adjacents,9
Timonius_platycarpus,5,5,0,Points-PointsKO-Adjacents,44
Timonius_polyneurus,0,0,0,NA,0
Timonius_pseudaffinis,0,0,0,NA,0
Timonius_pseudocapitatus,0,0,0,NA,0
Timonius_pubistipulus,54,42,12,Alphahull-PointsKO-Adjacents,630
Timonius_reflexus,0,0,0,NA,0
Timonius_repertus,1,1,0,Points-PointsKO-Adjacents,9
Timonius_rigidus,0,0,0,NA,0
Timonius_rivularis,2,2,0,Points-PointsKO-Adjacents,18
Timonius_rosselensis,0,0,0,NA,0
Timonius_rufescens,12,0,12,Points-PointsKO-Adjacents,62
Timonius_rufus,0,0,0,NA,0
Timonius_salsedoi,0,0,0,NA,0
Timonius_scaber,NA,NA,NA,NA,NA
Timonius_scabriflorus,2,2,0,Points-PointsKO-Adjacents,18
Timonius_schefferi,1,1,0,Points-PointsKO-Adjacents,7
Timonius_schumannii,0,0,0,NA,0
Timonius_secundiflorus,5,5,0,Points-PointsKO-Adjacents,34
Timonius_sessilis,0,0,0,NA,0
Timonius_singularis,99,85,14,Alphahull-PointsKO-Adjacents,228
Timonius_splendens,0,0,0,NA,0
Timonius_subauritus,4,4,0,Points-PointsKO-Adjacents,12
Timonius_subavenis,3,3,0,Points-PointsKO-Adjacents,21
Timonius_subcoriaceus,6,1,5,Points-PointsKO-Adjacents,54
Timonius_subsessilis,3,2,1,Points-PointsKO-Adjacents,25
Timonius_sylvestris,3,3,0,Points-PointsKO-Adjacents,27
Timonius_teysmannii,0,0,0,NA,0
Timonius_timon,1264,1123,141,Alphahull-PointsKO-Adjacents,17287
Timonius_tomentosus,2,2,0,Points-PointsKO-Adjacents,18
Timonius_trichanthus,29,17,12,Points-PointsKO-Adjacents,195
Timonius_trichocladus,2,2,0,Points-PointsKO-Adjacents,18
Timonius_trichophorus,0,0,0,NA,0
Timonius_uniflorus,19,1,18,Points-PointsKO-Adjacents,71
Timonius_versteegii,NA,NA,NA,NA,NA
Timonius_villamilii,19,11,8,Points-PointsKO-Adjacents,144
Timonius_wallichianus,9,0,9,Points-PointsKO-Adjacents,81
Timonius_wollastonii,1,1,0,Points-PointsKO-Adjacents,9
Timonius_wrayi,1,1,0,Points-PointsKO-Adjacents,9
Timonius_xanthocarpus,2,2,0,Points-PointsKO-Adjacents,18
Timonius_zuckianus,5,1,4,Points-PointsKO-Adjacents,25
Tina_antongiliensis,16,7,9,Points-PointsKO-Adjacents,107
Tina_apiculata,18,5,13,Points-PointsKO-Adjacents,116
Tina_chapelieriana,91,69,22,Alphahull-PointsKO-Adjacents,1587
Tina_chrysophylla,4,4,0,Points-PointsKO-Adjacents,36
Tina_conjugata,53,31,22,Alphahull-PointsKO-Adjacents,441
Tina_coursii,23,12,11,Points-PointsKO-Adjacents,101
Tina_dasycarpa,14,8,6,Points-PointsKO-Adjacents,78
Tina_dissitiflora,27,11,16,Points-PointsKO-Adjacents,202
Tina_isaloensis,44,24,20,Alphahull-PointsKO-Adjacents,402
Tina_isoneura,47,29,18,Alphahull-PointsKO-Adjacents,1675
Tina_macrocarpa,12,5,7,Points-PointsKO-Adjacents,84
Tina_phellocarpa,39,22,17,Alphahull-PointsKO-Adjacents,611
Tina_striata,241,213,28,Alphahull-PointsKO-Adjacents,2648
Tina_suarezensis,8,3,5,Points-PointsKO-Adjacents,27
Tina_tamatavensis,4,4,0,Points-PointsKO-Adjacents,20
Tina_thouarsiana,82,55,27,Alphahull-PointsKO-Adjacents,587
Tina_urschii,15,10,5,Points-PointsKO-Adjacents,21
Tina_vadonii,7,1,6,Points-PointsKO-Adjacents,51
Tinadendron_noumeanum,6,2,4,Points-PointsKO-Adjacents,16
Tinnea_somalensis,13,7,6,Points-PointsKO-Adjacents,85
Tipuana_tipu,126,93,33,Alphahull-PointsKO-Adjacents,1983
Tirpitzia_sinensis,44,29,15,Alphahull-PointsKO-Adjacents,1565
Tisonia_baillonii,8,0,8,Points-PointsKO-Adjacents,64
Tisonia_baronii,17,10,7,Points-PointsKO-Adjacents,120
Tisonia_capuronii,7,2,5,Points-PointsKO-Adjacents,34
Tisonia_cloiselii,1,1,0,Points-PointsKO-Adjacents,6
Tisonia_coriacea,67,48,19,Alphahull-PointsKO-Adjacents,699
Tisonia_ficulnea,10,3,7,Points-PointsKO-Adjacents,78
Tisonia_glabrata,8,0,8,Points-PointsKO-Adjacents,64
Tisonia_humbertii,8,2,6,Points-PointsKO-Adjacents,62
Tisonia_keraudrenae,8,2,6,Points-PointsKO-Adjacents,64
Tisonia_leandriana,7,6,1,Points-PointsKO-Adjacents,52
Tisonia_rubescens,8,0,8,Points-PointsKO-Adjacents,58
Tithonia_koelzii,6,1,5,Points-PointsKO-Adjacents,24
Tithonia_longiradiata,253,202,51,Alphahull-PointsKO-Adjacents,2240
Tococa_aristata,128,112,16,Alphahull-PointsKO-Adjacents,1252
Tococa_bullifera,130,80,50,Alphahull-PointsKO-Adjacents,9052
Tococa_capitata,66,43,23,Alphahull-PointsKO-Adjacents,2145
Tococa_caquetana,167,136,31,Alphahull-PointsKO-Adjacents,7188
Tococa_caudata,50,29,21,Alphahull-PointsKO-Adjacents,700
Tococa_cinnamomea,8,0,8,Points-PointsKO-Adjacents,72
Tococa_cordata,10,3,7,Points-PointsKO-Adjacents,66
Tococa_coronata,530,473,57,Alphahull-PointsKO-Adjacents,45400
Tococa_erioneura,15,10,5,Points-PointsKO-Adjacents,49
Tococa_erythrophylla,36,22,14,Alphahull-PointsKO-Adjacents,341
Tococa_guianensis,2342,2210,132,Alphahull-PointsKO-Adjacents,112791
Tococa_macrophysca,99,80,19,Alphahull-PointsKO-Adjacents,3324
Tococa_macroptera,12,3,9,Points-PointsKO-Adjacents,88
Tococa_macrosperma,249,201,48,Alphahull-PointsKO-Adjacents,15038
Tococa_parviflora,31,0,31,Points-PointsKO-Adjacents,249
Tococa_spadiciflora,93,72,21,Alphahull-PointsKO-Adjacents,589
Tococa_stellata,1,1,0,Points-PointsKO-Adjacents,9
Tococa_stenoptera,28,0,28,Points-PointsKO-Adjacents,201
Tococa_stephanotricha,34,19,15,Points-PointsKO-Adjacents,224
Tococa_subciliata,111,65,46,Alphahull-PointsKO-Adjacents,7385
Tococa_tepuiensis,39,26,13,Alphahull-PointsKO-Adjacents,1514
Tocoyena_brasiliensis,414,276,138,Alphahull-PointsKO-Adjacents,41830
Tocoyena_brevifolia,12,6,6,Points-PointsKO-Adjacents,65
Tocoyena_bullata,239,140,99,Alphahull-PointsKO-Adjacents,4345
Tocoyena_costanensis,31,8,23,Points-PointsKO-Adjacents,230
Tocoyena_foetida,42,12,30,Points-PointsKO-Adjacents,369
Tocoyena_formosa,2086,1933,153,Alphahull-PointsKO-Adjacents,53197
Tocoyena_guianensis,75,28,47,Alphahull-PointsKO-Adjacents,1381
Tocoyena_longiflora,56,23,33,Alphahull-PointsKO-Adjacents,1053
Tocoyena_megistantha,13,2,11,Points-PointsKO-Adjacents,108
Tocoyena_pendulina,5,5,0,Points-PointsKO-Adjacents,45
Tocoyena_pittieri,117,91,26,Alphahull-PointsKO-Adjacents,2020
Tocoyena_sellowiana,107,0,107,Points-PointsKO-Adjacents,625
Tocoyena_williamsii,170,113,57,Alphahull-PointsKO-Adjacents,7442
Toddaliopsis_bremekampii,37,23,14,Alphahull-PointsKO-Adjacents,1074
Toechima_erythrocarpum,158,146,12,Alphahull-PointsKO-Adjacents,204
Tontelea_attenuata,138,0,138,Points-PointsKO-Adjacents,961
Tontelea_coriacea,93,22,71,Alphahull-PointsKO-Adjacents,672
Tontelea_corymbosa,16,4,12,Points-PointsKO-Adjacents,136
Tontelea_divergens,16,3,13,Points-PointsKO-Adjacents,126
Tontelea_emarginata,33,5,28,Points-PointsKO-Adjacents,270
Tontelea_hondurensis,21,10,11,Points-PointsKO-Adjacents,140
Tontelea_leptophylla,41,25,16,Alphahull-PointsKO-Adjacents,648
Tontelea_mauritioides,85,18,67,Points-PointsKO-Adjacents,645
Tontelea_passiflora,166,76,90,Alphahull-PointsKO-Adjacents,10125
Toona_ciliata,1097,924,173,Alphahull-PointsKO-Adjacents,5670
Toona_fargesii,2,2,0,Points-PointsKO-Adjacents,18
Toona_sureni,26,4,22,Points-PointsKO-Adjacents,203
Topobea_aeruginosa,15,6,9,Points-PointsKO-Adjacents,63
Topobea_amplifolia,1,1,0,Points-PointsKO-Adjacents,9
Topobea_brachyura,27,15,12,Points-PointsKO-Adjacents,186
Topobea_calycularis,41,31,10,Alphahull-PointsKO-Adjacents,240
Topobea_fragrantissima,9,1,8,Points-PointsKO-Adjacents,39
Topobea_induta,1,1,0,Points-PointsKO-Adjacents,9
Topobea_laevigata,117,98,19,Alphahull-PointsKO-Adjacents,1254
Topobea_macbrydei,1,1,0,Points-PointsKO-Adjacents,9
Topobea_maguirei,2,2,0,Points-PointsKO-Adjacents,15
Topobea_maurofernandeziana,230,199,31,Alphahull-PointsKO-Adjacents,1041
Topobea_multiflora,174,131,43,Alphahull-PointsKO-Adjacents,1663
Topobea_parvifolia,5,5,0,Points-PointsKO-Adjacents,18
Topobea_pascoensis,4,4,0,Points-PointsKO-Adjacents,33
Topobea_pluvialis,4,4,0,Points-PointsKO-Adjacents,25
Topobea_standleyi,1,1,0,Points-PointsKO-Adjacents,9
Topobea_suaveolens,4,3,1,Points-PointsKO-Adjacents,22
Topobea_verrucosa,1,1,0,Points-PointsKO-Adjacents,9
Toronia_toru,347,318,29,Alphahull-PointsKO-Adjacents,1381
Torralbasia_cuneifolia,36,16,20,Points-PointsKO-Adjacents,210
Torreya_californica,468,435,33,Alphahull-PointsKO-Adjacents,1812
Torreya_fargesii,39,22,17,Alphahull-PointsKO-Adjacents,1346
Torreya_grandis,49,25,24,Alphahull-PointsKO-Adjacents,2040
Torreya_jackii,4,4,0,Points-PointsKO-Adjacents,34
Torreya_nucifera,456,308,148,Alphahull-PointsKO-Adjacents,3356
Torreya_taxifolia,30,15,15,Points-PointsKO-Adjacents,125
Toubaouate_brevipaniculata,55,38,17,Alphahull-PointsKO-Adjacents,579
Touchardia_latifolia,8,5,3,Points-PointsKO-Adjacents,48
Toulicia_bullata,11,1,10,Points-PointsKO-Adjacents,90
Toulicia_crassifolia,49,33,16,Alphahull-PointsKO-Adjacents,814
Toulicia_elliptica,26,1,25,Points-PointsKO-Adjacents,214
Toulicia_eriocarpa,11,0,11,Points-PointsKO-Adjacents,90
Toulicia_guianensis,237,164,73,Alphahull-PointsKO-Adjacents,21586
Toulicia_laevigata,78,53,25,Alphahull-PointsKO-Adjacents,2108
Toulicia_megalocarpa,5,5,0,Points-PointsKO-Adjacents,33
Toulicia_patentinervis,21,7,14,Points-PointsKO-Adjacents,177
Toulicia_petiolulata,8,2,6,Points-PointsKO-Adjacents,71
Toulicia_pulvinata,51,19,32,Points-PointsKO-Adjacents,438
Toulicia_reticulata,111,61,50,Alphahull-PointsKO-Adjacents,10634
Toulicia_stans,9,0,9,Points-PointsKO-Adjacents,69
Toulicia_subsquamulata,16,9,7,Points-PointsKO-Adjacents,122
Toulicia_tomentosa,86,46,40,Alphahull-PointsKO-Adjacents,3574
Tournefortia_acutiflora,221,166,55,Alphahull-PointsKO-Adjacents,5670
Tournefortia_angustiflora,157,114,43,Alphahull-PointsKO-Adjacents,4787
Tournefortia_astrotricha,2,2,0,Points-PointsKO-Adjacents,16
Tournefortia_bicolor,828,570,258,Alphahull-PointsKO-Adjacents,28675
Tournefortia_bojeri,0,0,0,NA,0
Tournefortia_brantii,18,12,6,Points-PointsKO-Adjacents,65
Tournefortia_brevilobata,8,0,8,Points-PointsKO-Adjacents,63
Tournefortia_cuspidata,317,0,317,Points-PointsKO-Adjacents,1846
Tournefortia_elongata,69,41,28,Alphahull-PointsKO-Adjacents,2677
Tournefortia_filiflora,23,8,15,Points-PointsKO-Adjacents,116
Tournefortia_foetidissima,44,16,28,Points-PointsKO-Adjacents,358
Tournefortia_fuliginosa,250,208,42,Alphahull-PointsKO-Adjacents,3422
Tournefortia_gigantifolia,77,56,21,Alphahull-PointsKO-Adjacents,1881
Tournefortia_glabra,881,759,122,Alphahull-PointsKO-Adjacents,16162
Tournefortia_hirsutissima,418,296,122,Alphahull-PointsKO-Adjacents,8636
Tournefortia_johnstonii,57,50,7,Alphahull-PointsKO-Adjacents,105
Tournefortia_killipii,3,3,0,Points-PointsKO-Adjacents,18
Tournefortia_lilloi,71,45,26,Alphahull-PointsKO-Adjacents,858
Tournefortia_loxensis,38,23,15,Alphahull-PointsKO-Adjacents,453
Tournefortia_macrostachya,13,2,11,Points-PointsKO-Adjacents,99
Tournefortia_maculata,202,112,90,Alphahull-PointsKO-Adjacents,5629
Tournefortia_multiflora,7,0,7,Points-PointsKO-Adjacents,38
Tournefortia_obtusiflora,0,0,0,NA,0
Tournefortia_ovalifolia,6,0,6,Points-PointsKO-Adjacents,54
Tournefortia_polystachya,123,88,35,Alphahull-PointsKO-Adjacents,3166
Tournefortia_puberula,43,22,21,Alphahull-PointsKO-Adjacents,356
Tournefortia_ramosissima,14,7,7,Points-PointsKO-Adjacents,112
Tournefortia_scabrida,338,294,44,Alphahull-PointsKO-Adjacents,4178
Touroulia_amazonica,5,0,5,Points-PointsKO-Adjacents,35
Touroulia_guianensis,115,65,50,Alphahull-PointsKO-Adjacents,12300
Toussaintia_orientalis,12,8,4,Points-PointsKO-Adjacents,78
Toussaintia_patriciae,4,4,0,Points-PointsKO-Adjacents,32
Tovaria_pendula,337,248,89,Alphahull-PointsKO-Adjacents,4537
Tovomita_acutiflora,36,17,19,Points-PointsKO-Adjacents,286
Tovomita_aequatoriensis,0,0,0,NA,0
Tovomita_albiflora,12,4,8,Points-PointsKO-Adjacents,105
Tovomita_amazonica,37,11,26,Points-PointsKO-Adjacents,315
Tovomita_atropurpurea,6,0,6,Points-PointsKO-Adjacents,42
Tovomita_auriculata,5,5,0,Points-PointsKO-Adjacents,45
Tovomita_bahiensis,13,4,9,Points-PointsKO-Adjacents,102
Tovomita_brasiliensis,150,80,70,Alphahull-PointsKO-Adjacents,1162
Tovomita_brevistaminea,187,115,72,Alphahull-PointsKO-Adjacents,4694
Tovomita_calodictyos,16,9,7,Points-PointsKO-Adjacents,107
Tovomita_caloneura,24,12,12,Points-PointsKO-Adjacents,136
Tovomita_calophyllophylla,22,14,8,Points-PointsKO-Adjacents,176
Tovomita_carinata,7,0,7,Points-PointsKO-Adjacents,44
Tovomita_chachapoyasensis,3,3,0,Points-PointsKO-Adjacents,27
Tovomita_choisyana,14,0,14,Points-PointsKO-Adjacents,98
Tovomita_clarkii,8,4,4,Points-PointsKO-Adjacents,59
Tovomita_coriacea,6,1,5,Points-PointsKO-Adjacents,48
Tovomita_croatii,51,27,24,Alphahull-PointsKO-Adjacents,497
Tovomita_eggersii,36,14,22,Points-PointsKO-Adjacents,294
Tovomita_elliptica,3,3,0,Points-PointsKO-Adjacents,27
Tovomita_fanshawei,21,9,12,Points-PointsKO-Adjacents,132
Tovomita_foldatsii,2,2,0,Points-PointsKO-Adjacents,18
Tovomita_glazioviana,25,0,25,Points-PointsKO-Adjacents,167
Tovomita_gracilipes,73,42,31,Alphahull-PointsKO-Adjacents,3148
Tovomita_grata,19,0,19,Points-PointsKO-Adjacents,161
Tovomita_guianensis,15,0,15,Points-PointsKO-Adjacents,126
Tovomita_krukovii,89,58,31,Alphahull-PointsKO-Adjacents,4292
Tovomita_laurina,70,30,40,Alphahull-PointsKO-Adjacents,1669
Tovomita_leucantha,60,44,16,Alphahull-PointsKO-Adjacents,962
Tovomita_longifolia,344,239,105,Alphahull-PointsKO-Adjacents,17031
Tovomita_macrophylla,111,61,50,Alphahull-PointsKO-Adjacents,9848
Tovomita_mangle,103,68,35,Alphahull-PointsKO-Adjacents,682
Tovomita_martiana,5,4,1,Points-PointsKO-Adjacents,39
Tovomita_micrantha,6,4,2,Points-PointsKO-Adjacents,31
Tovomita_microcarpa,2,2,0,Points-PointsKO-Adjacents,18
Tovomita_morii,11,3,8,Points-PointsKO-Adjacents,82
Tovomita_obovata,31,7,24,Points-PointsKO-Adjacents,230
Tovomita_obscura,4,4,0,Points-PointsKO-Adjacents,36
Tovomita_parviflora,15,10,5,Points-PointsKO-Adjacents,119
Tovomita_pyrifolia,23,0,23,Points-PointsKO-Adjacents,168
Tovomita_rubella,16,4,12,Points-PointsKO-Adjacents,120
Tovomita_schomburgkii,155,96,59,Alphahull-PointsKO-Adjacents,15494
Tovomita_spruceana,235,192,43,Alphahull-PointsKO-Adjacents,19049
Tovomita_stergiosii,8,2,6,Points-PointsKO-Adjacents,72
Tovomita_stylosa,296,258,38,Alphahull-PointsKO-Adjacents,4144
Tovomita_tenuiflora,44,23,21,Alphahull-PointsKO-Adjacents,3776
Tovomita_trojitana,32,26,6,Alphahull-PointsKO-Adjacents,393
Tovomita_umbellata,338,251,87,Alphahull-PointsKO-Adjacents,48352
Tovomita_weberbaueri,3,3,0,Points-PointsKO-Adjacents,27
Tovomita_weddeliana,14,9,5,Points-PointsKO-Adjacents,74
Tovomitidium_speciosum,75,32,43,Alphahull-PointsKO-Adjacents,2066
Tovomitopsis_guatemaltecana,41,31,10,Alphahull-PointsKO-Adjacents,176
Tovomitopsis_myrcioides,16,4,12,Points-PointsKO-Adjacents,127
Tovomitopsis_paniculata,58,0,58,Points-PointsKO-Adjacents,372
Toxicodendron_acuminatum,7,1,6,Points-PointsKO-Adjacents,53
Toxicodendron_calcicola,1,0,1,Points-PointsKO-Adjacents,9
Toxicodendron_delavayi,35,21,14,Alphahull-PointsKO-Adjacents,1745
Toxicodendron_fulvum,2,2,0,Points-PointsKO-Adjacents,18
Toxicodendron_grandiflorum,26,19,7,Points-PointsKO-Adjacents,226
Toxicodendron_hookeri,19,7,12,Points-PointsKO-Adjacents,113
Toxicodendron_rhetsoides,5,5,0,Points-PointsKO-Adjacents,45
Toxicodendron_rostratum,NA,NA,NA,NA,NA
Toxicodendron_striatum,517,425,92,Alphahull-PointsKO-Adjacents,7147
Toxicodendron_succedaneum,476,312,164,Alphahull-PointsKO-Adjacents,24260
Toxicodendron_sylvestre,291,164,127,Alphahull-PointsKO-Adjacents,11672
Toxicodendron_trichocarpum,263,166,97,Alphahull-PointsKO-Adjacents,3082
Toxicodendron_vernicifluum,168,85,83,Alphahull-PointsKO-Adjacents,9368
Toxicodendron_vernix,646,455,191,Alphahull-PointsKO-Adjacents,24977
Toxicodendron_wallichii,23,5,18,Points-PointsKO-Adjacents,207
Toxosiphon_carinatus,43,28,15,Alphahull-PointsKO-Adjacents,969
Toxosiphon_lindenii,118,88,30,Alphahull-PointsKO-Adjacents,857
Toxosiphon_macropodus,15,2,13,Points-PointsKO-Adjacents,128
Toxosiphon_trifoliatus,24,6,18,Points-PointsKO-Adjacents,179
Trachycarpus_fortunei,354,98,256,Alphahull-PointsKO-Adjacents,4442
Trachycarpus_geminisectus,6,0,6,Points-PointsKO-Adjacents,21
Trachycarpus_latisectus,0,0,0,NA,0
Trachycarpus_martianus,2,2,0,Points-PointsKO-Adjacents,18
Trachycarpus_nanus,1,1,0,Points-PointsKO-Adjacents,9
Trachycarpus_oreophilus,0,0,0,NA,0
Trachycarpus_princeps,2,2,0,Points-PointsKO-Adjacents,9
Trachycarpus_takil,0,0,0,NA,0
Trachycarpus_ukhrulensis,0,0,0,NA,0
Tragia_negeliensis,0,0,0,NA,0
Trattinnickia_aspera,154,110,44,Alphahull-PointsKO-Adjacents,4311
Trattinnickia_boliviana,213,133,80,Alphahull-PointsKO-Adjacents,27138
Trattinnickia_burserifolia,503,432,71,Alphahull-PointsKO-Adjacents,45327
Trattinnickia_demerarae,34,14,20,Points-PointsKO-Adjacents,299
Trattinnickia_ferruginea,41,31,10,Alphahull-PointsKO-Adjacents,711
Trattinnickia_glaziovii,248,182,66,Alphahull-PointsKO-Adjacents,24739
Trattinnickia_lancifolia,42,12,30,Points-PointsKO-Adjacents,339
Trattinnickia_lawrancei,41,14,27,Points-PointsKO-Adjacents,339
Trattinnickia_laxiflora,4,4,0,Points-PointsKO-Adjacents,36
Trattinnickia_peruviana,127,76,51,Alphahull-PointsKO-Adjacents,13980
Trattinnickia_rhoifolia,472,377,95,Alphahull-PointsKO-Adjacents,65294
Treculia_africana,152,114,38,Alphahull-PointsKO-Adjacents,3836
Treculia_obovoidea,111,94,17,Alphahull-PointsKO-Adjacents,2613
Trema_angustifolia,45,12,33,Points-PointsKO-Adjacents,380
Trema_aspera,666,502,164,Alphahull-PointsKO-Adjacents,11774
Trema_cannabina,307,182,125,Alphahull-PointsKO-Adjacents,7842
Trema_integerrima,170,100,70,Alphahull-PointsKO-Adjacents,5991
Trema_lamarckiana,123,86,37,Alphahull-PointsKO-Adjacents,2213
Trema_levigata,41,22,19,Alphahull-PointsKO-Adjacents,1010
Trema_micrantha,6485,5917,568,Alphahull-PointsKO-Adjacents,179997
Trema_nitida,14,1,13,Points-PointsKO-Adjacents,125
Trema_orientalis,1510,0,1510,Points-PointsKO-Adjacents,7402
Trema_politoria,16,0,16,Points-PointsKO-Adjacents,132
Trema_tomentosa,3079,1,3078,Points-PointsKO-Adjacents,8026
Trematolobelia_auriculata,0,0,0,NA,0
Trematolobelia_grandifolia,9,4,5,Points-PointsKO-Adjacents,58
Trematolobelia_macrostachys,14,7,7,Points-PointsKO-Adjacents,53
Trematolobelia_wimmeri,0,0,0,NA,0
Trembleya_laniflora,97,82,15,Alphahull-PointsKO-Adjacents,317
Trembleya_parviflora,710,651,59,Alphahull-PointsKO-Adjacents,11559
Trevesia_arborea,0,0,0,NA,0
Trevesia_burckii,9,2,7,Points-PointsKO-Adjacents,66
Trevesia_lateospina,1,1,0,Points-PointsKO-Adjacents,9
Trevesia_longipedicellata,1,1,0,Points-PointsKO-Adjacents,9
Trevesia_sphaerocarpa,1,1,0,Points-PointsKO-Adjacents,9
Trevesia_sundaica,5,0,5,Points-PointsKO-Adjacents,40
Trevesia_tomentella,NA,NA,NA,NA,NA
Trevesia_valida,6,1,5,Points-PointsKO-Adjacents,40
Trevesia_vietnamensis,NA,NA,NA,NA,NA
Trevia_nudiflora,0,0,0,NA,0
Triadica_cochinchinensis,314,246,68,Alphahull-PointsKO-Adjacents,11948
Triadica_sebifera,1718,1185,533,Alphahull-PointsKO-Adjacents,33831
Triainolepis_africana,52,14,38,Points-PointsKO-Adjacents,299
Triainolepis_emirnensis,8,1,7,Points-PointsKO-Adjacents,60
Triainolepis_mandrarensis,3,3,0,Points-PointsKO-Adjacents,27
Triainolepis_polyneura,1,1,0,Points-PointsKO-Adjacents,9
Tricalysia_acocantheroides,21,6,15,Points-PointsKO-Adjacents,168
Tricalysia_allocalyx,9,4,5,Points-PointsKO-Adjacents,60
Tricalysia_ambrensis,31,22,9,Alphahull-PointsKO-Adjacents,199
Tricalysia_amplexicaulis,39,26,13,Alphahull-PointsKO-Adjacents,359
Tricalysia_anomala,44,23,21,Alphahull-PointsKO-Adjacents,1243
Tricalysia_atherura,26,14,12,Points-PointsKO-Adjacents,115
Tricalysia_bagshawei,23,0,23,Points-PointsKO-Adjacents,151
Tricalysia_biafrana,37,8,29,Points-PointsKO-Adjacents,308
Tricalysia_bifida,21,4,17,Points-PointsKO-Adjacents,127
Tricalysia_boiviniana,27,17,10,Points-PointsKO-Adjacents,135
Tricalysia_bridsoniana,9,0,9,Points-PointsKO-Adjacents,54
Tricalysia_capensis,75,47,28,Alphahull-PointsKO-Adjacents,738
Tricalysia_congesta,49,0,49,Points-PointsKO-Adjacents,317
Tricalysia_cryptocalyx,59,46,13,Alphahull-PointsKO-Adjacents,2403
Tricalysia_dauphinensis,39,27,12,Alphahull-PointsKO-Adjacents,108
Tricalysia_elliottii,56,19,37,Points-PointsKO-Adjacents,425
Tricalysia_griseiflora,37,10,27,Points-PointsKO-Adjacents,302
Tricalysia_hensii,21,3,18,Points-PointsKO-Adjacents,167
Tricalysia_humbertii,7,2,5,Points-PointsKO-Adjacents,42
Tricalysia_jasminiflora,9,2,7,Points-PointsKO-Adjacents,75
Tricalysia_kivuensis,19,9,10,Points-PointsKO-Adjacents,129
Tricalysia_lasiodelphys,24,9,15,Points-PointsKO-Adjacents,173
Tricalysia_lejolyana,5,5,0,Points-PointsKO-Adjacents,26
Tricalysia_leucocarpa,14,5,9,Points-PointsKO-Adjacents,65
Tricalysia_longituba,46,19,27,Points-PointsKO-Adjacents,351
Tricalysia_madagascariensis,6,1,5,Points-PointsKO-Adjacents,47
Tricalysia_majungensis,9,3,6,Points-PointsKO-Adjacents,74
Tricalysia_micrantha,0,0,0,NA,0
Tricalysia_niamniamensis,26,5,21,Points-PointsKO-Adjacents,211
Tricalysia_obanensis,4,4,0,Points-PointsKO-Adjacents,36
Tricalysia_obstetrix,16,10,6,Points-PointsKO-Adjacents,96
Tricalysia_okelensis,145,102,43,Alphahull-PointsKO-Adjacents,4404
Tricalysia_oligoneura,51,28,23,Alphahull-PointsKO-Adjacents,2560
Tricalysia_orientalis,19,13,6,Points-PointsKO-Adjacents,115
Tricalysia_pallens,310,217,93,Alphahull-PointsKO-Adjacents,27067
Tricalysia_pangolina,47,30,17,Alphahull-PointsKO-Adjacents,2442
Tricalysia_pedicellata,9,3,6,Points-PointsKO-Adjacents,64
Tricalysia_perrieri,14,6,8,Points-PointsKO-Adjacents,116
Tricalysia_pynaertii,20,9,11,Points-PointsKO-Adjacents,128
Tricalysia_reticulata,59,34,25,Alphahull-PointsKO-Adjacents,650
Tricalysia_revoluta,2,2,0,Points-PointsKO-Adjacents,18
Tricalysia_schliebenii,6,0,6,Points-PointsKO-Adjacents,32
Tricalysia_soyauxii,33,19,14,Points-PointsKO-Adjacents,211
Tricalysia_trachycarpa,7,0,7,Points-PointsKO-Adjacents,61
Tricalysia_vanroechoudtii,19,10,9,Points-PointsKO-Adjacents,137
Tricalysia_verdcourtiana,20,4,16,Points-PointsKO-Adjacents,108
Tricalysia_wernhamiana,2,2,0,Points-PointsKO-Adjacents,9
Tricalysia_yangambiensis,9,2,7,Points-PointsKO-Adjacents,55
Tricalysia_zambesiaca,5,5,0,Points-PointsKO-Adjacents,36
Trichanthera_corymbosa,12,4,8,Points-PointsKO-Adjacents,102
Trichanthera_gigantea,349,284,65,Alphahull-PointsKO-Adjacents,12660
Trichilia_acuminata,55,41,14,Alphahull-PointsKO-Adjacents,1741
Trichilia_adolfi,93,61,32,Alphahull-PointsKO-Adjacents,7120
Trichilia_americana,438,356,82,Alphahull-PointsKO-Adjacents,8151
Trichilia_appendiculata,26,13,13,Points-PointsKO-Adjacents,215
Trichilia_aquifolia,9,4,5,Points-PointsKO-Adjacents,56
Trichilia_areolata,17,2,15,Points-PointsKO-Adjacents,138
Trichilia_blanchetii,10,0,10,Points-PointsKO-Adjacents,68
Trichilia_breviflora,18,11,7,Points-PointsKO-Adjacents,97
Trichilia_bullata,16,2,14,Points-PointsKO-Adjacents,123
Trichilia_casaretti,459,387,72,Alphahull-PointsKO-Adjacents,11040
Trichilia_catigua,1010,897,113,Alphahull-PointsKO-Adjacents,35579
Trichilia_chirriactensis,2,2,0,Points-PointsKO-Adjacents,18
Trichilia_cipo,164,96,68,Alphahull-PointsKO-Adjacents,22812
Trichilia_claussenii,874,0,874,Points-PointsKO-Adjacents,5324
Trichilia_discolor,1,1,0,Points-PointsKO-Adjacents,9
Trichilia_dregeana,98,40,58,Alphahull-PointsKO-Adjacents,848
Trichilia_elegans,1686,1526,160,Alphahull-PointsKO-Adjacents,66746
Trichilia_elsae,9,1,8,Points-PointsKO-Adjacents,72
Trichilia_emetica,519,394,125,Alphahull-PointsKO-Adjacents,11419
Trichilia_erythrocarpa,68,53,15,Alphahull-PointsKO-Adjacents,963
Trichilia_euneura,41,21,20,Alphahull-PointsKO-Adjacents,828
Trichilia_fasciculata,71,40,31,Alphahull-PointsKO-Adjacents,9574
Trichilia_florbranca,4,4,0,Points-PointsKO-Adjacents,21
Trichilia_gamopetala,6,0,6,Points-PointsKO-Adjacents,46
Trichilia_gilgiana,85,52,33,Alphahull-PointsKO-Adjacents,4077
Trichilia_gilletii,15,2,13,Points-PointsKO-Adjacents,102
Trichilia_glabra,227,190,37,Alphahull-PointsKO-Adjacents,5818
Trichilia_grandifolia,3,3,0,Points-PointsKO-Adjacents,9
Trichilia_havanensis,1371,1196,175,Alphahull-PointsKO-Adjacents,14707
Trichilia_hirta,810,711,99,Alphahull-PointsKO-Adjacents,28179
Trichilia_hispida,27,15,12,Points-PointsKO-Adjacents,175
Trichilia_inaequilatera,194,120,74,Alphahull-PointsKO-Adjacents,10523
Trichilia_laxipaniculata,78,63,15,Alphahull-PointsKO-Adjacents,937
Trichilia_lecointei,76,41,35,Alphahull-PointsKO-Adjacents,5916
Trichilia_lepidota,587,479,108,Alphahull-PointsKO-Adjacents,9175
Trichilia_lovettii,6,1,5,Points-PointsKO-Adjacents,39
Trichilia_magnifoliola,26,17,9,Points-PointsKO-Adjacents,179
Trichilia_martiana,116,50,66,Alphahull-PointsKO-Adjacents,2212
Trichilia_martineaui,37,1,36,Points-PointsKO-Adjacents,192
Trichilia_mazanensis,97,50,47,Alphahull-PointsKO-Adjacents,10687
Trichilia_megalantha,38,22,16,Alphahull-PointsKO-Adjacents,179
Trichilia_micrantha,579,495,84,Alphahull-PointsKO-Adjacents,66158
Trichilia_micropetala,47,15,32,Points-PointsKO-Adjacents,346
Trichilia_minutiflora,77,67,10,Alphahull-PointsKO-Adjacents,1336
Trichilia_monacantha,3,3,0,Points-PointsKO-Adjacents,27
Trichilia_monadelpha,234,169,65,Alphahull-PointsKO-Adjacents,7816
Trichilia_moschata,143,112,31,Alphahull-PointsKO-Adjacents,2536
Trichilia_mucronata,28,12,16,Points-PointsKO-Adjacents,148
Trichilia_obovata,48,39,9,Alphahull-PointsKO-Adjacents,681
Trichilia_ornithothera,22,8,14,Points-PointsKO-Adjacents,138
Trichilia_pachypoda,43,23,20,Alphahull-PointsKO-Adjacents,500
Trichilia_pallens,571,500,71,Alphahull-PointsKO-Adjacents,9577
Trichilia_pallida,3248,3018,230,Alphahull-PointsKO-Adjacents,122284
Trichilia_pittieri,14,7,7,Points-PointsKO-Adjacents,86
Trichilia_pleeana,817,688,129,Alphahull-PointsKO-Adjacents,59488
Trichilia_poeppigii,294,0,294,Points-PointsKO-Adjacents,1745
Trichilia_prieuriana,154,98,56,Alphahull-PointsKO-Adjacents,5735
Trichilia_primogenita,7,2,5,Points-PointsKO-Adjacents,48
Trichilia_pseudostipularis,151,117,34,Alphahull-PointsKO-Adjacents,2134
Trichilia_pungens,2,2,0,Points-PointsKO-Adjacents,17
Trichilia_quadrijuga,842,691,151,Alphahull-PointsKO-Adjacents,54662
Trichilia_quadrivalvis,3,3,0,Points-PointsKO-Adjacents,27
Trichilia_ramalhoi,71,1,70,Points-PointsKO-Adjacents,460
Trichilia_reticulata,4,4,0,Points-PointsKO-Adjacents,33
Trichilia_retusa,11,3,8,Points-PointsKO-Adjacents,99
Trichilia_rubescens,180,144,36,Alphahull-PointsKO-Adjacents,6248
Trichilia_rubra,517,433,84,Alphahull-PointsKO-Adjacents,56749
Trichilia_schomburgkii,245,170,75,Alphahull-PointsKO-Adjacents,17909
Trichilia_septentrionalis,253,182,71,Alphahull-PointsKO-Adjacents,29236
Trichilia_silvatica,277,203,74,Alphahull-PointsKO-Adjacents,5474
Trichilia_singularis,190,111,79,Alphahull-PointsKO-Adjacents,13296
Trichilia_solitudinis,113,66,47,Alphahull-PointsKO-Adjacents,5532
Trichilia_stellatotomentosa,132,95,37,Alphahull-PointsKO-Adjacents,3638
Trichilia_stenophylla,1,1,0,Points-PointsKO-Adjacents,9
Trichilia_stipitata,7,1,6,Points-PointsKO-Adjacents,63
Trichilia_surinamensis,146,100,46,Alphahull-PointsKO-Adjacents,5651
Trichilia_surumuensis,31,1,30,Points-PointsKO-Adjacents,176
Trichilia_tessmannii,89,44,45,Alphahull-PointsKO-Adjacents,3237
Trichilia_tetrapetala,19,0,19,Points-PointsKO-Adjacents,155
Trichilia_tomentosa,27,4,23,Points-PointsKO-Adjacents,220
Trichilia_trachyantha,6,0,6,Points-PointsKO-Adjacents,53
Trichilia_triacantha,3,1,2,Points-PointsKO-Adjacents,15
Trichilia_trifolia,399,288,111,Alphahull-PointsKO-Adjacents,12607
Trichilia_tsaratananensis,3,3,0,Points-PointsKO-Adjacents,27
Trichilia_tuberculata,159,0,159,Points-PointsKO-Adjacents,873
Trichilia_ulei,5,5,0,Points-PointsKO-Adjacents,45
Trichilia_welwitschii,41,15,26,Points-PointsKO-Adjacents,271
Trichocereus_coquimbanus,5,4,1,Points-PointsKO-Adjacents,42
Trichocereus_macrogonus,11,1,10,Points-PointsKO-Adjacents,99
Trichocereus_tunariensis,2,2,0,Points-PointsKO-Adjacents,18
Trichocladus_crinitus,52,18,34,Points-PointsKO-Adjacents,304
Trichocladus_ellipticus,110,28,82,Alphahull-PointsKO-Adjacents,1091
Trichocladus_goetzei,24,14,10,Points-PointsKO-Adjacents,135
Trichocladus_grandiflorus,23,10,13,Points-PointsKO-Adjacents,184
Trichoscypha_acuminata,379,345,34,Alphahull-PointsKO-Adjacents,8153
Trichoscypha_arborea,74,43,31,Alphahull-PointsKO-Adjacents,1501
Trichoscypha_baldwinii,41,30,11,Alphahull-PointsKO-Adjacents,800
Trichoscypha_bijuga,93,66,27,Alphahull-PointsKO-Adjacents,652
Trichoscypha_cavalliensis,28,16,12,Points-PointsKO-Adjacents,168
Trichoscypha_debruijnii,1,1,0,Points-PointsKO-Adjacents,9
Trichoscypha_hallei,1,1,0,Points-PointsKO-Adjacents,9
Trichoscypha_laxiflora,50,34,16,Alphahull-PointsKO-Adjacents,625
Trichoscypha_liberica,3,3,0,Points-PointsKO-Adjacents,26
Trichoscypha_longifolia,14,1,13,Points-PointsKO-Adjacents,110
Trichoscypha_lucens,188,113,75,Alphahull-PointsKO-Adjacents,3466
Trichoscypha_mannii,28,15,13,Points-PointsKO-Adjacents,194
Trichoscypha_oddonii,109,84,25,Alphahull-PointsKO-Adjacents,2657
Trichoscypha_oliveri,33,15,18,Points-PointsKO-Adjacents,237
Trichoscypha_patens,84,67,17,Alphahull-PointsKO-Adjacents,2857
Trichoscypha_reygaertii,33,11,22,Points-PointsKO-Adjacents,229
Trichoscypha_smythei,79,51,28,Alphahull-PointsKO-Adjacents,1706
Trichoscypha_ulugurensis,11,4,7,Points-PointsKO-Adjacents,89
Trichospermum_galeottii,358,283,75,Alphahull-PointsKO-Adjacents,7861
Grewia_inmac,4,4,0,Points-PointsKO-Adjacents,22
Trichospermum_mexicanum,548,467,81,Alphahull-PointsKO-Adjacents,7736
Trichospermum_richii,7,1,6,Points-PointsKO-Adjacents,44
Trichostigma_octandrum,433,277,156,Alphahull-PointsKO-Adjacents,15036
Tridesmostemon_congoense,1,1,0,Points-PointsKO-Adjacents,9
Tridesmostemon_omphalocarpoides,62,37,25,Alphahull-PointsKO-Adjacents,2298
Tridimeris_hahniana,11,0,11,Points-PointsKO-Adjacents,71
Triflorensia_australis,135,102,33,Alphahull-PointsKO-Adjacents,866
Triflorensia_cameronii,40,30,10,Alphahull-PointsKO-Adjacents,241
Triflorensia_ixoroides,161,128,33,Alphahull-PointsKO-Adjacents,2190
Cupania_acuta,2,2,0,Points-PointsKO-Adjacents,17
Trigonia_macrantha,5,5,0,Points-PointsKO-Adjacents,45
Trigonia_rugosa,251,199,52,Alphahull-PointsKO-Adjacents,1617
Trigonia_sericea,23,5,18,Points-PointsKO-Adjacents,173
Trigoniodendron_spiritusanctense,32,19,13,Points-PointsKO-Adjacents,225
Trigonobalanus_doichangensis,4,4,0,Points-PointsKO-Adjacents,36
Trigonobalanus_excelsa,14,5,9,Points-PointsKO-Adjacents,55
Trigonobalanus_verticillata,11,0,11,Points-PointsKO-Adjacents,37
Trigonopleura_dubia,0,0,0,NA,0
Trigonopleura_macrocarpa,0,0,0,NA,0
Trigonopleura_malayana,16,4,12,Points-PointsKO-Adjacents,142
Trigonopyren_albicostatus,6,1,5,Points-PointsKO-Adjacents,41
Trigonopyren_ovalifolius,2,2,0,Points-PointsKO-Adjacents,18
Trigonostemon_albiflorus,1,1,0,Points-PointsKO-Adjacents,9
Trigonostemon_aurantiacus,24,5,19,Points-PointsKO-Adjacents,205
Trigonostemon_bonianus,2,2,0,Points-PointsKO-Adjacents,18
Trigonostemon_capillipes,4,4,0,Points-PointsKO-Adjacents,27
Trigonostemon_carnosulus,NA,NA,NA,NA,NA
Trigonostemon_cherrieri,2,2,0,Points-PointsKO-Adjacents,12
Trigonostemon_chinensis,9,2,7,Points-PointsKO-Adjacents,81
Trigonostemon_croceus,0,0,0,NA,0
Trigonostemon_diffusus,0,0,0,NA,0
Trigonostemon_diplopetalus,2,2,0,Points-PointsKO-Adjacents,18
Trigonostemon_dipteranthus,0,0,0,NA,0
Trigonostemon_elegantissimus,3,3,0,Points-PointsKO-Adjacents,27
Trigonostemon_elmeri,9,3,6,Points-PointsKO-Adjacents,52
Trigonostemon_fragilis,0,0,0,NA,0
Trigonostemon_hartleyi,1,0,1,Points-PointsKO-Adjacents,7
Trigonostemon_heteranthus,42,13,29,Points-PointsKO-Adjacents,331
Trigonostemon_hirsutus,3,3,0,Points-PointsKO-Adjacents,27
Trigonostemon_howii,1,1,0,Points-PointsKO-Adjacents,9
Trigonostemon_inopinatus,9,7,2,Points-PointsKO-Adjacents,39
Trigonostemon_ionthocarpus,5,5,0,Points-PointsKO-Adjacents,45
Trigonostemon_kerrii,0,0,0,NA,0
Trigonostemon_longipedunculatus,2,2,0,Points-PointsKO-Adjacents,18
Trigonostemon_longipes,1,1,0,Points-PointsKO-Adjacents,8
Trigonostemon_magnificus,1,1,0,Points-PointsKO-Adjacents,9
Trigonostemon_malaccanus,10,3,7,Points-PointsKO-Adjacents,88
Trigonostemon_matangensis,1,1,0,Points-PointsKO-Adjacents,9
Trigonostemon_murtonii,0,0,0,NA,0
Trigonostemon_nemoralis,2,2,0,Points-PointsKO-Adjacents,18
Trigonostemon_philippinensis,10,0,10,Points-PointsKO-Adjacents,84
Trigonostemon_phyllocalyx,1,1,0,Points-PointsKO-Adjacents,9
Trigonostemon_pierrei,0,0,0,NA,0
Trigonostemon_polyanthus,12,1,11,Points-PointsKO-Adjacents,95
Trigonostemon_quocensis,13,0,13,Points-PointsKO-Adjacents,102
Trigonostemon_rufescens,2,2,0,Points-PointsKO-Adjacents,18
Trigonostemon_salicifolius,1,1,0,Points-PointsKO-Adjacents,9
Trigonostemon_sinclairii,3,3,0,Points-PointsKO-Adjacents,27
Trigonostemon_thyrsoideus,12,3,9,Points-PointsKO-Adjacents,102
Trigonostemon_verticillatus,5,4,1,Points-PointsKO-Adjacents,42
Trigonostemon_villosus,21,3,18,Points-PointsKO-Adjacents,147
Trigonostemon_viridissimus,12,0,12,Points-PointsKO-Adjacents,95
Trigonostemon_wetriifolius,NA,NA,NA,NA,NA
Trigynaea_axilliflora,4,4,0,Points-PointsKO-Adjacents,36
Trigynaea_cinnamomea,11,5,6,Points-PointsKO-Adjacents,74
Trigynaea_duckei,213,151,62,Alphahull-PointsKO-Adjacents,10278
Trigynaea_lagaropoda,10,0,10,Points-PointsKO-Adjacents,78
Trigynaea_lanceipetala,2,2,0,Points-PointsKO-Adjacents,18
Trigynaea_oblongifolia,27,10,17,Points-PointsKO-Adjacents,181
Trigynaea_triplinervis,40,33,7,Alphahull-PointsKO-Adjacents,211
Trilepisium_gymnandrum,NA,NA,NA,NA,NA
Trilepisium_madagascariense,461,327,134,Alphahull-PointsKO-Adjacents,16815
Trimeria_grandifolia,156,103,53,Alphahull-PointsKO-Adjacents,3408
Trimeria_trinervis,33,22,11,Alphahull-PointsKO-Adjacents,972
Triphasia_trifolia,9,0,9,Points-PointsKO-Adjacents,78
Triplaris_americana,821,668,153,Alphahull-PointsKO-Adjacents,74560
Triplaris_caracasana,63,41,22,Alphahull-PointsKO-Adjacents,2266
Triplaris_cumingiana,189,135,54,Alphahull-PointsKO-Adjacents,8669
Triplaris_dugandii,70,42,28,Alphahull-PointsKO-Adjacents,935
Triplaris_efistulifera,17,10,7,Points-PointsKO-Adjacents,92
Triplaris_fulva,1,1,0,Points-PointsKO-Adjacents,9
Triplaris_gardneriana,752,679,73,Alphahull-PointsKO-Adjacents,34132
Triplaris_longifolia,17,6,11,Points-PointsKO-Adjacents,150
Triplaris_melaenodendron,14,6,8,Points-PointsKO-Adjacents,104
Triplaris_moyobambensis,3,3,0,Points-PointsKO-Adjacents,27
Triplaris_peruviana,10,2,8,Points-PointsKO-Adjacents,81
Triplaris_physocalyx,4,4,0,Points-PointsKO-Adjacents,36
Triplaris_poeppigiana,93,70,23,Alphahull-PointsKO-Adjacents,1499
Triplaris_punctata,10,3,7,Points-PointsKO-Adjacents,90
Triplaris_purdiei,8,1,7,Points-PointsKO-Adjacents,69
Triplaris_setosa,73,51,22,Alphahull-PointsKO-Adjacents,443
Triplaris_vestita,38,28,10,Alphahull-PointsKO-Adjacents,107
Triplaris_weigeltiana,240,148,92,Alphahull-PointsKO-Adjacents,25918
Triplochiton_scleroxylon,597,541,56,Alphahull-PointsKO-Adjacents,4458
Triplochiton_zambesiacus,3,3,0,Points-PointsKO-Adjacents,27
Tripodanthus_acutifolius,339,217,122,Alphahull-PointsKO-Adjacents,13967
Tripterodendron_filicifolium,21,10,11,Points-PointsKO-Adjacents,165
Tripterygium_wilfordii,255,177,78,Alphahull-PointsKO-Adjacents,7253
Trischidium_alternum,138,94,44,Alphahull-PointsKO-Adjacents,6464
Trischidium_decipiens,11,0,11,Points-PointsKO-Adjacents,83
Trischidium_limae,10,2,8,Points-PointsKO-Adjacents,64
Trischidium_molle,391,349,42,Alphahull-PointsKO-Adjacents,8628
Trischidium_racemulosum,45,28,17,Alphahull-PointsKO-Adjacents,1383
Tristania_neriifolia,210,0,210,Points-PointsKO-Adjacents,272
Tristaniopsis_anomala,2,2,0,Points-PointsKO-Adjacents,18
Tristaniopsis_beccarii,0,0,0,NA,0
Tristaniopsis_bilocularis,3,3,0,Points-PointsKO-Adjacents,12
Tristaniopsis_burmanica,7,1,6,Points-PointsKO-Adjacents,57
Tristaniopsis_callobuxus,40,23,17,Alphahull-PointsKO-Adjacents,138
Tristaniopsis_capitulata,16,12,4,Points-PointsKO-Adjacents,56
Tristaniopsis_collina,814,744,70,Alphahull-PointsKO-Adjacents,1142
Tristaniopsis_decorticata,0,0,0,NA,0
Tristaniopsis_elliptica,5,0,5,Points-PointsKO-Adjacents,27
Tristaniopsis_exiliflora,205,182,23,Alphahull-PointsKO-Adjacents,796
Tristaniopsis_ferruginea,11,3,8,Points-PointsKO-Adjacents,75
Tristaniopsis_fruticosa,3,3,0,Points-PointsKO-Adjacents,21
Tristaniopsis_glauca,28,24,4,Alphahull-PointsKO-Adjacents,33
Tristaniopsis_guillainii,55,42,13,Alphahull-PointsKO-Adjacents,151
Tristaniopsis_kinabaluensis,0,0,0,NA,0
Tristaniopsis_laurina,1836,1632,204,Alphahull-PointsKO-Adjacents,2660
Tristaniopsis_littoralis,0,0,0,NA,0
Tristaniopsis_lucida,3,3,0,Points-PointsKO-Adjacents,12
Tristaniopsis_macphersonii,8,0,8,Points-PointsKO-Adjacents,31
Tristaniopsis_macrosperma,4,4,0,Points-PointsKO-Adjacents,29
Tristaniopsis_merguensis,4,0,4,Points-PointsKO-Adjacents,36
Tristaniopsis_micrantha,0,0,0,NA,0
Tristaniopsis_microcarpa,0,0,0,NA,0
Tristaniopsis_minutiflora,2,2,0,Points-PointsKO-Adjacents,13
Tristaniopsis_oblongifolia,0,0,0,NA,0
Tristaniopsis_obovata,3,3,0,Points-PointsKO-Adjacents,19
Tristaniopsis_oreophila,0,0,0,NA,0
Tristaniopsis_parvifolia,0,0,0,NA,0
Tristaniopsis_pentandra,0,0,0,NA,0
Tristaniopsis_polyandra,2,2,0,Points-PointsKO-Adjacents,12
Tristaniopsis_pontianensis,0,0,0,NA,0
Tristaniopsis_razakiana,1,1,0,Points-PointsKO-Adjacents,9
Tristaniopsis_reticulata,5,2,3,Points-PointsKO-Adjacents,23
Tristaniopsis_rubiginosa,0,0,0,NA,0
Tristaniopsis_vieillardii,4,3,1,Points-PointsKO-Adjacents,36
Tristaniopsis_whiteana,15,2,13,Points-PointsKO-Adjacents,112
Tristaniopsis_yateensis,4,4,0,Points-PointsKO-Adjacents,24
Trithrinax_brasiliensis,58,49,9,Alphahull-PointsKO-Adjacents,2753
Trithrinax_campestris,41,25,16,Alphahull-PointsKO-Adjacents,4468
Trithrinax_schizophylla,77,59,18,Alphahull-PointsKO-Adjacents,5551
Triumfetta_arborescens,6,0,6,Points-PointsKO-Adjacents,38
Triumfetta_bogotensis,631,472,159,Alphahull-PointsKO-Adjacents,12674
Triumfetta_calycina,24,15,9,Points-PointsKO-Adjacents,158
Triumfetta_grandiflora,227,153,74,Alphahull-PointsKO-Adjacents,1935
Triumfetta_grandistipulata,0,0,0,NA,0
Triumfetta_lappula,584,431,153,Alphahull-PointsKO-Adjacents,13243
Triumfetta_polyandra,8,4,4,Points-PointsKO-Adjacents,66
Triumfetta_semitriloba,1412,1071,341,Alphahull-PointsKO-Adjacents,40775
Triumfetta_trifida,3,3,0,Points-PointsKO-Adjacents,27
Triunia_robusta,12,5,7,Points-PointsKO-Adjacents,51
Helicia_youngiana,75,64,11,Alphahull-PointsKO-Adjacents,162
Trivalvaria_argentea,0,0,0,NA,0
Trivalvaria_costata,15,0,15,Points-PointsKO-Adjacents,126
Trivalvaria_macrophylla,12,3,9,Points-PointsKO-Adjacents,99
Trivalvaria_nervosa,1,1,0,Points-PointsKO-Adjacents,9
Trixis_inula,1191,993,198,Alphahull-PointsKO-Adjacents,16188
Trixis_pruskii,21,12,9,Points-PointsKO-Adjacents,135
Trochetia_boutoniana,0,0,0,NA,0
Trochetia_uniflora,0,0,0,NA,0
Trochetiopsis_erythroxylon,0,0,0,NA,0
Trochetiopsis_melanoxylon,0,0,0,NA,0
Styphelia_celebica,1,1,0,Points-PointsKO-Adjacents,9
Trochocarpa_laurina,2646,2515,131,Alphahull-PointsKO-Adjacents,2023
Trochodendron_aralioides,369,309,60,Alphahull-PointsKO-Adjacents,2202
Trophis_borbonica,1,1,0,Points-PointsKO-Adjacents,4
Trophis_caucana,724,644,80,Alphahull-PointsKO-Adjacents,10343
Trophis_cuspidata,40,26,14,Alphahull-PointsKO-Adjacents,525
Trophis_involucrata,104,93,11,Alphahull-PointsKO-Adjacents,309
Trophis_mexicana,486,433,53,Alphahull-PointsKO-Adjacents,5296
Trophis_noraminervae,4,3,1,Points-PointsKO-Adjacents,27
Paratrophis_philippinensis,11,0,11,Points-PointsKO-Adjacents,82
Trophis_racemosa,1445,0,1445,Points-PointsKO-Adjacents,6363
Trymatococcus_amazonicus,410,347,63,Alphahull-PointsKO-Adjacents,40331
Trymatococcus_oligandrus,58,39,19,Alphahull-PointsKO-Adjacents,1542
Tsebona_macrantha,19,8,11,Points-PointsKO-Adjacents,126
Tsingya_bemarana,4,4,0,Points-PointsKO-Adjacents,21
Tsoala_tubiflora,16,8,8,Points-PointsKO-Adjacents,125
Tsuga_canadensis,10872,0,10872,Points-PointsKO-Adjacents,15679
Tsuga_caroliniana,238,206,32,Alphahull-PointsKO-Adjacents,1000
Tsuga_chinensis,293,242,51,Alphahull-PointsKO-Adjacents,14581
Tsuga_diversifolia,109,85,24,Alphahull-PointsKO-Adjacents,893
Tsuga_dumosa,168,127,41,Alphahull-PointsKO-Adjacents,4085
Tsuga_forrestii,12,6,6,Points-PointsKO-Adjacents,98
Tsuga_heterophylla,5302,5100,202,Alphahull-PointsKO-Adjacents,12912
Tsuga_mertensiana,2872,2771,101,Alphahull-PointsKO-Adjacents,12738
Tsuga_sieboldii,164,126,38,Alphahull-PointsKO-Adjacents,1376
Tulestea_tomentosa,4,4,0,Points-PointsKO-Adjacents,30
Tunilla_albisaetacens,8,2,6,Points-PointsKO-Adjacents,72
Turbina_bracteata,55,39,16,Alphahull-PointsKO-Adjacents,898
Turnera_hatschbachii,1,1,0,Points-PointsKO-Adjacents,9
Turnera_hindsiana,7,5,2,Points-PointsKO-Adjacents,57
Turnera_odorata,65,37,28,Alphahull-PointsKO-Adjacents,1695
Turnera_panamensis,43,23,20,Alphahull-PointsKO-Adjacents,158
Turpinia_affinis,32,10,22,Points-PointsKO-Adjacents,279
Turpinia_cochinchinensis,73,0,73,Points-PointsKO-Adjacents,479
Turpinia_formosana,390,351,39,Alphahull-PointsKO-Adjacents,332
Turpinia_indochinensis,7,1,6,Points-PointsKO-Adjacents,63
Turpinia_insignis,214,173,41,Alphahull-PointsKO-Adjacents,1083
Turpinia_macrosperma,3,3,0,Points-PointsKO-Adjacents,12
Turpinia_megaphylla,20,3,17,Points-PointsKO-Adjacents,170
Turpinia_montana,44,13,31,Points-PointsKO-Adjacents,386
Turpinia_occidentalis,1856,1638,218,Alphahull-PointsKO-Adjacents,39498
Turpinia_ovalifolia,10,2,8,Points-PointsKO-Adjacents,41
Turpinia_parvifoliola,6,0,6,Points-PointsKO-Adjacents,54
Turpinia_pentandra,48,31,17,Alphahull-PointsKO-Adjacents,650
Turpinia_pomifera,38,10,28,Points-PointsKO-Adjacents,342
Turpinia_robusta,3,3,0,Points-PointsKO-Adjacents,27
Turpinia_simplicifolia,4,4,0,Points-PointsKO-Adjacents,36
Turpinia_ternata,157,128,29,Alphahull-PointsKO-Adjacents,341
Turpinia_tricornuta,19,0,19,Points-PointsKO-Adjacents,72
Turraea_abyssinica,16,0,16,Points-PointsKO-Adjacents,85
Turraea_anomala,3,2,1,Points-PointsKO-Adjacents,27
Turraea_barbata,5,5,0,Points-PointsKO-Adjacents,45
Turraea_fischeri,7,1,6,Points-PointsKO-Adjacents,48
Turraea_floribunda,97,50,47,Alphahull-PointsKO-Adjacents,2555
Turraea_fockei,8,6,2,Points-PointsKO-Adjacents,69
Turraea_geayi,23,7,16,Points-PointsKO-Adjacents,108
Turraea_holstii,71,41,30,Alphahull-PointsKO-Adjacents,2853
Turraea_humberti,9,3,6,Points-PointsKO-Adjacents,81
Turraea_kimbozensis,5,5,0,Points-PointsKO-Adjacents,19
Turraea_laciniata,0,0,0,NA,0
Turraea_lanceolata,18,8,10,Points-PointsKO-Adjacents,68
Turraea_leonensis,8,1,7,Points-PointsKO-Adjacents,72
Turraea_longifolia,6,2,4,Points-PointsKO-Adjacents,52
Turraea_nilotica,72,35,37,Alphahull-PointsKO-Adjacents,5257
Turraea_obtusifolia,143,110,33,Alphahull-PointsKO-Adjacents,4563
Turraea_pellegriniana,8,0,8,Points-PointsKO-Adjacents,68
Turraea_pubescens,498,417,81,Alphahull-PointsKO-Adjacents,6985
Turraea_rigida,2,2,0,Points-PointsKO-Adjacents,9
Turraea_robusta,56,0,56,Points-PointsKO-Adjacents,344
Turraea_sericea,100,71,29,Alphahull-PointsKO-Adjacents,3327
Turraea_thouvenotii,29,11,18,Points-PointsKO-Adjacents,195
Turraea_trichopoda,0,0,0,NA,0
Turraea_venulosa,10,7,3,Points-PointsKO-Adjacents,71
Turraea_vogelii,251,179,72,Alphahull-PointsKO-Adjacents,23074
Turraea_wakefieldii,22,11,11,Points-PointsKO-Adjacents,110
Turraea_zambesica,12,2,10,Points-PointsKO-Adjacents,100
Turraeanthus_africana,164,104,60,Alphahull-PointsKO-Adjacents,11123
Turraeanthus_longipes,66,50,16,Alphahull-PointsKO-Adjacents,1323
Turraeanthus_mannii,36,26,10,Alphahull-PointsKO-Adjacents,270
Bleasdalea_ferruginea,2,2,0,Points-PointsKO-Adjacents,15
Turrillia_vitiensis,1,1,0,Points-PointsKO-Adjacents,9
Tyleria_apiculata,5,5,0,Points-PointsKO-Adjacents,21
Tyleria_floribunda,9,2,7,Points-PointsKO-Adjacents,60
Tyleria_phelpsiana,5,5,0,Points-PointsKO-Adjacents,39
Tyleria_silvana,5,5,0,Points-PointsKO-Adjacents,41
Tyleria_spathulata,16,8,8,Points-PointsKO-Adjacents,78
Tyleria_spectabilis,8,5,3,Points-PointsKO-Adjacents,18
Tyleria_tremuloidea,8,0,8,Points-PointsKO-Adjacents,49
Uapaca_acuminata,61,39,22,Alphahull-PointsKO-Adjacents,1984
Uapaca_ambanjensis,24,14,10,Points-PointsKO-Adjacents,88
Uapaca_amplifolia,17,0,17,Points-PointsKO-Adjacents,110
Uapaca_benguelensis,6,0,6,Points-PointsKO-Adjacents,51
Uapaca_bojeri,101,88,13,Alphahull-PointsKO-Adjacents,524
Uapaca_brieyi,2,2,0,Points-PointsKO-Adjacents,14
Uapaca_densifolia,217,198,19,Alphahull-PointsKO-Adjacents,1492
Uapaca_ferruginea,51,31,20,Alphahull-PointsKO-Adjacents,576
Uapaca_gossweileri,9,3,6,Points-PointsKO-Adjacents,71
Uapaca_guineensis,318,250,68,Alphahull-PointsKO-Adjacents,21631
Uapaca_heudelotii,339,267,72,Alphahull-PointsKO-Adjacents,27787
Uapaca_katentaniensis,1,1,0,Points-PointsKO-Adjacents,9
Uapaca_kirkiana,109,65,44,Alphahull-PointsKO-Adjacents,9551
Uapaca_lebrunii,13,0,13,Points-PointsKO-Adjacents,91
Uapaca_lissopyrena,37,17,20,Points-PointsKO-Adjacents,288
Uapaca_littoralis,174,141,33,Alphahull-PointsKO-Adjacents,1288
Uapaca_louvelii,89,61,28,Alphahull-PointsKO-Adjacents,1001
Uapaca_mole,205,131,74,Alphahull-PointsKO-Adjacents,17725
Uapaca_niangadoumae,5,5,0,Points-PointsKO-Adjacents,12
Uapaca_nitida,140,88,52,Alphahull-PointsKO-Adjacents,12931
Uapaca_pilosa,24,11,13,Points-PointsKO-Adjacents,160
Uapaca_pynaertii,90,44,46,Alphahull-PointsKO-Adjacents,3106
Uapaca_robynsii,9,1,8,Points-PointsKO-Adjacents,72
Uapaca_rufopilosa,4,4,0,Points-PointsKO-Adjacents,36
Uapaca_sansibarica,66,24,42,Alphahull-PointsKO-Adjacents,2888
Uapaca_staudtii,105,84,21,Alphahull-PointsKO-Adjacents,2592
Uapaca_thouarsii,123,98,25,Alphahull-PointsKO-Adjacents,1066
Uapaca_togoensis,566,497,69,Alphahull-PointsKO-Adjacents,16651
Uapaca_vanhouttei,69,35,34,Alphahull-PointsKO-Adjacents,2411
Ugni_molinae,49,24,25,Alphahull-PointsKO-Adjacents,761
Ugni_myricoides,443,355,88,Alphahull-PointsKO-Adjacents,4382
Uittienia_modesta,2,2,0,Points-PointsKO-Adjacents,18
Uladendron_codesuri,5,5,0,Points-PointsKO-Adjacents,41
Uleanthus_erythrinoides,24,5,19,Points-PointsKO-Adjacents,159
Ulmus_alata,15714,0,15714,Points-PointsKO-Adjacents,16529
Ulmus_americana,23745,21876,1869,Alphahull-PointsKO-Adjacents,74733
Ulmus_bergmanniana,30,9,21,Points-PointsKO-Adjacents,261
Ulmus_canescens,130,51,79,Alphahull-PointsKO-Adjacents,4420
Ulmus_castaneifolia,17,5,12,Points-PointsKO-Adjacents,153
Ulmus_changii,6,0,6,Points-PointsKO-Adjacents,54
Ulmus_chenmoui,3,3,0,Points-PointsKO-Adjacents,27
Ulmus_crassifolia,1491,1318,173,Alphahull-PointsKO-Adjacents,11732
Ulmus_davidiana,431,298,133,Alphahull-PointsKO-Adjacents,14225
Ulmus_elliptica,6,0,6,Points-PointsKO-Adjacents,54
Ulmus_elongata,1,1,0,Points-PointsKO-Adjacents,9
Ulmus_gaussenii,2,2,0,Points-PointsKO-Adjacents,18
Ulmus_glabra,38003,31061,6942,Alphahull-PointsKO-Adjacents,62398
Ulmus_glaucescens,4,4,0,Points-PointsKO-Adjacents,36
Ulmus_harbinensis,NA,NA,NA,NA,NA
Ulmus_ismaelis,7,2,5,Points-PointsKO-Adjacents,60
Ulmus_laciniata,189,136,53,Alphahull-PointsKO-Adjacents,2190
Ulmus_laevis,5704,4633,1071,Alphahull-PointsKO-Adjacents,32273
Ulmus_lamellosa,2,1,1,Points-PointsKO-Adjacents,18
Ulmus_lanceifolia,7,1,6,Points-PointsKO-Adjacents,63
Ulmus_macrocarpa,120,81,39,Alphahull-PointsKO-Adjacents,1970
Ulmus_mexicana,301,256,45,Alphahull-PointsKO-Adjacents,4485
Ulmus_microcarpa,NA,NA,NA,NA,NA
Ulmus_minor,28203,22295,5908,Alphahull-PointsKO-Adjacents,63120
Ulmus_parvifolia,223,0,223,Points-PointsKO-Adjacents,1240
Ulmus_prunifolia,2,2,0,Points-PointsKO-Adjacents,18
Ulmus_pseudopropinqua,NA,NA,NA,NA,NA
Ulmus_pumila,41,5,36,Points-PointsKO-Adjacents,357
Ulmus_rubra,10486,9579,907,Alphahull-PointsKO-Adjacents,54290
Ulmus_serotina,148,106,42,Alphahull-PointsKO-Adjacents,3998
Ulmus_szechuanica,7,1,6,Points-PointsKO-Adjacents,63
Ulmus_thomasii,764,585,179,Alphahull-PointsKO-Adjacents,27484
Ulmus_uyematsui,66,58,8,Alphahull-PointsKO-Adjacents,167
Ulmus_villosa,8,0,8,Points-PointsKO-Adjacents,69
Ulmus_wallichiana,11,0,11,Points-PointsKO-Adjacents,92
Umbellularia_californica,2203,1959,244,Alphahull-PointsKO-Adjacents,4581
Umtiza_listerana,NA,NA,NA,NA,NA
Uncaria_sinensis,21,4,17,Points-PointsKO-Adjacents,183
Uncaria_sterrophylla,8,2,6,Points-PointsKO-Adjacents,57
Uncarina_abbreviata,38,0,38,Points-PointsKO-Adjacents,145
Uncarina_stellulifera,44,35,9,Alphahull-PointsKO-Adjacents,188
Uncarina_turicana,2,2,0,Points-PointsKO-Adjacents,12
Ungnadia_speciosa,438,360,78,Alphahull-PointsKO-Adjacents,8439
Unonopsis_aurantiaca,15,9,6,Points-PointsKO-Adjacents,48
Unonopsis_aviceps,53,41,12,Alphahull-PointsKO-Adjacents,399
Unonopsis_bahiensis,110,86,24,Alphahull-PointsKO-Adjacents,964
Unonopsis_bauxitae,3,3,0,Points-PointsKO-Adjacents,27
Unonopsis_bullata,36,25,11,Alphahull-PointsKO-Adjacents,174
Unonopsis_cauliflora,3,3,0,Points-PointsKO-Adjacents,27
Unonopsis_colombiana,24,15,9,Points-PointsKO-Adjacents,164
Unonopsis_costaricensis,28,16,12,Points-PointsKO-Adjacents,140
Unonopsis_darienensis,24,16,8,Points-PointsKO-Adjacents,154
Unonopsis_duckei,68,42,26,Alphahull-PointsKO-Adjacents,3239
Unonopsis_elegantissima,53,37,16,Alphahull-PointsKO-Adjacents,2687
Unonopsis_floribunda,458,401,57,Alphahull-PointsKO-Adjacents,29068
Unonopsis_glaucopetala,90,70,20,Alphahull-PointsKO-Adjacents,3053
Unonopsis_guatterioides,1697,1588,109,Alphahull-PointsKO-Adjacents,97710
Unonopsis_hammelii,17,11,6,Points-PointsKO-Adjacents,82
Unonopsis_heterotricha,1,1,0,Points-PointsKO-Adjacents,9
Unonopsis_longipes,22,10,12,Points-PointsKO-Adjacents,164
Unonopsis_macrocarpa,8,4,4,Points-PointsKO-Adjacents,51
Unonopsis_magnifolia,21,13,8,Points-PointsKO-Adjacents,126
Unonopsis_megalophylla,14,5,9,Points-PointsKO-Adjacents,108
Unonopsis_osae,27,22,5,Alphahull-PointsKO-Adjacents,64
Unonopsis_pacifica,59,48,11,Alphahull-PointsKO-Adjacents,1334
Unonopsis_panamensis,68,54,14,Alphahull-PointsKO-Adjacents,502
Unonopsis_penduliflora,12,8,4,Points-PointsKO-Adjacents,47
Unonopsis_perrottetii,41,0,41,Points-PointsKO-Adjacents,254
Unonopsis_peruviana,28,15,13,Points-PointsKO-Adjacents,158
Unonopsis_pittieri,180,147,33,Alphahull-PointsKO-Adjacents,1644
Unonopsis_renatoi,8,1,7,Points-PointsKO-Adjacents,53
Unonopsis_riedeliana,2,2,0,Points-PointsKO-Adjacents,18
Unonopsis_rufescens,94,65,29,Alphahull-PointsKO-Adjacents,7169
Unonopsis_sanctae-teresae,16,13,3,Points-PointsKO-Adjacents,44
Unonopsis_sericea,3,3,0,Points-PointsKO-Adjacents,27
Unonopsis_sessilicarpa,23,17,6,Points-PointsKO-Adjacents,122
Unonopsis_silvatica,3,3,0,Points-PointsKO-Adjacents,25
Unonopsis_spectabilis,152,100,52,Alphahull-PointsKO-Adjacents,13594
Unonopsis_stevensii,9,4,5,Points-PointsKO-Adjacents,49
Unonopsis_stipitata,470,405,65,Alphahull-PointsKO-Adjacents,29624
Unonopsis_storkii,48,35,13,Alphahull-PointsKO-Adjacents,266
Unonopsis_theobromifolia,52,45,7,Alphahull-PointsKO-Adjacents,156
Unonopsis_umbilicata,6,1,5,Points-PointsKO-Adjacents,36
Unonopsis_veneficiorum,239,206,33,Alphahull-PointsKO-Adjacents,11050
Urbananthus_critoniformis,1,1,0,Points-PointsKO-Adjacents,6
Urbanodendron_bahiense,27,10,17,Points-PointsKO-Adjacents,212
Urbanodendron_macrophyllum,0,0,0,NA,0
Urbanodendron_verrucosum,148,126,22,Alphahull-PointsKO-Adjacents,1852
Urera_acuminata,40,22,18,Alphahull-PointsKO-Adjacents,543
Urera_aurantiaca,227,163,64,Alphahull-PointsKO-Adjacents,14625
Urera_baccifera,2433,2129,304,Alphahull-PointsKO-Adjacents,89352
Urera_capitata,79,44,35,Alphahull-PointsKO-Adjacents,2205
Urera_caracasana,1289,1022,267,Alphahull-PointsKO-Adjacents,57240
Urera_chlorocarpa,7,3,4,Points-PointsKO-Adjacents,36
Urera_elata,220,176,44,Alphahull-PointsKO-Adjacents,1927
Urera_expansa,2,2,0,Points-PointsKO-Adjacents,18
Urera_fenestrata,58,42,16,Alphahull-PointsKO-Adjacents,181
Urera_filiformis,0,0,0,NA,0
Urera_glabra,16,5,11,Points-PointsKO-Adjacents,97
Urera_glabriuscula,37,24,13,Alphahull-PointsKO-Adjacents,298
Urera_kaalae,0,0,0,NA,0
Urera_killipiana,2,2,0,Points-PointsKO-Adjacents,18
Urera_laciniata,137,0,137,Points-PointsKO-Adjacents,913
Urera_mannii,5,5,0,Points-PointsKO-Adjacents,29
Urera_martiniana,4,3,1,Points-PointsKO-Adjacents,15
Urera_pacifica,14,4,10,Points-PointsKO-Adjacents,112
Urera_simplex,576,482,94,Alphahull-PointsKO-Adjacents,11096
Urera_verrucosa,161,90,71,Alphahull-PointsKO-Adjacents,5408
Uribea_tamarindoides,48,29,19,Alphahull-PointsKO-Adjacents,657
Urobotrya_congolana,67,44,23,Alphahull-PointsKO-Adjacents,589
Urobotrya_floresensis,0,0,0,NA,0
Urobotrya_latisquama,0,0,0,NA,0
Urobotrya_parviflora,0,0,0,NA,0
Urobotrya_siamensis,14,5,9,Points-PointsKO-Adjacents,114
Uromyrtus_archboldiana,8,3,5,Points-PointsKO-Adjacents,51
Uromyrtus_artensis,66,52,14,Alphahull-PointsKO-Adjacents,203
Uromyrtus_australis,57,52,5,Alphahull-PointsKO-Adjacents,36
Uromyrtus_billardierei,0,0,0,NA,0
Uromyrtus_brassii,12,2,10,Points-PointsKO-Adjacents,71
Uromyrtus_curvipes,NA,NA,NA,NA,NA
Uromyrtus_emarginata,19,12,7,Points-PointsKO-Adjacents,51
Uromyrtus_gomonenensis,0,0,0,NA,0
Uromyrtus_lamingtonensis,16,7,9,Points-PointsKO-Adjacents,19
Uromyrtus_metrosideros,68,60,8,Alphahull-PointsKO-Adjacents,4953
Uromyrtus_nekouana,0,0,0,NA,0
Uromyrtus_neomyrtoides,5,0,5,Points-PointsKO-Adjacents,39
Uromyrtus_ngoyensis,14,8,6,Points-PointsKO-Adjacents,91
Uromyrtus_novoguineensis,0,0,0,NA,0
Uromyrtus_paulotchensis,1,1,0,Points-PointsKO-Adjacents,8
Uromyrtus_rostrata,NA,NA,NA,NA,NA
Uromyrtus_sarawakensis,0,0,0,NA,0
Uromyrtus_supraaxillaris,5,5,0,Points-PointsKO-Adjacents,42
Uromyrtus_tenella,59,0,59,Points-PointsKO-Adjacents,91
Uromyrtus_thymifolia,9,3,6,Points-PointsKO-Adjacents,55
Urophyllum_aequale,0,0,0,NA,0
Urophyllum_arboreum,93,0,93,Points-PointsKO-Adjacents,554
Urophyllum_assahanicum,0,0,0,NA,0
Urophyllum_blumeanum,4,3,1,Points-PointsKO-Adjacents,36
Urophyllum_borneense,19,9,10,Points-PointsKO-Adjacents,166
Urophyllum_bracteolatum,0,0,0,NA,0
Urophyllum_britannicum,21,9,12,Points-PointsKO-Adjacents,117
Urophyllum_capituligerum,1,1,0,Points-PointsKO-Adjacents,9
Urophyllum_cephalotes,0,0,0,NA,0
Urophyllum_ceylanicum,NA,NA,NA,NA,NA
Urophyllum_chinense,14,6,8,Points-PointsKO-Adjacents,126
Urophyllum_chlamydanthum,0,0,0,NA,0
Urophyllum_clemensiorum,6,1,5,Points-PointsKO-Adjacents,37
Urophyllum_coffeoides,0,0,0,NA,0
Urophyllum_congestiflorum,13,0,13,Points-PointsKO-Adjacents,97
Urophyllum_corniculatum,NA,NA,NA,NA,NA
Urophyllum_corymbosum,8,0,8,Points-PointsKO-Adjacents,71
Urophyllum_cyphandrum,6,1,5,Points-PointsKO-Adjacents,18
Urophyllum_deliense,0,0,0,NA,0
Urophyllum_ellipticum,3,3,0,Points-PointsKO-Adjacents,19
Urophyllum_elmeri,0,0,0,NA,0
Urophyllum_enneandrum,5,0,5,Points-PointsKO-Adjacents,45
Urophyllum_grandifolium,2,2,0,Points-PointsKO-Adjacents,12
Urophyllum_griffithianum,10,3,7,Points-PointsKO-Adjacents,85
Urophyllum_hirsutum,29,11,18,Points-PointsKO-Adjacents,213
Urophyllum_holectomium,0,0,0,NA,0
Urophyllum_kinabaluense,13,9,4,Points-PointsKO-Adjacents,57
Urophyllum_lanaense,0,0,0,NA,0
Urophyllum_leucophlaeum,0,0,0,NA,0
Urophyllum_lineatum,1,1,0,Points-PointsKO-Adjacents,9
Urophyllum_longidens,2,2,0,Points-PointsKO-Adjacents,9
Urophyllum_longifolium,1,1,0,Points-PointsKO-Adjacents,9
Urophyllum_longipetalum,NA,NA,NA,NA,NA
Urophyllum_macrophyllum,9,1,8,Points-PointsKO-Adjacents,70
Urophyllum_macrurum,6,0,6,Points-PointsKO-Adjacents,31
Urophyllum_magnifolium,0,0,0,NA,0
Urophyllum_maingayi,0,0,0,NA,0
Urophyllum_nigricans,14,7,7,Points-PointsKO-Adjacents,102
Urophyllum_opacum,0,0,0,NA,0
Urophyllum_paniculatum,5,4,1,Points-PointsKO-Adjacents,43
Urophyllum_parviflorum,NA,NA,NA,NA,NA
Urophyllum_parvistipulum,1,1,0,Points-PointsKO-Adjacents,9
Urophyllum_peltistigma,NA,NA,NA,NA,NA
Urophyllum_pilosum,0,0,0,NA,0
Urophyllum_polyneurum,8,2,6,Points-PointsKO-Adjacents,64
Urophyllum_rufescens,2,2,0,Points-PointsKO-Adjacents,18
Urophyllum_salicifolium,12,1,11,Points-PointsKO-Adjacents,39
Urophyllum_sandahanicum,7,1,6,Points-PointsKO-Adjacents,54
Urophyllum_sessiliflorum,1,1,0,Points-PointsKO-Adjacents,9
Urophyllum_sintangense,NA,NA,NA,NA,NA
Urophyllum_streptopodium,3,3,0,Points-PointsKO-Adjacents,27
Urophyllum_subanurum,2,2,0,Points-PointsKO-Adjacents,12
Urophyllum_talangense,0,0,0,NA,0
Urophyllum_trifurcum,3,3,0,Points-PointsKO-Adjacents,27
Urophyllum_tsaianum,2,2,0,Points-PointsKO-Adjacents,18
Urophyllum_umbellulatum,1,1,0,Points-PointsKO-Adjacents,9
Urophyllum_villosum,3,3,0,Points-PointsKO-Adjacents,27
Urophyllum_woodii,9,6,3,Points-PointsKO-Adjacents,75
Urophyllum_yatesii,NA,NA,NA,NA,NA
Decalepis_salicifolia,1,1,0,Points-PointsKO-Adjacents,9
Uvaria_acuminata,128,104,24,Alphahull-PointsKO-Adjacents,1663
Uvaria_afzelii,68,47,21,Alphahull-PointsKO-Adjacents,2285
Uvaria_ambongoensis,7,1,6,Points-PointsKO-Adjacents,50
Uvaria_amplexicaulis,5,5,0,Points-PointsKO-Adjacents,39
Uvaria_angolensis,110,41,69,Alphahull-PointsKO-Adjacents,1292
Uvaria_anonoides,8,0,8,Points-PointsKO-Adjacents,72
Uvaria_antsiranensis,13,10,3,Points-PointsKO-Adjacents,30
Uvaria_bathiei,7,0,7,Points-PointsKO-Adjacents,63
Uvaria_caffra,75,48,27,Alphahull-PointsKO-Adjacents,1001
Uvaria_chamae,663,589,74,Alphahull-PointsKO-Adjacents,12962
Uvaria_combretifolia,12,4,8,Points-PointsKO-Adjacents,67
Uvaria_diplocampta,0,0,0,NA,0
Uvaria_doeringii,37,22,15,Alphahull-PointsKO-Adjacents,290
Uvaria_faulknerae,13,5,8,Points-PointsKO-Adjacents,75
Uvaria_laurentii,6,1,5,Points-PointsKO-Adjacents,39
Uvaria_leandrii,9,1,8,Points-PointsKO-Adjacents,53
Uvaria_manjensis,3,3,0,Points-PointsKO-Adjacents,27
Uvaria_ovata,47,29,18,Alphahull-PointsKO-Adjacents,245
Uvaria_pandensis,10,4,6,Points-PointsKO-Adjacents,51
Uvaria_saboureaui,4,4,0,Points-PointsKO-Adjacents,36
Uvaria_schweinfurthii,5,5,0,Points-PointsKO-Adjacents,36
Uvaria_sofa,14,2,12,Points-PointsKO-Adjacents,105
Uvaria_welwitschii,27,9,18,Points-PointsKO-Adjacents,203
Uvariastrum_germainii,15,2,13,Points-PointsKO-Adjacents,112
Uvariastrum_hexaloboides,37,26,11,Alphahull-PointsKO-Adjacents,1061
Uvariastrum_insculptum,106,75,31,Alphahull-PointsKO-Adjacents,4356
Uvariastrum_pierreanum,160,125,35,Alphahull-PointsKO-Adjacents,6276
Uvariastrum_zenkeri,21,11,10,Points-PointsKO-Adjacents,128
Uvariodendron_angustifolium,11,2,9,Points-PointsKO-Adjacents,89
Uvariodendron_anisatum,11,1,10,Points-PointsKO-Adjacents,57
Uvariodendron_calophyllum,34,17,17,Points-PointsKO-Adjacents,250
Uvariodendron_connivens,40,31,9,Alphahull-PointsKO-Adjacents,421
Uvariodendron_fuscum,5,5,0,Points-PointsKO-Adjacents,37
Uvariodendron_giganteum,24,13,11,Points-PointsKO-Adjacents,174
Uvariodendron_kirkii,48,30,18,Alphahull-PointsKO-Adjacents,364
Uvariodendron_magnificum,6,3,3,Points-PointsKO-Adjacents,29
Uvariodendron_mirabile,6,0,6,Points-PointsKO-Adjacents,44
Uvariodendron_molundense,58,33,25,Alphahull-PointsKO-Adjacents,1723
Uvariodendron_oligocarpum,4,4,0,Points-PointsKO-Adjacents,33
Uvariodendron_pycnophyllum,9,4,5,Points-PointsKO-Adjacents,31
Uvariodendron_usambarense,14,7,7,Points-PointsKO-Adjacents,53
Uvariopsis_bakeriana,17,11,6,Points-PointsKO-Adjacents,72
Uvariopsis_bisexualis,12,5,7,Points-PointsKO-Adjacents,66
Uvariopsis_congensis,33,17,16,Points-PointsKO-Adjacents,168
Uvariopsis_congolana,24,5,19,Points-PointsKO-Adjacents,188
Uvariopsis_dioica,28,19,9,Points-PointsKO-Adjacents,153
Uvariopsis_globiflora,26,18,8,Points-PointsKO-Adjacents,166
Uvariopsis_guineensis,36,24,12,Alphahull-PointsKO-Adjacents,941
Uvariopsis_korupensis,13,9,4,Points-PointsKO-Adjacents,48
Uvariopsis_noldeae,1,1,0,Points-PointsKO-Adjacents,9
Uvariopsis_sessiliflora,0,0,0,NA,0
Uvariopsis_solheidii,39,23,16,Alphahull-PointsKO-Adjacents,814
Uvariopsis_submontana,14,9,5,Points-PointsKO-Adjacents,48
Uvariopsis_tripetala,96,69,27,Alphahull-PointsKO-Adjacents,2557
Uvariopsis_vanderystii,20,12,8,Points-PointsKO-Adjacents,145
Uvariopsis_zenkeri,9,4,5,Points-PointsKO-Adjacents,81
Vaccinium_albidens,1,1,0,Points-PointsKO-Adjacents,9
Vaccinium_arboreum,1561,1334,227,Alphahull-PointsKO-Adjacents,20008
Vaccinium_arctostaphylos,37,1,36,Points-PointsKO-Adjacents,218
Vaccinium_bocatorense,1,1,0,Points-PointsKO-Adjacents,9
Vaccinium_brachybotrys,11,3,8,Points-PointsKO-Adjacents,99
Vaccinium_bracteatum,369,230,139,Alphahull-PointsKO-Adjacents,14721
Vaccinium_brevipedicellatum,1,1,0,Points-PointsKO-Adjacents,9
Vaccinium_carlesii,59,41,18,Alphahull-PointsKO-Adjacents,2787
Vaccinium_consanguineum,213,0,213,Points-PointsKO-Adjacents,264
Vaccinium_costaricense,26,19,7,Points-PointsKO-Adjacents,87
Vaccinium_cylindraceum,24,8,16,Points-PointsKO-Adjacents,58
Vaccinium_duclouxii,101,84,17,Alphahull-PointsKO-Adjacents,2099
Vaccinium_dunalianum,134,113,21,Alphahull-PointsKO-Adjacents,282
Vaccinium_exaristatum,19,7,12,Points-PointsKO-Adjacents,132
Vaccinium_exul,24,14,10,Points-PointsKO-Adjacents,168
Vaccinium_floribundum,660,581,79,Alphahull-PointsKO-Adjacents,4703
Vaccinium_guangdongense,NA,NA,NA,NA,NA
Vaccinium_harmandianum,36,21,15,Alphahull-PointsKO-Adjacents,1315
Vaccinium_iteophyllum,70,48,22,Alphahull-PointsKO-Adjacents,6975
Vaccinium_kachinense,NA,NA,NA,NA,NA
Vaccinium_kengii,18,9,9,Points-PointsKO-Adjacents,87
Vaccinium_latifolium,5,5,0,Points-PointsKO-Adjacents,40
Vaccinium_leucanthum,268,232,36,Alphahull-PointsKO-Adjacents,2446
Vaccinium_meridionale,53,38,15,Alphahull-PointsKO-Adjacents,731
Vaccinium_poasanum,216,184,32,Alphahull-PointsKO-Adjacents,1461
Vaccinium_puberulum,170,148,22,Alphahull-PointsKO-Adjacents,3585
Vaccinium_pubicalyx,35,0,35,Points-PointsKO-Adjacents,262
Vaccinium_racemosum,43,26,17,Alphahull-PointsKO-Adjacents,253
Vaccinium_retusum,8,0,8,Points-PointsKO-Adjacents,57
Vaccinium_selerianum,45,30,15,Alphahull-PointsKO-Adjacents,642
Vaccinium_sprengelii,121,73,48,Alphahull-PointsKO-Adjacents,12828
Vaccinium_stenophyllum,86,0,86,Points-PointsKO-Adjacents,405
Vaccinium_subdissitifolium,1,1,0,Points-PointsKO-Adjacents,9
Vaccinium_subfalcatum,6,2,4,Points-PointsKO-Adjacents,54
Vaccinium_leschenaultii,1,0,1,Points-PointsKO-Adjacents,9
Vaccinium_trichocladum,19,10,9,Points-PointsKO-Adjacents,171
Vaccinium_truncatocalyx,1,1,0,Points-PointsKO-Adjacents,9
Vaccinium_urceolatum,45,22,23,Alphahull-PointsKO-Adjacents,2131
Vaccinium_wrightii,120,96,24,Alphahull-PointsKO-Adjacents,337
Vaccinium_yaoshanicum,2,2,0,Points-PointsKO-Adjacents,18
Vachellia_abyssinica,35,18,17,Points-PointsKO-Adjacents,271
Vachellia_acuifera,4,4,0,Points-PointsKO-Adjacents,17
Vachellia_albicorticata,70,0,70,Points-PointsKO-Adjacents,479
Vachellia_allenii,29,22,7,Alphahull-PointsKO-Adjacents,66
Vachellia_amythethophylla,123,58,65,Alphahull-PointsKO-Adjacents,9427
Vachellia_anegadensis,2,2,0,Points-PointsKO-Adjacents,4
Vachellia_aroma,465,391,74,Alphahull-PointsKO-Adjacents,14770
Vachellia_astringens,68,38,30,Alphahull-PointsKO-Adjacents,5103
Vachellia_baessleri,NA,NA,NA,NA,NA
Vachellia_barahonensis,5,5,0,Points-PointsKO-Adjacents,34
Vachellia_belairioides,NA,NA,NA,NA,NA
Vachellia_brandegeana,63,52,11,Alphahull-PointsKO-Adjacents,372
Vachellia_bucheri,4,4,0,Points-PointsKO-Adjacents,20
Vachellia_campechiana,147,105,42,Alphahull-PointsKO-Adjacents,2336
Vachellia_caven,459,378,81,Alphahull-PointsKO-Adjacents,25293
Vachellia_cedilloi,8,5,3,Points-PointsKO-Adjacents,34
Vachellia_choriophylla,12,5,7,Points-PointsKO-Adjacents,89
Vachellia_collinsii,267,221,46,Alphahull-PointsKO-Adjacents,4461
Vachellia_constricta,632,563,69,Alphahull-PointsKO-Adjacents,13513
Vachellia_cookii,14,6,8,Points-PointsKO-Adjacents,91
Vachellia_cornigera,75,53,22,Alphahull-PointsKO-Adjacents,2627
Vachellia_cucuyo,3,3,0,Points-PointsKO-Adjacents,17
Vachellia_curvifructa,34,21,13,Alphahull-PointsKO-Adjacents,1688
Vachellia_daemon,1,1,0,Points-PointsKO-Adjacents,9
Vachellia_ditricha,120,95,25,Alphahull-PointsKO-Adjacents,1386
Vachellia_drepanolobium,156,119,37,Alphahull-PointsKO-Adjacents,8493
Vachellia_eburnea,2,2,0,Points-PointsKO-Adjacents,16
Vachellia_erioloba,131,95,36,Alphahull-PointsKO-Adjacents,14484
Vachellia_farnesiana,5446,4413,1033,Alphahull-PointsKO-Adjacents,133798
Vachellia_flexuosa,11,3,8,Points-PointsKO-Adjacents,72
Vachellia_gentlei,58,46,12,Alphahull-PointsKO-Adjacents,494
Vachellia_glandulifera,58,38,20,Alphahull-PointsKO-Adjacents,2330
Vachellia_globulifera,8,1,7,Points-PointsKO-Adjacents,60
Vachellia_hindsii,259,187,72,Alphahull-PointsKO-Adjacents,3582
Vachellia_hockii,638,527,111,Alphahull-PointsKO-Adjacents,29403
Vachellia_insulae-iacobi,2,2,0,Points-PointsKO-Adjacents,16
Vachellia_karroo,591,448,143,Alphahull-PointsKO-Adjacents,20898
Vachellia_lahai,77,51,26,Alphahull-PointsKO-Adjacents,1723
Vachellia_leucophloea,29,0,29,Points-PointsKO-Adjacents,242
Vachellia_macracantha,846,641,205,Alphahull-PointsKO-Adjacents,25860
Vachellia_melanoceras,23,14,9,Points-PointsKO-Adjacents,85
Vachellia_nilotica,1165,808,357,Alphahull-PointsKO-Adjacents,61679
Vachellia_oviedoensis,2,1,1,Points-PointsKO-Adjacents,18
Vachellia_pachyphloia,272,247,25,Alphahull-PointsKO-Adjacents,3276
Vachellia_pallidifolia,178,161,17,Alphahull-PointsKO-Adjacents,1008
Vachellia_pennatula,1354,1173,181,Alphahull-PointsKO-Adjacents,12770
Vachellia_polypyrigenes,0,0,0,NA,0
Vachellia_pringlei,215,170,45,Alphahull-PointsKO-Adjacents,3582
Vachellia_roigii,1,1,0,Points-PointsKO-Adjacents,9
Vachellia_rorudiana,8,2,6,Points-PointsKO-Adjacents,52
Vachellia_ruddiae,34,21,13,Alphahull-PointsKO-Adjacents,448
Vachellia_schaffneri,343,304,39,Alphahull-PointsKO-Adjacents,7955
Vachellia_seyal,111,0,111,Points-PointsKO-Adjacents,913
Vachellia_sphaerocephala,47,23,24,Alphahull-PointsKO-Adjacents,180
Vachellia_standleyi,2,2,0,Points-PointsKO-Adjacents,18
Vachellia_suberosa,158,143,15,Alphahull-PointsKO-Adjacents,1206
Vachellia_tortilis,692,534,158,Alphahull-PointsKO-Adjacents,16048
Vachellia_tortuosa,195,103,92,Alphahull-PointsKO-Adjacents,5123
Vachellia_valida,359,336,23,Alphahull-PointsKO-Adjacents,4319
Vachellia_xanthophloea,114,64,50,Alphahull-PointsKO-Adjacents,1747
Vachellia_zapatensis,1,1,0,Points-PointsKO-Adjacents,8
Valeriana_arborea,18,10,8,Points-PointsKO-Adjacents,110
Vallaris_indecora,9,0,9,Points-PointsKO-Adjacents,81
Vallea_ecuadorensis,47,33,14,Alphahull-PointsKO-Adjacents,424
Vallea_stipularis,769,679,90,Alphahull-PointsKO-Adjacents,8621
Vallesia_antillana,29,5,24,Points-PointsKO-Adjacents,175
Vallesia_aurantiaca,84,52,32,Alphahull-PointsKO-Adjacents,978
Vallesia_baileyana,29,2,27,Points-PointsKO-Adjacents,130
Vallesia_conzattii,1,1,0,Points-PointsKO-Adjacents,9
Vallesia_glabra,542,437,105,Alphahull-PointsKO-Adjacents,12325
Vallesia_hypoglauca,NA,NA,NA,NA,NA
Vallesia_laciniata,34,22,12,Alphahull-PointsKO-Adjacents,216
Vallesia_montana,8,1,7,Points-PointsKO-Adjacents,71
Vallesia_pubescens,NA,NA,NA,NA,NA
Vallesia_sinaloensis,27,16,11,Points-PointsKO-Adjacents,121
Vallesia_spectabilis,1,1,0,Points-PointsKO-Adjacents,9
Vangueria_apiculata,92,59,33,Alphahull-PointsKO-Adjacents,4281
Vangueria_bicolor,5,5,0,Points-PointsKO-Adjacents,33
Vangueria_burnettii,15,8,7,Points-PointsKO-Adjacents,119
Vangueria_burttii,14,7,7,Points-PointsKO-Adjacents,83
Vangueria_cyanescens,31,8,23,Points-PointsKO-Adjacents,240
Vangueria_dryadum,21,10,11,Points-PointsKO-Adjacents,156
Vangueria_esculenta,10,5,5,Points-PointsKO-Adjacents,83
Vangueria_gillettii,7,2,5,Points-PointsKO-Adjacents,53
Vangueria_glabrata,0,0,0,NA,0
Vangueria_induta,9,0,9,Points-PointsKO-Adjacents,66
Vangueria_infausta,401,316,85,Alphahull-PointsKO-Adjacents,22203
Vangueria_lasiantha,38,21,17,Alphahull-PointsKO-Adjacents,624
Vangueria_loranthifolia,22,14,8,Points-PointsKO-Adjacents,142
Vangueria_macrocalyx,73,57,16,Alphahull-PointsKO-Adjacents,1605
Vangueria_madagascariensis,140,67,73,Alphahull-PointsKO-Adjacents,4681
Vangueria_monteiroi,11,0,11,Points-PointsKO-Adjacents,87
Vangueria_obtusifolia,12,6,6,Points-PointsKO-Adjacents,62
Vangueria_pallidiflora,29,14,15,Points-PointsKO-Adjacents,123
Vangueria_parvifolia,54,37,17,Alphahull-PointsKO-Adjacents,1164
Vangueria_praecox,14,10,4,Points-PointsKO-Adjacents,92
Vangueria_randii,78,45,33,Alphahull-PointsKO-Adjacents,1523
Vangueria_rhodesiaca,0,0,0,NA,0
Vangueria_rufescens,10,6,4,Points-PointsKO-Adjacents,46
Vangueria_schliebenii,3,3,0,Points-PointsKO-Adjacents,18
Vangueria_schumanniana,23,14,9,Points-PointsKO-Adjacents,154
Vangueria_solitariiflora,5,5,0,Points-PointsKO-Adjacents,45
Vangueria_volkensii,45,19,26,Points-PointsKO-Adjacents,279
Vangueriella_chlorantha,106,89,17,Alphahull-PointsKO-Adjacents,782
Vangueriella_discolor,73,49,24,Alphahull-PointsKO-Adjacents,2393
Vangueriella_laxiflora,34,25,9,Alphahull-PointsKO-Adjacents,263
Vangueriella_nigerica,90,74,16,Alphahull-PointsKO-Adjacents,2461
Vangueriella_nigricans,18,5,13,Points-PointsKO-Adjacents,117
Vangueriella_olacifolia,17,11,6,Points-PointsKO-Adjacents,117
Vangueriella_orthacantha,49,14,35,Points-PointsKO-Adjacents,372
Vangueriella_soyauxii,16,9,7,Points-PointsKO-Adjacents,116
Vangueriella_spinosa,37,22,15,Alphahull-PointsKO-Adjacents,698
Vangueriella_vanguerioides,71,51,20,Alphahull-PointsKO-Adjacents,4846
Vangueriella_zenkeri,6,4,2,Points-PointsKO-Adjacents,36
Vangueriopsis_lanciflora,41,9,32,Points-PointsKO-Adjacents,341
Vangueriopsis_longiflora,8,4,4,Points-PointsKO-Adjacents,41
Vangueriopsis_rubiginosa,5,5,0,Points-PointsKO-Adjacents,42
Vangueriopsis_shimbaensis,1,1,0,Points-PointsKO-Adjacents,9
Van-royena_castanosperma,71,62,9,Alphahull-PointsKO-Adjacents,123
Vantanea_bahiaensis,53,32,21,Alphahull-PointsKO-Adjacents,275
Vantanea_celativenia,5,5,0,Points-PointsKO-Adjacents,45
Vantanea_compacta,255,196,59,Alphahull-PointsKO-Adjacents,2970
Vantanea_deniseae,8,2,6,Points-PointsKO-Adjacents,52
Vantanea_depleta,12,9,3,Points-PointsKO-Adjacents,65
Vantanea_guianensis,118,71,47,Alphahull-PointsKO-Adjacents,7435
Vantanea_macrocarpa,31,18,13,Points-PointsKO-Adjacents,203
Vantanea_magdalenensis,3,3,0,Points-PointsKO-Adjacents,27
Vantanea_micrantha,25,1,24,Points-PointsKO-Adjacents,175
Vantanea_minor,33,23,10,Alphahull-PointsKO-Adjacents,151
Vantanea_morii,27,0,27,Points-PointsKO-Adjacents,91
Vantanea_obovata,235,204,31,Alphahull-PointsKO-Adjacents,6096
Vantanea_occidentalis,12,4,8,Points-PointsKO-Adjacents,86
Vantanea_ovicarpa,5,5,0,Points-PointsKO-Adjacents,36
Vantanea_paraensis,39,12,27,Points-PointsKO-Adjacents,292
Vantanea_parviflora,198,128,70,Alphahull-PointsKO-Adjacents,11639
Vantanea_peruviana,9,2,7,Points-PointsKO-Adjacents,65
Vantanea_spichigeri,9,2,7,Points-PointsKO-Adjacents,72
Vantanea_tuberculata,1,1,0,Points-PointsKO-Adjacents,9
Varronia_anisodonta,2,2,0,Points-PointsKO-Adjacents,18
Varronia_areolata,1,0,1,Points-PointsKO-Adjacents,9
Varronia_baracoensis,1,1,0,Points-PointsKO-Adjacents,8
Varronia_barahonensis,NA,NA,NA,NA,NA
Varronia_bombardensis,NA,NA,NA,NA,NA
Cordia_brittonii,3,3,0,Points-PointsKO-Adjacents,24
Varronia_brownei,4,4,0,Points-PointsKO-Adjacents,29
Varronia_bullata,163,124,39,Alphahull-PointsKO-Adjacents,2772
Varronia_calcicola,1,1,0,Points-PointsKO-Adjacents,9
Varronia_chabrensis,NA,NA,NA,NA,NA
Varronia_claviceps,1,1,0,Points-PointsKO-Adjacents,7
Varronia_corallicola,0,0,0,NA,0
Varronia_cylindrostachya,296,242,54,Alphahull-PointsKO-Adjacents,3343
Varronia_dependens,11,5,6,Points-PointsKO-Adjacents,59
Varronia_exarata,1,0,1,Points-PointsKO-Adjacents,9
Varronia_fasciata,NA,NA,NA,NA,NA
Varronia_fasciculata,NA,NA,NA,NA,NA
Varronia_gibberosa,NA,NA,NA,NA,NA
Cordia_integrifolia,1,1,0,Points-PointsKO-Adjacents,9
Varronia_jamaicensis,1,1,0,Points-PointsKO-Adjacents,9
Varronia_jeremiensis,0,0,0,NA,0
Varronia_lamprophylla,1,1,0,Points-PointsKO-Adjacents,9
Varronia_macrocephala,327,258,69,Alphahull-PointsKO-Adjacents,2017
Varronia_nashii,NA,NA,NA,NA,NA
Varronia_oligodonta,1,1,0,Points-PointsKO-Adjacents,9
Varronia_perroyana,NA,NA,NA,NA,NA
Varronia_picardae,7,2,5,Points-PointsKO-Adjacents,40
Varronia_polycephala,522,0,522,Points-PointsKO-Adjacents,3247
Varronia_rupicola,15,4,11,Points-PointsKO-Adjacents,21
Cordia_cylindrostachya,344,253,91,Alphahull-PointsKO-Adjacents,3730
Varronia_selleana,3,3,0,Points-PointsKO-Adjacents,12
Varronia_serrata,15,2,13,Points-PointsKO-Adjacents,107
Varronia_spinescens,1367,1189,178,Alphahull-PointsKO-Adjacents,21267
Vasconcellea_cauliflora,271,199,72,Alphahull-PointsKO-Adjacents,8240
Vasconcellea_goudotiana,82,59,23,Alphahull-PointsKO-Adjacents,2844
Vasconcellea_longiflora,5,5,0,Points-PointsKO-Adjacents,45
Vasconcellea_microcarpa,181,107,74,Alphahull-PointsKO-Adjacents,7657
Vasconcellea_monoica,42,17,25,Points-PointsKO-Adjacents,353
Vasconcellea_palandensis,NA,NA,NA,NA,NA
Vasconcellea_parviflora,59,38,21,Alphahull-PointsKO-Adjacents,1113
Vasconcellea_pubescens,157,105,52,Alphahull-PointsKO-Adjacents,2591
Vasconcellea_quercifolia,492,388,104,Alphahull-PointsKO-Adjacents,20393
Vasconcellea_weberbaueri,5,5,0,Points-PointsKO-Adjacents,45
Vasivaea_alchorneoides,80,52,28,Alphahull-PointsKO-Adjacents,4668
Vasivaea_podocarpa,22,9,13,Points-PointsKO-Adjacents,128
Vassobia_breviflora,654,578,76,Alphahull-PointsKO-Adjacents,20763
Vassobia_dichotoma,31,10,21,Points-PointsKO-Adjacents,219
Vatairea_erythrocarpa,100,47,53,Alphahull-PointsKO-Adjacents,2323
Vatairea_fusca,92,45,47,Alphahull-PointsKO-Adjacents,7288
Vatairea_guianensis,297,215,82,Alphahull-PointsKO-Adjacents,30118
Vatairea_heteroptera,75,41,34,Alphahull-PointsKO-Adjacents,1529
Vatairea_lundellii,113,80,33,Alphahull-PointsKO-Adjacents,2820
Vatairea_macrocarpa,766,687,79,Alphahull-PointsKO-Adjacents,39768
Vatairea_paraensis,50,12,38,Points-PointsKO-Adjacents,411
Vatairea_sericea,78,39,39,Alphahull-PointsKO-Adjacents,2331
Vataireopsis_araroba,103,83,20,Alphahull-PointsKO-Adjacents,2039
Vataireopsis_iglesiasii,10,0,10,Points-PointsKO-Adjacents,71
Vataireopsis_speciosa,95,38,57,Alphahull-PointsKO-Adjacents,3784
Vataireopsis_surinamensis,17,10,7,Points-PointsKO-Adjacents,121
Vateria_copallifera,2,1,1,Points-PointsKO-Adjacents,18
Vateria_indica,3,0,3,Points-PointsKO-Adjacents,27
Vateriopsis_seychellarum,2,2,0,Points-PointsKO-Adjacents,9
Sunaptea_badiifolia,1,1,0,Points-PointsKO-Adjacents,9
Sunaptea_brevipes,NA,NA,NA,NA,NA
Sunaptea_brunigii,1,1,0,Points-PointsKO-Adjacents,9
Sunaptea_compressa,0,0,0,NA,0
Sunaptea_congesta,0,0,0,NA,0
Sunaptea_coriacea,NA,NA,NA,NA,NA
Sunaptea_cuspidata,0,0,0,NA,0
Sunaptea_endertii,2,2,0,Points-PointsKO-Adjacents,18
Sunaptea_flavovirens,0,0,0,NA,0
Vatica_guangxiensis,1,1,0,Points-PointsKO-Adjacents,9
Sunaptea_heteroptera,NA,NA,NA,NA,NA
Sunaptea_javanica,1,1,0,Points-PointsKO-Adjacents,9
Vatica_lanceifolia,1,0,1,Points-PointsKO-Adjacents,9
Vatica_mangachapoi,14,0,14,Points-PointsKO-Adjacents,105
Sunaptea_maritima,2,2,0,Points-PointsKO-Adjacents,18
Sunaptea_micrantha,15,5,10,Points-PointsKO-Adjacents,118
Sunaptea_obovata,NA,NA,NA,NA,NA
Vatica_odorata,23,2,21,Points-PointsKO-Adjacents,188
Sunaptea_pachyphylla,NA,NA,NA,NA,NA
Sunaptea_parvifolia,0,0,0,NA,0
Sunaptea_rynchocarpa,NA,NA,NA,NA,NA
Retinodendron_scortechinii,NA,NA,NA,NA,NA
Vatica_soepadmoi,0,0,0,NA,0
Pachynocarpus_stapfianus,1,0,1,Points-PointsKO-Adjacents,6
Vaughania_cloiselii,59,45,14,Alphahull-PointsKO-Adjacents,362
Vaughania_depauperata,39,24,15,Alphahull-PointsKO-Adjacents,546
Vaughania_perrieri,93,76,17,Alphahull-PointsKO-Adjacents,2092
Vaupesia_cataractarum,19,9,10,Points-PointsKO-Adjacents,135
Vauquelinia_californica,168,140,28,Alphahull-PointsKO-Adjacents,3001
Vauquelinia_corymbosa,221,199,22,Alphahull-PointsKO-Adjacents,3175
Vavaea_amicorum,474,359,115,Alphahull-PointsKO-Adjacents,6855
Veitchia_arecina,4,4,0,Points-PointsKO-Adjacents,30
Veitchia_filifera,1,1,0,Points-PointsKO-Adjacents,9
Veitchia_joannis,0,0,0,NA,0
Veitchia_lepidota,NA,NA,NA,NA,NA
Veitchia_metiti,2,2,0,Points-PointsKO-Adjacents,8
Veitchia_pachyclada,0,0,0,NA,0
Veitchia_simulans,0,0,0,NA,0
Veitchia_spiralis,3,3,0,Points-PointsKO-Adjacents,16
Veitchia_subdisticha,4,4,0,Points-PointsKO-Adjacents,25
Veitchia_vitiensis,1,1,0,Points-PointsKO-Adjacents,9
Veitchia_winin,3,3,0,Points-PointsKO-Adjacents,13
Vellozia_gigantea,4,4,0,Points-PointsKO-Adjacents,26
Vellozia_sincorana,15,7,8,Points-PointsKO-Adjacents,83
Vellozia_squamata,203,171,32,Alphahull-PointsKO-Adjacents,5598
Vepris_afzelii,20,5,15,Points-PointsKO-Adjacents,156
Vepris_allenii,0,0,0,NA,0
Vepris_amaniensis,24,14,10,Points-PointsKO-Adjacents,107
Vepris_ampody,24,9,15,Points-PointsKO-Adjacents,163
Vepris_aralioides,24,9,15,Points-PointsKO-Adjacents,144
Vepris_arenicola,6,2,4,Points-PointsKO-Adjacents,36
Vepris_arushensis,3,3,0,Points-PointsKO-Adjacents,18
Vepris_bachmannii,7,0,7,Points-PointsKO-Adjacents,51
Toddalia_bilocularis,1,0,1,Points-PointsKO-Adjacents,9
Vepris_borenensis,1,1,0,Points-PointsKO-Adjacents,9
Vepris_bremekampii,11,4,7,Points-PointsKO-Adjacents,76
Vepris_carringtoniana,3,3,0,Points-PointsKO-Adjacents,27
Vepris_cauliflora,23,12,11,Points-PointsKO-Adjacents,146
Vepris_dainellii,22,14,8,Points-PointsKO-Adjacents,133
Vepris_decaryana,6,2,4,Points-PointsKO-Adjacents,24
Vepris_densiflora,5,4,1,Points-PointsKO-Adjacents,45
Vepris_dicarpella,11,6,5,Points-PointsKO-Adjacents,54
Vepris_eggelingii,4,4,0,Points-PointsKO-Adjacents,34
Vepris_elliotii,58,31,27,Alphahull-PointsKO-Adjacents,149
Vepris_eugeniifolia,20,0,20,Points-PointsKO-Adjacents,160
Vepris_fadenii,7,2,5,Points-PointsKO-Adjacents,53
Vepris_fitoravina,44,22,22,Alphahull-PointsKO-Adjacents,375
Vepris_gabonensis,3,1,2,Points-PointsKO-Adjacents,27
Vepris_glaberrima,37,26,11,Alphahull-PointsKO-Adjacents,1164
Vepris_glandulosa,8,2,6,Points-PointsKO-Adjacents,50
Vepris_glomerata,55,28,27,Alphahull-PointsKO-Adjacents,742
Vepris_gossweileri,2,2,0,Points-PointsKO-Adjacents,18
Vepris_grandifolia,25,5,20,Points-PointsKO-Adjacents,180
Vepris_hanangensis,15,2,13,Points-PointsKO-Adjacents,104
Vepris_heterophylla,21,5,16,Points-PointsKO-Adjacents,140
Vepris_hiernii,34,17,17,Points-PointsKO-Adjacents,208
Vepris_humbertii,6,0,6,Points-PointsKO-Adjacents,45
Vepris_lanceolata,70,29,41,Alphahull-PointsKO-Adjacents,1523
Vepris_leandriana,37,25,12,Alphahull-PointsKO-Adjacents,446
Vepris_lepidota,8,5,3,Points-PointsKO-Adjacents,39
Vepris_louisii,12,1,11,Points-PointsKO-Adjacents,64
Vepris_louvelii,1,1,0,Points-PointsKO-Adjacents,9
Vepris_macedoi,NA,NA,NA,NA,NA
Vepris_macrophylla,48,27,21,Alphahull-PointsKO-Adjacents,301
Vepris_madagascarica,79,52,27,Alphahull-PointsKO-Adjacents,1943
Vepris_madagascariensis,78,52,26,Alphahull-PointsKO-Adjacents,1870
Vepris_mandangoana,0,0,0,NA,0
Vepris_morogorensis,11,3,8,Points-PointsKO-Adjacents,89
Vepris_myrei,2,2,0,Points-PointsKO-Adjacents,14
Vepris_nitida,59,38,21,Alphahull-PointsKO-Adjacents,903
Vepris_nobilis,141,93,48,Alphahull-PointsKO-Adjacents,5557
Vepris_noldeae,1,1,0,Points-PointsKO-Adjacents,9
Vepris_parvicalyx,22,6,16,Points-PointsKO-Adjacents,151
Vepris_peraperta,9,3,6,Points-PointsKO-Adjacents,56
Vepris_polymorpha,17,5,12,Points-PointsKO-Adjacents,124
Vepris_punctata,63,40,23,Alphahull-PointsKO-Adjacents,721
Vepris_reflexa,72,51,21,Alphahull-PointsKO-Adjacents,2317
Vepris_renieri,8,3,5,Points-PointsKO-Adjacents,52
Vepris_samburuensis,4,4,0,Points-PointsKO-Adjacents,30
Vepris_sansibarensis,27,14,13,Points-PointsKO-Adjacents,197
Vepris_sclerophylla,7,0,7,Points-PointsKO-Adjacents,55
Vepris_simplicifolia,130,109,21,Alphahull-PointsKO-Adjacents,2858
Vepris_soyauxii,27,14,13,Points-PointsKO-Adjacents,181
Vepris_spathulata,10,6,4,Points-PointsKO-Adjacents,41
Vepris_stolzii,31,15,16,Points-PointsKO-Adjacents,213
Vepris_suaveolens,52,0,52,Points-PointsKO-Adjacents,341
Vepris_tabouensis,20,8,12,Points-PointsKO-Adjacents,143
Vepris_termitaria,9,0,9,Points-PointsKO-Adjacents,69
Vepris_trichocarpa,29,6,23,Points-PointsKO-Adjacents,225
Vepris_trifoliolata,8,3,5,Points-PointsKO-Adjacents,68
Vepris_undulata,50,15,35,Points-PointsKO-Adjacents,420
Vepris_unifoliolata,67,42,25,Alphahull-PointsKO-Adjacents,1412
Vepris_verdoorniana,54,27,27,Alphahull-PointsKO-Adjacents,954
Vepris_welwitschii,1,1,0,Points-PointsKO-Adjacents,9
Vepris_whitei,0,0,0,NA,0
Vepris_zambesiaca,9,1,8,Points-PointsKO-Adjacents,67
Verbesina_ancashensis,NA,NA,NA,NA,NA
Verbesina_apleura,74,54,20,Alphahull-PointsKO-Adjacents,523
Verbesina_arborea,101,69,32,Alphahull-PointsKO-Adjacents,1381
Verbesina_aypatensis,1,1,0,Points-PointsKO-Adjacents,9
Verbesina_baruensis,6,0,6,Points-PointsKO-Adjacents,25
Verbesina_biserrata,NA,NA,NA,NA,NA
Verbesina_brachypoda,14,7,7,Points-PointsKO-Adjacents,96
Verbesina_breedlovei,29,16,13,Points-PointsKO-Adjacents,72
Verbesina_calciphila,7,3,4,Points-PointsKO-Adjacents,28
Verbesina_crocata,66,42,24,Alphahull-PointsKO-Adjacents,1900
Verbesina_cumingii,4,4,0,Points-PointsKO-Adjacents,36
Verbesina_elegans,11,4,7,Points-PointsKO-Adjacents,80
Verbesina_fastigiata,249,206,43,Alphahull-PointsKO-Adjacents,3919
Verbesina_furfuracea,6,3,3,Points-PointsKO-Adjacents,35
Verbesina_fuscasiccans,9,7,2,Points-PointsKO-Adjacents,36
Verbesina_guatemalensis,47,28,19,Alphahull-PointsKO-Adjacents,1081
Verbesina_hexantha,2,2,0,Points-PointsKO-Adjacents,16
Verbesina_huancabambae,1,1,0,Points-PointsKO-Adjacents,9
Verbesina_humboldtii,19,11,8,Points-PointsKO-Adjacents,105
Verbesina_hypargyrea,44,35,9,Alphahull-PointsKO-Adjacents,381
Verbesina_hypoglauca,107,83,24,Alphahull-PointsKO-Adjacents,1176
Verbesina_lanata,78,54,24,Alphahull-PointsKO-Adjacents,942
Verbesina_latisquama,20,10,10,Points-PointsKO-Adjacents,154
Verbesina_lopez-mirandae,2,2,0,Points-PointsKO-Adjacents,18
Verbesina_luetzelburgii,33,25,8,Alphahull-PointsKO-Adjacents,99
Verbesina_mameana,1,1,0,Points-PointsKO-Adjacents,9
Verbesina_minarum,2,2,0,Points-PointsKO-Adjacents,18
Verbesina_minuticeps,11,4,7,Points-PointsKO-Adjacents,76
Verbesina_nudipes,96,73,23,Alphahull-PointsKO-Adjacents,1004
Verbesina_oerstediana,160,125,35,Alphahull-PointsKO-Adjacents,1042
Verbesina_oligantha,58,38,20,Alphahull-PointsKO-Adjacents,1418
Verbesina_perymenioides,6,1,5,Points-PointsKO-Adjacents,42
Verbesina_petrobioides,0,0,0,NA,0
Verbesina_pseudoclaussenii,2,2,0,Points-PointsKO-Adjacents,9
Verbesina_rupestris,3,3,0,Points-PointsKO-Adjacents,25
Verbesina_sousae,13,0,13,Points-PointsKO-Adjacents,62
Verbesina_tapantiana,13,8,5,Points-PointsKO-Adjacents,51
Verbesina_turbacensis,457,368,89,Alphahull-PointsKO-Adjacents,6586
Vernicia_cordata,34,18,16,Points-PointsKO-Adjacents,214
Vernicia_fordii,155,116,39,Alphahull-PointsKO-Adjacents,19583
Vernicia_montana,73,47,26,Alphahull-PointsKO-Adjacents,6164
Vernonanthura_buxifolia,15,7,8,Points-PointsKO-Adjacents,107
Vernonanthura_densiflora,9,0,9,Points-PointsKO-Adjacents,72
Vernonanthura_deppeana,133,77,56,Alphahull-PointsKO-Adjacents,3288
Vernonanthura_discolor,659,589,70,Alphahull-PointsKO-Adjacents,6987
Vernonanthura_divaricata,677,598,79,Alphahull-PointsKO-Adjacents,11831
Vernonanthura_ferruginea,263,193,70,Alphahull-PointsKO-Adjacents,22666
Vernonanthura_fuertesii,2,2,0,Points-PointsKO-Adjacents,17
Vernonanthura_petiolaris,189,153,36,Alphahull-PointsKO-Adjacents,5274
Vernonanthura_phosphorica,174,109,65,Alphahull-PointsKO-Adjacents,9905
Vernonanthura_pinguis,19,7,12,Points-PointsKO-Adjacents,138
Vernonanthura_sambrayana,0,0,0,NA,0
Vernonanthura_yurimaguasensis,39,17,22,Points-PointsKO-Adjacents,306
Vernonia_albosquama,NA,NA,NA,NA,NA
Vernonia_ampandrandavensis,3,3,0,Points-PointsKO-Adjacents,25
Vernonia_angusta,2,1,1,Points-PointsKO-Adjacents,18
Vernonia_arborea,40,7,33,Points-PointsKO-Adjacents,339
Vernonia_arborescens,1,1,0,Points-PointsKO-Adjacents,9
Vernonia_arctioides,152,134,18,Alphahull-PointsKO-Adjacents,579
Vernonia_auriculifera,36,19,17,Points-PointsKO-Adjacents,243
Vernonia_brachycalyx,11,0,11,Points-PointsKO-Adjacents,86
Vernonia_brazzavillensis,28,16,12,Points-PointsKO-Adjacents,219
Vernonia_bruceae,6,1,5,Points-PointsKO-Adjacents,42
Vernonia_cockburniana,7,4,3,Points-PointsKO-Adjacents,25
Vernonia_esculenta,63,44,19,Alphahull-PointsKO-Adjacents,3255
Vernonia_hildebrandtii,51,36,15,Alphahull-PointsKO-Adjacents,570
Vernonia_hochstetteri,71,38,33,Alphahull-PointsKO-Adjacents,1611
Vernonia_lancifolia,1,1,0,Points-PointsKO-Adjacents,8
Vernonia_latisquamata,14,10,4,Points-PointsKO-Adjacents,61
Vernonia_leandrii,4,4,0,Points-PointsKO-Adjacents,27
Vernonia_mecistophylla,4,4,0,Points-PointsKO-Adjacents,24
Vernonia_pachyclada,12,8,4,Points-PointsKO-Adjacents,76
Vernonia_peguensis,0,0,0,NA,0
Vernonia_sericea,25,0,25,Points-PointsKO-Adjacents,179
Vernonia_solanifolia,40,19,21,Points-PointsKO-Adjacents,343
Vernonia_subsessilis,0,0,0,NA,0
Vernonia_tanalensis,4,4,0,Points-PointsKO-Adjacents,30
Vernonia_travancorica,0,0,0,NA,0
Vernonia_unicata,5,5,0,Points-PointsKO-Adjacents,14
Vernonia_villaregalis,21,10,11,Points-PointsKO-Adjacents,102
Vernoniopsis_caudata,46,23,23,Alphahull-PointsKO-Adjacents,172
Verschaffeltia_splendida,4,4,0,Points-PointsKO-Adjacents,17
Verticordia_cunninghamii,773,743,30,Alphahull-PointsKO-Adjacents,5163
Verticordia_verticillata,215,191,24,Alphahull-PointsKO-Adjacents,3616
Vesselowskya_rubifolia,116,109,7,Alphahull-PointsKO-Adjacents,340
Viburnum_acutifolium,162,133,29,Alphahull-PointsKO-Adjacents,1848
Viburnum_alabamense,NA,NA,NA,NA,NA
Viburnum_antioquiense,27,19,8,Points-PointsKO-Adjacents,132
Viburnum_axillare,11,5,6,Points-PointsKO-Adjacents,60
Viburnum_ayavacense,50,25,25,Alphahull-PointsKO-Adjacents,375
Viburnum_betulifolium,197,162,35,Alphahull-PointsKO-Adjacents,7667
Viburnum_blandum,32,17,15,Points-PointsKO-Adjacents,138
Viburnum_brachybotryum,67,37,30,Alphahull-PointsKO-Adjacents,5463
Viburnum_carolinianum,1,1,0,Points-PointsKO-Adjacents,9
Viburnum_caudatum,31,22,9,Alphahull-PointsKO-Adjacents,663
Viburnum_chingii,46,31,15,Alphahull-PointsKO-Adjacents,820
Viburnum_ciliatum,36,28,8,Alphahull-PointsKO-Adjacents,184
Viburnum_cinnamomifolium,24,10,14,Points-PointsKO-Adjacents,214
Viburnum_corymbiflorum,42,17,25,Points-PointsKO-Adjacents,376
Viburnum_costaricanum,302,281,21,Alphahull-PointsKO-Adjacents,349
Viburnum_cotinifolium,23,4,19,Points-PointsKO-Adjacents,189
Viburnum_cylindricum,132,0,132,Points-PointsKO-Adjacents,731
Viburnum_dentatum,1061,1,1060,Points-PointsKO-Adjacents,6499
Viburnum_discolor,22,9,13,Points-PointsKO-Adjacents,138
Viburnum_disjunctum,25,12,13,Points-PointsKO-Adjacents,135
Viburnum_elatum,163,139,24,Alphahull-PointsKO-Adjacents,2748
Viburnum_erosum,706,0,706,Points-PointsKO-Adjacents,1873
Viburnum_erubescens,111,0,111,Points-PointsKO-Adjacents,571
Viburnum_euryphyllum,3,3,0,Points-PointsKO-Adjacents,27
Viburnum_fordiae,120,90,30,Alphahull-PointsKO-Adjacents,5539
Viburnum_formosanum,152,117,35,Alphahull-PointsKO-Adjacents,380
Viburnum_glabratum,21,9,12,Points-PointsKO-Adjacents,154
Viburnum_glomeratum,45,18,27,Points-PointsKO-Adjacents,366
Viburnum_goudotii,1,1,0,Points-PointsKO-Adjacents,9
Viburnum_grandiflorum,22,0,22,Points-PointsKO-Adjacents,164
Viburnum_hallii,347,283,64,Alphahull-PointsKO-Adjacents,5253
Viburnum_hartwegii,347,311,36,Alphahull-PointsKO-Adjacents,2408
Viburnum_henryi,34,21,13,Alphahull-PointsKO-Adjacents,1279
Viburnum_hondurense,18,11,7,Points-PointsKO-Adjacents,89
Viburnum_incarum,32,16,16,Points-PointsKO-Adjacents,187
Viburnum_inopinatum,13,3,10,Points-PointsKO-Adjacents,102
Viburnum_jelskii,12,4,8,Points-PointsKO-Adjacents,108
Viburnum_jucundum,110,96,14,Alphahull-PointsKO-Adjacents,640
Viburnum_lantana,19248,2,19246,Points-PointsKO-Adjacents,21857
Viburnum_lautum,115,86,29,Alphahull-PointsKO-Adjacents,622
Viburnum_leiocarpum,10,7,3,Points-PointsKO-Adjacents,74
Viburnum_lentago,1101,760,341,Alphahull-PointsKO-Adjacents,31902
Viburnum_longiradiatum,6,1,5,Points-PointsKO-Adjacents,54
Viburnum_lutescens,22,5,17,Points-PointsKO-Adjacents,159
Viburnum_luzonicum,490,379,111,Alphahull-PointsKO-Adjacents,4451
Viburnum_mathewsii,13,5,8,Points-PointsKO-Adjacents,103
Viburnum_microcarpum,81,58,23,Alphahull-PointsKO-Adjacents,540
Viburnum_microphyllum,22,11,11,Points-PointsKO-Adjacents,128
Viburnum_molinae,0,0,0,NA,0
Viburnum_mortonianum,3,3,0,Points-PointsKO-Adjacents,27
Viburnum_mullaha,28,0,28,Points-PointsKO-Adjacents,226
Viburnum_nervosum,30,16,14,Points-PointsKO-Adjacents,191
Viburnum_obovatum,157,1,156,Points-PointsKO-Adjacents,1104
Viburnum_obtusatum,9,0,9,Points-PointsKO-Adjacents,30
Viburnum_odoratissimum,285,192,93,Alphahull-PointsKO-Adjacents,1194
Viburnum_oliganthum,63,41,22,Alphahull-PointsKO-Adjacents,3023
Viburnum_opulus,65604,55756,9848,Alphahull-PointsKO-Adjacents,115452
Viburnum_pichinchense,161,130,31,Alphahull-PointsKO-Adjacents,1700
Viburnum_prunifolium,1378,987,391,Alphahull-PointsKO-Adjacents,24143
Viburnum_punctatum,21,0,21,Points-PointsKO-Adjacents,181
Viburnum_recognitum,438,275,163,Alphahull-PointsKO-Adjacents,17624
Viburnum_reticulatum,38,26,12,Alphahull-PointsKO-Adjacents,412
Viburnum_rhytidophyllum,7,2,5,Points-PointsKO-Adjacents,57
Viburnum_rufidulum,1299,0,1299,Points-PointsKO-Adjacents,7761
Viburnum_seemanii,14,8,6,Points-PointsKO-Adjacents,97
Viburnum_shweliense,8,0,8,Points-PointsKO-Adjacents,59
Viburnum_stellatotomentosum,66,54,12,Alphahull-PointsKO-Adjacents,112
Viburnum_stenocalyx,65,51,14,Alphahull-PointsKO-Adjacents,624
Viburnum_subpubescens,0,0,0,NA,0
Viburnum_sulcatum,7,2,5,Points-PointsKO-Adjacents,45
Viburnum_sympodiale,110,64,46,Alphahull-PointsKO-Adjacents,4647
Viburnum_ternatum,4,4,0,Points-PointsKO-Adjacents,30
Viburnum_tiliifolium,40,31,9,Alphahull-PointsKO-Adjacents,866
Viburnum_tinoides,239,197,42,Alphahull-PointsKO-Adjacents,3035
Viburnum_tinus,4351,3799,552,Alphahull-PointsKO-Adjacents,16493
Viburnum_toronis,219,189,30,Alphahull-PointsKO-Adjacents,2116
Viburnum_trabeculosum,3,3,0,Points-PointsKO-Adjacents,18
Viburnum_tridentatum,2,2,0,Points-PointsKO-Adjacents,18
Viburnum_triphyllum,409,355,54,Alphahull-PointsKO-Adjacents,3555
Viburnum_undulatum,98,81,17,Alphahull-PointsKO-Adjacents,399
Viburnum_venustum,87,0,87,Points-PointsKO-Adjacents,189
Viburnum_witteanum,14,3,11,Points-PointsKO-Adjacents,99
Viburnum_wurdackii,1,1,0,Points-PointsKO-Adjacents,9
Vidalasia_fusca,0,0,0,NA,0
Vidalasia_morindifolia,0,0,0,NA,0
Vidalasia_murina,NA,NA,NA,NA,NA
Vidalasia_pubescens,NA,NA,NA,NA,NA
Vidalasia_tonkinensis,4,4,0,Points-PointsKO-Adjacents,23
Viguieranthus_brevipennatus,4,4,0,Points-PointsKO-Adjacents,36
Viguieranthus_cylindricostachys,18,4,14,Points-PointsKO-Adjacents,107
Viguieranthus_densinervus,32,14,18,Points-PointsKO-Adjacents,176
Viguieranthus_glandulosus,2,2,0,Points-PointsKO-Adjacents,18
Viguieranthus_kony,15,3,12,Points-PointsKO-Adjacents,92
Viguieranthus_longiracemosus,4,4,0,Points-PointsKO-Adjacents,36
Viguieranthus_umbilicus,3,3,0,Points-PointsKO-Adjacents,16
Viguieranthus_unifoliolatus,3,3,0,Points-PointsKO-Adjacents,20
Villaria_acutifolia,0,0,0,NA,0
Villaria_leytensis,0,0,0,NA,0
Villaria_odorata,0,0,0,NA,0
Viposia_integerrima,21,5,16,Points-PointsKO-Adjacents,169
Virgilia_oroboides,38,21,17,Alphahull-PointsKO-Adjacents,165
Viridivia_suberosa,10,4,6,Points-PointsKO-Adjacents,70
Virola_aequatorialis,17,11,6,Points-PointsKO-Adjacents,105
Virola_albidiflora,71,43,28,Alphahull-PointsKO-Adjacents,6992
Virola_bicuhyba,378,0,378,Points-PointsKO-Adjacents,2270
Virola_caducifolia,43,0,43,Points-PointsKO-Adjacents,325
Virola_calophylla,1168,1094,74,Alphahull-PointsKO-Adjacents,59886
Virola_calophylloidea,10,4,6,Points-PointsKO-Adjacents,72
Virola_carinata,101,45,56,Alphahull-PointsKO-Adjacents,4952
Virola_crebrinervia,17,2,15,Points-PointsKO-Adjacents,153
Virola_decorticans,83,54,29,Alphahull-PointsKO-Adjacents,5908
Virola_dixonii,78,64,14,Alphahull-PointsKO-Adjacents,1566
Virola_duckei,241,184,57,Alphahull-PointsKO-Adjacents,14910
Virola_elongata,1712,1635,77,Alphahull-PointsKO-Adjacents,72985
Virola_flexuosa,312,255,57,Alphahull-PointsKO-Adjacents,21193
Virola_gardneri,248,194,54,Alphahull-PointsKO-Adjacents,3566
Virola_guatemalensis,92,68,24,Alphahull-PointsKO-Adjacents,595
Virola_guggenheimii,24,10,14,Points-PointsKO-Adjacents,199
Virola_koschnyi,191,158,33,Alphahull-PointsKO-Adjacents,2349
Virola_kwatae,6,5,1,Points-PointsKO-Adjacents,36
Virola_loretensis,174,132,42,Alphahull-PointsKO-Adjacents,11857
Virola_macrocarpa,107,74,33,Alphahull-PointsKO-Adjacents,2074
Virola_malmei,22,5,17,Points-PointsKO-Adjacents,192
Virola_marlenei,74,57,17,Alphahull-PointsKO-Adjacents,2945
Virola_megacarpa,13,7,6,Points-PointsKO-Adjacents,52
Virola_michelii,314,251,63,Alphahull-PointsKO-Adjacents,24402
Virola_minutiflora,14,0,14,Points-PointsKO-Adjacents,116
Virola_mollissima,280,222,58,Alphahull-PointsKO-Adjacents,25338
Virola_multicostata,47,26,21,Alphahull-PointsKO-Adjacents,4767
Virola_multiflora,97,72,25,Alphahull-PointsKO-Adjacents,761
Virola_multinervia,282,216,66,Alphahull-PointsKO-Adjacents,25593
Virola_obovata,100,70,30,Alphahull-PointsKO-Adjacents,4414
Virola_officinalis,63,0,63,Points-PointsKO-Adjacents,379
Virola_parvifolia,3,3,0,Points-PointsKO-Adjacents,27
Virola_pavonis,447,398,49,Alphahull-PointsKO-Adjacents,16092
Virola_peruviana,313,270,43,Alphahull-PointsKO-Adjacents,14147
Virola_polyneura,8,0,8,Points-PointsKO-Adjacents,72
Virola_reidii,48,36,12,Alphahull-PointsKO-Adjacents,731
Virola_rugulosa,6,1,5,Points-PointsKO-Adjacents,54
Virola_schultesii,15,3,12,Points-PointsKO-Adjacents,93
Virola_sebifera,2614,2449,165,Alphahull-PointsKO-Adjacents,120240
Virola_steyermarkii,4,4,0,Points-PointsKO-Adjacents,21
Virola_surinamensis,369,258,111,Alphahull-PointsKO-Adjacents,40056
Virola_theiodora,122,70,52,Alphahull-PointsKO-Adjacents,9124
Virola_urbaniana,73,50,23,Alphahull-PointsKO-Adjacents,6117
Virola_venosa,201,156,45,Alphahull-PointsKO-Adjacents,14686
Virola_weberbaueri,10,1,9,Points-PointsKO-Adjacents,90
Virotia_francii,8,1,7,Points-PointsKO-Adjacents,53
Virotia_leptophylla,5,5,0,Points-PointsKO-Adjacents,35
Virotia_neurophylla,7,3,4,Points-PointsKO-Adjacents,30
Virotia_rousselii,6,1,5,Points-PointsKO-Adjacents,38
Vismia_affinis,15,6,9,Points-PointsKO-Adjacents,103
Vismia_baccifera,1086,986,100,Alphahull-PointsKO-Adjacents,25315
Vismia_bemerguii,84,46,38,Alphahull-PointsKO-Adjacents,5570
Vismia_billbergiana,235,193,42,Alphahull-PointsKO-Adjacents,2460
Vismia_brasiliensis,206,179,27,Alphahull-PointsKO-Adjacents,2796
Vismia_camparaguey,106,87,19,Alphahull-PointsKO-Adjacents,1567
Vismia_cauliflora,34,16,18,Points-PointsKO-Adjacents,234
Vismia_cavalcantii,31,5,26,Points-PointsKO-Adjacents,259
Vismia_cavanillesiana,10,1,9,Points-PointsKO-Adjacents,84
Vismia_cayennensis,761,668,93,Alphahull-PointsKO-Adjacents,53618
Vismia_confertiflora,96,43,53,Alphahull-PointsKO-Adjacents,10814
Vismia_crassa,19,7,12,Points-PointsKO-Adjacents,151
Vismia_cuatrecasasii,19,10,9,Points-PointsKO-Adjacents,99
Vismia_floribunda,89,63,26,Alphahull-PointsKO-Adjacents,6712
Vismia_glabra,48,19,29,Points-PointsKO-Adjacents,413
Vismia_gracilis,620,542,78,Alphahull-PointsKO-Adjacents,62084
Vismia_guianensis,1602,1417,185,Alphahull-PointsKO-Adjacents,86966
Vismia_guineensis,129,93,36,Alphahull-PointsKO-Adjacents,3691
Vismia_japurensis,541,475,66,Alphahull-PointsKO-Adjacents,40146
Vismia_jefensis,23,18,5,Points-PointsKO-Adjacents,79
Vismia_laevis,41,31,10,Alphahull-PointsKO-Adjacents,340
Vismia_lateriflora,115,39,76,Alphahull-PointsKO-Adjacents,7621
Vismia_latifolia,152,0,152,Points-PointsKO-Adjacents,1117
Vismia_latisepala,42,23,19,Alphahull-PointsKO-Adjacents,699
Vismia_laurentii,10,0,10,Points-PointsKO-Adjacents,72
Vismia_lauriformis,77,50,27,Alphahull-PointsKO-Adjacents,2181
Vismia_laxiflora,80,52,28,Alphahull-PointsKO-Adjacents,5502
Vismia_lehmannii,39,22,17,Alphahull-PointsKO-Adjacents,266
Vismia_lindeniana,15,2,13,Points-PointsKO-Adjacents,114
Vismia_macrophylla,1051,929,122,Alphahull-PointsKO-Adjacents,76642
Vismia_magnoliifolia,113,88,25,Alphahull-PointsKO-Adjacents,1604
Vismia_mandurr,55,36,19,Alphahull-PointsKO-Adjacents,1671
Vismia_martiana,263,221,42,Alphahull-PointsKO-Adjacents,4745
Vismia_micrantha,107,86,21,Alphahull-PointsKO-Adjacents,1894
Vismia_minutiflora,118,61,57,Alphahull-PointsKO-Adjacents,11956
Vismia_obtusa,24,5,19,Points-PointsKO-Adjacents,167
Vismia_orientalis,56,33,23,Alphahull-PointsKO-Adjacents,1190
Vismia_parviflora,9,0,9,Points-PointsKO-Adjacents,72
Vismia_pauciflora,3,3,0,Points-PointsKO-Adjacents,23
Vismia_pentagyna,86,51,35,Alphahull-PointsKO-Adjacents,949
Vismia_plicatifolia,44,30,14,Alphahull-PointsKO-Adjacents,1178
Vismia_pozuzoensis,135,92,43,Alphahull-PointsKO-Adjacents,7923
Vismia_ramuliflora,47,35,12,Alphahull-PointsKO-Adjacents,1491
Vismia_rufa,15,7,8,Points-PointsKO-Adjacents,84
Vismia_rusbyi,40,23,17,Alphahull-PointsKO-Adjacents,558
Vismia_sandwithii,143,84,59,Alphahull-PointsKO-Adjacents,19567
Vismia_schultesii,162,72,90,Alphahull-PointsKO-Adjacents,16797
Vismia_sessilifolia,84,0,84,Points-PointsKO-Adjacents,626
Vismia_sprucei,157,112,45,Alphahull-PointsKO-Adjacents,14770
Vismia_steyermarkii,4,4,0,Points-PointsKO-Adjacents,36
Vismia_tenuinervia,125,64,61,Alphahull-PointsKO-Adjacents,6324
Vismia_tomentosa,49,14,35,Points-PointsKO-Adjacents,370
Vismia_urceolata,7,0,7,Points-PointsKO-Adjacents,54
Vismianthus_sterculiifolius,0,0,0,NA,0
Vitellaria_paradoxa,3704,3640,64,Alphahull-PointsKO-Adjacents,9297
Vitellariopsis_cuneata,7,1,6,Points-PointsKO-Adjacents,51
Vitellariopsis_dispar,9,3,6,Points-PointsKO-Adjacents,78
Vitellariopsis_ferruginea,0,0,0,NA,0
Vitellariopsis_kirkii,16,7,9,Points-PointsKO-Adjacents,107
Vitellariopsis_marginata,24,12,12,Points-PointsKO-Adjacents,211
Vitex_acuminata,569,505,64,Alphahull-PointsKO-Adjacents,6860
Vitex_acunae,NA,NA,NA,NA,NA
Vitex_agnus-castus,928,713,215,Alphahull-PointsKO-Adjacents,7325
Vitex_ajugiflora,0,0,0,NA,0
Vitex_altissima,8,0,8,Points-PointsKO-Adjacents,72
Vitex_amaniensis,8,2,6,Points-PointsKO-Adjacents,51
Vitex_aurea,7,1,6,Points-PointsKO-Adjacents,46
Vitex_axillariflora,2,2,0,Points-PointsKO-Adjacents,18
Vitex_befotakensis,7,1,6,Points-PointsKO-Adjacents,63
Vitex_beraviensis,124,98,26,Alphahull-PointsKO-Adjacents,4020
Vitex_betsiliensis,55,40,15,Alphahull-PointsKO-Adjacents,374
Vitex_bogalensis,6,1,5,Points-PointsKO-Adjacents,54
Vitex_bojeri,62,9,53,Points-PointsKO-Adjacents,331
Vitex_brevilabiata,9,0,9,Points-PointsKO-Adjacents,77
Vitex_buchananii,47,18,29,Points-PointsKO-Adjacents,375
Vitex_burmensis,1,1,0,Points-PointsKO-Adjacents,9
Vitex_calothyrsa,49,28,21,Alphahull-PointsKO-Adjacents,659
Vitex_canescens,6,2,4,Points-PointsKO-Adjacents,54
Vitex_capitata,259,186,73,Alphahull-PointsKO-Adjacents,17264
Vitex_cauliflora,37,26,11,Alphahull-PointsKO-Adjacents,346
Vitex_cestroides,0,0,0,NA,0
Vitex_chrysleriana,5,5,0,Points-PointsKO-Adjacents,39
Vitex_chrysocarpa,137,0,137,Points-PointsKO-Adjacents,699
Vitex_chrysomallum,134,104,30,Alphahull-PointsKO-Adjacents,1691
Vitex_ciliata,22,12,10,Points-PointsKO-Adjacents,124
Vitex_cochinchinensis,1,1,0,Points-PointsKO-Adjacents,9
Vitex_cofassus,176,0,176,Points-PointsKO-Adjacents,911
Vitex_collina,37,22,15,Alphahull-PointsKO-Adjacents,128
Vitex_colombiensis,1,1,0,Points-PointsKO-Adjacents,9
Vitex_columbiensis,6,0,6,Points-PointsKO-Adjacents,54
Vitex_compressa,222,1,221,Points-PointsKO-Adjacents,1532
Vitex_congolensis,27,2,25,Points-PointsKO-Adjacents,222
Vitex_cooperi,108,94,14,Alphahull-PointsKO-Adjacents,1311
Vitex_coursii,39,35,4,Alphahull-PointsKO-Adjacents,44
Vitex_cuspidata,8,0,8,Points-PointsKO-Adjacents,72
Vitex_cymosa,650,482,168,Alphahull-PointsKO-Adjacents,63940
Vitex_divaricata,92,39,53,Alphahull-PointsKO-Adjacents,488
Vitex_diversifolia,1,0,1,Points-PointsKO-Adjacents,9
Vitex_doniana,994,842,152,Alphahull-PointsKO-Adjacents,36664
Vitex_duckei,44,22,22,Alphahull-PointsKO-Adjacents,2555
Vitex_duclouxii,1,1,0,Points-PointsKO-Adjacents,9
Vitex_elakelakensis,16,6,10,Points-PointsKO-Adjacents,65
Vitex_excelsa,12,2,10,Points-PointsKO-Adjacents,108
Vitex_ferruginea,127,51,76,Alphahull-PointsKO-Adjacents,1875
Vitex_fischeri,37,9,28,Points-PointsKO-Adjacents,279
Vitex_flava,2,2,0,Points-PointsKO-Adjacents,18
Vitex_flavens,52,13,39,Points-PointsKO-Adjacents,425
Vitex_floridula,16,6,10,Points-PointsKO-Adjacents,117
Vitex_froesii,10,0,10,Points-PointsKO-Adjacents,72
Vitex_gamosepala,30,13,17,Points-PointsKO-Adjacents,225
Vitex_gardneriana,204,178,26,Alphahull-PointsKO-Adjacents,5442
Vitex_gaumeri,551,501,50,Alphahull-PointsKO-Adjacents,3609
Vitex_gigantea,47,30,17,Alphahull-PointsKO-Adjacents,503
Vitex_glabrata,917,842,75,Alphahull-PointsKO-Adjacents,10964
Vitex_grandidiana,24,0,24,Points-PointsKO-Adjacents,85
Vitex_grandifolia,267,217,50,Alphahull-PointsKO-Adjacents,5154
Vitex_guianensis,4,2,2,Points-PointsKO-Adjacents,33
Vitex_harveyana,35,22,13,Alphahull-PointsKO-Adjacents,341
Vitex_hemsleyi,132,91,41,Alphahull-PointsKO-Adjacents,2194
Vitex_heptaphylla,35,23,12,Alphahull-PointsKO-Adjacents,351
Vitex_hirsutissima,24,16,8,Points-PointsKO-Adjacents,155
Vitex_hispidissima,15,8,7,Points-PointsKO-Adjacents,88
Vitex_humbertii,21,12,9,Points-PointsKO-Adjacents,95
Vitex_hypoleuca,12,3,9,Points-PointsKO-Adjacents,58
Vitex_keniensis,3,3,0,Points-PointsKO-Adjacents,27
Vitex_klugii,81,42,39,Alphahull-PointsKO-Adjacents,7244
Vitex_krukovii,16,6,10,Points-PointsKO-Adjacents,135
Vitex_kwangsiensis,5,5,0,Points-PointsKO-Adjacents,45
Vitex_lanigera,18,0,18,Points-PointsKO-Adjacents,104
Vitex_lastellei,4,4,0,Points-PointsKO-Adjacents,21
Vitex_lehmbachii,11,0,11,Points-PointsKO-Adjacents,87
Vitex_leucoxylon,2,0,2,Points-PointsKO-Adjacents,18
Vitex_lignum-vitae,203,172,31,Alphahull-PointsKO-Adjacents,1210
Vitex_limonifolia,3,0,3,Points-PointsKO-Adjacents,27
Vitex_longisepala,17,10,7,Points-PointsKO-Adjacents,104
Vitex_lucens,405,346,59,Alphahull-PointsKO-Adjacents,1559
Vitex_macrofoliola,0,0,0,NA,0
Vitex_madagascariensis,8,1,7,Points-PointsKO-Adjacents,66
Vitex_madiensis,307,215,92,Alphahull-PointsKO-Adjacents,9230
Vitex_maranhana,9,0,9,Points-PointsKO-Adjacents,66
Vitex_martii,9,5,4,Points-PointsKO-Adjacents,73
Vitex_masoalensis,2,2,0,Points-PointsKO-Adjacents,13
Vitex_masoniana,28,17,11,Points-PointsKO-Adjacents,182
Vitex_medusicalyx,1,1,0,Points-PointsKO-Adjacents,9
Vitex_megapotamica,925,816,109,Alphahull-PointsKO-Adjacents,22357
Vitex_micrantha,45,26,19,Alphahull-PointsKO-Adjacents,1267
Vitex_millsii,1,1,0,Points-PointsKO-Adjacents,9
Vitex_milnei,9,2,7,Points-PointsKO-Adjacents,45
Vitex_mollis,453,389,64,Alphahull-PointsKO-Adjacents,4428
Vitex_mombassae,96,45,51,Alphahull-PointsKO-Adjacents,9433
Vitex_morogoroensis,0,0,0,NA,0
Vitex_mossambicensis,9,3,6,Points-PointsKO-Adjacents,68
Vitex_negundo,367,211,156,Alphahull-PointsKO-Adjacents,31543
Vitex_novae-pommeraniae,16,7,9,Points-PointsKO-Adjacents,50
Vitex_obovata,61,42,19,Alphahull-PointsKO-Adjacents,523
Vitex_orinocensis,400,0,400,Points-PointsKO-Adjacents,2924
Vitex_oxycuspis,3,3,0,Points-PointsKO-Adjacents,27
Vitex_panshiniana,89,52,37,Alphahull-PointsKO-Adjacents,6273
Vitex_parviflora,59,30,29,Alphahull-PointsKO-Adjacents,1158
Vitex_payos,88,54,34,Alphahull-PointsKO-Adjacents,5385
Vitex_peduncularis,8,0,8,Points-PointsKO-Adjacents,69
Vitex_perrieri,6,0,6,Points-PointsKO-Adjacents,53
Vitex_petersiana,7,1,6,Points-PointsKO-Adjacents,54
Vitex_phaeotricha,29,18,11,Points-PointsKO-Adjacents,203
Vitex_phillyreifolia,NA,NA,NA,NA,NA
Vitex_pierreana,6,1,5,Points-PointsKO-Adjacents,45
Vitex_pinnata,203,0,203,Points-PointsKO-Adjacents,1491
Vitex_polygama,1038,919,119,Alphahull-PointsKO-Adjacents,40236
Vitex_pooara,13,9,4,Points-PointsKO-Adjacents,117
Vitex_pseudolea,20,2,18,Points-PointsKO-Adjacents,176
Vitex_pyramidata,139,102,37,Alphahull-PointsKO-Adjacents,1439
Vitex_queenslandica,56,42,14,Alphahull-PointsKO-Adjacents,203
Vitex_quinata,213,126,87,Alphahull-PointsKO-Adjacents,1722
Vitex_regnelliana,20,5,15,Points-PointsKO-Adjacents,139
Vitex_rehmannii,50,38,12,Alphahull-PointsKO-Adjacents,1253
Vitex_rivularis,46,25,21,Alphahull-PointsKO-Adjacents,2269
Vitex_rubra,2,2,0,Points-PointsKO-Adjacents,18
Vitex_rubroaurantiaca,9,2,7,Points-PointsKO-Adjacents,69
Vitex_rufescens,268,193,75,Alphahull-PointsKO-Adjacents,18505
Vitex_scabra,0,0,0,NA,0
Vitex_schaueriana,107,72,35,Alphahull-PointsKO-Adjacents,5083
Vitex_schliebenii,5,5,0,Points-PointsKO-Adjacents,45
Vitex_schomburgkiana,56,32,24,Alphahull-PointsKO-Adjacents,726
Vitex_schunkei,14,4,10,Points-PointsKO-Adjacents,105
Vitex_sellowiana,192,147,45,Alphahull-PointsKO-Adjacents,4203
Vitex_siamica,20,10,10,Points-PointsKO-Adjacents,124
Vitex_snethlagiana,1,1,0,Points-PointsKO-Adjacents,9
Vitex_sprucei,29,12,17,Points-PointsKO-Adjacents,192
Vitex_stahelii,40,21,19,Alphahull-PointsKO-Adjacents,1175
Vitex_stellata,8,6,2,Points-PointsKO-Adjacents,24
Vitex_strickeri,22,14,8,Points-PointsKO-Adjacents,143
Vitex_teloravina,5,5,0,Points-PointsKO-Adjacents,45
Vitex_thyrsiflora,74,35,39,Alphahull-PointsKO-Adjacents,1490
Vitex_tomentosa,8,0,8,Points-PointsKO-Adjacents,36
Vitex_trichantha,9,2,7,Points-PointsKO-Adjacents,60
Vitex_triflora,571,474,97,Alphahull-PointsKO-Adjacents,58476
Vitex_trifolia,847,476,371,Alphahull-PointsKO-Adjacents,15802
Vitex_tripinnata,7,0,7,Points-PointsKO-Adjacents,60
Vitex_tristis,11,7,4,Points-PointsKO-Adjacents,19
Vitex_turczaninowii,9,0,9,Points-PointsKO-Adjacents,58
Vitex_ugogoensis,7,2,5,Points-PointsKO-Adjacents,50
Vitex_uniflora,8,3,5,Points-PointsKO-Adjacents,40
Vitex_urceolata,1,0,1,Points-PointsKO-Adjacents,9
Vitex_vansteenisii,1,1,0,Points-PointsKO-Adjacents,9
Vitex_vauthieri,9,0,9,Points-PointsKO-Adjacents,72
Vitex_velutinifolia,9,0,9,Points-PointsKO-Adjacents,47
Vitex_vestita,113,72,41,Alphahull-PointsKO-Adjacents,3339
Vitex_vitilevuensis,NA,NA,NA,NA,NA
Vitex_vondrozensis,0,0,0,NA,0
Vitex_welwitschii,10,0,10,Points-PointsKO-Adjacents,72
Vitex_wimberleyi,NA,NA,NA,NA,NA
Vitex_yaundensis,4,2,2,Points-PointsKO-Adjacents,36
Vitex_yunnanensis,24,14,10,Points-PointsKO-Adjacents,210
Vitex_zanzibarensis,17,8,9,Points-PointsKO-Adjacents,92
Vitex_zeyheri,22,14,8,Points-PointsKO-Adjacents,189
Voacanga_africana,384,281,103,Alphahull-PointsKO-Adjacents,17359
Voacanga_bracteata,215,162,53,Alphahull-PointsKO-Adjacents,4431
Voacanga_caudiflora,34,19,15,Points-PointsKO-Adjacents,223
Voacanga_chalotiana,9,0,9,Points-PointsKO-Adjacents,66
Voacanga_foetida,3,3,0,Points-PointsKO-Adjacents,27
Voacanga_globosa,12,3,9,Points-PointsKO-Adjacents,86
Voacanga_gracilipes,7,0,7,Points-PointsKO-Adjacents,59
Voacanga_grandifolia,93,50,43,Alphahull-PointsKO-Adjacents,3156
Voacanga_havilandii,4,0,4,Points-PointsKO-Adjacents,30
Voacanga_megacarpa,1,1,0,Points-PointsKO-Adjacents,9
Voacanga_pachyceras,15,0,15,Points-PointsKO-Adjacents,117
Voacanga_psilocalyx,93,69,24,Alphahull-PointsKO-Adjacents,1992
Voacanga_thouarsii,309,196,113,Alphahull-PointsKO-Adjacents,8695
Voanioala_gerardii,8,5,3,Points-PointsKO-Adjacents,42
Voatamalo_capuronii,5,5,0,Points-PointsKO-Adjacents,36
Voatamalo_eugenioides,7,2,5,Points-PointsKO-Adjacents,33
Vochysia_acuminata,183,139,44,Alphahull-PointsKO-Adjacents,4959
Vochysia_allenii,43,31,12,Alphahull-PointsKO-Adjacents,239
Vochysia_angustifolia,22,0,22,Points-PointsKO-Adjacents,165
Vochysia_antioquiae,3,3,0,Points-PointsKO-Adjacents,16
Vochysia_apopetala,5,5,0,Points-PointsKO-Adjacents,39
Vochysia_assua,7,0,7,Points-PointsKO-Adjacents,63
Vochysia_aurifera,1,1,0,Points-PointsKO-Adjacents,9
Vochysia_bautistae,2,2,0,Points-PointsKO-Adjacents,12
Vochysia_bifalcata,120,0,120,Points-PointsKO-Adjacents,740
Vochysia_biloba,33,7,26,Points-PointsKO-Adjacents,273
Vochysia_boliviana,30,16,14,Points-PointsKO-Adjacents,214
Vochysia_braceliniae,38,13,25,Points-PointsKO-Adjacents,320
Vochysia_caesia,3,3,0,Points-PointsKO-Adjacents,27
Vochysia_calamana,5,5,0,Points-PointsKO-Adjacents,36
Vochysia_calophylla,22,8,14,Points-PointsKO-Adjacents,187
Vochysia_cassiquiarensis,0,0,0,NA,0
Vochysia_catingae,9,0,9,Points-PointsKO-Adjacents,80
Vochysia_cayennensis,3,1,2,Points-PointsKO-Adjacents,24
Vochysia_citrifolia,53,26,27,Alphahull-PointsKO-Adjacents,1029
Vochysia_complicata,11,0,11,Points-PointsKO-Adjacents,76
Vochysia_costata,11,2,9,Points-PointsKO-Adjacents,88
Vochysia_crassifolia,45,23,22,Alphahull-PointsKO-Adjacents,1413
Vochysia_dasyantha,42,29,13,Alphahull-PointsKO-Adjacents,706
Vochysia_densiflora,20,0,20,Points-PointsKO-Adjacents,149
Vochysia_divergens,206,158,48,Alphahull-PointsKO-Adjacents,14300
Vochysia_diversa,22,0,22,Points-PointsKO-Adjacents,198
Vochysia_duquei,11,4,7,Points-PointsKO-Adjacents,64
Vochysia_elegans,9,0,9,Points-PointsKO-Adjacents,71
Vochysia_elliptica,484,436,48,Alphahull-PointsKO-Adjacents,10406
Vochysia_emarginata,169,142,27,Alphahull-PointsKO-Adjacents,3891
Vochysia_eximia,8,0,8,Points-PointsKO-Adjacents,72
Vochysia_expansa,7,1,6,Points-PointsKO-Adjacents,54
Vochysia_ferruginea,703,583,120,Alphahull-PointsKO-Adjacents,62472
Vochysia_floribunda,38,11,27,Points-PointsKO-Adjacents,312
Vochysia_gardneri,291,259,32,Alphahull-PointsKO-Adjacents,11742
Vochysia_gigantea,32,10,22,Points-PointsKO-Adjacents,212
Vochysia_glaberrima,52,27,25,Alphahull-PointsKO-Adjacents,1552
Vochysia_glazioviana,15,8,7,Points-PointsKO-Adjacents,98
Vochysia_grandis,30,6,24,Points-PointsKO-Adjacents,233
Vochysia_guatemalensis,416,364,52,Alphahull-PointsKO-Adjacents,4845
Vochysia_guianensis,108,52,56,Alphahull-PointsKO-Adjacents,8264
Vochysia_gummifera,7,4,3,Points-PointsKO-Adjacents,54
Vochysia_haenkeana,413,353,60,Alphahull-PointsKO-Adjacents,29963
Vochysia_hannekesaskiae,2,2,0,Points-PointsKO-Adjacents,18
Vochysia_herbacea,43,26,17,Alphahull-PointsKO-Adjacents,1395
Vochysia_inundata,42,12,30,Points-PointsKO-Adjacents,365
Vochysia_jonkeri,3,3,0,Points-PointsKO-Adjacents,23
Vochysia_julianensis,1,1,0,Points-PointsKO-Adjacents,9
Vochysia_kosnipatae,4,4,0,Points-PointsKO-Adjacents,36
Vochysia_lanceolata,8,0,8,Points-PointsKO-Adjacents,63
Vochysia_laurifolia,30,9,21,Points-PointsKO-Adjacents,221
Vochysia_laxiflora,12,3,9,Points-PointsKO-Adjacents,99
Vochysia_leguiana,9,2,7,Points-PointsKO-Adjacents,81
Vochysia_lehmannii,91,78,13,Alphahull-PointsKO-Adjacents,3639
Vochysia_liscanoi,1,1,0,Points-PointsKO-Adjacents,9
Vochysia_lomatophylla,57,0,57,Points-PointsKO-Adjacents,423
Vochysia_magnifica,205,165,40,Alphahull-PointsKO-Adjacents,3941
Vochysia_maguirei,2,2,0,Points-PointsKO-Adjacents,18
Vochysia_majuscula,2,2,0,Points-PointsKO-Adjacents,18
Vochysia_mapirensis,63,37,26,Alphahull-PointsKO-Adjacents,1101
Vochysia_mapuerae,5,5,0,Points-PointsKO-Adjacents,45
Vochysia_martiana,3,3,0,Points-PointsKO-Adjacents,27
Vochysia_maxima,44,21,23,Alphahull-PointsKO-Adjacents,2658
Vochysia_megalantha,14,5,9,Points-PointsKO-Adjacents,117
Vochysia_megalophylla,32,22,10,Alphahull-PointsKO-Adjacents,102
Vochysia_meridensis,11,4,7,Points-PointsKO-Adjacents,99
Vochysia_neyratii,10,10,0,Points-PointsKO-Adjacents,45
Vochysia_obidensis,62,28,34,Alphahull-PointsKO-Adjacents,508
Vochysia_oblongifolia,21,0,21,Points-PointsKO-Adjacents,156
Vochysia_obscura,181,110,71,Alphahull-PointsKO-Adjacents,9601
Vochysia_oppugnata,73,46,27,Alphahull-PointsKO-Adjacents,2059
Vochysia_ortegae,2,2,0,Points-PointsKO-Adjacents,18
Vochysia_pachyantha,3,3,0,Points-PointsKO-Adjacents,27
Vochysia_parviflora,8,1,7,Points-PointsKO-Adjacents,68
Vochysia_pauciflora,1,1,0,Points-PointsKO-Adjacents,9
Vochysia_penae,NA,NA,NA,NA,NA
Vochysia_pinkusii,4,4,0,Points-PointsKO-Adjacents,36
Vochysia_punctata,5,5,0,Points-PointsKO-Adjacents,32
Vochysia_pyramidalis,487,439,48,Alphahull-PointsKO-Adjacents,23388
Vochysia_revoluta,11,3,8,Points-PointsKO-Adjacents,85
Vochysia_riedeliana,48,26,22,Alphahull-PointsKO-Adjacents,353
Vochysia_rotundifolia,9,6,3,Points-PointsKO-Adjacents,65
Vochysia_rubiginosa,5,5,0,Points-PointsKO-Adjacents,34
Vochysia_rufa,710,651,59,Alphahull-PointsKO-Adjacents,28066
Vochysia_saccata,6,0,6,Points-PointsKO-Adjacents,54
Vochysia_saldanhana,25,11,14,Points-PointsKO-Adjacents,153
Vochysia_schomburgkii,3,3,0,Points-PointsKO-Adjacents,27
Vochysia_schwackeana,53,38,15,Alphahull-PointsKO-Adjacents,895
Vochysia_spathiphylla,6,0,6,Points-PointsKO-Adjacents,48
Vochysia_spathulata,9,0,9,Points-PointsKO-Adjacents,70
Vochysia_speciosa,0,0,0,NA,0
Vochysia_splendens,16,5,11,Points-PointsKO-Adjacents,125
Vochysia_stafleui,2,2,0,Points-PointsKO-Adjacents,18
Vochysia_steyermarkiana,3,3,0,Points-PointsKO-Adjacents,14
Vochysia_surinamensis,81,44,37,Alphahull-PointsKO-Adjacents,3926
Vochysia_tetraphylla,3,3,0,Points-PointsKO-Adjacents,27
Vochysia_thyrsoidea,466,420,46,Alphahull-PointsKO-Adjacents,14213
Vochysia_tillettii,10,5,5,Points-PointsKO-Adjacents,57
Vochysia_tomentosa,60,1,59,Points-PointsKO-Adjacents,461
Vochysia_tucanorum,1404,1277,127,Alphahull-PointsKO-Adjacents,34360
Vochysia_venezuelana,110,91,19,Alphahull-PointsKO-Adjacents,2679
Vochysia_venulosa,2,2,0,Points-PointsKO-Adjacents,18
Vochysia_vismiifolia,192,104,88,Alphahull-PointsKO-Adjacents,17490
Volkameria_aculeata,69,24,45,Alphahull-PointsKO-Adjacents,520
Volkameria_eriophylla,8,0,8,Points-PointsKO-Adjacents,60
Volkameria_glabra,188,0,188,Points-PointsKO-Adjacents,1553
Volkameria_heterophylla,3,2,1,Points-PointsKO-Adjacents,20
Volkameria_ligustrina,159,107,52,Alphahull-PointsKO-Adjacents,5073
Volkameria_mollis,5,5,0,Points-PointsKO-Adjacents,41
Votomita_cupuliformis,3,2,1,Points-PointsKO-Adjacents,25
Votomita_guianensis,21,11,10,Points-PointsKO-Adjacents,136
Votomita_monadelpha,4,4,0,Points-PointsKO-Adjacents,36
Votomita_orbinaxia,1,1,0,Points-PointsKO-Adjacents,9
Votomita_orinocensis,5,5,0,Points-PointsKO-Adjacents,36
Votomita_plerocarpa,5,5,0,Points-PointsKO-Adjacents,43
Votomita_pubescens,7,2,5,Points-PointsKO-Adjacents,48
Votomita_roraimensis,7,0,7,Points-PointsKO-Adjacents,54
Votschia_nemophila,1,1,0,Points-PointsKO-Adjacents,5
Vouacapoua_americana,50,32,18,Alphahull-PointsKO-Adjacents,1461
Vouacapoua_macropetala,6,2,4,Points-PointsKO-Adjacents,43
Vouacapoua_pallidior,24,0,24,Points-PointsKO-Adjacents,127
Vouarana_anomala,44,21,23,Alphahull-PointsKO-Adjacents,378
Vouarana_guianensis,190,131,59,Alphahull-PointsKO-Adjacents,13404
Wallacea_insignis,32,25,7,Alphahull-PointsKO-Adjacents,491
Wallacea_multiflora,9,1,8,Points-PointsKO-Adjacents,75
Wallaceodendron_celebicum,9,3,6,Points-PointsKO-Adjacents,52
Wallenia_lamarckiana,25,16,9,Points-PointsKO-Adjacents,90
Wallenia_xylosteoides,0,0,0,NA,0
Wallichia_caryotoides,12,1,11,Points-PointsKO-Adjacents,108
Wallichia_disticha,1,1,0,Points-PointsKO-Adjacents,9
Wallichia_lidiae,NA,NA,NA,NA,NA
Wallichia_nana,0,0,0,NA,0
Wallichia_triandra,NA,NA,NA,NA,NA
Walsura_pinnata,28,2,26,Points-PointsKO-Adjacents,239
Walsura_robusta,20,2,18,Points-PointsKO-Adjacents,165
Walsura_trichostemon,3,3,0,Points-PointsKO-Adjacents,27
Heynea_trifolia,0,0,0,NA,0
Walsura_villosa,0,0,0,NA,0
Waltheria_cinerescens,199,161,38,Alphahull-PointsKO-Adjacents,3032
Waltheria_conzattii,27,0,27,Points-PointsKO-Adjacents,129
Waltheria_involucrata,22,11,11,Points-PointsKO-Adjacents,144
Waltheria_polyantha,15,6,9,Points-PointsKO-Adjacents,119
Warburgia_elongata,2,2,0,Points-PointsKO-Adjacents,18
Warburgia_salutaris,38,0,38,Points-PointsKO-Adjacents,307
Warburgia_stuhlmannii,14,0,14,Points-PointsKO-Adjacents,74
Warburgia_ugandensis,36,15,21,Points-PointsKO-Adjacents,238
Warneckea_amaniensis,28,14,14,Points-PointsKO-Adjacents,164
Warneckea_bebaiensis,17,10,7,Points-PointsKO-Adjacents,88
Warneckea_cauliflora,14,10,4,Points-PointsKO-Adjacents,57
Warneckea_cinnamomoides,48,18,30,Points-PointsKO-Adjacents,387
Warneckea_congolensis,2,2,0,Points-PointsKO-Adjacents,18
Warneckea_erubescens,8,1,7,Points-PointsKO-Adjacents,36
Warneckea_fascicularis,16,6,10,Points-PointsKO-Adjacents,102
Warneckea_floribunda,14,7,7,Points-PointsKO-Adjacents,86
Warneckea_guineensis,28,18,10,Points-PointsKO-Adjacents,173
Warneckea_jasminoides,47,22,25,Alphahull-PointsKO-Adjacents,786
Warneckea_macrantha,12,6,6,Points-PointsKO-Adjacents,75
Warneckea_mangrovensis,3,3,0,Points-PointsKO-Adjacents,19
Warneckea_memecyloides,27,14,13,Points-PointsKO-Adjacents,223
Warneckea_sansibarica,48,17,31,Points-PointsKO-Adjacents,303
Warneckea_sapinii,30,16,14,Points-PointsKO-Adjacents,212
Warneckea_sessilicarpa,0,0,0,NA,0
Warneckea_superba,1,1,0,Points-PointsKO-Adjacents,9
Warneckea_urschii,4,0,4,Points-PointsKO-Adjacents,29
Warneckea_walikalensis,6,2,4,Points-PointsKO-Adjacents,39
Warneckea_wildeana,5,5,0,Points-PointsKO-Adjacents,45
Warszewiczia_ambigua,8,0,8,Points-PointsKO-Adjacents,63
Warszewiczia_coccinea,1379,1257,122,Alphahull-PointsKO-Adjacents,56218
Warszewiczia_cordata,112,81,31,Alphahull-PointsKO-Adjacents,3226
Warszewiczia_elata,63,21,42,Alphahull-PointsKO-Adjacents,845
Warszewiczia_longistaminea,24,1,23,Points-PointsKO-Adjacents,206
Warszewiczia_peltata,6,0,6,Points-PointsKO-Adjacents,54
Warszewiczia_schwackei,120,70,50,Alphahull-PointsKO-Adjacents,3984
Warszewiczia_uxpanapensis,57,35,22,Alphahull-PointsKO-Adjacents,258
Washingtonia_filifera,255,218,37,Alphahull-PointsKO-Adjacents,3628
Washingtonia_robusta,51,23,28,Alphahull-PointsKO-Adjacents,528
Weberbauerocereus_churinensis,0,0,0,NA,0
Weberbauerocereus_johnsonii,1,1,0,Points-PointsKO-Adjacents,9
Weberbauerocereus_longicomus,0,0,0,NA,0
Weberbauerocereus_madidiensis,5,5,0,Points-PointsKO-Adjacents,20
Weberbauerocereus_weberbaueri,4,4,0,Points-PointsKO-Adjacents,27
Weberbauerocereus_winterianus,1,1,0,Points-PointsKO-Adjacents,9
Wedelia_fruticosa,4,1,3,Points-PointsKO-Adjacents,36
Weinmannia_affinis,2,2,0,Points-PointsKO-Adjacents,15
Weinmannia_anisophylla,26,4,22,Points-PointsKO-Adjacents,187
Weinmannia_apurimacensis,3,3,0,Points-PointsKO-Adjacents,27
Weinmannia_arguta,10,2,8,Points-PointsKO-Adjacents,53
Weinmannia_auriculata,88,55,33,Alphahull-PointsKO-Adjacents,1597
Weinmannia_auriculifera,35,12,23,Points-PointsKO-Adjacents,241
Weinmannia_baccariniana,0,0,0,NA,0
Weinmannia_baehniana,7,3,4,Points-PointsKO-Adjacents,59
Weinmannia_balbisiana,388,290,98,Alphahull-PointsKO-Adjacents,5069
Weinmannia_bangii,15,8,7,Points-PointsKO-Adjacents,80
Weinmannia_bojeriana,104,83,21,Alphahull-PointsKO-Adjacents,1140
Weinmannia_boliviensis,21,10,11,Points-PointsKO-Adjacents,185
Weinmannia_brachystachya,0,0,0,NA,0
Weinmannia_burserifolia,66,49,17,Alphahull-PointsKO-Adjacents,448
Weinmannia_chryseis,21,5,16,Points-PointsKO-Adjacents,183
Weinmannia_cinerea,3,3,0,Points-PointsKO-Adjacents,27
Weinmannia_cochensis,193,169,24,Alphahull-PointsKO-Adjacents,1480
Weinmannia_cogolloi,4,4,0,Points-PointsKO-Adjacents,15
Weinmannia_cordata,5,5,0,Points-PointsKO-Adjacents,37
Weinmannia_costulata,2,2,0,Points-PointsKO-Adjacents,18
Weinmannia_crassifolia,104,77,27,Alphahull-PointsKO-Adjacents,830
Weinmannia_cundinamarcensis,30,0,30,Points-PointsKO-Adjacents,166
Weinmannia_cutervensis,3,3,0,Points-PointsKO-Adjacents,16
Weinmannia_cymbifolia,21,12,9,Points-PointsKO-Adjacents,83
Weinmannia_davidsonii,33,0,33,Points-PointsKO-Adjacents,80
Weinmannia_decora,28,14,14,Points-PointsKO-Adjacents,202
Weinmannia_descendens,3,3,0,Points-PointsKO-Adjacents,27
Weinmannia_discolor,126,96,30,Alphahull-PointsKO-Adjacents,2118
Weinmannia_dzieduszyckii,8,5,3,Points-PointsKO-Adjacents,70
Weinmannia_elliptica,110,70,40,Alphahull-PointsKO-Adjacents,1794
Weinmannia_eriocarpa,37,24,13,Alphahull-PointsKO-Adjacents,379
Weinmannia_fagaroides,472,380,92,Alphahull-PointsKO-Adjacents,5544
Weinmannia_fraxinea,84,29,55,Alphahull-PointsKO-Adjacents,2067
Weinmannia_glomerata,11,6,5,Points-PointsKO-Adjacents,82
Weinmannia_guyanensis,19,9,10,Points-PointsKO-Adjacents,139
Weinmannia_haenkeana,36,16,20,Points-PointsKO-Adjacents,207
Weinmannia_henricorum,1,1,0,Points-PointsKO-Adjacents,9
Weinmannia_hepaticarum,2,2,0,Points-PointsKO-Adjacents,18
Weinmannia_hildebrandtii,31,18,13,Points-PointsKO-Adjacents,205
Weinmannia_humblotii,39,22,17,Alphahull-PointsKO-Adjacents,442
Weinmannia_humilis,132,0,132,Points-PointsKO-Adjacents,670
Weinmannia_icacifolia,5,5,0,Points-PointsKO-Adjacents,43
Weinmannia_ilutepuiensis,4,4,0,Points-PointsKO-Adjacents,26
Weinmannia_integrifolia,4,4,0,Points-PointsKO-Adjacents,30
Weinmannia_intermedia,63,52,11,Alphahull-PointsKO-Adjacents,529
Weinmannia_jahnii,1,1,0,Points-PointsKO-Adjacents,9
Weinmannia_jelskii,3,3,0,Points-PointsKO-Adjacents,16
Weinmannia_karsteniana,36,21,15,Alphahull-PointsKO-Adjacents,125
Weinmannia_kunthiana,9,0,9,Points-PointsKO-Adjacents,79
Weinmannia_lansbergiana,8,0,8,Points-PointsKO-Adjacents,66
Weinmannia_latifolia,71,43,28,Alphahull-PointsKO-Adjacents,713
Weinmannia_laurina,44,32,12,Alphahull-PointsKO-Adjacents,804
Weinmannia_laxiramea,18,9,9,Points-PointsKO-Adjacents,78
Weinmannia_lechleriana,76,0,76,Points-PointsKO-Adjacents,351
Weinmannia_lentiscifolia,73,31,42,Alphahull-PointsKO-Adjacents,1031
Weinmannia_lopezana,5,0,5,Points-PointsKO-Adjacents,45
Weinmannia_louveliana,7,3,4,Points-PointsKO-Adjacents,57
Weinmannia_lowryana,4,4,0,Points-PointsKO-Adjacents,25
Weinmannia_loxensis,8,5,3,Points-PointsKO-Adjacents,30
Weinmannia_lucens,27,15,12,Points-PointsKO-Adjacents,193
Weinmannia_macrophylla,68,45,23,Alphahull-PointsKO-Adjacents,298
Weinmannia_macrostachya,1,1,0,Points-PointsKO-Adjacents,9
Weinmannia_magnifolia,8,2,6,Points-PointsKO-Adjacents,39
Weinmannia_mammea,7,3,4,Points-PointsKO-Adjacents,51
Weinmannia_mariquitae,169,139,30,Alphahull-PointsKO-Adjacents,1399
Weinmannia_marojejyensis,5,5,0,Points-PointsKO-Adjacents,12
Weinmannia_microphylla,79,49,30,Alphahull-PointsKO-Adjacents,360
Weinmannia_minutiflora,15,4,11,Points-PointsKO-Adjacents,111
Weinmannia_multijuga,138,88,50,Alphahull-PointsKO-Adjacents,1641
Weinmannia_organensis,40,27,13,Alphahull-PointsKO-Adjacents,319
Weinmannia_ouaiemensis,0,0,0,NA,0
Weinmannia_ovata,110,69,41,Alphahull-PointsKO-Adjacents,885
Weinmannia_parvifoliolata,4,4,0,Points-PointsKO-Adjacents,36
Weinmannia_paulliniifolia,430,378,52,Alphahull-PointsKO-Adjacents,5182
Weinmannia_pentaphylla,72,56,16,Alphahull-PointsKO-Adjacents,508
Weinmannia_pinnata,902,744,158,Alphahull-PointsKO-Adjacents,9823
Weinmannia_piurensis,5,5,0,Points-PointsKO-Adjacents,39
Weinmannia_polyphylla,38,23,15,Alphahull-PointsKO-Adjacents,292
Weinmannia_portlandiana,0,0,0,NA,0
Weinmannia_pubescens,404,342,62,Alphahull-PointsKO-Adjacents,3414
Weinmannia_rakotomalazana,4,4,0,Points-PointsKO-Adjacents,21
Weinmannia_reticulata,98,59,39,Alphahull-PointsKO-Adjacents,699
Weinmannia_rhoifolia,5,5,0,Points-PointsKO-Adjacents,45
Weinmannia_rollottii,234,205,29,Alphahull-PointsKO-Adjacents,3053
Weinmannia_rutenbergii,109,88,21,Alphahull-PointsKO-Adjacents,1318
Weinmannia_sanguisugarum,9,1,8,Points-PointsKO-Adjacents,62
Weinmannia_silvatica,40,11,29,Points-PointsKO-Adjacents,275
Weinmannia_sorbifolia,261,179,82,Alphahull-PointsKO-Adjacents,6690
Weinmannia_spiraeoides,0,0,0,NA,0
Weinmannia_spruceana,60,41,19,Alphahull-PointsKO-Adjacents,770
Weinmannia_stenocarpa,4,4,0,Points-PointsKO-Adjacents,36
Weinmannia_stenostachya,46,30,16,Alphahull-PointsKO-Adjacents,1266
Weinmannia_subsessiliflora,12,4,8,Points-PointsKO-Adjacents,108
Weinmannia_testudineata,1,1,0,Points-PointsKO-Adjacents,9
Weinmannia_tolimensis,11,8,3,Points-PointsKO-Adjacents,68
Weinmannia_tomentosa,202,181,21,Alphahull-PointsKO-Adjacents,935
Weinmannia_trianaea,53,24,29,Alphahull-PointsKO-Adjacents,574
Weinmannia_trichosperma,67,44,23,Alphahull-PointsKO-Adjacents,2424
Weinmannia_ulei,3,3,0,Points-PointsKO-Adjacents,27
Weinmannia_velutina,78,57,21,Alphahull-PointsKO-Adjacents,1072
Weinmannia_venosa,4,4,0,Points-PointsKO-Adjacents,27
Weinmannia_venusta,8,2,6,Points-PointsKO-Adjacents,62
Weinmannia_vulcanicola,24,14,10,Points-PointsKO-Adjacents,83
Weinmannia_wercklei,60,46,14,Alphahull-PointsKO-Adjacents,172
Weinmannia_yungasensis,17,8,9,Points-PointsKO-Adjacents,52
Welchiodendron_longivalve,204,186,18,Alphahull-PointsKO-Adjacents,554
Welfia_regia,182,148,34,Alphahull-PointsKO-Adjacents,2426
Wendlandia_amocana,0,0,0,NA,0
Wendlandia_andamanica,0,0,0,NA,0
Wendlandia_angustifolia,0,0,0,NA,0
Wendlandia_arabica,5,1,4,Points-PointsKO-Adjacents,42
Wendlandia_arborescens,0,0,0,NA,0
Wendlandia_bicuspidata,1,1,0,Points-PointsKO-Adjacents,9
Wendlandia_bouvardioides,2,2,0,Points-PointsKO-Adjacents,18
Wendlandia_brachyantha,1,1,0,Points-PointsKO-Adjacents,8
Wendlandia_brevipaniculata,NA,NA,NA,NA,NA
Wendlandia_buddleacea,6,1,5,Points-PointsKO-Adjacents,50
Wendlandia_budleioides,9,4,5,Points-PointsKO-Adjacents,35
Wendlandia_burkillii,1,1,0,Points-PointsKO-Adjacents,9
Wendlandia_cavaleriei,1,1,0,Points-PointsKO-Adjacents,9
Wendlandia_coriacea,1,1,0,Points-PointsKO-Adjacents,9
Wendlandia_dasythyrsa,1,1,0,Points-PointsKO-Adjacents,9
Wendlandia_densiflora,9,5,4,Points-PointsKO-Adjacents,56
Wendlandia_erythroxylon,6,0,6,Points-PointsKO-Adjacents,46
Wendlandia_ferruginea,0,0,0,NA,0
Wendlandia_formosana,293,235,58,Alphahull-PointsKO-Adjacents,768
Wendlandia_gamblei,0,0,0,NA,0
Wendlandia_glabrata,9,1,8,Points-PointsKO-Adjacents,78
Wendlandia_glomerulata,0,0,0,NA,0
Wendlandia_guangdongensis,2,2,0,Points-PointsKO-Adjacents,18
Wendlandia_heyneana,0,0,0,NA,0
Wendlandia_heynei,11,0,11,Points-PointsKO-Adjacents,85
Wendlandia_junghuhniana,0,0,0,NA,0
Wendlandia_lauterbachii,0,0,0,NA,0
Wendlandia_laxa,1,1,0,Points-PointsKO-Adjacents,9
Wendlandia_ligustrina,1,1,0,Points-PointsKO-Adjacents,9
Wendlandia_litseifolia,0,0,0,NA,0
Wendlandia_luzoniensis,13,7,6,Points-PointsKO-Adjacents,33
Wendlandia_merrilliana,2,2,0,Points-PointsKO-Adjacents,18
Wendlandia_nervosa,0,0,0,NA,0
Wendlandia_nitens,0,0,0,NA,0
Wendlandia_nobilis,0,0,0,NA,0
Wendlandia_oligantha,2,2,0,Points-PointsKO-Adjacents,18
Wendlandia_paedicalyx,1,1,0,Points-PointsKO-Adjacents,9
Wendlandia_paniculata,70,0,70,Points-PointsKO-Adjacents,436
Wendlandia_parviflora,NA,NA,NA,NA,NA
Wendlandia_philippinensis,2,2,0,Points-PointsKO-Adjacents,16
Wendlandia_pingpienensis,5,5,0,Points-PointsKO-Adjacents,45
Wendlandia_puberula,4,4,0,Points-PointsKO-Adjacents,36
Wendlandia_scabra,29,12,17,Points-PointsKO-Adjacents,259
Wendlandia_sibuyanensis,1,1,0,Points-PointsKO-Adjacents,9
Wendlandia_sikkimensis,0,0,0,NA,0
Wendlandia_speciosa,13,4,9,Points-PointsKO-Adjacents,94
Wendlandia_syringoides,0,0,0,NA,0
Wendlandia_ternifolia,NA,NA,NA,NA,NA
Wendlandia_thorelii,1,1,0,Points-PointsKO-Adjacents,9
Wendlandia_thyrsoidea,1,1,0,Points-PointsKO-Adjacents,9
Wendlandia_tinctoria,32,12,20,Points-PointsKO-Adjacents,270
Wendlandia_tonkiniana,0,0,0,NA,0
Wendlandia_uvariifolia,111,77,34,Alphahull-PointsKO-Adjacents,3128
Wendlandia_villosa,1,1,0,Points-PointsKO-Adjacents,9
Wendlandia_wallichii,1,1,0,Points-PointsKO-Adjacents,9
Wendlandia_warburgii,NA,NA,NA,NA,NA
Wercklea_cocleana,14,8,6,Points-PointsKO-Adjacents,57
Wercklea_ferox,205,155,50,Alphahull-PointsKO-Adjacents,5171
Wercklea_grandiflora,7,3,4,Points-PointsKO-Adjacents,25
Wercklea_horrida,9,4,5,Points-PointsKO-Adjacents,39
Wercklea_hottensis,1,1,0,Points-PointsKO-Adjacents,9
Wercklea_insignis,55,40,15,Alphahull-PointsKO-Adjacents,139
Wercklea_magnibracteata,4,4,0,Points-PointsKO-Adjacents,27
Wercklea_woodsonii,44,32,12,Alphahull-PointsKO-Adjacents,80
Wetria_australiensis,0,0,0,NA,0
Wetria_insignis,5,0,5,Points-PointsKO-Adjacents,45
Wettinia_aequalis,42,23,19,Alphahull-PointsKO-Adjacents,325
Wettinia_aequatorialis,14,9,5,Points-PointsKO-Adjacents,81
Wettinia_anomala,23,13,10,Points-PointsKO-Adjacents,131
Wettinia_augusta,175,141,34,Alphahull-PointsKO-Adjacents,4476
Wettinia_castanea,12,5,7,Points-PointsKO-Adjacents,95
Wettinia_disticha,8,1,7,Points-PointsKO-Adjacents,59
Wettinia_drudei,116,88,28,Alphahull-PointsKO-Adjacents,5204
Wettinia_fascicularis,58,42,16,Alphahull-PointsKO-Adjacents,979
Wettinia_hirsuta,11,3,8,Points-PointsKO-Adjacents,87
Wettinia_kalbreyeri,123,94,29,Alphahull-PointsKO-Adjacents,1651
Wettinia_lanata,5,2,3,Points-PointsKO-Adjacents,39
Wettinia_longipetala,27,14,13,Points-PointsKO-Adjacents,136
Wettinia_maynensis,171,146,25,Alphahull-PointsKO-Adjacents,3061
Wettinia_microcarpa,6,3,3,Points-PointsKO-Adjacents,33
Wettinia_minima,7,3,4,Points-PointsKO-Adjacents,37
Wettinia_oxycarpa,23,10,13,Points-PointsKO-Adjacents,152
Wettinia_panamensis,6,0,6,Points-PointsKO-Adjacents,48
Wettinia_praemorsa,144,113,31,Alphahull-PointsKO-Adjacents,1887
Wettinia_quinaria,111,97,14,Alphahull-PointsKO-Adjacents,825
Wettinia_radiata,86,67,19,Alphahull-PointsKO-Adjacents,763
Wettinia_verruculosa,13,7,6,Points-PointsKO-Adjacents,78
Whiteodendron_moultonianum,3,0,3,Points-PointsKO-Adjacents,27
Whitmorea_grandiflora,6,0,6,Points-PointsKO-Adjacents,36
Whyanbeelia_terrae-reginae,17,9,8,Points-PointsKO-Adjacents,50
Widdringtonia_nodiflora,173,128,45,Alphahull-PointsKO-Adjacents,3007
Widdringtonia_schwarzii,26,18,8,Points-PointsKO-Adjacents,135
Widdringtonia_wallichii,26,23,3,Alphahull-PointsKO-Adjacents,32
Widdringtonia_whytei,15,11,4,Points-PointsKO-Adjacents,41
Wielandia_bemarensis,59,40,19,Alphahull-PointsKO-Adjacents,1910
Wielandia_bojeriana,96,65,31,Alphahull-PointsKO-Adjacents,2252
Wielandia_danguyana,11,6,5,Points-PointsKO-Adjacents,54
Wielandia_elegans,75,47,28,Alphahull-PointsKO-Adjacents,3550
Wielandia_fadenii,45,28,17,Alphahull-PointsKO-Adjacents,213
Wielandia_laureola,23,0,23,Points-PointsKO-Adjacents,58
Wielandia_leandriana,46,22,24,Alphahull-PointsKO-Adjacents,255
Wielandia_mimosoides,109,87,22,Alphahull-PointsKO-Adjacents,1072
Wielandia_oblongifolia,110,84,26,Alphahull-PointsKO-Adjacents,1100
Wielandia_platyrachis,101,74,27,Alphahull-PointsKO-Adjacents,1239
Wielandia_ranavalonae,21,4,17,Points-PointsKO-Adjacents,107
Wielandia_tanalorum,28,10,18,Points-PointsKO-Adjacents,187
Wielandia_unifex,2,2,0,Points-PointsKO-Adjacents,18
Wigandia_urens,848,696,152,Alphahull-PointsKO-Adjacents,11867
Wightia_speciosissima,16,5,11,Points-PointsKO-Adjacents,140
Wikstroemia_alberti,0,0,0,NA,0
Wikstroemia_androsaemifolia,55,17,38,Points-PointsKO-Adjacents,335
Wikstroemia_australis,7,2,5,Points-PointsKO-Adjacents,3
Wikstroemia_bicornuta,5,2,3,Points-PointsKO-Adjacents,19
Wikstroemia_coriacea,14,3,11,Points-PointsKO-Adjacents,54
Wikstroemia_furcata,8,5,3,Points-PointsKO-Adjacents,24
Wikstroemia_monticola,4,4,0,Points-PointsKO-Adjacents,24
Wikstroemia_oahuensis,38,0,38,Points-PointsKO-Adjacents,109
Wikstroemia_ovata,0,0,0,NA,0
Wikstroemia_phillyreifolia,5,5,0,Points-PointsKO-Adjacents,32
Wikstroemia_polyantha,3,3,0,Points-PointsKO-Adjacents,27
Wikstroemia_pulcherrima,8,4,4,Points-PointsKO-Adjacents,24
Wikstroemia_sandwicensis,14,0,14,Points-PointsKO-Adjacents,66
Wikstroemia_skottsbergiana,3,3,0,Points-PointsKO-Adjacents,17
Wikstroemia_tenuiramis,14,0,14,Points-PointsKO-Adjacents,88
Wikstroemia_villosa,1,1,0,Points-PointsKO-Adjacents,9
Wilkiea_wardellii,56,42,14,Alphahull-PointsKO-Adjacents,154
Willardia_parviflora,7,0,7,Points-PointsKO-Adjacents,61
Williamodendron_cinnamomeum,5,5,0,Points-PointsKO-Adjacents,19
Williamodendron_glaucophyllum,24,19,5,Points-PointsKO-Adjacents,40
Williamodendron_quadrilocellatum,2,2,0,Points-PointsKO-Adjacents,12
Williamodendron_spectabile,8,4,4,Points-PointsKO-Adjacents,64
Willughbeia_cirrhifera,1,1,0,Points-PointsKO-Adjacents,9
Wimmeria_acuminata,22,15,7,Points-PointsKO-Adjacents,90
Wimmeria_bartlettii,112,88,24,Alphahull-PointsKO-Adjacents,1656
Wimmeria_chiapensis,66,55,11,Alphahull-PointsKO-Adjacents,339
Wimmeria_concolor,306,276,30,Alphahull-PointsKO-Adjacents,1608
Wimmeria_confusa,64,42,22,Alphahull-PointsKO-Adjacents,264
Wimmeria_cyclocarpa,7,2,5,Points-PointsKO-Adjacents,57
Wimmeria_lanceolata,37,30,7,Alphahull-PointsKO-Adjacents,484
Wimmeria_lundelliana,6,1,5,Points-PointsKO-Adjacents,38
Wimmeria_mexicana,48,33,15,Alphahull-PointsKO-Adjacents,515
Wimmeria_microphylla,162,139,23,Alphahull-PointsKO-Adjacents,857
Wimmeria_montana,66,56,10,Alphahull-PointsKO-Adjacents,341
Wimmeria_obtusifolia,15,3,12,Points-PointsKO-Adjacents,116
Wimmeria_pubescens,159,124,35,Alphahull-PointsKO-Adjacents,1272
Wimmeria_serrulata,19,8,11,Points-PointsKO-Adjacents,147
Wimmeria_sternii,23,12,11,Points-PointsKO-Adjacents,129
Withania_begoniifolia,0,0,0,NA,0
Witheringia_coccoloboides,268,228,40,Alphahull-PointsKO-Adjacents,1819
Witheringia_solanacea,1268,1126,142,Alphahull-PointsKO-Adjacents,21045
Wittmackanthus_stanleyanus,99,73,26,Alphahull-PointsKO-Adjacents,3473
Wodyetia_bifurcata,11,0,11,Points-PointsKO-Adjacents,47
Wollemia_nobilis,6,0,6,Points-PointsKO-Adjacents,47
Woodburnia_penduliflora,0,0,0,NA,0
Woodfordia_fruticosa,8,1,7,Points-PointsKO-Adjacents,62
Woodfordia_uniflora,26,8,18,Points-PointsKO-Adjacents,184
Wrightia_angustifolia,3,3,0,Points-PointsKO-Adjacents,27
Wrightia_annamensis,10,1,9,Points-PointsKO-Adjacents,88
Wrightia_antidysenterica,3,2,1,Points-PointsKO-Adjacents,27
Wrightia_arborea,29,3,26,Points-PointsKO-Adjacents,258
Wrightia_candollei,2,2,0,Points-PointsKO-Adjacents,18
Wrightia_coccinea,11,0,11,Points-PointsKO-Adjacents,90
Wrightia_collettii,0,0,0,NA,0
Wrightia_demartiniana,6,0,6,Points-PointsKO-Adjacents,48
Wrightia_dolichocarpa,NA,NA,NA,NA,NA
Wrightia_dubia,16,5,11,Points-PointsKO-Adjacents,104
Wrightia_flavorosea,NA,NA,NA,NA,NA
Wrightia_indica,1,1,0,Points-PointsKO-Adjacents,9
Wrightia_karaketii,0,0,0,NA,0
Wrightia_laevis,135,78,57,Alphahull-PointsKO-Adjacents,2647
Wrightia_lanceolata,2,2,0,Points-PointsKO-Adjacents,18
Wrightia_lecomtei,0,0,0,NA,0
Wrightia_natalensis,25,17,8,Points-PointsKO-Adjacents,216
Wrightia_novobritannica,0,0,0,NA,0
Wrightia_palawanensis,0,0,0,NA,0
Wrightia_poomae,2,2,0,Points-PointsKO-Adjacents,9
Wrightia_puberula,1,1,0,Points-PointsKO-Adjacents,9
Wrightia_pubescens,575,472,103,Alphahull-PointsKO-Adjacents,8738
Wrightia_saligna,1191,1129,62,Alphahull-PointsKO-Adjacents,12561
Wrightia_siamensis,1,1,0,Points-PointsKO-Adjacents,9
Wrightia_sikkimensis,14,5,9,Points-PointsKO-Adjacents,126
Wrightia_sirikitiae,6,2,4,Points-PointsKO-Adjacents,30
Wrightia_tinctoria,6,1,5,Points-PointsKO-Adjacents,54
Wrightia_tokiae,2,2,0,Points-PointsKO-Adjacents,9
Wrightia_viridiflora,4,4,0,Points-PointsKO-Adjacents,30
Wunderlichia_azulensis,54,45,9,Alphahull-PointsKO-Adjacents,614
Wunderlichia_bahiensis,6,3,3,Points-PointsKO-Adjacents,39
Wunderlichia_cruelsiana,81,59,22,Alphahull-PointsKO-Adjacents,1557
Wunderlichia_mirabilis,186,157,29,Alphahull-PointsKO-Adjacents,6982
Wurdastom_dorrii,5,5,0,Points-PointsKO-Adjacents,33
Wurdastom_dudleyi,2,2,0,Points-PointsKO-Adjacents,18
Wurdastom_ecuadorense,13,9,4,Points-PointsKO-Adjacents,45
Xanthoceras_sorbifolium,1,1,0,Points-PointsKO-Adjacents,9
Xanthocercis_madagascariensis,87,73,14,Alphahull-PointsKO-Adjacents,1822
Xanthocercis_rabiensis,4,4,0,Points-PointsKO-Adjacents,18
Xanthocercis_zambesiaca,69,50,19,Alphahull-PointsKO-Adjacents,2709
Xanthomyrtus_angustifolia,10,5,5,Points-PointsKO-Adjacents,54
Xanthomyrtus_arfakensis,3,3,0,Points-PointsKO-Adjacents,27
Xanthomyrtus_compacta,21,7,14,Points-PointsKO-Adjacents,117
Xanthomyrtus_diplycosiifolia,2,2,0,Points-PointsKO-Adjacents,16
Xanthomyrtus_flavida,7,0,7,Points-PointsKO-Adjacents,63
Xanthomyrtus_hienghenensis,16,6,10,Points-PointsKO-Adjacents,70
Xanthomyrtus_humilis,6,0,6,Points-PointsKO-Adjacents,54
Xanthomyrtus_kanalaensis,11,4,7,Points-PointsKO-Adjacents,67
Xanthomyrtus_koebrensis,4,4,0,Points-PointsKO-Adjacents,25
Xanthomyrtus_lanceolata,1,1,0,Points-PointsKO-Adjacents,9
Xanthomyrtus_leeuwenii,4,4,0,Points-PointsKO-Adjacents,36
Xanthomyrtus_montis-sucklingii,2,2,0,Points-PointsKO-Adjacents,12
Xanthomyrtus_montivaga,16,5,11,Points-PointsKO-Adjacents,123
Xanthomyrtus_oreophila,1,1,0,Points-PointsKO-Adjacents,9
Xanthomyrtus_ovata,0,0,0,NA,0
Xanthomyrtus_papuana,31,13,18,Points-PointsKO-Adjacents,235
Xanthomyrtus_polyclada,11,2,9,Points-PointsKO-Adjacents,81
Xanthomyrtus_schlechteri,19,0,19,Points-PointsKO-Adjacents,119
Xanthomyrtus_scolopacina,7,1,6,Points-PointsKO-Adjacents,63
Xanthomyrtus_splendens,1,1,0,Points-PointsKO-Adjacents,7
Xanthophyllum_beccarianum,3,2,1,Points-PointsKO-Adjacents,27
Xanthophyllum_bicolor,0,0,0,NA,0
Xanthophyllum_borneense,1,1,0,Points-PointsKO-Adjacents,9
Xanthophyllum_brachystachyum,2,2,0,Points-PointsKO-Adjacents,18
Xanthophyllum_brevipes,1,1,0,Points-PointsKO-Adjacents,9
Xanthophyllum_ceraceifolium,0,0,0,NA,0
Xanthophyllum_clovis,2,2,0,Points-PointsKO-Adjacents,9
Xanthophyllum_contractum,0,0,0,NA,0
Xanthophyllum_crassum,NA,NA,NA,NA,NA
Xanthophyllum_discolor,6,1,5,Points-PointsKO-Adjacents,53
Xanthophyllum_ecarinatum,13,2,11,Points-PointsKO-Adjacents,112
Xanthophyllum_ellipticum,13,2,11,Points-PointsKO-Adjacents,111
Xanthophyllum_ferrugineum,2,2,0,Points-PointsKO-Adjacents,18
Xanthophyllum_flavescens,5,0,5,Points-PointsKO-Adjacents,45
Xanthophyllum_hainanense,20,8,12,Points-PointsKO-Adjacents,150
Xanthophyllum_havilandii,3,3,0,Points-PointsKO-Adjacents,25
Xanthophyllum_heterophyllum,0,0,0,NA,0
Xanthophyllum_impressum,0,0,0,NA,0
Xanthophyllum_inflatum,1,1,0,Points-PointsKO-Adjacents,9
Xanthophyllum_ionanthum,1,1,0,Points-PointsKO-Adjacents,9
Xanthophyllum_korthalsianum,0,0,0,NA,0
Skaphium_lanceatum,6,0,6,Points-PointsKO-Adjacents,54
Xanthophyllum_lineare,1,1,0,Points-PointsKO-Adjacents,8
Xanthophyllum_longum,0,0,0,NA,0
Xanthophyllum_macrophyllum,5,5,0,Points-PointsKO-Adjacents,45
Xanthophyllum_montanum,0,0,0,NA,0
Xanthophyllum_neglectum,5,5,0,Points-PointsKO-Adjacents,45
Xanthophyllum_nigricans,0,0,0,NA,0
Xanthophyllum_nitidum,0,0,0,NA,0
Xanthophyllum_obscurum,14,3,11,Points-PointsKO-Adjacents,102
Xanthophyllum_macintyrii,59,47,12,Alphahull-PointsKO-Adjacents,288
Xanthophyllum_oliganthum,2,2,0,Points-PointsKO-Adjacents,18
Xanthophyllum_ovatifolium,1,0,1,Points-PointsKO-Adjacents,9
Xanthophyllum_pachycarpon,3,3,0,Points-PointsKO-Adjacents,27
Xanthophyllum_parvifolium,0,0,0,NA,0
Xanthophyllum_pauciflorum,0,0,0,NA,0
Xanthophyllum_pedicellatum,0,0,0,NA,0
Xanthophyllum_penibukanense,8,1,7,Points-PointsKO-Adjacents,56
Xanthophyllum_petiolatum,0,0,0,NA,0
Xanthophyllum_pseudoadenotus,2,2,0,Points-PointsKO-Adjacents,18
Xanthophyllum_pulchrum,4,1,3,Points-PointsKO-Adjacents,36
Xanthophyllum_purpureum,7,0,7,Points-PointsKO-Adjacents,56
Xanthophyllum_ramiflorum,1,1,0,Points-PointsKO-Adjacents,9
Xanthophyllum_rectum,0,0,0,NA,0
Xanthophyllum_reflexum,0,0,0,NA,0
Xanthophyllum_resupinatum,4,4,0,Points-PointsKO-Adjacents,36
Xanthophyllum_reticulatum,4,4,0,Points-PointsKO-Adjacents,36
Xanthophyllum_rheophilum,1,1,0,Points-PointsKO-Adjacents,9
Xanthophyllum_rufum,9,0,9,Points-PointsKO-Adjacents,75
Xanthophyllum_schizocarpon,5,5,0,Points-PointsKO-Adjacents,45
Xanthophyllum_stipitatum,15,3,12,Points-PointsKO-Adjacents,111
Xanthophyllum_subcoriaceum,3,3,0,Points-PointsKO-Adjacents,27
Xanthophyllum_tardicrescens,1,1,0,Points-PointsKO-Adjacents,9
Xanthophyllum_tenue,9,0,9,Points-PointsKO-Adjacents,75
Xanthophyllum_trichocladum,4,4,0,Points-PointsKO-Adjacents,36
Xanthophyllum_velutinum,5,4,1,Points-PointsKO-Adjacents,44
Xanthophyllum_virens,5,5,0,Points-PointsKO-Adjacents,45
Xanthophyllum_vitellinum,16,2,14,Points-PointsKO-Adjacents,142
Xanthophyllum_yunnanense,2,2,0,Points-PointsKO-Adjacents,18
Xanthophytum_calycinum,3,3,0,Points-PointsKO-Adjacents,19
Xanthophytum_grandifolium,0,0,0,NA,0
Xanthophytum_magnisepalum,0,0,0,NA,0
Xanthorrhoea_acanthostachya,26,12,14,Points-PointsKO-Adjacents,109
Xanthorrhoea_brevistyla,18,16,2,Points-PointsKO-Adjacents,109
Xanthorrhoea_brunonis,58,38,20,Alphahull-PointsKO-Adjacents,581
Xanthorrhoea_drummondii,53,40,13,Alphahull-PointsKO-Adjacents,345
Xanthorrhoea_glauca,1086,1048,38,Alphahull-PointsKO-Adjacents,6781
Xanthorrhoea_gracilis,182,166,16,Alphahull-PointsKO-Adjacents,813
Xanthorrhoea_malacophylla,269,252,17,Alphahull-PointsKO-Adjacents,630
Xanthorrhoea_nana,49,44,5,Alphahull-PointsKO-Adjacents,805
Xanthorrhoea_platyphylla,44,1,43,Points-PointsKO-Adjacents,242
Xanthorrhoea_preissii,290,250,40,Alphahull-PointsKO-Adjacents,1182
Xanthorrhoea_semiplana,1791,1763,28,Alphahull-PointsKO-Adjacents,915
Xanthorrhoea_thorntonii,98,75,23,Alphahull-PointsKO-Adjacents,2327
Xanthosoma_undipes,147,0,147,Points-PointsKO-Adjacents,841
Xanthostemon_arenarius,9,7,2,Points-PointsKO-Adjacents,21
Xanthostemon_aurantiacus,20,16,4,Points-PointsKO-Adjacents,31
Xanthostemon_bracteatus,2,2,0,Points-PointsKO-Adjacents,16
Xanthostemon_brassii,4,4,0,Points-PointsKO-Adjacents,30
Xanthostemon_carlii,13,7,6,Points-PointsKO-Adjacents,34
Xanthostemon_chrysanthus,180,146,34,Alphahull-PointsKO-Adjacents,555
Xanthostemon_confertiflorus,5,5,0,Points-PointsKO-Adjacents,44
Xanthostemon_crenulatus,66,50,16,Alphahull-PointsKO-Adjacents,1104
Xanthostemon_eucalyptoides,400,384,16,Alphahull-PointsKO-Adjacents,1753
Xanthostemon_ferrugineus,9,3,6,Points-PointsKO-Adjacents,23
Xanthostemon_formosus,12,8,4,Points-PointsKO-Adjacents,16
Xanthostemon_fruticosus,2,2,0,Points-PointsKO-Adjacents,5
Xanthostemon_glaucus,1,1,0,Points-PointsKO-Adjacents,8
Xanthostemon_graniticus,13,10,3,Points-PointsKO-Adjacents,35
Xanthostemon_grisii,2,2,0,Points-PointsKO-Adjacents,16
Xanthostemon_laurinus,21,15,6,Points-PointsKO-Adjacents,63
Xanthostemon_macrophyllus,12,7,5,Points-PointsKO-Adjacents,39
Xanthostemon_melanoxylon,2,2,0,Points-PointsKO-Adjacents,9
Xanthostemon_multiflorus,39,24,15,Alphahull-PointsKO-Adjacents,178
Xanthostemon_novaguineensis,0,0,0,NA,0
Xanthostemon_oppositifolius,42,33,9,Alphahull-PointsKO-Adjacents,54
Xanthostemon_paabaensis,0,0,0,NA,0
Xanthostemon_paradoxus,1657,1624,33,Alphahull-PointsKO-Adjacents,4052
Xanthostemon_petiolatus,12,2,10,Points-PointsKO-Adjacents,92
Xanthostemon_philippinensis,0,0,0,NA,0
Xanthostemon_psidioides,190,174,16,Alphahull-PointsKO-Adjacents,2023
Xanthostemon_pubescens,18,12,6,Points-PointsKO-Adjacents,77
Xanthostemon_retusus,21,15,6,Points-PointsKO-Adjacents,63
Xanthostemon_ruber,26,18,8,Points-PointsKO-Adjacents,72
Xanthostemon_sebertii,0,0,0,NA,0
Xanthostemon_speciosus,3,3,0,Points-PointsKO-Adjacents,14
Xanthostemon_sulfureus,7,3,4,Points-PointsKO-Adjacents,23
Xanthostemon_umbrosus,156,125,31,Alphahull-PointsKO-Adjacents,1484
Xanthostemon_velutinus,6,3,3,Points-PointsKO-Adjacents,34
Xanthostemon_verdugonianus,0,0,0,NA,0
Xanthostemon_verticillatus,13,5,8,Points-PointsKO-Adjacents,40
Xanthostemon_verus,7,1,6,Points-PointsKO-Adjacents,56
Xanthostemon_vieillardii,13,4,9,Points-PointsKO-Adjacents,45
Xanthostemon_whitei,81,72,9,Alphahull-PointsKO-Adjacents,107
Xanthostemon_xerophilus,31,0,31,Points-PointsKO-Adjacents,65
Xanthostemon_youngii,21,16,5,Points-PointsKO-Adjacents,38
Xantolis_assamica,3,3,0,Points-PointsKO-Adjacents,27
Xantolis_baranensis,0,0,0,NA,0
Xantolis_boniana,5,5,0,Points-PointsKO-Adjacents,39
Xantolis_burmanica,8,0,8,Points-PointsKO-Adjacents,63
Xantolis_cambodiana,2,2,0,Points-PointsKO-Adjacents,18
Xantolis_hookeri,3,2,1,Points-PointsKO-Adjacents,27
Xantolis_longispinosa,5,5,0,Points-PointsKO-Adjacents,30
Xantolis_maritima,0,0,0,NA,0
Xantolis_parvifolia,0,0,0,NA,0
Xantolis_racemosa,8,8,0,Points-PointsKO-Adjacents,30
Xantolis_siamensis,0,0,0,NA,0
Xantolis_stenosepala,2,2,0,Points-PointsKO-Adjacents,18
Xantolis_tomentosa,0,0,0,NA,0
Xantonnea_parvifolia,1,1,0,Points-PointsKO-Adjacents,9
Xantonnea_quocensis,2,2,0,Points-PointsKO-Adjacents,18
Xantonneopsis_robinsonii,1,1,0,Points-PointsKO-Adjacents,9
Xerochlamys_coriacea,21,14,7,Points-PointsKO-Adjacents,110
Xerochlamys_diospyroidea,32,1,31,Points-PointsKO-Adjacents,66
Xerochlamys_elliptica,8,6,2,Points-PointsKO-Adjacents,60
Xerochlamys_tampoketsensis,16,10,6,Points-PointsKO-Adjacents,86
Xerochlamys_undulata,38,32,6,Alphahull-PointsKO-Adjacents,364
Xerochlamys_villosa,27,19,8,Points-PointsKO-Adjacents,81
Xerophyta_argentea,1,1,0,Points-PointsKO-Adjacents,9
Xerophyta_kirkii,5,5,0,Points-PointsKO-Adjacents,21
Xerophyta_spekei,9,1,8,Points-PointsKO-Adjacents,75
Xerophyta_splendens,12,7,5,Points-PointsKO-Adjacents,46
Xerospermum_bonii,NA,NA,NA,NA,NA
Xerospermum_noronhianum,25,13,12,Points-PointsKO-Adjacents,210
Ximenia_americana,2185,1662,523,Alphahull-PointsKO-Adjacents,92467
Ximenia_caffra,243,163,80,Alphahull-PointsKO-Adjacents,13029
Ximenia_coriacea,115,96,19,Alphahull-PointsKO-Adjacents,3285
Ximenia_perrieri,17,10,7,Points-PointsKO-Adjacents,117
Ximenia_roigii,NA,NA,NA,NA,NA
Ximeniopsis_horridus,3,3,0,Points-PointsKO-Adjacents,21
Xolocotzia_asperifolia,6,1,5,Points-PointsKO-Adjacents,25
Xylia_africana,9,1,8,Points-PointsKO-Adjacents,54
Xylia_evansii,55,42,13,Alphahull-PointsKO-Adjacents,1953
Xylia_fraterna,20,12,8,Points-PointsKO-Adjacents,107
Xylia_ghesquierei,9,4,5,Points-PointsKO-Adjacents,69
Xylia_hoffmannii,58,42,16,Alphahull-PointsKO-Adjacents,568
Xylia_mendoncae,0,0,0,NA,0
Xylia_schliebenii,4,3,1,Points-PointsKO-Adjacents,35
Xylia_torreana,24,8,16,Points-PointsKO-Adjacents,191
Xylia_xylocarpa,16,5,11,Points-PointsKO-Adjacents,144
Xylocarpus_granatum,228,109,119,Alphahull-PointsKO-Adjacents,1634
Xylocarpus_moluccensis,279,196,83,Alphahull-PointsKO-Adjacents,3413
Xylocarpus_rumphii,23,0,23,Points-PointsKO-Adjacents,144
Xyloolaena_humbertii,6,1,5,Points-PointsKO-Adjacents,21
Xyloolaena_perrieri,37,22,15,Alphahull-PointsKO-Adjacents,113
Xyloolaena_richardii,75,58,17,Alphahull-PointsKO-Adjacents,1019
Xyloolaena_sambiranensis,26,19,7,Points-PointsKO-Adjacents,82
Xyloolaena_speciosa,17,10,7,Points-PointsKO-Adjacents,82
Xylopia_acutiflora,158,107,51,Alphahull-PointsKO-Adjacents,6864
Xylopia_aethiopica,464,375,89,Alphahull-PointsKO-Adjacents,10308
Xylopia_africana,35,24,11,Alphahull-PointsKO-Adjacents,151
Xylopia_amazonica,260,199,61,Alphahull-PointsKO-Adjacents,32329
Xylopia_ambanjensis,16,0,16,Points-PointsKO-Adjacents,95
Xylopia_amoena,3,3,0,Points-PointsKO-Adjacents,27
Xylopia_amplexicaulis,0,0,0,NA,0
Xylopia_arenaria,31,18,13,Points-PointsKO-Adjacents,155
Xylopia_aromatica,2677,2466,211,Alphahull-PointsKO-Adjacents,116928
Xylopia_aurantiiodora,10,3,7,Points-PointsKO-Adjacents,75
Xylopia_barbata,28,0,28,Points-PointsKO-Adjacents,213
Xylopia_beananensis,21,6,15,Points-PointsKO-Adjacents,113
Xylopia_bemarivensis,28,14,14,Points-PointsKO-Adjacents,161
Xylopia_benthamii,488,420,68,Alphahull-PointsKO-Adjacents,62226
Xylopia_bocatorena,153,135,18,Alphahull-PointsKO-Adjacents,426
Xylopia_brasiliensis,408,0,408,Points-PointsKO-Adjacents,2540
Xylopia_buxifolia,46,29,17,Alphahull-PointsKO-Adjacents,679
Xylopia_calophylla,78,43,35,Alphahull-PointsKO-Adjacents,7857
Xylopia_capuronii,2,2,0,Points-PointsKO-Adjacents,18
Xylopia_caudata,3,1,2,Points-PointsKO-Adjacents,21
Xylopia_cayennensis,59,31,28,Alphahull-PointsKO-Adjacents,2980
Xylopia_chrysophylla,9,2,7,Points-PointsKO-Adjacents,53
Xylopia_collina,23,13,10,Points-PointsKO-Adjacents,128
Xylopia_columbiana,26,16,10,Points-PointsKO-Adjacents,132
Xylopia_conjungens,6,0,6,Points-PointsKO-Adjacents,54
Xylopia_coriifolia,1,1,0,Points-PointsKO-Adjacents,9
Xylopia_crinita,29,8,21,Points-PointsKO-Adjacents,201
Xylopia_cupularis,20,8,12,Points-PointsKO-Adjacents,130
Xylopia_cuspidata,286,238,48,Alphahull-PointsKO-Adjacents,13673
Xylopia_danguyella,9,0,9,Points-PointsKO-Adjacents,72
Xylopia_decorticans,16,1,15,Points-PointsKO-Adjacents,42
Xylopia_dehiscens,6,1,5,Points-PointsKO-Adjacents,54
Xylopia_densiflora,0,0,0,NA,0
Xylopia_densifolia,5,0,5,Points-PointsKO-Adjacents,31
Xylopia_dielsii,2,2,0,Points-PointsKO-Adjacents,18
Xylopia_discreta,146,82,64,Alphahull-PointsKO-Adjacents,9345
Xylopia_elliotii,9,4,5,Points-PointsKO-Adjacents,81
Xylopia_elliptica,6,0,6,Points-PointsKO-Adjacents,54
Xylopia_emarginata,616,510,106,Alphahull-PointsKO-Adjacents,63656
Xylopia_excellens,50,24,26,Alphahull-PointsKO-Adjacents,1281
Xylopia_fananehanensis,5,1,4,Points-PointsKO-Adjacents,30
Xylopia_ferruginea,15,4,11,Points-PointsKO-Adjacents,110
Xylopia_flamignii,2,2,0,Points-PointsKO-Adjacents,18
Xylopia_flexuosa,8,1,7,Points-PointsKO-Adjacents,57
Xylopia_frutescens,892,686,206,Alphahull-PointsKO-Adjacents,53569
Xylopia_fusca,1,1,0,Points-PointsKO-Adjacents,9
Xylopia_gilbertii,8,0,8,Points-PointsKO-Adjacents,56
Xylopia_humblotiana,53,25,28,Alphahull-PointsKO-Adjacents,258
Xylopia_hypolampra,78,0,78,Points-PointsKO-Adjacents,498
Xylopia_katangensis,8,0,8,Points-PointsKO-Adjacents,69
Xylopia_kuchingensis,0,0,0,NA,0
Xylopia_laevigata,365,280,85,Alphahull-PointsKO-Adjacents,6892
Xylopia_lamii,6,0,6,Points-PointsKO-Adjacents,48
Xylopia_langsdorfiana,103,71,32,Alphahull-PointsKO-Adjacents,651
Xylopia_lastelliana,14,3,11,Points-PointsKO-Adjacents,102
Xylopia_latipetala,4,4,0,Points-PointsKO-Adjacents,15
Xylopia_lemurica,19,0,19,Points-PointsKO-Adjacents,82
Xylopia_lenombe,0,0,0,NA,0
Xylopia_le-testui,56,31,25,Alphahull-PointsKO-Adjacents,1379
Xylopia_ligustrifolia,109,68,41,Alphahull-PointsKO-Adjacents,9110
Xylopia_longicuspis,1,1,0,Points-PointsKO-Adjacents,9
Xylopia_longipetala,183,130,53,Alphahull-PointsKO-Adjacents,6144
Melodorum_maccreai,10,1,9,Points-PointsKO-Adjacents,78
Xylopia_macrantha,93,68,25,Alphahull-PointsKO-Adjacents,1152
Xylopia_madagascariensis,1,1,0,Points-PointsKO-Adjacents,6
Xylopia_malayana,27,9,18,Points-PointsKO-Adjacents,200
Xylopia_micans,24,11,13,Points-PointsKO-Adjacents,183
Xylopia_mildbraedii,16,5,11,Points-PointsKO-Adjacents,136
Xylopia_mucronata,18,3,15,Points-PointsKO-Adjacents,136
Xylopia_multiflora,87,56,31,Alphahull-PointsKO-Adjacents,10317
Xylopia_mwasumbii,10,2,8,Points-PointsKO-Adjacents,62
Xylopia_nervosa,34,1,33,Points-PointsKO-Adjacents,287
Xylopia_nitida,157,111,46,Alphahull-PointsKO-Adjacents,24462
Xylopia_ochrantha,97,55,42,Alphahull-PointsKO-Adjacents,654
Xylopia_odoratissima,9,0,9,Points-PointsKO-Adjacents,81
Xylopia_orestera,0,0,0,NA,0
Xylopia_orinocensis,4,4,0,Points-PointsKO-Adjacents,26
Xylopia_panamensis,11,8,3,Points-PointsKO-Adjacents,41
Xylopia_paniculata,0,0,0,NA,0
Xylopia_parviflora,155,103,52,Alphahull-PointsKO-Adjacents,2267
Xylopia_perrieri,20,7,13,Points-PointsKO-Adjacents,151
Xylopia_peruviana,14,2,12,Points-PointsKO-Adjacents,117
Xylopia_phloiodora,32,19,13,Points-PointsKO-Adjacents,231
Xylopia_pittieri,7,0,7,Points-PointsKO-Adjacents,59
Xylopia_plowmanii,16,4,12,Points-PointsKO-Adjacents,125
Xylopia_polyantha,72,30,42,Alphahull-PointsKO-Adjacents,15983
Xylopia_pulchella,0,0,0,NA,0
Xylopia_pulcherrima,27,13,14,Points-PointsKO-Adjacents,187
Xylopia_pynaertii,28,1,27,Points-PointsKO-Adjacents,161
Xylopia_quintasii,152,122,30,Alphahull-PointsKO-Adjacents,3564
Xylopia_richardii,2,2,0,Points-PointsKO-Adjacents,18
Xylopia_rubescens,94,64,30,Alphahull-PointsKO-Adjacents,2096
Xylopia_sahafariensis,5,5,0,Points-PointsKO-Adjacents,36
Xylopia_sericea,1001,843,158,Alphahull-PointsKO-Adjacents,71612
Xylopia_sericolampra,3,3,0,Points-PointsKO-Adjacents,27
Xylopia_sericophylla,47,35,12,Alphahull-PointsKO-Adjacents,271
Xylopia_spruceana,74,51,23,Alphahull-PointsKO-Adjacents,4730
Xylopia_staudtii,112,0,112,Points-PointsKO-Adjacents,681
Xylopia_stenopetala,6,0,6,Points-PointsKO-Adjacents,54
Alphonsea_subdehiscens,5,5,0,Points-PointsKO-Adjacents,36
Xylopia_surinamensis,6,1,5,Points-PointsKO-Adjacents,54
Xylopia_talbotii,0,0,0,NA,0
Xylopia_toussaintii,1,1,0,Points-PointsKO-Adjacents,9
Xylopia_trichostemon,9,0,9,Points-PointsKO-Adjacents,81
Xylopia_venezuelana,7,3,4,Points-PointsKO-Adjacents,63
Xylopia_vielana,7,0,7,Points-PointsKO-Adjacents,39
Xylopia_villosa,61,34,27,Alphahull-PointsKO-Adjacents,1499
Xylopia_wilwerthii,7,2,5,Points-PointsKO-Adjacents,42
Xylopia_xylantha,8,1,7,Points-PointsKO-Adjacents,70
Xylosma_avilae,NA,NA,NA,NA,NA
Xylosma_bahamensis,3,3,0,Points-PointsKO-Adjacents,21
Xylosma_benthamii,273,154,119,Alphahull-PointsKO-Adjacents,25262
Xylosma_boliviana,6,2,4,Points-PointsKO-Adjacents,52
Xylosma_buxifolia,37,10,27,Points-PointsKO-Adjacents,198
Xylosma_characantha,77,55,22,Alphahull-PointsKO-Adjacents,1857
Xylosma_chlorantha,97,75,22,Alphahull-PointsKO-Adjacents,1889
Xylosma_ciliatifolia,536,436,100,Alphahull-PointsKO-Adjacents,24225
Xylosma_cinerea,80,46,34,Alphahull-PointsKO-Adjacents,2544
Xylosma_controversa,60,0,60,Points-PointsKO-Adjacents,534
Xylosma_cordata,4,4,0,Points-PointsKO-Adjacents,36
Xylosma_coriacea,0,0,0,NA,0
Xylosma_crenata,4,4,0,Points-PointsKO-Adjacents,8
Xylosma_domingensis,1,0,1,Points-PointsKO-Adjacents,9
Xylosma_flexuosa,981,847,134,Alphahull-PointsKO-Adjacents,14316
Xylosma_glaberrima,114,0,114,Points-PointsKO-Adjacents,645
Lasiochlamys_grossecrenata,1,1,0,Points-PointsKO-Adjacents,9
Xylosma_hispidula,85,73,12,Alphahull-PointsKO-Adjacents,407
Xylosma_intermedia,167,97,70,Alphahull-PointsKO-Adjacents,4589
Xylosma_longifolia,43,13,30,Points-PointsKO-Adjacents,387
Xylosma_longipetiolata,19,10,9,Points-PointsKO-Adjacents,158
Xylosma_lucida,7,2,5,Points-PointsKO-Adjacents,63
Xylosma_nitida,4,4,0,Points-PointsKO-Adjacents,21
Xylosma_obovata,5,5,0,Points-PointsKO-Adjacents,34
Xylosma_oligandra,178,146,32,Alphahull-PointsKO-Adjacents,2295
Xylosma_pachyphylla,3,2,1,Points-PointsKO-Adjacents,15
Xylosma_panamensis,175,122,53,Alphahull-PointsKO-Adjacents,4451
Xylosma_paucinervosa,3,3,0,Points-PointsKO-Adjacents,27
Lasiochlamys_peltata,1,1,0,Points-PointsKO-Adjacents,9
Xylosma_prockia,354,277,77,Alphahull-PointsKO-Adjacents,11942
Xylosma_pseudosalzmanii,64,35,29,Alphahull-PointsKO-Adjacents,4538
Xylosma_pubescens,49,22,27,Alphahull-PointsKO-Adjacents,590
Xylosma_quichensis,88,0,88,Points-PointsKO-Adjacents,431
Xylosma_raimondii,0,0,0,NA,0
Xylosma_rubicunda,24,8,16,Points-PointsKO-Adjacents,178
Xylosma_ruiziana,1,1,0,Points-PointsKO-Adjacents,9
Xylosma_rusbyana,5,5,0,Points-PointsKO-Adjacents,45
Xylosma_schaefferioides,8,5,3,Points-PointsKO-Adjacents,38
Xylosma_schroederi,12,6,6,Points-PointsKO-Adjacents,88
Xylosma_schwaneckeana,7,4,3,Points-PointsKO-Adjacents,18
Xylosma_serrata,0,0,0,NA,0
Xylosma_spiculifera,64,39,25,Alphahull-PointsKO-Adjacents,473
Xylosma_tessmannii,168,113,55,Alphahull-PointsKO-Adjacents,13522
Xylosma_tweediana,394,348,46,Alphahull-PointsKO-Adjacents,10100
Xylosma_velutina,183,112,71,Alphahull-PointsKO-Adjacents,3017
Xylosma_venosa,377,315,62,Alphahull-PointsKO-Adjacents,14817
Xylotheca_kraussiana,56,0,56,Points-PointsKO-Adjacents,416
Xylotheca_tettensis,102,69,33,Alphahull-PointsKO-Adjacents,1710
Xymalos_monospora,347,266,81,Alphahull-PointsKO-Adjacents,9977
Yasunia_sessiliflora,8,6,2,Points-PointsKO-Adjacents,56
Yucca_aloifolia,138,80,58,Alphahull-PointsKO-Adjacents,4996
Yucca_baccata,1413,1376,37,Alphahull-PointsKO-Adjacents,10983
Yucca_brevifolia,987,0,987,Points-PointsKO-Adjacents,1493
Yucca_capensis,9,1,8,Points-PointsKO-Adjacents,52
Yucca_carnerosana,79,77,2,Alphahull-PointsKO-Adjacents,3882
Yucca_decipiens,41,27,14,Alphahull-PointsKO-Adjacents,941
Yucca_declinata,1,1,0,Points-PointsKO-Adjacents,9
Yucca_elata,1522,1464,58,Alphahull-PointsKO-Adjacents,7239
Yucca_faxoniana,91,82,9,Alphahull-PointsKO-Adjacents,4443
Yucca_filifera,193,178,15,Alphahull-PointsKO-Adjacents,4679
Yucca_gigantea,40,17,23,Points-PointsKO-Adjacents,287
Yucca_glauca,1225,1141,84,Alphahull-PointsKO-Adjacents,27267
Yucca_gloriosa,61,18,43,Points-PointsKO-Adjacents,432
Yucca_grandiflora,14,0,14,Points-PointsKO-Adjacents,98
Yucca_jaliscensis,17,5,12,Points-PointsKO-Adjacents,113
Yucca_madrensis,73,54,19,Alphahull-PointsKO-Adjacents,744
Yucca_mixtecana,27,24,3,Alphahull-PointsKO-Adjacents,71
Yucca_periculosa,150,145,5,Alphahull-PointsKO-Adjacents,662
Yucca_potosina,9,1,8,Points-PointsKO-Adjacents,42
Yucca_queretaroensis,4,0,4,Points-PointsKO-Adjacents,28
Yucca_rostrata,43,33,10,Alphahull-PointsKO-Adjacents,1205
Yucca_schidigera,805,0,805,Points-PointsKO-Adjacents,1292
Yucca_thompsoniana,23,13,10,Points-PointsKO-Adjacents,189
Yucca_treculeana,233,188,45,Alphahull-PointsKO-Adjacents,8560
Yucca_valida,62,0,62,Points-PointsKO-Adjacents,306
Abelia_tyaihyoni,1,1,0,Points-PointsKO-Adjacents,9
Zanha_africana,28,6,22,Points-PointsKO-Adjacents,200
Zanha_golungensis,103,64,39,Alphahull-PointsKO-Adjacents,1235
Zanha_suaveolens,9,3,6,Points-PointsKO-Adjacents,62
Zanthoxylum_acanthopodium,91,61,30,Alphahull-PointsKO-Adjacents,2432
Zanthoxylum_aculeatissimum,5,5,0,Points-PointsKO-Adjacents,39
Zanthoxylum_acuminatum,612,451,161,Alphahull-PointsKO-Adjacents,15624
Zanthoxylum_ailanthoides,316,186,130,Alphahull-PointsKO-Adjacents,2684
Zanthoxylum_albuquerquei,4,4,0,Points-PointsKO-Adjacents,36
Zanthoxylum_amapaense,32,3,29,Points-PointsKO-Adjacents,260
Zanthoxylum_americanum,1186,875,311,Alphahull-PointsKO-Adjacents,37846
Zanthoxylum_anadenium,0,0,0,NA,0
Zanthoxylum_apiculatum,28,5,23,Points-PointsKO-Adjacents,243
Zanthoxylum_arborescens,140,109,31,Alphahull-PointsKO-Adjacents,1200
Zanthoxylum_armatum,454,353,101,Alphahull-PointsKO-Adjacents,23879
Zanthoxylum_austrosinense,10,2,8,Points-PointsKO-Adjacents,90
Zanthoxylum_avicennae,66,34,32,Alphahull-PointsKO-Adjacents,2351
Zanthoxylum_bifoliolatum,25,17,8,Points-PointsKO-Adjacents,128
Zanthoxylum_bouetense,9,2,7,Points-PointsKO-Adjacents,48
Zanthoxylum_brisasanum,12,1,11,Points-PointsKO-Adjacents,87
Zanthoxylum_bungeanum,126,87,39,Alphahull-PointsKO-Adjacents,8865
Zanthoxylum_capense,164,122,42,Alphahull-PointsKO-Adjacents,5405
Zanthoxylum_caribaeum,1091,813,278,Alphahull-PointsKO-Adjacents,46410
Zanthoxylum_chalybeum,47,18,29,Points-PointsKO-Adjacents,385
Zanthoxylum_ciliatum,59,27,32,Alphahull-PointsKO-Adjacents,242
Zanthoxylum_claessensii,8,2,6,Points-PointsKO-Adjacents,61
Zanthoxylum_clava-herculis,488,359,129,Alphahull-PointsKO-Adjacents,10636
Zanthoxylum_coco,134,100,34,Alphahull-PointsKO-Adjacents,4218
Zanthoxylum_comosum,7,0,7,Points-PointsKO-Adjacents,63
Zanthoxylum_compactum,137,81,56,Alphahull-PointsKO-Adjacents,11712
Zanthoxylum_coriaceum,7,2,5,Points-PointsKO-Adjacents,46
Zanthoxylum_culantrillo,66,32,34,Alphahull-PointsKO-Adjacents,329
Zanthoxylum_decaryi,31,15,16,Points-PointsKO-Adjacents,174
Zanthoxylum_deremense,53,35,18,Alphahull-PointsKO-Adjacents,1456
Zanthoxylum_dipetalum,11,4,7,Points-PointsKO-Adjacents,52
Zanthoxylum_djalma-batistae,15,8,7,Points-PointsKO-Adjacents,95
Zanthoxylum_ekmanii,49,0,49,Points-PointsKO-Adjacents,278
Zanthoxylum_elephantiasis,2,2,0,Points-PointsKO-Adjacents,15
Zanthoxylum_esquirolii,42,24,18,Alphahull-PointsKO-Adjacents,2316
Zanthoxylum_fagara,2372,2022,350,Alphahull-PointsKO-Adjacents,72744
Zanthoxylum_flavum,61,24,37,Alphahull-PointsKO-Adjacents,991
Zanthoxylum_formiciferum,19,6,13,Points-PointsKO-Adjacents,154
Zanthoxylum_gardneri,101,67,34,Alphahull-PointsKO-Adjacents,8557
Zanthoxylum_gentryi,14,5,9,Points-PointsKO-Adjacents,77
Zanthoxylum_gilletii,168,92,76,Alphahull-PointsKO-Adjacents,8357
Zanthoxylum_harrisii,4,3,1,Points-PointsKO-Adjacents,30
Zanthoxylum_hawaiiense,2,2,0,Points-PointsKO-Adjacents,8
Zanthoxylum_heitzii,50,31,19,Alphahull-PointsKO-Adjacents,1938
Zanthoxylum_heterophyllum,0,0,0,NA,0
Zanthoxylum_holtzianum,20,13,7,Points-PointsKO-Adjacents,133
Zanthoxylum_huberi,61,24,37,Alphahull-PointsKO-Adjacents,1086
Zanthoxylum_integrifolium,1,1,0,Points-PointsKO-Adjacents,6
Zanthoxylum_juniperinum,83,55,28,Alphahull-PointsKO-Adjacents,603
Zanthoxylum_kauaense,28,15,13,Points-PointsKO-Adjacents,126
Zanthoxylum_khasianum,5,5,0,Points-PointsKO-Adjacents,45
Zanthoxylum_kleinii,159,133,26,Alphahull-PointsKO-Adjacents,2377
Zanthoxylum_laurentii,8,3,5,Points-PointsKO-Adjacents,60
Zanthoxylum_lemairei,22,5,17,Points-PointsKO-Adjacents,171
Zanthoxylum_lenticellosum,0,0,0,NA,0
Zanthoxylum_lenticulare,37,27,10,Alphahull-PointsKO-Adjacents,467
Zanthoxylum_lepidopteriphilum,34,16,18,Points-PointsKO-Adjacents,261
Zanthoxylum_leprieurii,125,48,77,Alphahull-PointsKO-Adjacents,1081
Zanthoxylum_limoncello,194,143,51,Alphahull-PointsKO-Adjacents,911
Zanthoxylum_lindense,6,2,4,Points-PointsKO-Adjacents,46
Zanthoxylum_madagascariense,40,23,17,Alphahull-PointsKO-Adjacents,407
Zanthoxylum_mantaro,9,0,9,Points-PointsKO-Adjacents,81
Zanthoxylum_martinicense,53,29,24,Alphahull-PointsKO-Adjacents,1194
Zanthoxylum_megistophyllum,0,0,0,NA,0
Zanthoxylum_melanostictum,420,343,77,Alphahull-PointsKO-Adjacents,4527
Zanthoxylum_mezoneurispinosum,9,4,5,Points-PointsKO-Adjacents,46
Zanthoxylum_micranthum,20,4,16,Points-PointsKO-Adjacents,180
Zanthoxylum_mildbraedii,8,3,5,Points-PointsKO-Adjacents,64
Zanthoxylum_molle,17,0,17,Points-PointsKO-Adjacents,153
Zanthoxylum_mollissimum,97,55,42,Alphahull-PointsKO-Adjacents,1404
Zanthoxylum_monogynum,328,249,79,Alphahull-PointsKO-Adjacents,14160
Zanthoxylum_motuoense,NA,NA,NA,NA,NA
Zanthoxylum_myriacanthum,39,18,21,Points-PointsKO-Adjacents,351
Zanthoxylum_nebuletorum,10,6,4,Points-PointsKO-Adjacents,71
Zanthoxylum_nemorale,43,27,16,Alphahull-PointsKO-Adjacents,290
Zanthoxylum_nitidum,221,125,96,Alphahull-PointsKO-Adjacents,4926
Zanthoxylum_oahuense,0,0,0,NA,0
Zanthoxylum_ovalifolium,102,0,102,Points-PointsKO-Adjacents,160
Zanthoxylum_ovatifoliolatum,3,3,0,Points-PointsKO-Adjacents,27
Zanthoxylum_oxyphyllum,15,1,14,Points-PointsKO-Adjacents,135
Zanthoxylum_panamense,39,27,12,Alphahull-PointsKO-Adjacents,531
Zanthoxylum_paniculatum,0,0,0,NA,0
Zanthoxylum_paracanthum,10,4,6,Points-PointsKO-Adjacents,59
Zanthoxylum_paulae,15,1,14,Points-PointsKO-Adjacents,133
Zanthoxylum_pentandrum,44,0,44,Points-PointsKO-Adjacents,359
Zanthoxylum_petiolare,574,475,99,Alphahull-PointsKO-Adjacents,35434
Zanthoxylum_piasezkii,9,3,6,Points-PointsKO-Adjacents,80
Zanthoxylum_pilosiusculum,5,3,2,Points-PointsKO-Adjacents,36
Zanthoxylum_pimpinelloides,10,0,10,Points-PointsKO-Adjacents,79
Zanthoxylum_blackburnia,33,15,18,Points-PointsKO-Adjacents,119
Zanthoxylum_pteracanthum,0,0,0,NA,0
Zanthoxylum_pucro,32,18,14,Points-PointsKO-Adjacents,163
Zanthoxylum_punctatum,46,19,27,Points-PointsKO-Adjacents,231
Zanthoxylum_quinduense,123,98,25,Alphahull-PointsKO-Adjacents,1893
Zanthoxylum_retusum,12,5,7,Points-PointsKO-Adjacents,93
Zanthoxylum_rhoifolium,3706,3401,305,Alphahull-PointsKO-Adjacents,132811
Zanthoxylum_riedelianum,979,847,132,Alphahull-PointsKO-Adjacents,46876
Zanthoxylum_rigidum,112,68,44,Alphahull-PointsKO-Adjacents,2895
Zanthoxylum_rubescens,42,14,28,Points-PointsKO-Adjacents,335
Zanthoxylum_schreberi,200,122,78,Alphahull-PointsKO-Adjacents,4754
Zanthoxylum_setulosum,186,144,42,Alphahull-PointsKO-Adjacents,3179
Zanthoxylum_spinosum,12,8,4,Points-PointsKO-Adjacents,81
Zanthoxylum_sprucei,245,191,54,Alphahull-PointsKO-Adjacents,20099
Zanthoxylum_stelligerum,186,163,23,Alphahull-PointsKO-Adjacents,6663
Zanthoxylum_stenophyllum,48,27,21,Alphahull-PointsKO-Adjacents,5256
Zanthoxylum_stipitatum,4,3,1,Points-PointsKO-Adjacents,36
Zanthoxylum_subspicatum,2,2,0,Points-PointsKO-Adjacents,18
Zanthoxylum_syncarpum,103,69,34,Alphahull-PointsKO-Adjacents,4474
Zanthoxylum_taediosum,9,0,9,Points-PointsKO-Adjacents,79
Zanthoxylum_tambopatense,2,2,0,Points-PointsKO-Adjacents,18
Zanthoxylum_thomasianum,2,1,1,Points-PointsKO-Adjacents,15
Zanthoxylum_thorncroftii,10,5,5,Points-PointsKO-Adjacents,90
Zanthoxylum_thouvenotii,13,5,8,Points-PointsKO-Adjacents,80
Zanthoxylum_tingoassuiba,129,88,41,Alphahull-PointsKO-Adjacents,5435
Zanthoxylum_tragodes,32,6,26,Points-PointsKO-Adjacents,208
Zanthoxylum_trijugum,8,0,8,Points-PointsKO-Adjacents,54
Zanthoxylum_tsihanimposa,17,5,12,Points-PointsKO-Adjacents,106
Zanthoxylum_undulatifolium,8,3,5,Points-PointsKO-Adjacents,72
Zanthoxylum_usambarense,11,0,11,Points-PointsKO-Adjacents,87
Zanthoxylum_verrucosum,40,26,14,Alphahull-PointsKO-Adjacents,500
Zanthoxylum_viride,23,6,17,Points-PointsKO-Adjacents,167
Zanthoxylum_zanthoxyloides,617,572,45,Alphahull-PointsKO-Adjacents,7312
Zapoteca_aculeata,7,3,4,Points-PointsKO-Adjacents,41
Zapoteca_alinae,20,13,7,Points-PointsKO-Adjacents,83
Zapoteca_amazonica,56,0,56,Points-PointsKO-Adjacents,452
Zapoteca_caracasana,51,22,29,Alphahull-PointsKO-Adjacents,642
Zapoteca_formosa,1280,1026,254,Alphahull-PointsKO-Adjacents,24099
Zapoteca_gracilis,7,2,5,Points-PointsKO-Adjacents,45
Zapoteca_nervosa,6,2,4,Points-PointsKO-Adjacents,32
Zapoteca_portoricensis,524,400,124,Alphahull-PointsKO-Adjacents,7515
Zapoteca_tehuana,19,13,6,Points-PointsKO-Adjacents,43
Zapoteca_tetragona,442,333,109,Alphahull-PointsKO-Adjacents,10578
Zelkova_abelicea,6,1,5,Points-PointsKO-Adjacents,27
Zelkova_carpinifolia,55,38,17,Alphahull-PointsKO-Adjacents,116
Zelkova_schneideriana,37,11,26,Points-PointsKO-Adjacents,329
Zelkova_serrata,488,279,209,Alphahull-PointsKO-Adjacents,3604
Zelkova_sicula,2,2,0,Points-PointsKO-Adjacents,12
Zelkova_sinica,9,0,9,Points-PointsKO-Adjacents,81
Zenia_insignis,18,10,8,Points-PointsKO-Adjacents,162
Zenkerella_capparidacea,25,13,12,Points-PointsKO-Adjacents,93
Zenkerella_citrina,40,29,11,Alphahull-PointsKO-Adjacents,493
Zenkerella_egregia,10,5,5,Points-PointsKO-Adjacents,42
Zenkerella_grotei,9,4,5,Points-PointsKO-Adjacents,36
Zenkerella_perplexa,3,3,0,Points-PointsKO-Adjacents,23
Zenkerella_schliebenii,1,0,1,Points-PointsKO-Adjacents,9
Zeyherella_mayumbensis,37,28,9,Alphahull-PointsKO-Adjacents,598
Zeyheria_montana,946,852,94,Alphahull-PointsKO-Adjacents,28348
Zeyheria_tuberculosa,674,600,74,Alphahull-PointsKO-Adjacents,23354
Zinowiewia_australis,63,23,40,Alphahull-PointsKO-Adjacents,702
Zinowiewia_aymardii,6,0,6,Points-PointsKO-Adjacents,51
Zinowiewia_concinna,92,72,20,Alphahull-PointsKO-Adjacents,1995
Zinowiewia_costaricensis,103,80,23,Alphahull-PointsKO-Adjacents,396
Zinowiewia_cuneifolia,10,3,7,Points-PointsKO-Adjacents,39
Zinowiewia_integerrima,278,229,49,Alphahull-PointsKO-Adjacents,3223
Zinowiewia_madsenii,7,2,5,Points-PointsKO-Adjacents,51
Zinowiewia_matudae,70,0,70,Points-PointsKO-Adjacents,189
Zinowiewia_micrantha,4,4,0,Points-PointsKO-Adjacents,27
Zinowiewia_pallida,8,5,3,Points-PointsKO-Adjacents,51
Zinowiewia_rubra,75,58,17,Alphahull-PointsKO-Adjacents,455
Zinowiewia_sulphurea,1,1,0,Points-PointsKO-Adjacents,9
Zinowiewia_tacanensis,72,0,72,Points-PointsKO-Adjacents,206
Ziziphus_abyssinica,243,134,109,Alphahull-PointsKO-Adjacents,5196
Ziziphus_amole,486,413,73,Alphahull-PointsKO-Adjacents,6723
Ziziphus_celata,3,3,0,Points-PointsKO-Adjacents,27
Ziziphus_chloroxylon,15,11,4,Points-PointsKO-Adjacents,53
Ziziphus_cinnamomum,194,105,89,Alphahull-PointsKO-Adjacents,7850
Ziziphus_cotinifolia,240,206,34,Alphahull-PointsKO-Adjacents,10140
Sarcomphalus_crenatus,1,1,0,Points-PointsKO-Adjacents,9
Ziziphus_cyclocardia,6,0,6,Points-PointsKO-Adjacents,49
Celtis_grewioides,0,0,0,NA,0
Ziziphus_guatemalensis,99,1,98,Points-PointsKO-Adjacents,358
Ziziphus_incurva,36,21,15,Alphahull-PointsKO-Adjacents,1536
Ziziphus_joazeiro,1004,913,91,Alphahull-PointsKO-Adjacents,19801
Ziziphus_jujuba,160,101,59,Alphahull-PointsKO-Adjacents,16773
Ziziphus_laui,5,4,1,Points-PointsKO-Adjacents,36
Ziziphus_mairei,2,2,0,Points-PointsKO-Adjacents,18
Ziziphus_mauritiana,261,0,261,Points-PointsKO-Adjacents,1725
Ziziphus_melastomoides,0,0,0,NA,0
Ziziphus_mexicana,113,89,24,Alphahull-PointsKO-Adjacents,753
Ziziphus_montana,10,5,5,Points-PointsKO-Adjacents,88
Ziziphus_mucronata,688,536,152,Alphahull-PointsKO-Adjacents,33686
Ziziphus_nummularia,26,4,22,Points-PointsKO-Adjacents,210
Ziziphus_obtusifolia,806,731,75,Alphahull-PointsKO-Adjacents,22841
Ziziphus_oenopolia,214,169,45,Alphahull-PointsKO-Adjacents,2560
Ziziphus_piurensis,6,2,4,Points-PointsKO-Adjacents,52
Ziziphus_pubescens,2,2,0,Points-PointsKO-Adjacents,18
Ziziphus_pubinervis,1,1,0,Points-PointsKO-Adjacents,9
Ziziphus_reticulata,38,22,16,Alphahull-PointsKO-Adjacents,258
Ziziphus_rignonii,42,27,15,Alphahull-PointsKO-Adjacents,328
Ziziphus_rivularis,20,1,19,Points-PointsKO-Adjacents,156
Ziziphus_robertsoniana,7,2,5,Points-PointsKO-Adjacents,32
Ziziphus_rugosa,28,1,27,Points-PointsKO-Adjacents,237
Ziziphus_saeri,34,15,19,Points-PointsKO-Adjacents,284
Sarcomphalus_laurinus,7,1,6,Points-PointsKO-Adjacents,47
Ziziphus_sonorensis,160,120,40,Alphahull-PointsKO-Adjacents,3002
Ziziphus_spina-christi,31,5,26,Points-PointsKO-Adjacents,251
Ziziphus_strychnifolia,17,5,12,Points-PointsKO-Adjacents,135
Ziziphus_taylorii,9,1,8,Points-PointsKO-Adjacents,22
Ziziphus_thyrsiflora,62,48,14,Alphahull-PointsKO-Adjacents,471
Ziziphus_undulata,67,32,35,Alphahull-PointsKO-Adjacents,2846
Ziziphus_xiangchengensis,2,2,0,Points-PointsKO-Adjacents,18
Ziziphus_xylopyrus,1,1,0,Points-PointsKO-Adjacents,9
Ziziphus_yucatanensis,46,1,45,Points-PointsKO-Adjacents,146
Zollernia_glabra,112,0,112,Points-PointsKO-Adjacents,544
Zollernia_glaziovii,16,0,16,Points-PointsKO-Adjacents,92
Zollernia_grandifolia,13,7,6,Points-PointsKO-Adjacents,86
Zollernia_ilicifolia,570,469,101,Alphahull-PointsKO-Adjacents,13687
Zollernia_kanukuensis,13,6,7,Points-PointsKO-Adjacents,98
Zollernia_magnifica,26,2,24,Points-PointsKO-Adjacents,147
Zollernia_modesta,34,19,15,Points-PointsKO-Adjacents,230
Zollernia_paraensis,106,66,40,Alphahull-PointsKO-Adjacents,7794
Tristira_triptera,7,2,5,Points-PointsKO-Adjacents,53
Zombia_antillarum,6,1,5,Points-PointsKO-Adjacents,51
Zuccarinia_macrophylla,1,1,0,Points-PointsKO-Adjacents,9
Zuelania_guidonia,502,404,98,Alphahull-PointsKO-Adjacents,10774
Zygia_ampla,130,77,53,Alphahull-PointsKO-Adjacents,7708
Zygia_andaquiensis,3,3,0,Points-PointsKO-Adjacents,24
Zygia_bangii,2,2,0,Points-PointsKO-Adjacents,18
Zygia_basijuga,45,16,29,Points-PointsKO-Adjacents,380
Zygia_biblora,NA,NA,NA,NA,NA
Zygia_bifoliola,2,2,0,Points-PointsKO-Adjacents,18
Zygia_bisingula,4,4,0,Points-PointsKO-Adjacents,36
Zygia_brenesii,87,76,11,Alphahull-PointsKO-Adjacents,171
Zygia_cataractae,700,584,116,Alphahull-PointsKO-Adjacents,72001
Zygia_cauliflora,46,26,20,Alphahull-PointsKO-Adjacents,1088
Zygia_claviflora,109,70,39,Alphahull-PointsKO-Adjacents,4966
Zygia_coccinea,296,253,43,Alphahull-PointsKO-Adjacents,7938
Zygia_codonocalyx,2,2,0,Points-PointsKO-Adjacents,9
Zygia_cognata,93,60,33,Alphahull-PointsKO-Adjacents,1210
Zygia_collina,13,1,12,Points-PointsKO-Adjacents,111
Zygia_confusa,21,10,11,Points-PointsKO-Adjacents,82
Zygia_conzattii,157,114,43,Alphahull-PointsKO-Adjacents,3358
Zygia_cupirensis,7,0,7,Points-PointsKO-Adjacents,42
Zygia_dinizii,79,37,42,Alphahull-PointsKO-Adjacents,4976
Zygia_dissitiflora,9,2,7,Points-PointsKO-Adjacents,63
Zygia_englesingii,54,38,16,Alphahull-PointsKO-Adjacents,610
Zygia_garcia-barrigae,2,2,0,Points-PointsKO-Adjacents,18
Zygia_gigantifoliola,57,46,11,Alphahull-PointsKO-Adjacents,320
Zygia_guinetii,3,3,0,Points-PointsKO-Adjacents,27
Zygia_hernandezii,3,3,0,Points-PointsKO-Adjacents,27
Zygia_heteroneura,42,34,8,Alphahull-PointsKO-Adjacents,369
Zygia_inaequalis,717,629,88,Alphahull-PointsKO-Adjacents,64420
Zygia_inundata,53,0,53,Points-PointsKO-Adjacents,436
Zygia_juruana,91,36,55,Alphahull-PointsKO-Adjacents,4680
Zygia_lathetica,38,30,8,Alphahull-PointsKO-Adjacents,337
Zygia_latifolia,1429,1250,179,Alphahull-PointsKO-Adjacents,120036
Zygia_lehmannii,3,3,0,Points-PointsKO-Adjacents,27
Zygia_longifolia,624,515,109,Alphahull-PointsKO-Adjacents,25187
Zygia_macbridii,15,7,8,Points-PointsKO-Adjacents,91
Zygia_megistocarpa,19,13,6,Points-PointsKO-Adjacents,86
Zygia_morongii,24,13,11,Points-PointsKO-Adjacents,203
Zygia_multipunctata,6,1,5,Points-PointsKO-Adjacents,39
Zygia_ocumarensis,13,4,9,Points-PointsKO-Adjacents,110
Zygia_odoratissima,6,0,6,Points-PointsKO-Adjacents,54
Zygia_palustris,15,7,8,Points-PointsKO-Adjacents,80
Zygia_paucijugata,14,7,7,Points-PointsKO-Adjacents,90
Zygia_peckii,53,36,17,Alphahull-PointsKO-Adjacents,906
Zygia_picramnioides,22,13,9,Points-PointsKO-Adjacents,166
Zygia_pithecolobioides,28,12,16,Points-PointsKO-Adjacents,215
Zygia_potaroensis,3,3,0,Points-PointsKO-Adjacents,27
Zygia_racemosa,281,225,56,Alphahull-PointsKO-Adjacents,19507
Zygia_rubiginosa,9,4,5,Points-PointsKO-Adjacents,22
Zygia_sabatieri,7,4,3,Points-PointsKO-Adjacents,42
Zygia_selloi,9,0,9,Points-PointsKO-Adjacents,56
Zygia_steyermarkii,2,2,0,Points-PointsKO-Adjacents,18
Zygia_tetragona,9,7,2,Points-PointsKO-Adjacents,57
Zygia_transamazonica,6,1,5,Points-PointsKO-Adjacents,54
Zygia_trunciflora,22,14,8,Points-PointsKO-Adjacents,123
Zygia_turneri,5,2,3,Points-PointsKO-Adjacents,39
Zygia_unifoliolata,308,228,80,Alphahull-PointsKO-Adjacents,26389
Zygogynum_amplexicaule,70,57,13,Alphahull-PointsKO-Adjacents,126
Zygogynum_comptonii,21,11,10,Points-PointsKO-Adjacents,79
Zygogynum_crassifolium,11,5,6,Points-PointsKO-Adjacents,62
Zygogynum_pancheri,135,121,14,Alphahull-PointsKO-Adjacents,172
Zygogynum_pauciflorum,11,7,4,Points-PointsKO-Adjacents,29
Zygophyllum_darvasicum,NA,NA,NA,NA,NA
